ReviewId,ReviewerId,CommentIndex,NumOfVotes,NumOfCurrent,NumOfincurrent,CurrentPar,IncurrentPar,ScoreOfReliability,Case1,Case2,LaterNumOfVotes,LatterNumOfCurrent,LatterNumOfincurrent,LatterCurrentPar,LatterIncurrentPar,LatterScoreOfReliability,LatterCase1,LatterCase2,VotingScore,Status,IncurrentVote,IsFirstVoteIncurrent,ExpertiseLevel
7072,1000153,1,252,233,19,0.924603,0.075397,0.924603,14,5,253,234,19,0.924901,0.075099,0.924901,14,5,1, merged,0,0,0.898974138754
7108,1000118,1,236,202,34,0.855932,0.144068,0.855932,34,0,237,202,35,0.852321,0.147679,0.852321,35,0,1, merged,1,1,0.0023596520494
7136,1000063,1,595,520,75,0.87395,0.12605,0.87395,66,9,597,522,75,0.874372,0.125628,0.874372,66,9,-1, merged,0,0,0
7147,1000007,2,237,207,30,0.873418,0.126582,1.717862,24,6,239,208,31,0.870293,0.129707,1.710952,24,7,-1, merged,1,0,0.14671639424
7147,1000009,1,180,152,28,0.844444,0.155556,0.844444,26,2,182,153,29,0.840659,0.159341,0.840659,27,2,1, merged,1,1,0.0862236713713
7158,1000327,1,10,3,7,0.3,0.7,0.3,6,1,11,4,7,0.363636,0.636364,0.363636,6,1,1, merged,0,0,1.05963855422
7158,1000329,2,21,12,9,0.571429,0.428571,0.871429,6,3,22,13,9,0.590909,0.409091,0.954545,6,3,1, merged,0,0,0.981536926148
7159,1000329,2,22,13,9,0.590909,0.409091,1.340909,6,3,23,14,9,0.608696,0.391304,1.386473,6,3,1, merged,0,0,1.07986111111
7187,1000327,2,11,4,7,0.363636,0.636364,0.363636,6,1,13,4,9,0.307692,0.692308,0.307692,8,1,1, merged,1,1,0.0296381559737
7187,1000329,4,23,14,9,0.608696,0.391304,0.972332,6,3,25,16,9,0.64,0.36,0.947692,6,3,-1, merged,0,0,0.0149769667332
7190,1000329,2,25,16,9,0.64,0.36,1.214468,6,3,26,17,9,0.653846,0.346154,1.237179,6,3,1, merged,0,0,0.318874409953
7191,1000328,1,21,11,10,0.52381,0.47619,0.52381,10,0,22,12,10,0.545455,0.454545,0.545455,10,0,1, merged,0,0,0.254802786866
7191,1000329,3,26,17,9,0.653846,0.346154,1.760989,6,3,28,18,10,0.642857,0.357143,1.780148,6,4,-1, merged,1,1,0.197378068816
7192,1000328,1,22,12,10,0.545455,0.454545,0.545455,10,0,24,14,10,0.583333,0.416667,0.583333,10,0,1, merged,0,0,0.445323003219
7192,1000329,3,28,18,10,0.642857,0.357143,1.780148,6,4,29,19,10,0.655172,0.344828,1.838506,6,4,1, merged,0,0,0.343595544508
7193,1000004,1,295,241,54,0.816949,0.183051,0.816949,48,6,296,241,55,0.814189,0.185811,0.814189,49,6,1, merged,1,1,0.1238050033
7193,1000329,3,29,19,10,0.655172,0.344828,2.072122,6,4,35,21,14,0.6,0.4,2.003475,10,4,1, merged,1,1,0.261391662621
7194,1000329,2,35,21,14,0.6,0.4,1.189286,10,4,39,22,17,0.564103,0.435897,1.130769,13,4,1, merged,1,1,0.266963058423
7195,1000329,2,39,22,17,0.564103,0.435897,1.130769,13,4,43,23,20,0.534884,0.465116,1.081759,16,4,1, merged,1,1,0.363220471486
7196,1000329,2,43,23,20,0.534884,0.465116,1.081759,16,4,47,25,22,0.531915,0.468085,1.068147,18,4,1, merged,1,1,0.369416092646
7197,1000328,1,24,14,10,0.583333,0.416667,0.583333,10,0,29,14,15,0.482759,0.517241,0.482759,15,0,1, merged,1,1,0.451123638806
7197,1000329,3,47,25,22,0.531915,0.468085,1.65148,18,4,52,26,26,0.5,0.5,1.496272,22,4,1, merged,1,1,0.375429220916
7198,1000328,1,29,14,15,0.482759,0.517241,0.482759,15,0,34,14,20,0.411765,0.588235,0.411765,20,0,1, merged,1,1,0.459590445266
7198,1000329,3,52,26,26,0.5,0.5,1.496272,22,4,58,27,31,0.465517,0.534483,1.370953,27,4,1, merged,1,1,0.381267862058
7199,1000328,1,34,14,20,0.411765,0.588235,0.411765,20,0,36,14,22,0.388889,0.611111,0.388889,22,0,1, abandoned,1,1,0
7199,1000329,3,58,27,31,0.465517,0.534483,1.370953,27,4,59,27,32,0.457627,0.542373,1.334016,28,4,1, abandoned,1,1,0
7200,1000328,1,36,14,22,0.388889,0.611111,0.388889,22,0,37,15,22,0.405405,0.594595,0.405405,22,0,-1, abandoned,0,0,0.343177502573
7200,1000329,2,59,27,32,0.457627,0.542373,0.846516,28,4,60,28,32,0.466667,0.533333,0.872072,28,4,-1, abandoned,0,0,0.27760727056
7206,1000004,2,297,242,55,0.814815,0.185185,0.814815,49,6,298,243,55,0.815436,0.184564,1.315436,49,6,1, merged,0,0,0.0594175491679
7218,1000007,1,239,208,31,0.870293,0.129707,0.870293,24,7,241,210,31,0.871369,0.128631,0.871369,24,7,-1, merged,0,0,0.162222253129
7218,1000153,2,256,237,19,0.925781,0.074219,1.796074,14,5,257,238,19,0.92607,0.07393,1.797439,14,5,1, merged,0,0,0.108498812799
7220,1000327,1,13,4,9,0.307692,0.692308,0.307692,8,1,14,5,9,0.357143,0.642857,0.357143,8,1,1, merged,0,0,0
7221,1000327,1,14,5,9,0.357143,0.642857,0.357143,8,1,16,7,9,0.4375,0.5625,0.4375,8,1,-1, merged,0,0,0.00327785169805
7222,1000327,1,16,7,9,0.4375,0.5625,0.4375,8,1,18,9,9,0.5,0.5,0.5,8,1,-1, merged,0,0,0.0329804560261
7223,1000023,1,86,74,12,0.860465,0.139535,0.860465,12,0,87,75,12,0.862069,0.137931,0.862069,12,0,-1, merged,0,0,0
7223,1000329,2,67,35,32,0.522388,0.477612,1.382853,28,4,69,37,32,0.536232,0.463768,1.398301,28,4,-1, merged,0,0,0.120092670487
7227,1000009,1,184,155,29,0.842391,0.157609,0.842391,27,2,185,156,29,0.843243,0.156757,0.843243,27,2,-1, abandoned,0,0,0.210740543189
7227,1000153,2,258,239,19,0.926357,0.073643,1.768748,14,5,259,240,19,0.926641,0.073359,1.769884,14,5,-1, abandoned,0,0,0.217734067816
7228,1000007,2,241,210,31,0.871369,0.128631,1.714613,24,7,243,212,31,0.872428,0.127572,1.717348,24,7,-1, merged,0,0,1.40124513619
7228,1000009,1,185,156,29,0.843243,0.156757,0.843243,27,2,187,158,29,0.84492,0.15508,0.84492,27,2,-1, merged,0,0,0.850163586637
7231,1000063,2,598,523,75,0.874582,0.125418,1.374582,66,9,600,524,76,0.873333,0.126667,1.347018,67,9,-1, abandoned,1,0,0.652802561022
7231,1000327,1,18,9,9,0.5,0.5,0.5,8,1,19,9,10,0.473684,0.526316,0.473684,9,1,1, abandoned,1,1,0.104166666667
7234,1000130,1,64,49,15,0.765625,0.234375,0.765625,14,1,65,50,15,0.769231,0.230769,0.769231,14,1,-1, merged,0,0,0.0393722192302
7238,1000063,2,603,527,76,0.873964,0.126036,1.409175,67,9,605,529,76,0.87438,0.12562,1.402158,67,9,-1, merged,0,0,0.0950786654176
7238,1000329,1,71,38,33,0.535211,0.464789,0.535211,29,4,72,38,34,0.527778,0.472222,0.527778,30,4,1, merged,1,1,0.0524608853508
7242,1000327,2,19,9,10,0.473684,0.526316,0.473684,9,1,20,10,10,0.5,0.5,0.5,9,1,-1, merged,0,0,0.162877328217
7242,1000329,3,73,39,34,0.534247,0.465753,1.007931,30,4,75,41,34,0.546667,0.453333,1.046667,30,4,-1, merged,0,0,0.185842122085
7243,1000329,2,75,41,34,0.546667,0.453333,0.546667,30,4,78,42,36,0.538462,0.461538,0.538462,32,4,1, merged,1,1,0.778616352201
7251,1000063,1,606,530,76,0.874587,0.125413,0.874587,67,9,609,532,77,0.873563,0.126437,0.873563,68,9,1, merged,1,1,0.272958203472
7257,1000023,1,87,75,12,0.862069,0.137931,0.862069,12,0,88,76,12,0.863636,0.136364,0.863636,12,0,1, merged,0,0,0.00493917484597
7257,1000063,3,611,534,77,0.873977,0.126023,2.651539,68,9,612,535,77,0.874183,0.125817,2.654486,68,9,1, merged,0,0,0.0050306431765
7258,1000063,1,612,535,77,0.874183,0.125817,0.874183,68,9,613,536,77,0.874388,0.125612,0.874388,68,9,1, merged,0,0,0
7288,1000327,1,20,10,10,0.5,0.5,0.5,9,1,21,11,10,0.52381,0.47619,0.52381,9,1,1, merged,0,0,0.067958612673
7289,1000014,2,253,226,27,0.893281,0.106719,1.693281,25,2,254,227,27,0.893701,0.106299,1.750844,25,2,1, merged,0,0,0.0187290150639
7295,1000124,2,95,93,2,0.978947,0.021053,1.857735,2,0,96,94,2,0.979167,0.020833,1.807738,2,0,1, merged,0,0,0.0425792372324
7295,1000166,1,33,29,4,0.878788,0.121212,0.878788,3,1,35,29,6,0.828571,0.171429,0.828571,5,1,1, merged,1,1,0.475613356234
7306,1000329,2,81,44,37,0.54321,0.45679,0.54321,33,4,82,45,37,0.54878,0.45122,0.74878,33,4,1, merged,0,0,0.401068991042
7307,1000063,1,618,541,77,0.875405,0.124595,0.875405,68,9,619,542,77,0.875606,0.124394,0.875606,68,9,1, merged,0,0,0.0164635299602
7315,1000063,1,619,542,77,0.875606,0.124394,0.875606,68,9,620,542,78,0.874194,0.125806,0.874194,69,9,1, merged,1,1,0.0143493061011
7340,1000328,2,38,16,22,0.421053,0.578947,0.969833,22,0,39,16,23,0.410256,0.589744,0.96978,23,0,1, abandoned,1,1,0.0934748549388
7340,1000329,1,82,45,37,0.54878,0.45122,0.54878,33,4,84,47,37,0.559524,0.440476,0.559524,33,4,-1, abandoned,0,0,0.0684369924334
7341,1000328,2,39,16,23,0.410256,0.589744,0.96978,23,0,42,17,25,0.404762,0.595238,0.96798,25,0,-1, abandoned,1,0,1.44646464646
7341,1000329,1,84,47,37,0.559524,0.440476,0.559524,33,4,87,49,38,0.563218,0.436782,0.563218,34,4,-1, abandoned,1,0,1.12598566308
7342,1000091,3,54,42,12,0.777778,0.222222,1.745758,11,1,55,42,13,0.763636,0.236364,1.705556,12,1,1, abandoned,1,1,0.194808779677
7342,1000328,2,42,17,25,0.404762,0.595238,0.96798,25,0,44,17,27,0.386364,0.613636,0.941919,27,0,1, abandoned,1,1,0.735267916031
7342,1000329,1,87,49,38,0.563218,0.436782,0.563218,34,4,90,50,40,0.555556,0.444444,0.555556,36,4,-1, abandoned,1,0,0.569028964711
7343,1000091,2,55,42,13,0.763636,0.236364,1.319192,12,1,56,43,13,0.767857,0.232143,1.322205,12,1,-1, abandoned,0,0,0.0533673776466
7343,1000328,3,44,17,27,0.386364,0.613636,1.705556,27,0,45,17,28,0.377778,0.622222,1.699983,28,0,1, abandoned,1,1,0.0438291491842
7343,1000329,1,90,50,40,0.555556,0.444444,0.555556,36,4,92,51,41,0.554348,0.445652,0.554348,37,4,-1, abandoned,1,0,0.0318184357201
7346,1000327,1,21,11,10,0.52381,0.47619,0.52381,9,1,22,12,10,0.545455,0.454545,0.545455,9,1,-1, merged,0,0,0.291058035714
7354,1000121,2,189,172,17,0.910053,0.089947,0.910053,16,1,190,173,17,0.910526,0.089474,1.410526,16,1,1, merged,0,0,0.0527405107871
7375,1000153,4,260,241,19,0.926923,0.073077,2.693749,14,5,261,242,19,0.927203,0.072797,2.695887,14,5,-1, abandoned,0,0,0.904169896868
7382,1000014,2,256,229,27,0.894531,0.105469,1.760303,25,2,257,230,27,0.894942,0.105058,1.761608,25,2,1, merged,0,0,0
7385,1000012,2,271,246,25,0.907749,0.092251,1.810662,24,1,272,247,25,0.908088,0.091912,1.811934,24,1,1, merged,0,0,0.351633706941
7386,1000014,3,257,230,27,0.894942,0.105058,1.839104,25,2,258,231,27,0.895349,0.104651,2.839793,25,2,1, merged,0,0,0
7386,1000070,1,197,186,11,0.944162,0.055838,0.944162,9,2,198,187,11,0.944444,0.055556,0.944444,9,2,1, merged,0,0,0.00530548618973
7386,1000121,4,190,173,17,0.910526,0.089474,2.74963,16,1,191,174,17,0.910995,0.089005,3.750788,16,1,1, merged,0,0,0.00366856966694
7387,1000327,1,22,12,10,0.545455,0.454545,0.545455,9,1,23,13,10,0.565217,0.434783,0.565217,9,1,1, merged,0,0,0.711969111969
7387,1000329,2,93,52,41,0.55914,0.44086,1.104594,37,4,94,53,41,0.56383,0.43617,1.129047,37,4,1, merged,0,0,1.06422070535
7389,1000327,1,23,13,10,0.565217,0.434783,0.565217,9,1,24,13,11,0.541667,0.458333,0.541667,10,1,1, abandoned,1,1,0.724615384615
7389,1000329,2,95,54,41,0.568421,0.431579,1.133638,37,4,96,54,42,0.5625,0.4375,1.104167,38,4,1, abandoned,1,1,1.07395480226
7392,1000063,1,628,550,78,0.875796,0.124204,0.875796,69,9,629,551,78,0.875994,0.124006,0.875994,69,9,1, merged,0,0,0.00615557840348
7393,1000007,2,246,215,31,0.873984,0.126016,0.873984,24,7,247,216,31,0.874494,0.125506,1.541161,24,7,1, merged,0,0,0.435367858473
7394,1000004,4,301,246,55,0.817276,0.182724,2.358942,49,6,302,246,56,0.81457,0.18543,2.120284,49,7,-1, merged,1,1,0.0765357266367
7394,1000327,3,24,13,11,0.541667,0.458333,1.541667,10,1,25,13,12,0.52,0.48,1.305714,10,2,-1, merged,1,1,0
7404,1000124,2,96,94,2,0.979167,0.020833,1.807738,2,0,97,95,2,0.979381,0.020619,1.812715,2,0,1, merged,0,0,0.15148057593
7404,1000166,1,35,29,6,0.828571,0.171429,0.828571,5,1,36,30,6,0.833333,0.166667,0.833333,5,1,1, merged,0,0,0.0889233954451
7407,1000007,2,247,216,31,0.874494,0.125506,1.716599,24,7,248,217,31,0.875,0.125,1.713542,24,7,1, merged,0,0,0.468290561498
7407,1000009,1,190,160,30,0.842105,0.157895,0.842105,28,2,192,161,31,0.838542,0.161458,0.838542,29,2,1, merged,1,1,0.284117594507
7414,1000118,1,239,204,35,0.853556,0.146444,0.853556,35,0,240,205,35,0.854167,0.145833,0.854167,35,0,1, merged,0,0,0.203072146882
7430,1000328,2,45,17,28,0.377778,0.622222,0.944788,28,0,46,18,28,0.391304,0.608696,0.962733,28,0,1, merged,0,0,0.673685257523
7430,1000329,1,97,55,42,0.56701,0.43299,0.56701,38,4,98,56,42,0.571429,0.428571,0.571429,38,4,-1, merged,0,0,0.546749161074
7431,1000124,2,97,95,2,0.979381,0.020619,1.812715,2,0,98,96,2,0.979592,0.020408,1.790403,2,0,1, merged,0,0,0.0159692254123
7431,1000166,1,36,30,6,0.833333,0.166667,0.833333,5,1,37,30,7,0.810811,0.189189,0.810811,6,1,1, merged,1,1,0.173047589328
7438,1000026,1,82,75,7,0.914634,0.085366,0.914634,6,1,84,76,8,0.904762,0.095238,0.904762,7,1,-1, merged,1,0,0.109881491809
7439,1000153,4,262,243,19,0.927481,0.072519,3.806926,14,5,265,246,19,0.928302,0.071698,3.298259,14,5,-1, merged,0,0,0.0272512541821
7439,1000534,6,0,0,0,0,0,4.675347,0,0,2,1,1,0.5,0.5,4.661895,1,0,1, merged,1,1,0
7440,1000124,2,98,96,2,0.979592,0.020408,1.790403,2,0,99,97,2,0.979798,0.020202,1.769272,2,0,1, merged,0,0,0.187848067045
7440,1000166,1,37,30,7,0.810811,0.189189,0.810811,6,1,38,30,8,0.789474,0.210526,0.789474,7,1,1, merged,1,1,1.94335260116
7451,1000063,1,642,564,78,0.878505,0.121495,0.878505,69,9,643,564,79,0.877138,0.122862,0.877138,70,9,1, merged,1,1,0
7453,1000329,3,98,56,42,0.571429,0.428571,1.357143,38,4,99,57,42,0.575758,0.424242,1.159091,38,4,-1, abandoned,0,0,1.10405555556
7456,1000328,2,46,18,28,0.391304,0.608696,0.967062,28,0,47,18,29,0.382979,0.617021,0.957236,29,0,1, abandoned,1,1,0.407534832989
7456,1000329,1,99,57,42,0.575758,0.424242,0.575758,38,4,101,58,43,0.574257,0.425743,0.574257,39,4,1, abandoned,1,1,0.407786613834
7457,1000328,1,47,18,29,0.382979,0.617021,0.382979,29,0,48,19,29,0.395833,0.604167,0.395833,29,0,-1, abandoned,0,0,0.433969822863
7457,1000329,2,101,58,43,0.574257,0.425743,0.957236,39,4,102,59,43,0.578431,0.421569,0.974265,39,4,-1, abandoned,0,0,0.431546289943
7459,1000327,2,25,13,12,0.52,0.48,1.092816,10,2,26,14,12,0.538462,0.461538,1.115385,10,2,-1, abandoned,0,0,0.325339796632
7459,1000329,1,103,59,44,0.572816,0.427184,0.572816,40,4,104,60,44,0.576923,0.423077,0.576923,40,4,-1, abandoned,0,0,0.410937255258
7460,1000124,2,99,97,2,0.979798,0.020202,1.769272,2,0,100,98,2,0.98,0.02,1.749231,2,0,1, merged,0,0,0.191014727739
7460,1000166,1,38,30,8,0.789474,0.210526,0.789474,7,1,39,30,9,0.769231,0.230769,0.769231,8,1,1, merged,1,1,2.03563218391
7467,1000043,1,56,43,13,0.767857,0.232143,0.767857,12,1,57,43,14,0.754386,0.245614,0.754386,13,1,1, merged,1,1,0.505768545189
7469,1000130,2,70,55,15,0.785714,0.214286,1.484127,14,1,71,56,15,0.788732,0.211268,1.491857,14,1,-1, abandoned,0,0,0.00125168463612
7475,1000327,2,26,14,12,0.538462,0.461538,1.405128,10,2,27,15,12,0.555556,0.444444,1.365079,10,2,-1, merged,0,0,0.0125047368957
7475,1000329,6,106,62,44,0.584906,0.415094,3.738366,40,4,111,67,44,0.603604,0.396396,4.722822,40,4,-1, merged,0,0,0.0161880178929
7477,1000063,2,643,564,79,0.877138,0.122862,1.432694,70,9,644,565,79,0.877329,0.122671,1.448758,70,9,1, merged,0,0,0.00115588376947
7477,1000327,1,27,15,12,0.555556,0.444444,0.555556,10,2,28,16,12,0.571429,0.428571,0.571429,10,2,1, merged,0,0,0
7487,1000004,2,302,246,56,0.81457,0.18543,1.30207,49,7,303,247,56,0.815182,0.184818,1.309009,49,7,1, merged,0,0,0.0786656708987
7488,1000004,2,303,247,56,0.815182,0.184818,1.309009,49,7,304,248,56,0.815789,0.184211,1.321814,49,7,1, merged,0,0,0.111454083894
7488,1000327,4,28,16,12,0.571429,0.428571,2.484041,10,2,29,17,12,0.586207,0.413793,2.515163,10,2,1, merged,0,0,0.146905575316
7488,1000329,3,111,67,44,0.603604,0.396396,1.912612,40,4,112,68,44,0.607143,0.392857,1.928956,40,4,1, merged,0,0,0.175999855437
7489,1000063,2,644,565,79,0.877329,0.122671,1.723483,70,9,645,566,79,0.877519,0.122481,1.734662,70,9,1, merged,0,0,0.00239046569304
7492,1000329,1,112,68,44,0.607143,0.392857,0.607143,40,4,113,68,45,0.60177,0.39823,0.60177,41,4,1, abandoned,1,1,0.0657118055556
7495,1000014,2,260,233,27,0.896154,0.103846,1.824725,25,2,261,234,27,0.896552,0.103448,1.825656,25,2,-1, merged,0,0,0.716413954635
7495,1000153,1,266,247,19,0.928571,0.071429,0.928571,14,5,268,249,19,0.929104,0.070896,0.929104,14,5,-1, merged,0,0,0.912820424555
7519,1000327,1,29,17,12,0.586207,0.413793,0.586207,10,2,30,17,13,0.566667,0.433333,0.566667,11,2,1, merged,1,1,0.0615642784651
7530,1000124,2,100,98,2,0.98,0.02,1.749231,2,0,101,99,2,0.980198,0.019802,1.730198,2,0,1, merged,0,0,0.192558076715
7530,1000166,1,39,30,9,0.769231,0.230769,0.769231,8,1,40,30,10,0.75,0.25,0.75,9,1,1, merged,1,1,2.04685714286
7555,1000327,1,30,17,13,0.566667,0.433333,0.566667,11,2,31,18,13,0.580645,0.419355,0.580645,11,2,-1, abandoned,0,0,0.0682595943989
7555,1000329,2,114,69,45,0.605263,0.394737,1.17193,41,4,115,70,45,0.608696,0.391304,1.189341,41,4,-1, abandoned,0,0,0.134865346788
7566,1000023,2,92,80,12,0.869565,0.130435,1.736912,12,0,93,81,12,0.870968,0.129032,1.739655,12,0,1, merged,0,0,0.353999505627
7567,1000023,2,93,81,12,0.870968,0.129032,1.739655,12,0,94,82,12,0.87234,0.12766,1.74234,12,0,1, merged,0,0,0.354142890891
7569,1000023,1,94,82,12,0.87234,0.12766,0.87234,12,0,95,83,12,0.873684,0.126316,0.873684,12,0,1, merged,0,0,0.000157300719651
7569,1000063,2,652,571,81,0.875767,0.124233,1.748107,72,9,653,572,81,0.875957,0.124043,1.749641,72,9,1, merged,0,0,0.000304389618712
7573,1000023,2,95,83,12,0.873684,0.126316,1.743684,12,0,96,84,12,0.875,0.125,1.746287,12,0,1, merged,0,0,0.354272333054
7606,1000124,2,101,99,2,0.980198,0.019802,1.730198,2,0,102,100,2,0.980392,0.019608,1.712099,2,0,1, merged,0,0,0.0647084665552
7606,1000166,1,40,30,10,0.75,0.25,0.75,9,1,41,30,11,0.731707,0.268293,0.731707,10,1,1, merged,1,1,0.687214714781
7616,1000121,1,192,175,17,0.911458,0.088542,0.911458,16,1,193,176,17,0.911917,0.088083,0.911917,16,1,1, merged,0,0,0.0850963373487
7625,1000329,1,118,72,46,0.610169,0.389831,0.610169,42,4,125,77,48,0.616,0.384,0.616,44,4,-1, merged,1,0,0.00602719246119
7626,1000009,1,193,162,31,0.839378,0.160622,0.839378,29,2,194,163,31,0.840206,0.159794,0.840206,29,2,1, merged,0,0,0.0900478454888
7626,1000015,2,432,394,38,0.912037,0.087963,1.751415,36,2,433,395,38,0.91224,0.08776,1.752446,36,2,1, merged,0,0,0.118071562023
7627,1000329,2,125,77,48,0.616,0.384,1.154462,44,4,126,78,48,0.619048,0.380952,1.162526,44,4,1, merged,0,0,1.09105928086
7636,1000063,1,669,587,82,0.877429,0.122571,0.877429,73,9,670,588,82,0.877612,0.122388,0.877612,73,9,1, merged,0,0,0.0122369386312
7643,1000063,1,670,588,82,0.877612,0.122388,0.877612,73,9,671,589,82,0.877794,0.122206,0.877794,73,9,1, merged,0,0,0.000640143392142
7646,1000011,1,211,202,9,0.957346,0.042654,0.957346,8,1,212,203,9,0.957547,0.042453,0.957547,8,1,1, merged,0,0,0.131447694947
7666,1000328,2,48,19,29,0.395833,0.604167,1.020833,29,0,50,21,29,0.42,0.58,1.047907,29,0,-1, abandoned,0,0,0.751465201465
7666,1000329,1,128,80,48,0.625,0.375,0.625,44,4,129,81,48,0.627907,0.372093,0.627907,44,4,-1, abandoned,0,0,0.715630182421
7669,1000009,1,194,163,31,0.840206,0.159794,0.840206,29,2,197,164,33,0.832487,0.167513,0.832487,31,2,1, merged,1,1,0.833016380141
7669,1000014,2,268,241,27,0.899254,0.100746,1.73946,25,2,269,242,27,0.899628,0.100372,1.732116,25,2,1, merged,0,0,0.705843768634
7705,1000118,1,247,212,35,0.8583,0.1417,0.8583,35,0,248,213,35,0.858871,0.141129,0.858871,35,0,1, merged,0,0,0.517025002284
7707,1000063,1,697,615,82,0.882353,0.117647,0.882353,73,9,700,617,83,0.881429,0.118571,0.881429,74,9,-1, merged,1,0,0.660750328059
7718,1000328,2,50,21,29,0.42,0.58,1.238182,29,0,51,22,29,0.431373,0.568627,1.264706,29,0,1, merged,0,0,0.0447643979058
7722,1000054,1,18,15,3,0.833333,0.166667,0.833333,1,2,19,15,4,0.789474,0.210526,0.789474,2,2,1, merged,1,1,1.13173933427
7722,1000124,2,105,103,2,0.980952,0.019048,1.814286,2,0,106,104,2,0.981132,0.018868,1.770606,2,0,1, merged,0,0,0.268079434893
7725,1000124,2,106,104,2,0.981132,0.018868,1.785054,2,0,107,105,2,0.981308,0.018692,1.76977,2,0,1, merged,0,0,0.0232435363278
7727,1000124,2,107,105,2,0.981308,0.018692,1.713016,2,0,108,106,2,0.981481,0.018519,1.719577,2,0,1, merged,0,0,0.0937162587251
7727,1000166,1,41,30,11,0.731707,0.268293,0.731707,10,1,42,31,11,0.738095,0.261905,0.738095,10,1,1, merged,0,0,0.981100777129
7740,1000120,2,35,29,6,0.828571,0.171429,0.828571,5,1,36,30,6,0.833333,0.166667,1.833333,5,1,1, merged,0,0,0.0793580159013
7744,1000121,3,194,177,17,0.912371,0.087629,2.102778,16,1,195,177,18,0.907692,0.092308,2.096426,17,1,1, abandoned,1,1,0.517730257241
7744,1000329,2,129,81,48,0.627907,0.372093,1.190407,44,4,130,81,49,0.623077,0.376923,1.188733,45,4,1, abandoned,1,1,1.04239040529
7745,1000014,1,269,242,27,0.899628,0.100372,0.899628,25,2,270,243,27,0.9,0.1,0.9,25,2,1, merged,0,0,0.499523979835
7745,1000329,3,130,81,49,0.623077,0.376923,2.088362,45,4,131,82,49,0.625954,0.374046,2.095954,45,4,1, merged,0,0,1.04971122112
7756,1000121,1,195,177,18,0.907692,0.092308,0.907692,17,1,196,178,18,0.908163,0.091837,0.908163,17,1,1, merged,0,0,8.58332260405e-05
7756,1000329,2,131,82,49,0.625954,0.374046,1.533647,45,4,132,83,49,0.628788,0.371212,1.536951,45,4,1, merged,0,0,5.42742057819e-73
7757,1000121,1,196,178,18,0.908163,0.091837,0.908163,17,1,197,179,18,0.908629,0.091371,0.908629,17,1,1, merged,0,0,0.0307874558046
7757,1000329,2,132,83,49,0.628788,0.371212,1.536951,45,4,133,84,49,0.631579,0.368421,1.540208,45,4,1, merged,0,0,0.0537364094405
7758,1000329,2,133,84,49,0.631579,0.368421,1.488722,45,4,135,84,51,0.622222,0.377778,1.455556,47,4,1, merged,1,1,0
7765,1000199,2,64,50,14,0.78125,0.21875,1.646115,14,0,65,51,14,0.784615,0.215385,1.634615,14,0,1, merged,0,0,0.705669910616
7766,1000329,3,135,84,51,0.622222,0.377778,1.192222,47,4,136,85,51,0.625,0.375,2.199257,47,4,1, merged,0,0,0.218984149774
7774,1000109,2,93,75,18,0.806452,0.193548,1.591067,18,0,94,76,18,0.808511,0.191489,1.596389,18,0,1, merged,0,0,0.0469981469319
7774,1000199,1,65,51,14,0.784615,0.215385,0.784615,14,0,66,52,14,0.787879,0.212121,0.787879,14,0,1, merged,0,0,0.00539565257206
7777,1000014,2,271,244,27,0.900369,0.099631,1.663081,25,2,272,245,27,0.900735,0.099265,1.654834,25,2,1, merged,0,0,0.0283569049928
7777,1000043,1,59,45,14,0.762712,0.237288,0.762712,13,1,61,46,15,0.754098,0.245902,0.754098,14,1,-1, merged,1,0,0.0398298028949
7778,1000124,1,108,106,2,0.981481,0.018519,0.981481,2,0,109,107,2,0.981651,0.018349,0.981651,2,0,1, merged,0,0,0.450357237867
7783,1000004,1,311,254,57,0.81672,0.18328,0.81672,50,7,312,255,57,0.817308,0.182692,0.817308,50,7,-1, merged,0,0,0
7783,1000329,3,136,85,51,0.625,0.375,2.230182,47,4,140,87,53,0.621429,0.378571,2.212321,49,4,-1, merged,1,0,0.049343590611
7784,1000007,1,259,226,33,0.872587,0.127413,0.872587,26,7,260,227,33,0.873077,0.126923,0.873077,26,7,1, merged,0,0,0.225550111658
7784,1000015,2,434,396,38,0.912442,0.087558,1.785029,36,2,436,398,38,0.912844,0.087156,1.785921,36,2,1, merged,0,0,0.16982462739
7785,1000070,1,204,193,11,0.946078,0.053922,0.946078,9,2,206,194,12,0.941748,0.058252,0.941748,9,3,-1, merged,1,0,0.767603232263
7785,1000121,3,197,179,18,0.908629,0.091371,1.854708,17,1,198,180,18,0.909091,0.090909,2.850838,17,1,1, merged,0,0,0.56775026483
7795,1000091,1,56,43,13,0.767857,0.232143,0.767857,12,1,57,44,13,0.77193,0.22807,0.77193,12,1,1, merged,0,0,0.00659192295703
7795,1000130,2,71,56,15,0.788732,0.211268,1.55659,14,1,72,57,15,0.791667,0.208333,1.563596,14,1,1, merged,0,0,0.00698974230933
7803,1000153,3,283,264,19,0.932862,0.067138,0.932862,14,5,284,265,19,0.933099,0.066901,2.433099,14,5,1, merged,0,0,0.446071034715
7805,1000070,2,206,194,12,0.941748,0.058252,1.341748,9,3,207,195,12,0.942029,0.057971,1.352743,9,3,1, merged,0,0,0.7485242541
7805,1000328,1,55,22,33,0.4,0.6,0.4,33,0,56,23,33,0.410714,0.589286,0.410714,33,0,1, merged,0,0,0.766747572816
7842,1000003,2,261,216,45,0.827586,0.172414,1.734994,40,5,262,217,45,0.828244,0.171756,1.736501,40,5,1, merged,0,0,0.607712765957
7845,1000120,2,36,30,6,0.833333,0.166667,1.75,5,1,37,31,6,0.837838,0.162162,1.760915,5,1,1, merged,0,0,0.0681818181818
7853,1000026,2,85,77,8,0.905882,0.094118,1.71023,7,1,86,78,8,0.906977,0.093023,1.715487,7,1,1, merged,0,0,0.277985723922
7859,1000003,3,264,218,46,0.825758,0.174242,2.417241,41,5,265,219,46,0.826415,0.173585,2.402357,41,5,-1, abandoned,0,0,0.239996753979
7862,1000026,1,86,78,8,0.906977,0.093023,0.906977,7,1,88,80,8,0.909091,0.090909,0.909091,7,1,-1, merged,0,0,0.834097340125
7863,1000014,1,272,245,27,0.900735,0.099265,0.900735,25,2,273,245,28,0.897436,0.102564,0.897436,26,2,1, merged,1,1,0.264018466123
7865,1000023,1,102,90,12,0.882353,0.117647,0.882353,12,0,103,90,13,0.873786,0.126214,0.873786,13,0,1, merged,1,1,0.0640922004756
7866,1000023,1,103,90,13,0.873786,0.126214,0.873786,13,0,104,90,14,0.865385,0.134615,0.865385,14,0,1, merged,1,1,0.0164171734498
7873,1000091,2,59,46,13,0.779661,0.220339,1.40109,12,1,60,47,13,0.783333,0.216667,1.407447,12,1,1, merged,0,0,0.41344520406
7873,1000329,1,140,87,53,0.621429,0.378571,0.621429,49,4,141,88,53,0.624113,0.375887,0.624113,49,4,1, merged,0,0,0.646764091858
7875,1000015,1,442,404,38,0.914027,0.085973,0.914027,36,2,443,404,39,0.911964,0.088036,0.911964,37,2,1, abandoned,1,1,1.05051538311
7875,1000153,2,286,267,19,0.933566,0.066434,1.847594,14,5,287,268,19,0.933798,0.066202,1.845762,14,5,-1, abandoned,0,0,0.926556950571
7876,1000026,1,88,80,8,0.909091,0.090909,0.909091,7,1,89,81,8,0.910112,0.089888,0.910112,7,1,1, merged,0,0,0.0327597897949
7883,1000124,2,109,107,2,0.981651,0.018349,1.725837,2,0,110,108,2,0.981818,0.018182,1.715152,2,0,1, merged,0,0,0.031051629232
7883,1000166,1,43,32,11,0.744186,0.255814,0.744186,10,1,45,33,12,0.733333,0.266667,0.733333,11,1,1, merged,1,1,0.328322656665
7884,1000109,1,94,76,18,0.808511,0.191489,0.808511,18,0,95,77,18,0.810526,0.189474,0.810526,18,0,1, merged,0,0,0.445198714741
7891,1000124,2,110,108,2,0.981818,0.018182,1.715152,2,0,111,109,2,0.981982,0.018018,1.705386,2,0,1, merged,0,0,0.191421373641
7891,1000166,1,45,33,12,0.733333,0.266667,0.733333,11,1,47,34,13,0.723404,0.276596,0.723404,12,1,1, merged,1,1,1.97978723404
7904,1000003,1,270,224,46,0.82963,0.17037,0.82963,41,5,272,226,46,0.830882,0.169118,0.830882,41,5,-1, merged,0,0,0.0840538353358
7907,1000120,1,37,31,6,0.837838,0.162162,0.837838,5,1,39,32,7,0.820513,0.179487,0.820513,6,1,1, merged,1,1,0.0535714285714
7911,1000007,1,268,233,35,0.869403,0.130597,0.869403,28,7,270,233,37,0.862963,0.137037,0.862963,30,7,1, merged,1,1,0.295581430146
7911,1000009,2,199,166,33,0.834171,0.165829,1.703574,31,2,200,167,33,0.835,0.165,1.697963,31,2,1, merged,0,0,0.178340304429
7925,1000063,2,726,642,84,0.884298,0.115702,1.804298,75,9,727,643,84,0.884457,0.115543,1.805509,75,9,1, merged,0,0,0.00511637590668
7936,1000124,2,111,109,2,0.981982,0.018018,1.705386,2,0,112,110,2,0.982143,0.017857,1.71131,2,0,1, merged,0,0,0.203273691186
7936,1000166,1,47,34,13,0.723404,0.276596,0.723404,12,1,48,35,13,0.729167,0.270833,0.729167,12,1,1, merged,0,0,2.0962962963
7944,1000091,1,60,47,13,0.783333,0.216667,0.783333,12,1,61,48,13,0.786885,0.213115,0.786885,12,1,1, merged,0,0,0.233670429703
7944,1000328,3,56,23,33,0.410714,0.589286,1.823418,33,0,57,24,33,0.421053,0.578947,1.839882,33,0,1, merged,0,0,0.165338735278
7944,1000329,2,143,90,53,0.629371,0.370629,1.412704,49,4,144,91,53,0.631944,0.368056,1.41883,49,4,1, merged,0,0,0.101608439794
7948,1000004,1,315,258,57,0.819048,0.180952,0.819048,50,7,316,259,57,0.81962,0.18038,0.81962,50,7,-1, abandoned,0,0,0.0168634532114
7948,1000328,2,57,24,33,0.421053,0.578947,1.2401,33,0,58,25,33,0.431034,0.568966,1.250655,33,0,-1, abandoned,0,0,0.0151777423082
7966,1000109,1,95,77,18,0.810526,0.189474,0.810526,18,0,96,78,18,0.8125,0.1875,0.8125,18,0,1, merged,0,0,0.28651686201
7975,1000124,2,112,110,2,0.982143,0.017857,1.71131,2,0,113,111,2,0.982301,0.017699,1.716995,2,0,1, merged,0,0,0.0745363047542
7975,1000166,1,48,35,13,0.729167,0.270833,0.729167,12,1,49,36,13,0.734694,0.265306,0.734694,12,1,1, merged,0,0,0.643330826219
7979,1000026,1,89,81,8,0.910112,0.089888,0.910112,7,1,90,82,8,0.911111,0.088889,0.911111,7,1,1, merged,0,0,0.432957900575
7997,1000015,3,449,410,39,0.91314,0.08686,2.759405,37,2,450,411,39,0.913333,0.086667,2.760795,37,2,1, merged,0,0,0.131833342503
7997,1000026,2,90,82,8,0.911111,0.088889,1.846265,7,1,91,83,8,0.912088,0.087912,1.847462,7,1,1, merged,0,0,0.0701172931702
7997,1000153,1,293,274,19,0.935154,0.064846,0.935154,14,5,294,275,19,0.935374,0.064626,0.935374,14,5,1, merged,0,0,0.127034230548
7998,1000007,2,270,233,37,0.862963,0.137037,1.798337,30,7,271,234,37,0.863469,0.136531,1.795901,30,7,1, merged,0,0,0.472783520521
7998,1000153,1,294,275,19,0.935374,0.064626,0.935374,14,5,296,276,20,0.932432,0.067568,0.932432,15,5,1, merged,1,1,0.341356499645
7999,1000063,2,728,644,84,0.884615,0.115385,1.763403,75,9,730,645,85,0.883562,0.116438,1.736503,76,9,-1, merged,1,0,0.0152092908845
7999,1000124,3,113,111,2,0.982301,0.017699,2.745704,2,0,116,114,2,0.982759,0.017241,2.719261,2,0,-1, merged,0,0,0.195606722244
8006,1000063,1,730,645,85,0.883562,0.116438,0.883562,76,9,731,646,85,0.883721,0.116279,0.883721,76,9,1, merged,0,0,0.0038798912896
8016,1000118,2,254,219,35,0.862205,0.137795,1.781124,35,0,255,220,35,0.862745,0.137255,1.783798,35,0,1, merged,0,0,0.0324601506048
8036,1000015,2,450,411,39,0.913333,0.086667,1.845766,37,2,451,412,39,0.913525,0.086475,1.846185,37,2,1, merged,0,0,0.962533371789
8036,1000153,1,296,276,20,0.932432,0.067568,0.932432,15,5,297,277,20,0.93266,0.06734,0.93266,15,5,1, merged,0,0,0.864946130167
8037,1000328,2,59,26,33,0.440678,0.559322,1.075898,33,0,60,27,33,0.45,0.55,1.0875,33,0,1, merged,0,0,0
8037,1000329,1,159,101,58,0.63522,0.36478,0.63522,54,4,160,102,58,0.6375,0.3625,0.6375,54,4,1, merged,0,0,0
8054,1000070,1,211,199,12,0.943128,0.056872,0.943128,9,3,212,199,13,0.938679,0.061321,0.938679,10,3,1, merged,1,1,0.0123131608983
8055,1000124,2,116,114,2,0.982759,0.017241,1.717452,2,0,117,115,2,0.982906,0.017094,1.722906,2,0,1, merged,0,0,0.201084656085
8055,1000166,1,49,36,13,0.734694,0.265306,0.734694,12,1,50,37,13,0.74,0.26,0.74,12,1,1, merged,0,0,1.95699481865
8062,1000124,2,117,115,2,0.982906,0.017094,1.722906,2,0,118,116,2,0.983051,0.016949,1.728149,2,0,1, merged,0,0,0.253530345101
8062,1000166,1,50,37,13,0.74,0.26,0.74,12,1,51,38,13,0.745098,0.254902,0.745098,12,1,1, merged,0,0,1.50541237113
8063,1000329,2,160,102,58,0.6375,0.3625,1.218452,54,4,161,103,58,0.639752,0.360248,1.228537,54,4,1, merged,0,0,0
8064,1000004,5,318,261,57,0.820755,0.179245,4.417648,50,7,322,264,58,0.819876,0.180124,4.37316,51,7,-1, merged,1,0,0.0114544521624
8064,1000007,6,271,234,37,0.863469,0.136531,5.281117,30,7,272,235,37,0.863971,0.136029,5.23713,30,7,-1, merged,0,0,0.0283442002062
8064,1000009,1,203,170,33,0.837438,0.162562,0.837438,31,2,205,170,35,0.829268,0.170732,0.829268,33,2,1, merged,1,1,0.0178271383854
8064,1000015,4,451,412,39,0.913525,0.086475,3.596893,37,2,454,414,40,0.911894,0.088106,3.553284,38,2,1, merged,1,1,0.0223872924834
8064,1000026,2,92,84,8,0.913043,0.086957,1.750482,7,1,99,87,12,0.878788,0.121212,1.708056,11,1,-1, merged,1,0,0.0119935256348
8064,1000153,3,298,278,20,0.932886,0.067114,2.683368,15,5,300,280,20,0.933333,0.066667,2.64139,15,5,-1, merged,0,0,0.0214347695585
8069,1000109,2,97,79,18,0.814433,0.185567,1.814433,18,0,98,80,18,0.816327,0.183673,1.482993,18,0,1, merged,0,0,0.295454555239
8073,1000043,1,63,48,15,0.761905,0.238095,0.761905,14,1,64,49,15,0.765625,0.234375,0.765625,14,1,1, merged,0,0,0.00633854979889
8073,1000124,2,118,116,2,0.983051,0.016949,1.744956,2,0,119,117,2,0.983193,0.016807,1.748818,2,0,1, merged,0,0,0.207547080836
8080,1000121,1,198,180,18,0.909091,0.090909,0.909091,17,1,199,181,18,0.909548,0.090452,0.909548,17,1,1, merged,0,0,0.544794535189
8090,1000329,2,161,103,58,0.639752,0.360248,1.228537,54,4,162,103,59,0.635802,0.364198,1.219136,55,4,1, abandoned,1,1,0.0429471626602
8091,1000329,2,162,103,59,0.635802,0.364198,1.219136,55,4,163,103,60,0.631902,0.368098,1.209883,56,4,1, abandoned,1,1,0.122713647067
8092,1000329,2,163,103,60,0.631902,0.368098,1.209883,56,4,164,103,61,0.628049,0.371951,1.200776,57,4,1, abandoned,1,1,0.0843306732928
8093,1000329,2,164,103,61,0.628049,0.371951,1.200776,57,4,165,104,61,0.630303,0.369697,1.197871,57,4,-1, abandoned,0,0,0.470653226568
8094,1000329,2,165,104,61,0.630303,0.369697,1.197871,57,4,166,105,61,0.63253,0.36747,1.19503,57,4,-1, abandoned,0,0,0.0677205148006
8095,1000329,2,166,105,61,0.63253,0.36747,1.19503,57,4,167,105,62,0.628743,0.371257,1.186265,58,4,1, abandoned,1,1,0.139514401512
8096,1000329,2,167,105,62,0.628743,0.371257,1.186265,58,4,168,105,63,0.625,0.375,1.177632,59,4,1, abandoned,1,1,0.0965593194106
8097,1000329,2,168,105,63,0.625,0.375,1.177632,59,4,169,105,64,0.621302,0.378698,1.169128,60,4,1, abandoned,1,1,0.149009017501
8098,1000329,2,169,105,64,0.621302,0.378698,1.169128,60,4,170,105,65,0.617647,0.382353,1.160751,61,4,1, abandoned,1,1,0.948162475822
8100,1000329,2,172,107,65,0.622093,0.377907,1.165196,61,4,173,108,65,0.624277,0.375723,1.162739,61,4,-1, abandoned,0,0,0.103804715803
8101,1000007,1,272,235,37,0.863971,0.136029,0.863971,30,7,273,235,38,0.860806,0.139194,0.860806,31,7,1, merged,1,1,1.08284488921
8119,1000004,1,329,271,58,0.823708,0.176292,0.823708,51,7,331,273,58,0.824773,0.175227,0.824773,51,7,-1, merged,0,0,0.090243484225
8120,1000014,1,282,253,29,0.897163,0.102837,0.897163,27,2,283,254,29,0.897527,0.102473,0.897527,27,2,1, merged,0,0,0
8120,1000023,2,105,91,14,0.866667,0.133333,1.76383,14,0,106,92,14,0.867925,0.132075,1.765451,14,0,1, merged,0,0,0.000137017613582
8132,1000023,2,106,92,14,0.867925,0.132075,1.867925,14,0,107,93,14,0.869159,0.130841,1.869159,14,0,1, merged,0,0,0.00192212356066
8143,1000109,2,98,80,18,0.816327,0.183673,1.607371,18,0,99,81,18,0.818182,0.181818,1.612299,18,0,1, merged,0,0,0.183004568096
8143,1000199,1,67,53,14,0.791045,0.208955,0.791045,14,0,68,54,14,0.794118,0.205882,0.794118,14,0,1, merged,0,0,0.192319894896
8149,1000109,1,99,81,18,0.818182,0.181818,0.818182,18,0,101,82,19,0.811881,0.188119,0.811881,19,0,1, merged,1,1,1.31948051948
8149,1000199,3,68,54,14,0.794118,0.205882,2.278966,14,0,69,54,15,0.782609,0.217391,2.19449,15,0,1, merged,1,1,1.37621145374
8150,1000109,1,101,82,19,0.811881,0.188119,0.811881,19,0,106,85,21,0.801887,0.198113,0.801887,21,0,1, merged,1,1,0.405514709733
8151,1000070,2,212,199,13,0.938679,0.061321,1.843441,10,3,213,200,13,0.938967,0.061033,1.848058,10,3,1, merged,0,0,0.256388808069
8152,1000004,2,331,273,58,0.824773,0.175227,1.611659,51,7,333,274,59,0.822823,0.177177,1.597016,52,7,1, merged,1,1,0.035983550377
8152,1000091,1,61,48,13,0.786885,0.213115,0.786885,12,1,62,48,14,0.774194,0.225806,0.774194,13,1,1, merged,1,1,0.00248138957816
8153,1000007,2,277,239,38,0.862816,0.137184,1.685782,31,7,278,240,38,0.863309,0.136691,1.687119,31,7,1, merged,0,0,1.31441281139
8153,1000009,1,209,172,37,0.822967,0.177033,0.822967,33,4,210,173,37,0.82381,0.17619,0.82381,33,4,1, merged,0,0,0.831959613611
8157,1000121,2,199,181,18,0.909548,0.090452,1.703362,17,1,200,182,18,0.91,0.09,1.705918,17,1,1, merged,0,0,0.540005464069
8162,1000015,2,458,418,40,0.912664,0.087336,1.785391,38,2,459,419,40,0.912854,0.087146,1.787854,38,2,1, merged,0,0,0.319214349532
8165,1000124,2,119,117,2,0.983193,0.016807,1.728291,2,0,120,118,2,0.983333,0.016667,1.733333,2,0,1, merged,0,0,0.0405921533015
8165,1000166,1,51,38,13,0.745098,0.254902,0.745098,12,1,52,39,13,0.75,0.25,0.75,12,1,1, merged,0,0,0.393420749075
8167,1000109,1,107,86,21,0.803738,0.196262,0.803738,21,0,110,87,23,0.790909,0.209091,0.790909,23,0,1, merged,1,1,0.308412116557
8190,1000004,1,340,279,61,0.820588,0.179412,0.820588,54,7,343,280,63,0.816327,0.183673,0.816327,56,7,1, merged,1,1,0.0211607376164
8190,1000005,2,49,37,12,0.755102,0.244898,1.57569,12,0,50,38,12,0.76,0.24,1.576327,12,0,1, merged,0,0,0.00161748013829
8190,1000121,3,200,182,18,0.91,0.09,2.48569,17,1,201,183,18,0.910448,0.089552,2.486774,17,1,1, merged,0,0,0.00796982963238
8191,1000004,1,343,280,63,0.816327,0.183673,0.816327,56,7,344,280,64,0.813953,0.186047,0.813953,57,7,1, merged,1,1,0.03466796875
8191,1000120,2,39,32,7,0.820513,0.179487,1.636839,6,1,40,33,7,0.825,0.175,1.638953,6,1,1, merged,0,0,0.251893939394
8198,1000015,2,460,420,40,0.913043,0.086957,1.788043,38,2,462,422,40,0.91342,0.08658,1.790613,38,2,1, merged,0,0,0
8232,1000063,2,748,662,86,0.885027,0.114973,1.778157,77,9,749,663,86,0.88518,0.11482,1.77912,77,9,1, merged,0,0,0.0104132521098
8244,1000014,2,285,256,29,0.898246,0.101754,1.898246,27,2,287,258,29,0.898955,0.101045,1.232288,27,2,-1, merged,0,0,0.498866134444
8250,1000004,1,344,280,64,0.813953,0.186047,0.813953,57,7,345,281,64,0.814493,0.185507,0.814493,57,7,1, merged,0,0,0.419104381443
8250,1000120,2,40,33,7,0.825,0.175,1.638953,6,1,41,34,7,0.829268,0.170732,1.643761,6,1,1, merged,0,0,0.411278195489
8283,1000003,2,291,244,47,0.838488,0.161512,1.62589,42,5,293,245,48,0.836177,0.163823,1.614803,43,5,1, merged,1,1,0.263778256202
8287,1000043,2,65,50,15,0.769231,0.230769,1.554945,14,1,66,50,16,0.757576,0.242424,1.516196,15,1,1, abandoned,1,1,0.0125184094256
8288,1000329,2,178,112,66,0.629213,0.370787,1.387834,62,4,180,112,68,0.622222,0.377778,1.367985,64,4,1, abandoned,1,1,0.238139825218
8290,1000043,1,66,50,16,0.757576,0.242424,0.757576,15,1,67,50,17,0.746269,0.253731,0.746269,16,1,1, abandoned,1,1,0.0733137829912
8290,1000063,2,754,668,86,0.885942,0.114058,1.643517,77,9,756,669,87,0.884921,0.115079,1.631189,78,9,-1, abandoned,1,0,0.673067910553
8292,1000063,1,756,669,87,0.884921,0.115079,0.884921,78,9,758,669,89,0.882586,0.117414,0.882586,80,9,1, abandoned,1,1,0.342114649065
8297,1000004,2,347,283,64,0.815562,0.184438,1.441936,57,7,348,284,64,0.816092,0.183908,1.443752,57,7,-1, merged,0,0,0.0332632117094
8297,1000329,1,182,114,68,0.626374,0.373626,0.626374,64,4,188,118,70,0.62766,0.37234,0.62766,66,4,-1, merged,1,0,0.0332024969716
8319,1000118,2,264,229,35,0.867424,0.132576,1.70953,35,0,265,230,35,0.867925,0.132075,1.702707,35,0,1, merged,0,0,0.244861385521
8337,1000003,1,301,251,50,0.833887,0.166113,0.833887,45,5,304,253,51,0.832237,0.167763,0.832237,46,5,-1, merged,1,0,0.583394607843
8337,1000328,3,70,37,33,0.528571,0.471429,1.990118,33,0,71,38,33,0.535211,0.464789,2.002865,33,0,1, merged,0,0,1.12265258216
8337,1000329,2,188,118,70,0.62766,0.37234,1.461547,66,4,192,122,70,0.635417,0.364583,1.467654,66,4,-1, merged,0,0,0.894687310261
8338,1000003,1,304,253,51,0.832237,0.167763,0.832237,46,5,308,255,53,0.827922,0.172078,0.827922,48,5,-1, merged,1,0,0.216486740373
8338,1000091,2,62,48,14,0.774194,0.225806,1.60643,13,1,66,50,16,0.757576,0.242424,1.585498,15,1,-1, merged,1,0,0.277668863975
8344,1000120,3,41,34,7,0.829268,0.170732,2.232404,6,1,42,35,7,0.833333,0.166667,2.24537,6,1,1, merged,0,0,0.320895522388
8344,1000328,2,71,38,33,0.535211,0.464789,1.403136,33,0,72,39,33,0.541667,0.458333,1.412037,33,0,1, merged,0,0,0.0157894736842
8362,1000007,1,281,243,38,0.864769,0.135231,0.864769,31,7,283,244,39,0.862191,0.137809,0.862191,32,7,-1, abandoned,1,0,0
8374,1000007,2,283,244,39,0.862191,0.137809,1.362191,32,7,284,245,39,0.862676,0.137324,1.529343,32,7,1, merged,0,0,0.656138643699
8378,1000004,1,348,284,64,0.816092,0.183908,0.816092,57,7,350,286,64,0.817143,0.182857,0.817143,57,7,-1, merged,0,0,0.0198136365475
8390,1000026,1,102,90,12,0.882353,0.117647,0.882353,11,1,104,92,12,0.884615,0.115385,0.884615,11,1,-1, merged,0,0,0
8390,1000153,2,308,288,20,0.935065,0.064935,1.817418,15,5,309,289,20,0.935275,0.064725,1.81989,15,5,1, merged,0,0,0
8393,1000011,1,217,208,9,0.958525,0.041475,0.958525,8,1,218,209,9,0.958716,0.041284,0.958716,8,1,1, merged,0,0,1.84666460778
8393,1000015,2,472,432,40,0.915254,0.084746,1.87378,38,2,473,432,41,0.913319,0.086681,1.872035,38,3,-1, merged,1,1,1.05500651568
8399,1000015,2,476,435,41,0.913866,0.086134,1.513866,38,3,477,436,41,0.914046,0.085954,1.580713,38,3,1, merged,0,0,0.530731727291
8402,1000109,3,112,89,23,0.794643,0.205357,2.492135,23,0,113,89,24,0.787611,0.212389,2.495505,24,0,1, merged,1,1,0
8406,1000004,2,350,286,64,0.817143,0.182857,1.731369,57,7,351,287,64,0.817664,0.182336,1.732069,57,7,1, merged,0,0,0.0508911521324
8406,1000015,1,478,437,41,0.914226,0.085774,0.914226,38,3,479,438,41,0.914405,0.085595,0.914405,38,3,1, merged,0,0,0.0261988393403
8407,1000004,2,351,287,64,0.817664,0.182336,1.732069,57,7,352,288,64,0.818182,0.181818,1.732765,57,7,1, merged,0,0,0.053403307888
8407,1000015,1,479,438,41,0.914405,0.085595,0.914405,38,3,480,439,41,0.914583,0.085417,0.914583,38,3,1, merged,0,0,0.0268056191785
8408,1000004,2,352,288,64,0.818182,0.181818,1.732765,57,7,353,289,64,0.818697,0.181303,1.733458,57,7,1, merged,0,0,0.0559122695486
8408,1000015,1,480,439,41,0.914583,0.085417,0.914583,38,3,481,440,41,0.914761,0.085239,0.914761,38,3,1, merged,0,0,0.0274122137405
8409,1000004,2,353,289,64,0.818697,0.181303,1.733458,57,7,354,290,64,0.819209,0.180791,1.734147,57,7,1, merged,0,0,0.058418043202
8409,1000015,1,481,440,41,0.914761,0.085239,0.914761,38,3,482,441,41,0.914938,0.085062,0.914938,38,3,1, merged,0,0,0.028018623111
8410,1000004,2,354,290,64,0.819209,0.180791,1.734147,57,7,355,291,64,0.819718,0.180282,1.734832,57,7,1, merged,0,0,0.0640952380952
8410,1000015,1,482,441,41,0.914938,0.085062,0.914938,38,3,483,442,41,0.915114,0.084886,0.915114,38,3,1, merged,0,0,0.0274801587302
8414,1000329,1,192,122,70,0.635417,0.364583,0.635417,66,4,193,122,71,0.632124,0.367876,0.632124,67,4,1, merged,1,1,0.158479146006
8420,1000063,2,760,671,89,0.882895,0.117105,1.776512,80,9,761,672,89,0.883049,0.116951,1.777415,80,9,1, merged,0,0,0.0257531333747
8434,1000004,3,355,291,64,0.819718,0.180282,0.819718,57,7,357,293,64,0.820728,0.179272,1.820728,57,7,-1, merged,0,0,0.0712246192893
8441,1000063,2,763,673,90,0.882045,0.117955,0.882045,80,10,764,674,90,0.882199,0.117801,1.882199,80,10,1, merged,0,0,0
8464,1000009,2,215,177,38,0.823256,0.176744,0.823256,34,4,216,178,38,0.824074,0.175926,0.824074,34,4,-1, abandoned,0,0,0
8473,1000015,2,484,443,41,0.915289,0.084711,1.851187,38,3,486,445,41,0.915638,0.084362,1.85174,38,3,1, merged,0,0,0.531812804684
8473,1000153,1,312,292,20,0.935897,0.064103,0.935897,15,5,313,293,20,0.936102,0.063898,0.936102,15,5,-1, merged,0,0,0.509750745174
8487,1000124,2,121,119,2,0.983471,0.016529,1.738188,2,0,122,120,2,0.983607,0.016393,1.742866,2,0,1, merged,0,0,0.20072121689
8487,1000166,1,53,40,13,0.754717,0.245283,0.754717,12,1,54,41,13,0.759259,0.240741,0.759259,12,1,1, merged,0,0,1.98620689655
8492,1000328,2,75,42,33,0.56,0.44,1.194021,33,0,76,43,33,0.565789,0.434211,1.203545,33,0,1, merged,0,0,1.20746934225
8492,1000329,1,194,123,71,0.634021,0.365979,0.634021,67,4,196,125,71,0.637755,0.362245,0.637755,67,4,-1, merged,0,0,0.961874623267
8497,1000009,1,217,179,38,0.824885,0.175115,0.824885,34,4,220,180,40,0.818182,0.181818,0.818182,34,6,-1, merged,1,1,0
8518,1000004,1,357,293,64,0.820728,0.179272,0.820728,57,7,363,299,64,0.823691,0.176309,0.823691,57,7,-1, merged,0,0,0.0350925105339
8518,1000121,2,205,186,19,0.907317,0.092683,1.728045,18,1,209,188,21,0.899522,0.100478,1.723213,20,1,-1, merged,1,0,0.0444607153572
8527,1000023,1,108,94,14,0.87037,0.12963,0.87037,14,0,109,95,14,0.87156,0.12844,0.87156,14,0,1, merged,0,0,0.000623125754566
8527,1000063,2,766,676,90,0.882507,0.117493,1.752877,80,10,767,677,90,0.88266,0.11734,1.754219,80,10,1, merged,0,0,0.00145428103981
8532,1000063,1,771,681,90,0.883268,0.116732,0.883268,80,10,772,682,90,0.88342,0.11658,0.88342,80,10,-1, abandoned,0,0,0.0677158754683
8535,1000063,1,772,682,90,0.88342,0.11658,0.88342,80,10,774,684,90,0.883721,0.116279,0.883721,80,10,-1, merged,0,0,0.0433927838145
8548,1000004,3,367,303,64,0.825613,0.174387,1.825613,57,7,369,304,65,0.823848,0.176152,1.823848,57,8,-1, merged,1,0,0.111270000965
8548,1000070,5,217,204,13,0.940092,0.059908,3.405299,10,3,218,205,13,0.940367,0.059633,3.407431,10,3,1, merged,0,0,0.172984488371
8548,1000329,4,197,126,71,0.639594,0.360406,2.465207,67,4,199,128,71,0.643216,0.356784,2.467064,67,4,-1, merged,0,0,0.128165850953
8576,1000015,2,487,446,41,0.915811,0.084189,1.801525,38,3,488,447,41,0.915984,0.084016,1.802776,38,3,1, merged,0,0,0.0295699741681
8576,1000026,1,105,93,12,0.885714,0.114286,0.885714,11,1,106,94,12,0.886792,0.113208,0.886792,11,1,1, merged,0,0,0.594761208577
8578,1000015,2,488,447,41,0.915984,0.084016,1.415984,38,3,489,448,41,0.916155,0.083845,1.316155,38,3,1, merged,0,0,0.124181581029
8578,1000534,1,2,1,1,0.5,0.5,0.5,1,0,5,2,3,0.4,0.6,0.4,3,0,1, merged,1,1,0
8588,1000328,1,78,45,33,0.576923,0.423077,0.576923,33,0,80,46,34,0.575,0.425,0.575,34,0,1, merged,1,1,0.63381256656
8598,1000109,2,116,92,24,0.793103,0.206897,1.418103,24,0,117,92,25,0.786325,0.213675,1.34188,25,0,1, abandoned,1,1,0
8599,1000120,1,43,36,7,0.837209,0.162791,0.837209,6,1,44,36,8,0.818182,0.181818,0.818182,7,1,1, merged,1,1,0.0425316570786
8600,1000063,1,779,688,91,0.883184,0.116816,0.883184,81,10,784,692,92,0.882653,0.117347,0.882653,82,10,-1, merged,1,0,0.0178309899736
8604,1000109,2,117,92,25,0.786325,0.213675,1.34188,25,0,118,93,25,0.788136,0.211864,1.33359,25,0,1, merged,0,0,0
8607,1000003,1,328,273,55,0.832317,0.167683,0.832317,50,5,329,274,55,0.832827,0.167173,0.832827,50,5,1, merged,0,0,0.756330432824
8609,1000003,2,329,274,55,0.832827,0.167173,1.667609,50,5,334,278,56,0.832335,0.167665,1.661395,51,5,-1, merged,1,0,0.0212180581317
8611,1000003,1,334,278,56,0.832335,0.167665,0.832335,51,5,335,279,56,0.832836,0.167164,0.832836,51,5,1, merged,0,0,0.758566938856
8613,1000007,2,288,249,39,0.864583,0.135417,1.682765,32,7,292,252,40,0.863014,0.136986,1.671049,33,7,-1, merged,1,0,0.0197879643262
8613,1000009,1,220,180,40,0.818182,0.181818,0.818182,34,6,224,181,43,0.808036,0.191964,0.808036,37,6,1, merged,1,1,0.0123680211481
8614,1000003,1,335,279,56,0.832836,0.167164,0.832836,51,5,336,280,56,0.833333,0.166667,0.833333,51,5,1, merged,0,0,0.663044758539
8614,1000015,2,495,454,41,0.917172,0.082828,1.750008,38,3,496,455,41,0.917339,0.082661,1.750672,38,3,1, merged,0,0,0.628640878862
8623,1000004,1,369,304,65,0.823848,0.176152,0.823848,57,8,371,306,65,0.824798,0.175202,0.824798,57,8,-1, merged,0,0,0.0679427055377
8623,1000121,2,212,191,21,0.900943,0.099057,1.724792,20,1,213,192,21,0.901408,0.098592,1.726206,20,1,-1, merged,0,0,0.0776075599124
8626,1000327,1,31,18,13,0.580645,0.419355,0.580645,11,2,34,20,14,0.588235,0.411765,0.588235,11,3,-1, merged,1,1,0.713918128655
8628,1000328,2,82,48,34,0.585366,0.414634,0.918699,34,0,83,49,34,0.590361,0.409639,1.090361,34,0,1, merged,0,0,0.0426487009108
8635,1000121,3,215,194,21,0.902326,0.097674,2.398058,20,1,216,194,22,0.898148,0.101852,2.399354,21,1,1, merged,1,1,0.130190273079
8635,1000329,2,202,128,74,0.633663,0.366337,1.495732,70,4,204,129,75,0.632353,0.367647,1.501205,71,4,-1, merged,1,0,0.0731062381007
8636,1000009,2,225,182,43,0.808889,0.191111,1.768165,37,6,226,183,43,0.809735,0.190265,1.764689,37,6,1, merged,0,0,0.934484222605
8636,1000011,1,221,212,9,0.959276,0.040724,0.959276,8,1,222,212,10,0.954955,0.045045,0.954955,9,1,1, merged,1,1,1.84521212121
8638,1000009,2,226,183,43,0.809735,0.190265,1.764689,37,6,227,184,43,0.810573,0.189427,1.761245,37,6,1, merged,0,0,0.186872989877
8638,1000011,1,222,212,10,0.954955,0.045045,0.954955,9,1,223,212,11,0.950673,0.049327,0.950673,10,1,1, merged,1,1,0.369984378501
8648,1000004,2,371,306,65,0.824798,0.175202,1.697525,57,8,372,307,65,0.825269,0.174731,1.699143,57,8,1, merged,0,0,0.00604457876842
8648,1000023,1,110,96,14,0.872727,0.127273,0.872727,14,0,111,97,14,0.873874,0.126126,0.873874,14,0,1, merged,0,0,0.00109030022195
8675,1000004,2,372,307,65,0.825269,0.174731,1.712061,57,8,373,308,65,0.825737,0.174263,1.713588,57,8,-1, abandoned,0,0,0.000196574116443
8675,1000026,1,106,94,12,0.886792,0.113208,0.886792,11,1,107,95,12,0.88785,0.11215,0.88785,11,1,-1, abandoned,0,0,0.0023665354384
8688,1000007,3,292,252,40,0.863014,0.136986,2.681682,33,7,293,253,40,0.863481,0.136519,2.672115,33,7,1, merged,0,0,0.498746701847
8688,1000026,2,107,95,12,0.88785,0.11215,1.818668,11,1,109,96,13,0.880734,0.119266,1.808634,12,1,-1, merged,1,0,0.80118932819
8688,1000153,1,318,296,22,0.930818,0.069182,0.930818,17,5,319,296,23,0.9279,0.0721,0.9279,18,5,1, merged,1,1,0.416824515691
8692,1000121,2,217,195,22,0.898618,0.101382,1.773618,21,1,218,196,22,0.899083,0.100917,1.787971,21,1,1, merged,0,0,0.576443671049
8694,1000124,2,122,120,2,0.983607,0.016393,1.742866,2,0,123,121,2,0.98374,0.01626,1.747376,2,0,1, merged,0,0,0.0689238713877
8694,1000166,1,54,41,13,0.759259,0.240741,0.759259,12,1,55,42,13,0.763636,0.236364,0.763636,12,1,1, merged,0,0,0.659917790753
8698,1000121,1,218,196,22,0.899083,0.100917,0.899083,21,1,219,196,23,0.894977,0.105023,0.894977,22,1,1, merged,1,1,0.574168814433
8699,1000026,2,109,96,13,0.880734,0.119266,1.808634,12,1,110,97,13,0.881818,0.118182,1.809943,12,1,1, merged,0,0,0.735613359024
8699,1000153,1,319,296,23,0.9279,0.0721,0.9279,18,5,320,297,23,0.928125,0.071875,0.928125,18,5,1, merged,0,0,0.0442435775452
8708,1000329,2,206,131,75,0.635922,0.364078,1.222388,71,4,210,133,77,0.633333,0.366667,1.228922,73,4,-1, merged,1,0,0.0450093011798
8709,1000329,1,210,133,77,0.633333,0.366667,0.633333,73,4,213,134,79,0.629108,0.370892,0.629108,75,4,1, merged,1,1,0.0823533043532
8722,1000329,1,213,134,79,0.629108,0.370892,0.629108,75,4,214,135,79,0.630841,0.369159,0.630841,75,4,-1, merged,0,0,0.0306164581675
8724,1000004,3,373,308,65,0.825737,0.174263,2.012216,57,8,376,311,65,0.827128,0.172872,2.022872,57,8,-1, merged,0,0,0.00882367988948
8724,1000121,4,219,196,23,0.894977,0.105023,2.907193,22,1,220,197,23,0.895455,0.104545,2.918327,22,1,1, merged,0,0,0.0137755296936
8724,1000328,1,84,50,34,0.595238,0.404762,0.595238,34,0,85,51,34,0.6,0.4,0.6,34,0,-1, merged,0,0,0.0234656766284
8729,1000004,1,376,311,65,0.827128,0.172872,0.827128,57,8,377,312,65,0.827586,0.172414,0.827586,57,8,-1, abandoned,0,0,0.0560481549417
8739,1000118,2,288,253,35,0.878472,0.121528,1.735615,35,0,289,254,35,0.878893,0.121107,1.742529,35,0,1, merged,0,0,0.712539294446
8743,1000118,1,289,254,35,0.878893,0.121107,0.878893,35,0,290,255,35,0.87931,0.12069,0.87931,35,0,1, merged,0,0,0.00498761430012
8745,1000015,1,509,468,41,0.91945,0.08055,0.91945,38,3,510,468,42,0.917647,0.082353,0.917647,39,3,1, merged,1,1,0
8745,1000063,3,791,699,92,0.883692,0.116308,2.564335,82,10,792,700,92,0.883838,0.116162,2.551485,82,10,1, merged,0,0,0.0249345665389
8745,1000091,2,67,51,16,0.761194,0.238806,1.680644,15,1,68,51,17,0.75,0.25,1.667647,16,1,1, merged,1,1,0.120871146978
8746,1000004,2,377,312,65,0.827586,0.172414,1.827586,57,8,378,313,65,0.828042,0.171958,1.828042,57,8,-1, abandoned,0,0,0.00790439561982
8746,1000063,4,792,700,92,0.883838,0.116162,3.641859,82,10,793,701,92,0.883985,0.116015,3.634441,82,10,-1, abandoned,0,0,0.034107046069
8789,1000153,2,322,299,23,0.928571,0.071429,1.702765,18,5,323,300,23,0.928793,0.071207,1.70657,18,5,1, merged,0,0,0.619750936626
8792,1000153,2,323,300,23,0.928793,0.071207,0.928793,18,5,324,301,23,0.929012,0.070988,1.929012,18,5,1, merged,0,0,0.0848566936339
8794,1000153,2,324,301,23,0.929012,0.070988,1.679012,18,5,326,303,23,0.929448,0.070552,1.707226,18,5,-1, merged,0,0,0.200170738589
8795,1000109,1,118,93,25,0.788136,0.211864,0.788136,25,0,120,94,26,0.783333,0.216667,0.783333,26,0,1, merged,1,1,0.700232782369
8795,1000199,2,74,58,16,0.783784,0.216216,1.571919,16,0,76,59,17,0.776316,0.223684,1.559649,17,0,1, merged,1,1,0.729473341693
8802,1000329,2,215,136,79,0.632558,0.367442,1.23115,75,4,216,137,79,0.634259,0.365741,1.235658,75,4,1, merged,0,0,0.253421368547
8804,1000063,2,793,701,92,0.883985,0.116015,1.488152,82,10,794,702,92,0.884131,0.115869,1.491028,82,10,1, merged,0,0,0.660998202735
8849,1000014,2,305,276,29,0.904918,0.095082,1.780624,27,2,306,277,29,0.905229,0.094771,1.781633,27,2,1, merged,0,0,0.521848879973
8855,1000124,2,125,123,2,0.984,0.016,1.747636,2,0,126,124,2,0.984127,0.015873,1.751984,2,0,1, merged,0,0,0.0703652518681
8855,1000166,1,55,42,13,0.763636,0.236364,0.763636,12,1,56,43,13,0.767857,0.232143,0.767857,12,1,1, merged,0,0,0.669561315661
8861,1000014,2,306,277,29,0.905229,0.094771,1.514424,27,2,308,278,30,0.902597,0.097403,1.50487,28,2,1, merged,1,1,0.00672115209838
8861,1000328,1,87,53,34,0.609195,0.390805,0.609195,34,0,88,53,35,0.602273,0.397727,0.602273,35,0,1, merged,1,1,0.0363683933776
8864,1000004,2,380,315,65,0.828947,0.171053,1.715434,57,8,381,316,65,0.829396,0.170604,1.716493,57,8,1, merged,0,0,0.241381573287
8874,1000199,2,76,59,17,0.776316,0.223684,1.32177,17,0,78,61,17,0.782051,0.217949,1.282051,17,0,-1, merged,0,0,0.995256916996
8875,1000199,2,78,61,17,0.782051,0.217949,1.282051,17,0,81,63,18,0.777778,0.222222,1.239316,18,0,1, merged,1,1,0.711317347635
8877,1000109,2,120,94,26,0.783333,0.216667,1.6375,26,0,121,95,26,0.785124,0.214876,1.642267,26,0,1, merged,0,0,0.790714019983
8879,1000199,3,81,63,18,0.777778,0.222222,2.096459,18,0,83,65,18,0.783133,0.216867,2.089799,18,0,-1, merged,0,0,0.477574052723
8884,1000004,2,381,316,65,0.829396,0.170604,1.725324,57,8,388,320,68,0.824742,0.175258,1.716634,60,8,1, merged,1,1,0.0240983606557
8884,1000121,1,221,198,23,0.895928,0.104072,0.895928,22,1,222,198,24,0.891892,0.108108,0.891892,23,1,1, merged,1,1,0
8885,1000003,2,336,280,56,0.833333,0.166667,1.610312,51,5,338,280,58,0.828402,0.171598,1.601452,53,5,1, merged,1,1,0.0865451891533
8894,1000004,2,388,320,68,0.824742,0.175258,1.688688,60,8,389,321,68,0.825193,0.174807,1.6896,60,8,1, merged,0,0,0
8894,1000007,1,294,254,40,0.863946,0.136054,0.863946,33,7,295,255,40,0.864407,0.135593,0.864407,33,7,1, merged,0,0,0
8898,1000015,2,515,473,42,0.918447,0.081553,1.812386,39,3,516,474,42,0.918605,0.081395,1.814127,39,3,1, merged,0,0,0.559661531886
8902,1000014,1,308,278,30,0.902597,0.097403,0.902597,28,2,310,279,31,0.9,0.1,0.9,29,2,-1, abandoned,1,0,0.049388374579
8905,1000014,1,310,279,31,0.9,0.1,0.9,29,2,311,279,32,0.897106,0.102894,0.897106,30,2,1, abandoned,1,1,0
8908,1000004,1,389,321,68,0.825193,0.174807,0.825193,60,8,391,322,69,0.823529,0.176471,0.823529,60,9,-1, merged,1,0,0.0297827183128
8927,1000118,2,295,259,36,0.877966,0.122034,1.755061,36,0,296,260,36,0.878378,0.121622,1.750601,36,0,1, merged,0,0,0.425038120008
8970,1000007,1,295,255,40,0.864407,0.135593,0.864407,33,7,298,257,41,0.862416,0.137584,0.862416,34,7,-1, merged,1,0,0.327134243273
8972,1000118,2,299,263,36,0.879599,0.120401,1.798791,36,0,300,264,36,0.88,0.12,1.790891,36,0,1, merged,0,0,0.0307665018052
8973,1000026,2,115,102,13,0.886957,0.113043,1.886957,12,1,116,103,13,0.887931,0.112069,1.887931,12,1,1, merged,0,0,0.813327177593
8991,1000153,1,326,303,23,0.929448,0.070552,0.929448,18,5,327,304,23,0.929664,0.070336,0.929664,18,5,-1, abandoned,0,0,0.881593117348
8992,1000015,3,523,481,42,0.919694,0.080306,1.849358,39,3,524,482,42,0.919847,0.080153,1.846677,39,3,1, merged,0,0,0.11895130388
8992,1000153,2,327,304,23,0.929664,0.070336,0.929664,18,5,328,304,24,0.926829,0.073171,0.926829,19,5,1, merged,1,1,0.127739053935
8994,1000009,2,239,196,43,0.820084,0.179916,1.607962,37,6,240,197,43,0.820833,0.179167,1.611878,37,6,1, merged,0,0,0.897816061074
8995,1000070,2,223,210,13,0.941704,0.058296,1.813926,10,3,224,211,13,0.941964,0.058036,1.814892,10,3,1, merged,0,0,0.617261606696
8998,1000009,2,240,197,43,0.820833,0.179167,1.769551,37,6,241,198,43,0.821577,0.178423,1.770729,37,6,-1, abandoned,0,0,0.0161369067219
8998,1000011,1,234,222,12,0.948718,0.051282,0.948718,10,2,236,224,12,0.949153,0.050847,0.949153,10,2,-1, abandoned,0,0,0.0309739936052
8999,1000121,2,223,199,24,0.892377,0.107623,1.612377,23,1,224,200,24,0.892857,0.107143,1.623626,23,1,1, merged,0,0,0.538079101206
9000,1000121,2,224,200,24,0.892857,0.107143,1.623626,23,1,225,201,24,0.893333,0.106667,1.634074,23,1,1, merged,0,0,0.268845406271
9004,1000121,3,226,202,24,0.893805,0.106195,2.559546,23,1,227,203,24,0.894273,0.105727,2.535388,23,1,-1, abandoned,0,0,0.305602334303
9007,1000121,1,227,203,24,0.894273,0.105727,0.894273,23,1,228,204,24,0.894737,0.105263,0.894737,23,1,1, merged,0,0,0.094467865335
9008,1000124,2,126,124,2,0.984127,0.015873,1.756057,2,0,127,125,2,0.984252,0.015748,1.746964,2,0,1, merged,0,0,0.0312299369975
9008,1000166,1,57,44,13,0.77193,0.22807,0.77193,12,1,59,45,14,0.762712,0.237288,0.762712,13,1,1, merged,1,1,0.195593488392
9021,1000121,2,228,204,24,0.894737,0.105263,1.783626,23,1,229,205,24,0.895197,0.104803,1.795197,23,1,1, merged,0,0,0.525703545944
9040,1000110,2,4,4,0,1,0,1.588235,0,0,5,5,0,1,0,1.6,0,0,1, merged,0,0,1.4375
9040,1000327,1,34,20,14,0.588235,0.411765,0.588235,11,3,35,21,14,0.6,0.4,0.6,11,3,1, merged,0,0,0.834848484848
9043,1000015,1,527,485,42,0.920304,0.079696,0.920304,39,3,528,486,42,0.920455,0.079545,0.920455,39,3,1, merged,0,0,0.212446324313
9046,1000004,2,397,327,70,0.823678,0.176322,1.577301,61,9,398,328,70,0.824121,0.175879,1.581263,61,9,1, merged,0,0,0.407684793227
9046,1000091,1,69,52,17,0.753623,0.246377,0.753623,16,1,70,53,17,0.757143,0.242857,0.757143,16,1,1, merged,0,0,0.394902912621
9048,1000004,2,399,329,70,0.824561,0.175439,1.542871,61,9,400,330,70,0.825,0.175,1.547222,61,9,1, merged,0,0,0.05224609375
9065,1000004,2,414,344,70,0.830918,0.169082,1.580918,61,9,415,345,70,0.831325,0.168675,1.631325,61,9,1, merged,0,0,0.00416698743838
9066,1000004,2,415,345,70,0.831325,0.168675,0.831325,61,9,416,346,70,0.831731,0.168269,1.831731,61,9,1, merged,0,0,0.00619545307617
9074,1000007,2,300,258,42,0.86,0.14,1.780455,35,7,301,259,42,0.860465,0.139535,1.781369,35,7,-1, merged,0,0,0.123547279315
9074,1000015,1,528,486,42,0.920455,0.079545,0.920455,39,3,531,489,42,0.920904,0.079096,0.920904,39,3,-1, merged,0,0,0.0895874023367
9102,1000003,1,343,285,58,0.830904,0.169096,0.830904,53,5,344,286,58,0.831395,0.168605,0.831395,53,5,1, merged,0,0,0.0310835071977
9108,1000015,2,533,491,42,0.921201,0.078799,1.853019,39,3,534,492,42,0.921348,0.078652,1.853933,39,3,1, merged,0,0,0.565099300872
9109,1000015,2,534,492,42,0.921348,0.078652,1.853933,39,3,535,493,42,0.921495,0.078505,1.854829,39,3,1, merged,0,0,0.239187501976
9113,1000004,1,420,350,70,0.833333,0.166667,0.833333,61,9,421,351,70,0.833729,0.166271,0.833729,61,9,1, merged,0,0,0.110881901394
9123,1000004,2,421,351,70,0.833729,0.166271,1.760558,61,9,423,353,70,0.834515,0.165485,1.755727,61,9,-1, merged,0,0,0.0575487816565
9123,1000026,3,120,106,14,0.883333,0.116667,2.643892,12,2,121,107,14,0.884298,0.115702,2.640025,12,2,1, merged,0,0,0.139045860219
9123,1000153,1,328,304,24,0.926829,0.073171,0.926829,19,5,330,304,26,0.921212,0.078788,0.921212,21,5,1, merged,1,1,0.059982894739
9127,1000009,2,244,201,43,0.82377,0.17623,1.772923,37,6,245,202,43,0.82449,0.17551,1.77407,37,6,1, merged,0,0,0.082239635404
9127,1000011,1,236,224,12,0.949153,0.050847,0.949153,10,2,238,226,12,0.94958,0.05042,0.94958,10,2,-1, merged,0,0,0.152902980171
9132,1000109,2,121,95,26,0.785124,0.214876,1.566733,26,0,122,96,26,0.786885,0.213115,1.570976,26,0,1, merged,0,0,0.851594202899
9132,1000199,1,87,68,19,0.781609,0.218391,0.781609,19,0,88,69,19,0.784091,0.215909,0.784091,19,0,1, merged,0,0,0.908333333333
9134,1000199,2,88,69,19,0.784091,0.215909,1.595412,19,0,89,70,19,0.786517,0.213483,1.601332,19,0,1, merged,0,0,0.0140977443609
9136,1000109,2,123,97,26,0.788618,0.211382,1.577507,26,0,124,97,27,0.782258,0.217742,1.573467,27,0,1, abandoned,1,1,0.38463177652
9136,1000199,1,90,71,19,0.788889,0.211111,0.788889,19,0,91,72,19,0.791209,0.208791,0.791209,19,0,-1, abandoned,0,0,0.403883260979
9157,1000014,2,319,286,33,0.896552,0.103448,1.524003,31,2,320,287,33,0.896875,0.103125,1.526745,31,2,1, merged,0,0,0.514499520508
9159,1000153,1,330,304,26,0.921212,0.078788,0.921212,21,5,331,305,26,0.92145,0.07855,0.92145,21,5,1, merged,0,0,0
9179,1000105,1,143,112,31,0.783217,0.216783,0.783217,29,2,145,113,32,0.77931,0.22069,0.77931,30,2,1, merged,1,1,0.038034800069
9184,1000153,2,331,305,26,0.92145,0.07855,1.741122,21,5,333,307,26,0.921922,0.078078,1.706537,21,5,-1, merged,0,0,0.0099056838029
9188,1000015,3,538,496,42,0.921933,0.078067,2.509752,39,3,539,497,42,0.922078,0.077922,2.515556,39,3,1, merged,0,0,0
9188,1000199,1,91,72,19,0.791209,0.208791,0.791209,19,0,92,73,19,0.793478,0.206522,0.793478,19,0,1, merged,0,0,0.480773880652
9189,1000199,1,92,73,19,0.793478,0.206522,0.793478,19,0,93,74,19,0.795699,0.204301,0.795699,19,0,1, merged,0,0,0.724593723102
9193,1000004,2,423,353,70,0.834515,0.165485,1.834515,61,9,424,354,70,0.834906,0.165094,1.834906,61,9,1, merged,0,0,0.042121309371
9255,1000121,1,231,207,24,0.896104,0.103896,0.896104,23,1,232,208,24,0.896552,0.103448,0.896552,23,1,1, merged,0,0,0.613141875931
9256,1000121,1,232,208,24,0.896552,0.103448,0.896552,23,1,234,209,25,0.893162,0.106838,0.893162,24,1,1, merged,1,1,0.462216913724
9260,1000005,2,50,38,12,0.76,0.24,1.657196,12,0,51,38,13,0.745098,0.254902,1.64016,13,0,1, merged,1,1,0.126650903753
9260,1000014,1,321,288,33,0.897196,0.102804,0.897196,31,2,324,290,34,0.895062,0.104938,0.895062,32,2,-1, merged,1,0,0.0999167793521
9260,1000121,3,234,209,25,0.893162,0.106838,2.550359,24,1,236,210,26,0.889831,0.110169,2.52999,25,1,1, merged,1,1,0.0955538085185
9263,1000054,2,21,17,4,0.809524,0.190476,1.690712,2,2,22,18,4,0.818182,0.181818,1.700535,2,2,1, merged,0,0,1.3541433892
9281,1000329,1,219,140,79,0.639269,0.360731,0.639269,75,4,222,141,81,0.635135,0.364865,0.635135,77,4,1, merged,1,1,0.0690739276411
9283,1000121,2,236,210,26,0.889831,0.110169,1.789831,25,1,237,211,26,0.890295,0.109705,1.799386,25,1,1, merged,0,0,0.28865499359
9284,1000121,2,237,211,26,0.890295,0.109705,1.799386,25,1,238,212,26,0.890756,0.109244,1.807423,25,1,1, merged,0,0,0.527540790428
9285,1000121,2,238,212,26,0.890756,0.109244,1.807423,25,1,239,213,26,0.891213,0.108787,1.81429,25,1,1, merged,0,0,0.306656601368
9290,1000003,1,347,289,58,0.832853,0.167147,0.832853,53,5,349,291,58,0.833811,0.166189,0.833811,53,5,-1, merged,0,0,0.0188203314895
9290,1000118,2,310,272,38,0.877419,0.122581,1.710272,38,0,311,273,38,0.877814,0.122186,1.711624,38,0,1, merged,0,0,0.118442732769
9293,1000004,4,425,355,70,0.835294,0.164706,3.517356,61,9,426,356,70,0.835681,0.164319,3.498945,61,9,1, merged,0,0,0.32416
9293,1000012,1,275,250,25,0.909091,0.090909,0.909091,24,1,276,250,26,0.905797,0.094203,0.905797,25,1,1, merged,1,1,0.910979877515
9293,1000026,3,123,109,14,0.886179,0.113821,2.682062,12,2,124,110,14,0.887097,0.112903,2.663264,12,2,1, merged,0,0,0.265124016939
9301,1000153,2,336,310,26,0.922619,0.077381,1.819678,21,5,337,311,26,0.922849,0.077151,1.822849,21,5,1, merged,0,0,0
9304,1000014,1,325,291,34,0.895385,0.104615,0.895385,32,2,326,291,35,0.892638,0.107362,0.892638,33,2,1, merged,1,1,0.616814159292
9304,1000015,2,543,501,42,0.922652,0.077348,1.818037,39,3,544,502,42,0.922794,0.077206,1.815432,39,3,1, merged,0,0,0.912719271685
9313,1000015,1,544,502,42,0.922794,0.077206,0.922794,39,3,546,503,43,0.921245,0.078755,0.921245,40,3,1, merged,1,1,9.75993482527e-05
9313,1000109,2,141,110,31,0.780142,0.219858,1.702936,31,0,143,111,32,0.776224,0.223776,1.697469,32,0,1, merged,1,1,0.000860261199985
9322,1000015,2,546,503,43,0.921245,0.078755,1.679415,40,3,547,504,43,0.921389,0.078611,1.676228,40,3,1, merged,0,0,0.00376165192193
9322,1000109,1,153,116,37,0.75817,0.24183,0.75817,37,0,155,117,38,0.754839,0.245161,0.754839,38,0,1, merged,1,1,0.0711845124906
9323,1000015,2,547,504,43,0.921389,0.078611,1.676228,40,3,548,505,43,0.921533,0.078467,1.677943,40,3,1, merged,0,0,0.0725495519957
9323,1000109,1,155,117,38,0.754839,0.245161,0.754839,38,0,156,118,38,0.75641,0.24359,0.75641,38,0,1, merged,0,0,1.30087209302
9324,1000015,2,548,505,43,0.921533,0.078467,1.677943,40,3,549,506,43,0.921676,0.078324,1.676393,40,3,1, merged,0,0,0.000856603549689
9324,1000109,1,156,118,38,0.75641,0.24359,0.75641,38,0,159,120,39,0.754717,0.245283,0.754717,39,0,1, merged,1,1,0.0153165767366
9340,1000118,2,311,273,38,0.877814,0.122186,1.789578,38,0,312,274,38,0.878205,0.121795,1.790826,38,0,1, merged,0,0,0.616164061927
9342,1000063,3,827,732,95,0.885127,0.114873,2.821297,85,10,828,733,95,0.885266,0.114734,2.822108,85,10,1, merged,0,0,0.000443541796787
9355,1000063,2,833,738,95,0.885954,0.114046,1.790413,85,10,837,742,95,0.886499,0.113501,1.785234,85,10,-1, merged,0,0,0.748830956964
9400,1000004,1,429,359,70,0.83683,0.16317,0.83683,61,9,430,360,70,0.837209,0.162791,0.837209,61,9,-1, merged,0,0,0.174248225907
9400,1000592,2,1,0,1,0,1,0.83683,0,1,3,2,1,0.666667,0.333333,1.503876,0,1,1, merged,0,0,0.333102493075
9404,1000199,2,94,75,19,0.797872,0.202128,1.594747,19,0,95,76,19,0.8,0.2,1.587879,19,0,-1, abandoned,0,0,0.384226337992
9405,1000121,2,239,213,26,0.891213,0.108787,1.81429,25,1,240,214,26,0.891667,0.108333,1.820238,25,1,1, merged,0,0,0.0353460337067
9407,1000328,2,91,56,35,0.615385,0.384615,1.25052,35,0,93,57,36,0.612903,0.387097,1.24519,36,0,1, merged,1,1,0.207132590902
9407,1000329,1,222,141,81,0.635135,0.364865,0.635135,77,4,223,141,82,0.632287,0.367713,0.632287,78,4,1, merged,1,1,0.214283142369
9408,1000004,1,430,360,70,0.837209,0.162791,0.837209,61,9,431,361,70,0.837587,0.162413,0.837587,61,9,-1, abandoned,0,0,0.444898826601
9408,1000329,3,223,141,82,0.632287,0.367713,2.191719,78,4,224,142,82,0.633929,0.366071,2.201245,78,4,-1, abandoned,0,0,0.952999533147
9409,1000007,1,301,259,42,0.860465,0.139535,0.860465,35,7,302,260,42,0.860927,0.139073,0.860927,35,7,-1, merged,0,0,0
9409,1000011,2,241,229,12,0.950207,0.049793,1.810673,10,2,242,230,12,0.950413,0.049587,1.81134,10,2,1, merged,0,0,0
9413,1000015,2,549,506,43,0.921676,0.078324,1.709555,40,3,550,507,43,0.921818,0.078182,1.712863,40,3,1, merged,0,0,0.109330931944
9418,1000109,2,169,130,39,0.769231,0.230769,1.560276,39,0,171,132,39,0.77193,0.22807,1.560662,39,0,-1, merged,0,0,0.800614250614
9419,1000009,2,245,202,43,0.82449,0.17551,1.748243,37,6,246,203,43,0.825203,0.174797,1.74918,37,6,1, merged,0,0,0.90819628077
9419,1000153,1,341,315,26,0.923754,0.076246,0.923754,21,5,342,316,26,0.923977,0.076023,0.923977,21,5,1, merged,0,0,0.997033923239
9420,1000004,2,431,361,70,0.837587,0.162413,1.471516,61,9,432,362,70,0.837963,0.162037,1.469074,61,9,1, merged,0,0,0.419343530911
9420,1000329,1,224,142,82,0.633929,0.366071,0.633929,78,4,225,142,83,0.631111,0.368889,0.631111,79,4,1, merged,1,1,0.998916336518
9433,1000004,1,433,363,70,0.838337,0.161663,0.838337,61,9,434,363,71,0.836406,0.163594,0.836406,62,9,1, merged,1,1,0.183798632805
9435,1000004,2,434,363,71,0.836406,0.163594,1.836406,62,9,436,365,71,0.837156,0.162844,1.837156,62,9,-1, merged,0,0,0.044318905156
9444,1000063,1,844,749,95,0.887441,0.112559,0.887441,85,10,845,750,95,0.887574,0.112426,0.887574,85,10,-1, merged,0,0,0.000215107838613
9455,1000118,2,312,274,38,0.878205,0.121795,1.692364,38,0,313,275,38,0.878594,0.121406,1.694384,38,0,1, merged,0,0,0.0644131174976
9460,1000132,2,74,62,12,0.837838,0.162162,1.701474,10,2,76,62,14,0.815789,0.184211,1.641876,12,2,1, abandoned,1,1,0.147329831967
9466,1000004,2,437,366,71,0.837529,0.162471,1.837529,62,9,438,367,71,0.8379,0.1621,1.8379,62,9,1, merged,0,0,0.00381679389313
9466,1000063,3,848,753,95,0.887972,0.112028,2.7255,85,10,849,754,95,0.888104,0.111896,2.726003,85,10,1, merged,0,0,0.000119954417321
9469,1000070,2,228,215,13,0.942982,0.057018,1.758772,10,3,232,216,16,0.931034,0.068966,1.75,13,3,1, merged,1,1,0.0887817895329
9472,1000124,2,127,125,2,0.984252,0.015748,1.746964,2,0,128,126,2,0.984375,0.015625,1.751042,2,0,1, merged,0,0,0.218695090439
9472,1000166,1,59,45,14,0.762712,0.237288,0.762712,13,1,60,46,14,0.766667,0.233333,0.766667,13,1,1, merged,0,0,1.40061538462
9475,1000007,2,303,261,42,0.861386,0.138614,1.785363,35,7,304,262,42,0.861842,0.138158,1.78604,35,7,1, merged,0,0,0.462446340985
9475,1000153,1,342,316,26,0.923977,0.076023,0.923977,21,5,343,317,26,0.924198,0.075802,0.924198,21,5,1, merged,0,0,0.341914519107
9477,1000004,1,438,367,71,0.8379,0.1621,0.8379,62,9,441,369,72,0.836735,0.163265,0.836735,63,9,1, merged,1,1,0.0429252782194
9478,1000070,1,232,216,16,0.931034,0.068966,0.931034,13,3,234,217,17,0.92735,0.07265,0.92735,13,4,-1, merged,1,0,0.258544085178
9481,1000121,1,241,215,26,0.892116,0.107884,0.892116,25,1,242,216,26,0.892562,0.107438,0.892562,25,1,1, merged,0,0,0.115680719251
9494,1000004,2,441,369,72,0.836735,0.163265,1.730027,63,9,443,370,73,0.835214,0.164786,1.728831,64,9,1, merged,1,1,0.00894564076994
9494,1000014,1,328,293,35,0.893293,0.106707,0.893293,33,2,329,294,35,0.893617,0.106383,0.893617,33,2,-1, merged,0,0,0.0136602826441
9494,1000153,3,346,320,26,0.924855,0.075145,2.654883,21,5,347,321,26,0.925072,0.074928,2.653904,21,5,1, merged,0,0,0.0195085248388
9508,1000009,1,247,204,43,0.825911,0.174089,0.825911,37,6,248,205,43,0.826613,0.173387,0.826613,37,6,1, merged,0,0,0.468684868681
9509,1000009,1,248,205,43,0.826613,0.173387,0.826613,37,6,249,206,43,0.827309,0.172691,0.827309,37,6,1, merged,0,0,0.459316173863
9516,1000118,2,313,275,38,0.878594,0.121406,1.808419,38,0,315,276,39,0.87619,0.12381,1.791445,39,0,1, merged,1,1,0.0137549880868
9527,1000003,3,349,291,58,0.833811,0.166189,1.739608,53,5,352,294,58,0.835227,0.164773,2.241364,53,5,-1, abandoned,0,0,0
9527,1000012,2,276,250,26,0.905797,0.094203,0.905797,25,1,277,251,26,0.906137,0.093863,1.406137,25,1,-1, abandoned,0,0,0
9530,1000109,3,175,136,39,0.777143,0.222857,2.009163,39,0,176,137,39,0.778409,0.221591,2.046295,39,0,1, merged,0,0,0.265274492224
9530,1000199,4,96,76,20,0.791667,0.208333,2.80083,20,0,97,77,20,0.793814,0.206186,2.840109,20,0,1, merged,0,0,0.275889054289
9543,1000118,1,316,277,39,0.876582,0.123418,0.876582,39,0,317,278,39,0.876972,0.123028,0.876972,39,0,1, merged,0,0,0.194292861063
9545,1000004,1,445,372,73,0.835955,0.164045,0.835955,64,9,447,373,74,0.834452,0.165548,0.834452,65,9,1, merged,1,1,0.0193628981886
9557,1000063,2,851,756,95,0.888367,0.111633,1.837085,85,10,852,757,95,0.888498,0.111502,1.837865,85,10,1, merged,0,0,0.0770597546893
9567,1000109,2,176,137,39,0.778409,0.221591,1.575706,39,0,177,138,39,0.779661,0.220339,1.579661,39,0,1, merged,0,0,0.0368484848485
9567,1000153,3,347,321,26,0.925072,0.074928,2.500778,21,5,348,322,26,0.925287,0.074713,2.504948,21,5,1, merged,0,0,0.996924360319
9580,1000003,1,353,295,58,0.835694,0.164306,0.835694,53,5,354,296,58,0.836158,0.163842,0.836158,53,5,-1, merged,0,0,0.028448529985
9613,1000004,1,450,376,74,0.835556,0.164444,0.835556,65,9,451,377,74,0.83592,0.16408,0.83592,65,9,1, merged,0,0,0.0109614097512
9613,1000005,2,51,38,13,0.745098,0.254902,1.580654,13,0,52,39,13,0.75,0.25,1.58592,13,0,1, merged,0,0,0.00189988667928
9614,1000014,2,331,296,35,0.89426,0.10574,1.819761,33,2,332,297,35,0.894578,0.105422,1.820293,33,2,1, merged,0,0,0.0235551359315
9614,1000153,1,349,323,26,0.925501,0.074499,0.925501,21,5,350,324,26,0.925714,0.074286,0.925714,21,5,1, merged,0,0,0.0165206726716
9615,1000121,2,244,218,26,0.893443,0.106557,1.528636,25,1,245,219,26,0.893878,0.106122,1.53063,25,1,-1, abandoned,0,0,0.529874614336
9615,1000329,1,233,148,85,0.635193,0.364807,0.635193,81,4,234,149,85,0.636752,0.363248,0.636752,81,4,-1, abandoned,0,0,0.901122014301
9633,1000329,1,234,149,85,0.636752,0.363248,0.636752,81,4,236,150,86,0.635593,0.364407,0.635593,82,4,-1, merged,1,0,0.224288249461
9645,1000023,1,121,107,14,0.884298,0.115702,0.884298,14,0,123,108,15,0.878049,0.121951,0.878049,14,1,-1, merged,1,1,0.350272723782
9645,1000063,2,854,759,95,0.888759,0.111241,1.773056,85,10,855,760,95,0.888889,0.111111,1.766938,85,10,1, merged,0,0,0.337641260166
9647,1000063,1,855,760,95,0.888889,0.111111,0.888889,85,10,856,761,95,0.889019,0.110981,0.889019,85,10,1, merged,0,0,0.00529940794005
9665,1000004,1,452,378,74,0.836283,0.163717,0.836283,65,9,453,379,74,0.836645,0.163355,0.836645,65,9,1, merged,0,0,0.186142781055
9669,1000005,1,52,39,13,0.75,0.25,0.75,13,0,53,40,13,0.754717,0.245283,0.754717,13,0,1, merged,0,0,0.212483061688
9669,1000014,2,333,298,35,0.894895,0.105105,1.644895,33,2,334,299,35,0.89521,0.10479,1.649927,33,2,1, merged,0,0,0.169060794846
9669,1000121,3,245,219,26,0.893878,0.106122,2.538772,25,1,246,220,26,0.894309,0.105691,2.544236,25,1,1, merged,0,0,0.160124693451
9686,1000023,2,123,108,15,0.878049,0.121951,1.76784,14,1,124,109,15,0.879032,0.120968,1.767792,14,1,1, merged,0,0,0.353946681505
9686,1000063,1,862,767,95,0.889791,0.110209,0.889791,85,10,863,767,96,0.88876,0.11124,0.88876,86,10,1, merged,1,1,0.333274593544
9694,1000009,1,252,209,43,0.829365,0.170635,0.829365,37,6,253,210,43,0.83004,0.16996,0.83004,37,6,1, merged,0,0,0.322981121305
9717,1000124,2,129,127,2,0.984496,0.015504,1.762274,2,0,130,128,2,0.984615,0.015385,1.765865,2,0,1, merged,0,0,0.0268329223494
9717,1000166,1,63,49,14,0.777778,0.222222,0.777778,13,1,64,50,14,0.78125,0.21875,0.78125,13,1,1, merged,0,0,0.169193327087
9721,1000015,2,563,519,44,0.921847,0.078153,0.921847,41,3,564,520,44,0.921986,0.078014,1.921986,41,3,1, merged,0,0,0.202615490515
9722,1000003,3,354,296,58,0.836158,0.163842,2.590875,53,5,355,297,58,0.83662,0.16338,2.595879,53,5,1, merged,0,0,3.57307636763e-11
9722,1000005,2,53,40,13,0.754717,0.245283,1.754717,13,0,54,41,13,0.759259,0.240741,1.759259,13,0,1, merged,0,0,0.00228770057144
9723,1000007,1,313,270,43,0.86262,0.13738,0.86262,36,7,314,270,44,0.859873,0.140127,0.859873,37,7,1, merged,1,1,0.347399846612
9723,1000153,2,352,326,26,0.926136,0.073864,1.788756,21,5,353,327,26,0.926346,0.073654,1.786218,21,5,1, merged,0,0,0.258828526982
9725,1000121,1,246,220,26,0.894309,0.105691,0.894309,25,1,247,221,26,0.894737,0.105263,0.894737,25,1,1, merged,0,0,0.0934842331581
9732,1000121,1,247,221,26,0.894737,0.105263,0.894737,25,1,248,221,27,0.891129,0.108871,0.891129,26,1,1, merged,1,1,0.309446433544
9732,1000124,2,130,128,2,0.984615,0.015385,1.879352,2,0,132,130,2,0.984848,0.015152,1.875978,2,0,-1, merged,0,0,0.303597168597
9737,1000328,1,97,61,36,0.628866,0.371134,0.628866,36,0,100,63,37,0.63,0.37,0.63,37,0,-1, merged,1,0,0.301295127124
9746,1000118,1,318,279,39,0.877358,0.122642,0.877358,39,0,319,280,39,0.877743,0.122257,0.877743,39,0,1, merged,0,0,0.248665849198
9752,1000063,1,869,772,97,0.888377,0.111623,0.888377,87,10,870,772,98,0.887356,0.112644,0.887356,88,10,1, merged,1,1,0.0182255380387
9775,1000063,1,873,775,98,0.887743,0.112257,0.887743,88,10,875,777,98,0.888,0.112,0.888,88,10,-1, merged,0,0,0.043765263658
9785,1000063,1,878,779,99,0.887244,0.112756,0.887244,89,10,879,779,100,0.886234,0.113766,0.886234,90,10,1, merged,1,1,0.00349117723883
9790,1000054,2,22,18,4,0.818182,0.181818,1.599432,2,2,24,20,4,0.833333,0.166667,1.606061,2,2,1, merged,0,0,0.0109369557645
9790,1000166,1,64,50,14,0.78125,0.21875,0.78125,13,1,66,51,15,0.772727,0.227273,0.772727,14,1,1, merged,1,1,0.361449799782
9803,1000004,2,456,382,74,0.837719,0.162281,1.657539,65,9,457,383,74,0.838074,0.161926,1.661083,65,9,-1, merged,0,0,0.0525923718713
9803,1000121,3,248,221,27,0.891129,0.108871,2.548668,26,1,249,222,27,0.891566,0.108434,2.55265,26,1,1, merged,0,0,0.0148046092184
9812,1000014,1,336,301,35,0.895833,0.104167,0.895833,33,2,337,302,35,0.896142,0.103858,0.896142,33,2,1, merged,0,0,0.505823852991
9812,1000328,2,102,64,38,0.627451,0.372549,1.523284,38,0,103,65,38,0.631068,0.368932,1.52721,38,0,1, merged,0,0,0.879096505522
9818,1000109,2,186,145,41,0.77957,0.22043,1.584765,40,1,187,146,41,0.780749,0.219251,1.588441,40,1,1, merged,0,0,0.688315879235
9819,1000109,2,187,146,41,0.780749,0.219251,1.588441,40,1,188,147,41,0.781915,0.218085,1.592041,40,1,1, merged,0,0,0.690217889091
9820,1000109,2,188,147,41,0.781915,0.218085,1.592041,40,1,189,148,41,0.783069,0.216931,1.595569,40,1,1, merged,0,0,0.401578569908
9821,1000109,2,189,148,41,0.783069,0.216931,1.595569,40,1,190,149,41,0.784211,0.215789,1.599025,40,1,1, merged,0,0,0.203532220883
9822,1000109,2,190,149,41,0.784211,0.215789,1.599025,40,1,191,150,41,0.78534,0.21466,1.602413,40,1,1, merged,0,0,0.269505365573
9823,1000109,2,191,150,41,0.78534,0.21466,1.602413,40,1,192,151,41,0.786458,0.213542,1.605735,40,1,1, merged,0,0,0.694075115738
9824,1000109,2,192,151,41,0.786458,0.213542,1.605735,40,1,193,152,41,0.787565,0.212435,1.608993,40,1,1, merged,0,0,0.35184460894
9825,1000109,1,193,152,41,0.787565,0.212435,0.787565,40,1,194,153,41,0.78866,0.21134,0.78866,40,1,1, merged,0,0,0.692043276657
9826,1000109,1,194,153,41,0.78866,0.21134,0.78866,40,1,195,154,41,0.789744,0.210256,0.789744,40,1,1, merged,0,0,1.48059360731
9832,1000124,2,132,130,2,0.984848,0.015152,1.757576,2,0,133,131,2,0.984962,0.015038,1.761082,2,0,1, merged,0,0,0.119527891318
9832,1000166,1,66,51,15,0.772727,0.227273,0.772727,14,1,67,52,15,0.776119,0.223881,0.776119,14,1,1, merged,0,0,0.749891833423
9836,1000004,1,457,383,74,0.838074,0.161926,0.838074,65,9,458,384,74,0.838428,0.161572,0.838428,65,9,-1, merged,0,0,0.176470584323
9836,1000007,3,314,270,44,0.859873,0.140127,2.528656,37,7,315,271,44,0.860317,0.139683,2.530777,37,7,1, merged,0,0,0.358589143254
9836,1000009,2,254,211,43,0.830709,0.169291,1.668783,37,6,256,213,43,0.832031,0.167969,1.670459,37,6,-1, merged,0,0,0.24984887273
9837,1000109,1,199,158,41,0.79397,0.20603,0.79397,40,1,200,159,41,0.795,0.205,0.795,40,1,1, merged,0,0,0.85005574136
9843,1000004,2,458,384,74,0.838428,0.161572,1.466999,65,9,459,384,75,0.836601,0.163399,1.46277,66,9,1, merged,1,1,0.0394561102159
9843,1000328,1,105,66,39,0.628571,0.371429,0.628571,39,0,107,67,40,0.626168,0.373832,0.626168,40,0,1, merged,1,1,0.0989162314483
9846,1000004,2,459,384,75,0.836601,0.163399,1.460455,66,9,461,386,75,0.83731,0.16269,1.455492,66,9,-1, merged,0,0,0.0736658711042
9846,1000328,1,109,68,41,0.623853,0.376147,0.623853,41,0,110,68,42,0.618182,0.381818,0.618182,42,0,1, merged,1,1,0.204059073735
9847,1000328,1,110,68,42,0.618182,0.381818,0.618182,42,0,111,68,43,0.612613,0.387387,0.612613,43,0,1, merged,1,1,0.154568769191
9849,1000328,1,111,68,43,0.612613,0.387387,0.612613,43,0,112,68,44,0.607143,0.392857,0.607143,44,0,1, merged,1,1,0.312325381716
9850,1000328,1,112,68,44,0.607143,0.392857,0.607143,44,0,114,69,45,0.605263,0.394737,0.605263,44,1,1, merged,1,0,0.213723520499
9851,1000328,1,114,69,45,0.605263,0.394737,0.605263,44,1,116,70,46,0.603448,0.396552,0.603448,45,1,1, merged,1,1,0.216868795666
9851,1000329,3,236,150,86,0.635593,0.364407,1.897661,82,4,238,151,87,0.634454,0.365546,1.892873,83,4,1, merged,1,1,0.139247415552
9852,1000328,1,116,70,46,0.603448,0.396552,0.603448,45,1,118,71,47,0.601695,0.398305,0.601695,46,1,-1, merged,1,0,0.131981906271
9852,1000329,3,238,151,87,0.634454,0.365546,1.892873,83,4,240,152,88,0.633333,0.366667,1.888207,83,5,-1, merged,1,0,0.0853555343649
9853,1000328,1,118,71,47,0.601695,0.398305,0.601695,46,1,119,71,48,0.596639,0.403361,0.596639,47,1,1, merged,1,1,0.133151652487
9853,1000329,3,240,152,88,0.633333,0.366667,1.888207,83,5,243,153,90,0.62963,0.37037,1.868314,85,5,1, merged,1,1,0.0866834515429
9854,1000329,2,243,153,90,0.62963,0.37037,1.271675,85,5,244,154,90,0.631148,0.368852,1.275215,85,5,1, merged,0,0,0.380136257185
9855,1000329,2,244,154,90,0.631148,0.368852,1.275215,85,5,246,156,90,0.634146,0.365854,1.276604,85,5,-1, merged,0,0,0.490221431144
9856,1000014,2,337,302,35,0.896142,0.103858,1.492781,33,2,339,303,36,0.893805,0.106195,1.493805,34,2,-1, abandoned,1,0,0
9856,1000328,1,119,71,48,0.596639,0.403361,0.596639,47,1,120,72,48,0.6,0.4,0.6,47,1,-1, abandoned,0,0,0.913101514771
9856,1000329,4,246,156,90,0.634146,0.365854,2.793594,85,5,247,156,91,0.631579,0.368421,2.875384,86,5,1, abandoned,1,1,0.907891762046
9856,1000592,3,3,2,1,0.666667,0.333333,2.159448,0,1,4,3,1,0.75,0.25,2.243805,0,1,-1, abandoned,0,0,0
9862,1000329,1,253,161,92,0.636364,0.363636,0.636364,87,5,254,162,92,0.637795,0.362205,0.637795,87,5,-1, merged,0,0,0.131673261413
9864,1000328,1,120,72,48,0.6,0.4,0.6,47,1,121,73,48,0.603306,0.396694,0.603306,47,1,1, merged,0,0,0.500173010381
9867,1000153,2,355,329,26,0.926761,0.073239,1.886761,21,5,356,330,26,0.926966,0.073034,1.888505,21,5,-1, abandoned,0,0,1.00462275124
9872,1000023,1,127,112,15,0.88189,0.11811,0.88189,14,1,128,113,15,0.882812,0.117188,0.882812,14,1,-1, merged,0,0,0.00589934061957
9872,1000063,4,879,779,100,0.886234,0.113766,3.709301,90,10,881,781,100,0.886493,0.113507,3.576344,90,10,-1, merged,0,0,0.00966616630373
9873,1000121,1,249,222,27,0.891566,0.108434,0.891566,26,1,253,225,28,0.889328,0.110672,0.889328,27,1,-1, merged,1,0,0.0565133762497
9878,1000043,2,76,58,18,0.763158,0.236842,1.649651,17,1,77,59,18,0.766234,0.233766,1.652983,17,1,1, merged,0,0,0.0123301377278
9878,1000063,1,881,781,100,0.886493,0.113507,0.886493,90,10,883,783,100,0.88675,0.11325,0.88675,90,10,-1, merged,0,0,0.109733592768
9896,1000063,3,885,785,100,0.887006,0.112994,2.7001,90,10,886,786,100,0.887133,0.112867,2.701538,90,10,-1, abandoned,0,0,0.01063658674
9910,1000132,1,77,63,14,0.818182,0.181818,0.818182,12,2,78,63,15,0.807692,0.192308,0.807692,13,2,1, merged,1,1,0.927713920817
9911,1000132,1,78,63,15,0.807692,0.192308,0.807692,13,2,79,63,16,0.797468,0.202532,0.797468,14,2,1, merged,1,1,0.939440203562
9925,1000121,2,253,225,28,0.889328,0.110672,1.768116,27,1,254,226,28,0.889764,0.110236,1.769161,27,1,1, merged,0,0,0.480769482412
9935,1000015,1,570,526,44,0.922807,0.077193,0.922807,41,3,572,527,45,0.921329,0.078671,0.921329,41,4,1, merged,1,0,0.00895399617535
9935,1000043,2,77,59,18,0.766234,0.233766,1.689041,17,1,78,60,18,0.769231,0.230769,1.690559,17,1,1, merged,0,0,0.0112368226801
9936,1000121,4,254,226,28,0.889764,0.110236,3.009116,27,1,255,226,29,0.886275,0.113725,3.01647,28,1,1, merged,1,1,0.0444839472561
9936,1000328,2,122,74,48,0.606557,0.393443,1.481557,47,1,126,76,50,0.603175,0.396825,1.492063,49,1,1, merged,1,1,0.0869328275873
9936,1000329,3,254,162,92,0.637795,0.362205,2.119353,87,5,257,164,93,0.638132,0.361868,2.130196,88,5,1, merged,1,1,0.054673856394
9936,1000592,1,8,7,1,0.875,0.125,0.875,0,1,9,8,1,0.888889,0.111111,0.888889,0,1,-1, merged,0,0,0.044548092305
9943,1000328,1,127,77,50,0.606299,0.393701,0.606299,49,1,128,78,50,0.609375,0.390625,0.609375,49,1,1, merged,0,0,1.06684483317
9943,1000329,2,257,164,93,0.638132,0.361868,1.244432,88,5,258,165,93,0.639535,0.360465,1.24891,88,5,1, merged,0,0,1.00816818057
9945,1000328,2,128,78,50,0.609375,0.390625,1.24891,49,1,129,78,51,0.604651,0.395349,1.245578,50,1,1, abandoned,1,1,1.05994017301
9945,1000329,1,258,165,93,0.639535,0.360465,0.639535,88,5,259,166,93,0.640927,0.359073,0.640927,88,5,-1, abandoned,0,0,1.00490964062
9947,1000328,2,129,78,51,0.604651,0.395349,1.49354,50,1,130,79,51,0.607692,0.392308,1.376923,50,1,1, merged,0,0,0.535402393297
9947,1000592,1,9,8,1,0.888889,0.111111,0.888889,0,1,13,10,3,0.769231,0.230769,0.769231,2,1,1, merged,1,1,0.471673553719
9948,1000014,1,339,303,36,0.893805,0.106195,0.893805,34,2,348,306,42,0.87931,0.12069,0.87931,40,2,-1, merged,1,0,4.48297093016e-05
9948,1000023,5,129,114,15,0.883721,0.116279,4.379475,14,1,130,115,15,0.884615,0.115385,4.365228,14,1,1, merged,0,0,1.9383149911e-05
9948,1000121,2,255,226,29,0.886275,0.113725,1.78008,28,1,257,227,30,0.883268,0.116732,1.762579,29,1,-1, merged,1,0,6.70663057145e-05
9953,1000014,2,348,306,42,0.87931,0.12069,1.694125,40,2,349,307,42,0.879656,0.120344,1.69617,40,2,1, merged,0,0,0.54000534021
9964,1000004,3,468,392,76,0.837607,0.162393,2.366628,67,9,470,392,78,0.834043,0.165957,2.36459,67,11,-1, merged,1,1,0.0861774538183
9964,1000015,1,572,527,45,0.921329,0.078671,0.921329,41,4,574,528,46,0.919861,0.080139,0.919861,41,5,1, merged,1,0,0.106264413666
9964,1000328,2,130,79,51,0.607692,0.392308,1.529021,50,1,131,80,51,0.610687,0.389313,1.530548,50,1,1, merged,0,0,0.215436231529
9971,1000014,3,349,307,42,0.879656,0.120344,2.134021,40,2,352,309,43,0.877841,0.122159,2.124053,41,2,1, merged,1,1,0.515347455203
9971,1000328,1,131,80,51,0.610687,0.389313,0.610687,50,1,132,80,52,0.606061,0.393939,0.606061,51,1,1, merged,1,1,0.929021340978
9971,1000329,2,261,168,93,0.643678,0.356322,1.254365,88,5,264,169,95,0.640152,0.359848,1.246212,90,5,1, merged,1,1,0.919654796016
9981,1000054,3,24,20,4,0.833333,0.166667,2.584485,2,2,25,21,4,0.84,0.16,2.575779,2,2,1, merged,0,0,0.000353535324501
9996,1000091,1,71,54,17,0.760563,0.239437,0.760563,16,1,72,54,18,0.75,0.25,0.75,17,1,1, abandoned,1,1,0.481328245584
9996,1000329,2,264,169,95,0.640152,0.359848,1.400715,90,5,265,170,95,0.641509,0.358491,1.391509,90,5,-1, abandoned,0,0,0.390660126712
10007,1000063,1,904,803,101,0.888274,0.111726,0.888274,91,10,905,804,101,0.888398,0.111602,0.888398,91,10,1, merged,0,0,0.339882988825
10017,1000063,2,910,809,101,0.889011,0.110989,1.534172,91,10,911,810,101,0.889133,0.110867,1.536192,91,10,1, merged,0,0,0.757275077375
10035,1000005,1,54,41,13,0.759259,0.240741,0.759259,13,0,55,42,13,0.763636,0.236364,0.763636,13,0,1, merged,0,0,0.420628415301
10036,1000063,3,911,810,101,0.889133,0.110867,2.142583,91,10,912,811,101,0.889254,0.110746,2.146926,91,10,1, merged,0,0,0.153400775506
10036,1000328,1,134,82,52,0.61194,0.38806,0.61194,51,1,135,83,52,0.614815,0.385185,0.614815,51,1,1, merged,0,0,1.09240701256
10036,1000329,2,265,170,95,0.641509,0.358491,1.25345,90,5,266,171,95,0.642857,0.357143,1.257672,90,5,1, merged,0,0,1.01081292517
10041,1000121,3,257,227,30,0.883268,0.116732,2.14094,29,1,258,228,30,0.883721,0.116279,2.145563,29,1,1, merged,0,0,0.0310998784266
10041,1000328,2,135,83,52,0.614815,0.385185,1.257672,51,1,136,84,52,0.617647,0.382353,1.261842,51,1,1, merged,0,0,0.0586145869737
10041,1000329,1,266,171,95,0.642857,0.357143,0.642857,90,5,267,172,95,0.644195,0.355805,0.644195,90,5,1, merged,0,0,0.037540154624
10051,1000023,2,132,117,15,0.886364,0.113636,1.7811,14,1,133,118,15,0.887218,0.112782,1.783172,14,1,1, merged,0,0,0.0995501116753
10059,1000327,3,35,21,14,0.6,0.4,2.035897,11,3,37,23,14,0.621622,0.378378,2.309122,11,3,-1, merged,0,0,0.411201523546
10059,1000592,1,13,10,3,0.769231,0.230769,0.769231,2,1,16,13,3,0.8125,0.1875,0.8125,2,1,-1, merged,0,0,0.572227352006
10063,1000015,1,584,538,46,0.921233,0.078767,0.921233,41,5,585,538,47,0.919658,0.080342,0.919658,42,5,1, merged,1,1,0.201577630811
10063,1000153,2,356,330,26,0.926966,0.073034,1.848199,21,5,358,332,26,0.927374,0.072626,1.847032,21,5,-1, merged,0,0,0.206439615734
10064,1000015,2,585,538,47,0.919658,0.080342,1.745745,42,5,587,539,48,0.918228,0.081772,1.726739,43,5,1, merged,1,1,0.226545345224
10064,1000120,1,46,38,8,0.826087,0.173913,0.826087,7,1,47,38,9,0.808511,0.191489,0.808511,8,1,1, merged,1,1,0.0572357723573
10080,1000004,1,470,392,78,0.834043,0.165957,0.834043,67,11,472,393,79,0.832627,0.167373,0.832627,68,11,1, abandoned,1,1,0
10080,1000007,4,315,271,44,0.860317,0.139683,3.510623,37,7,316,272,44,0.860759,0.139241,3.504175,37,7,-1, abandoned,0,0,0.0214265500459
10080,1000026,2,135,120,15,0.888889,0.111111,1.722931,13,2,137,121,16,0.883212,0.116788,1.715839,14,2,1, abandoned,1,1,0.407803029938
10080,1000153,3,358,332,26,0.927374,0.072626,2.650306,21,5,359,333,26,0.927577,0.072423,2.643415,21,5,-1, abandoned,0,0,0.0168741979605
10087,1000328,1,136,84,52,0.617647,0.382353,0.617647,51,1,141,86,55,0.609929,0.390071,0.609929,54,1,-1, merged,1,0,0.0699225697795
10087,1000329,2,268,173,95,0.645522,0.354478,1.263169,90,5,271,174,97,0.642066,0.357934,1.251995,92,5,-1, merged,1,0,0.0441597292198
10116,1000109,2,202,161,41,0.79703,0.20297,1.621206,40,1,203,162,41,0.79803,0.20197,1.624117,40,1,1, merged,0,0,0.837171052632
10128,1000023,1,133,118,15,0.887218,0.112782,0.887218,14,1,134,119,15,0.88806,0.11194,0.88806,14,1,1, merged,0,0,0.000704857671179
10129,1000063,1,913,812,101,0.889376,0.110624,0.889376,91,10,914,813,101,0.889497,0.110503,0.889497,91,10,1, merged,0,0,0.0627349500044
10129,1000329,2,272,175,97,0.643382,0.356618,1.532758,92,5,273,176,97,0.644689,0.355311,1.534185,92,5,1, merged,0,0,0.573407202216
10152,1000004,2,472,393,79,0.832627,0.167373,1.711158,68,11,474,395,79,0.833333,0.166667,1.709738,68,11,-1, merged,0,0,0.017971758665
10152,1000014,1,354,311,43,0.878531,0.121469,0.878531,41,2,356,312,44,0.876404,0.123596,0.876404,42,2,1, merged,1,1,0.00606469002695
10154,1000329,2,273,176,97,0.644689,0.355311,1.291747,92,5,275,178,97,0.647273,0.352727,1.292775,92,5,-1, merged,0,0,0.90272344069
10157,1000121,1,261,229,32,0.877395,0.122605,0.877395,31,1,263,231,32,0.878327,0.121673,0.878327,31,1,-1, merged,0,0,0.0283705648575
10159,1000015,2,590,542,48,0.918644,0.081356,0.918644,43,5,592,544,48,0.918919,0.081081,1.918919,43,5,1, merged,0,0,0.0328843975008
10184,1000153,2,359,333,26,0.927577,0.072423,1.82091,21,5,360,333,27,0.925,0.075,1.806579,22,5,1, abandoned,1,1,0.269669703459
10191,1000327,1,37,23,14,0.621622,0.378378,0.621622,11,3,39,25,14,0.641026,0.358974,0.641026,11,3,-1, merged,0,0,0.136165577342
10194,1000109,2,204,163,41,0.79902,0.20098,1.625107,40,1,205,164,41,0.8,0.2,1.627957,40,1,1, merged,0,0,0.693063693007
10195,1000109,2,205,164,41,0.8,0.2,1.627957,40,1,206,165,41,0.800971,0.199029,1.630758,40,1,1, merged,0,0,0.716460994347
10205,1000004,2,475,396,79,0.833684,0.166316,1.583684,68,11,476,397,79,0.834034,0.165966,1.634034,68,11,1, merged,0,0,0.0215886031569
10208,1000014,2,357,313,44,0.876751,0.123249,1.766968,42,2,359,313,46,0.871866,0.128134,1.762441,44,2,1, merged,1,1,0.48135911899
10208,1000015,3,595,547,48,0.919328,0.080672,2.686296,43,5,596,547,49,0.917785,0.082215,2.680226,44,5,1, merged,1,1,0
10208,1000063,1,920,819,101,0.890217,0.109783,0.890217,91,10,923,822,101,0.890574,0.109426,0.890574,91,10,-1, merged,0,0,0.0534221089332
10226,1000023,2,135,120,15,0.888889,0.111111,1.780053,14,1,136,121,15,0.889706,0.110294,1.780987,14,1,1, merged,0,0,0.000284264087654
10226,1000063,1,928,827,101,0.891164,0.108836,0.891164,91,10,929,828,101,0.891281,0.108719,0.891281,91,10,1, merged,0,0,0.000452834047274
10232,1000004,2,476,397,79,0.834034,0.165966,1.504576,68,11,477,398,79,0.834382,0.165618,1.503612,68,11,1, merged,0,0,0.0229461175989
10235,1000004,3,477,398,79,0.834382,0.165618,2.316177,68,11,478,399,79,0.834728,0.165272,2.313242,68,11,-1, merged,0,0,0.436666666667
10235,1000014,1,359,313,46,0.871866,0.128134,0.871866,44,2,362,314,48,0.867403,0.132597,0.867403,46,2,1, merged,1,1,0.523314290826
10235,1000328,2,141,86,55,0.609929,0.390071,1.481795,54,1,144,88,56,0.611111,0.388889,1.478514,55,1,-1, merged,1,0,1.11530776298
10235,1000329,4,277,180,97,0.649819,0.350181,2.965996,92,5,280,182,98,0.65,0.35,2.963242,93,5,-1, merged,1,0,1.0320580561
10243,1000014,1,362,314,48,0.867403,0.132597,0.867403,46,2,363,315,48,0.867769,0.132231,0.867769,46,2,1, merged,0,0,0.496927823987
10248,1000043,1,82,64,18,0.780488,0.219512,0.780488,17,1,83,64,19,0.771084,0.228916,0.771084,18,1,1, merged,1,1,0.289436713066
10251,1000014,2,363,315,48,0.867769,0.132231,1.757474,46,2,364,316,48,0.868132,0.131868,1.75219,46,2,1, merged,0,0,0.108196658492
10251,1000023,1,136,121,15,0.889706,0.110294,0.889706,14,1,138,122,16,0.884058,0.115942,0.884058,14,2,-1, merged,1,1,0.81182274581
10271,1000043,1,84,65,19,0.77381,0.22619,0.77381,18,1,85,65,20,0.764706,0.235294,0.764706,19,1,1, abandoned,1,1,0.627692307692
10271,1000105,2,153,120,33,0.784314,0.215686,1.558123,31,2,154,121,33,0.785714,0.214286,1.55042,31,2,-1, abandoned,0,0,0.62663180537
10277,1000109,2,207,166,41,0.801932,0.198068,1.63172,40,1,208,167,41,0.802885,0.197115,1.634464,40,1,1, merged,0,0,0.698530861709
10292,1000153,2,360,333,27,0.925,0.075,1.712879,22,5,361,334,27,0.925208,0.074792,1.716253,22,5,1, merged,0,0,0.100385017943
10295,1000007,2,317,273,44,0.861199,0.138801,1.828941,37,7,319,274,45,0.858934,0.141066,1.816381,38,7,1, merged,1,1,1.30710691824
10305,1000592,1,16,13,3,0.8125,0.1875,0.8125,2,1,17,14,3,0.823529,0.176471,0.823529,2,1,1, merged,0,0,0.536764705882
10307,1000592,1,17,14,3,0.823529,0.176471,0.823529,2,1,18,15,3,0.833333,0.166667,0.833333,2,1,1, merged,0,0,0.253514667787
10310,1000043,1,85,65,20,0.764706,0.235294,0.764706,19,1,86,66,20,0.767442,0.232558,0.767442,19,1,1, merged,0,0,0.0259470874793
10310,1000130,2,78,63,15,0.807692,0.192308,1.572398,14,1,79,64,15,0.810127,0.189873,1.577568,14,1,1, merged,0,0,0.0188350762908
10312,1000014,3,365,317,48,0.868493,0.131507,2.572508,46,2,366,318,48,0.868852,0.131148,2.575971,46,2,1, merged,0,0,0.001138646999
10312,1000063,1,931,830,101,0.891515,0.108485,0.891515,91,10,934,832,102,0.890792,0.109208,0.890792,91,11,-1, merged,1,0,0.00255302581756
10312,1000120,2,48,39,9,0.8125,0.1875,1.704015,8,1,49,40,9,0.816327,0.183673,1.707119,8,1,-1, merged,0,0,0
10313,1000153,1,361,334,27,0.925208,0.074792,0.925208,22,5,362,335,27,0.925414,0.074586,0.925414,22,5,1, merged,0,0,0.880724606734
10316,1000329,2,280,182,98,0.65,0.35,0.65,93,5,281,183,98,0.651246,0.348754,1.651246,93,5,-1, abandoned,0,0,0.00546448087432
10350,1000118,2,337,298,39,0.884273,0.115727,1.533488,39,0,338,299,39,0.884615,0.115385,1.530449,39,0,1, merged,0,0,0.653120366084
10354,1000327,2,39,25,14,0.641026,0.358974,1.541927,11,3,40,26,14,0.65,0.35,1.542857,11,3,-1, merged,0,0,0
10370,1000015,1,597,548,49,0.917923,0.082077,0.917923,44,5,598,549,49,0.91806,0.08194,0.91806,44,5,1, merged,0,0,1.05581877178
10377,1000014,1,366,318,48,0.868852,0.131148,0.868852,46,2,367,319,48,0.86921,0.13079,0.86921,46,2,1, merged,0,0,0.513654618474
10377,1000153,2,364,337,27,0.925824,0.074176,1.794677,22,5,365,338,27,0.926027,0.073973,1.795237,22,5,1, merged,0,0,0.631433266465
10381,1000070,1,255,235,20,0.921569,0.078431,0.921569,16,4,258,237,21,0.918605,0.081395,0.918605,17,4,-1, merged,1,0,0
10381,1000327,2,40,26,14,0.65,0.35,1.571569,11,3,42,27,15,0.642857,0.357143,1.561462,12,3,-1, merged,1,0,0
10389,1000043,3,86,66,20,0.767442,0.232558,2.388765,19,1,87,67,20,0.770115,0.229885,2.395149,19,1,1, merged,0,0,0.00106423941643
10389,1000130,2,80,65,15,0.8125,0.1875,1.621324,14,1,81,66,15,0.814815,0.185185,1.625034,14,1,1, merged,0,0,0.0017726957727
10390,1000004,2,478,399,79,0.834728,0.165272,1.441625,68,11,479,400,79,0.835073,0.164927,1.443181,68,11,-1, merged,0,0,0.108842109193
10390,1000328,1,145,88,57,0.606897,0.393103,0.606897,56,1,148,90,58,0.608108,0.391892,0.608108,57,1,-1, merged,1,0,0.274172212212
10390,1000329,3,281,183,98,0.651246,0.348754,2.09287,93,5,283,185,98,0.65371,0.34629,2.096891,93,5,-1, merged,0,0,0.253749333009
10390,1000592,4,18,15,3,0.833333,0.166667,2.926203,2,1,19,15,4,0.789474,0.210526,2.886365,3,1,1, merged,1,1,0.203567446208
10397,1000329,1,283,185,98,0.65371,0.34629,0.65371,93,5,284,186,98,0.65493,0.34507,0.65493,93,5,-1, abandoned,0,0,0.201428018457
10402,1000007,2,319,274,45,0.858934,0.141066,1.776994,38,7,320,275,45,0.859375,0.140625,1.775903,38,7,-1, abandoned,0,0,0.144029278495
10402,1000015,1,598,549,49,0.91806,0.08194,0.91806,44,5,599,549,50,0.916528,0.083472,0.916528,45,5,1, abandoned,1,1,0.117306904625
10404,1000004,1,480,401,79,0.835417,0.164583,0.835417,68,11,481,402,79,0.835759,0.164241,0.835759,68,11,1, merged,0,0,0.0256384065373
10404,1000592,2,19,15,4,0.789474,0.210526,1.62489,3,1,20,16,4,0.8,0.2,1.635759,3,1,1, merged,0,0,0.259493670886
10406,1000592,3,20,16,4,0.8,0.2,2.425,3,1,21,17,4,0.809524,0.190476,2.47619,3,1,1, merged,0,0,0.728571428571
10408,1000327,3,42,27,15,0.642857,0.357143,1.947271,12,3,43,28,15,0.651163,0.348837,1.959113,12,3,-1, merged,0,0,0.0262128468968
10408,1000329,2,284,186,98,0.65493,0.34507,1.304414,93,5,288,188,100,0.652778,0.347222,1.30795,95,5,-1, merged,1,0,0.0195142749631
10409,1000091,2,72,54,18,0.75,0.25,1.360738,17,1,75,55,20,0.733333,0.266667,1.345175,19,1,-1, merged,1,0,0.0698094919358
10409,1000328,1,149,91,58,0.610738,0.389262,0.610738,57,1,152,93,59,0.611842,0.388158,0.611842,58,1,-1, merged,1,0,0.0907991662274
10412,1000118,3,338,299,39,0.884615,0.115385,2.583864,39,0,339,300,39,0.884956,0.115044,2.549143,39,0,1, merged,0,0,0.0552354467061
10413,1000118,2,339,300,39,0.884956,0.115044,1.727061,39,0,340,301,39,0.885294,0.114706,1.730122,39,0,1, merged,0,0,0.131076727009
10416,1000063,1,935,833,102,0.890909,0.109091,0.890909,91,11,937,834,103,0.890075,0.109925,0.890075,92,11,-1, merged,1,0,0.0837225240101
10416,1000121,2,268,233,35,0.869403,0.130597,1.760312,34,1,269,234,35,0.869888,0.130112,1.759963,34,1,1, merged,0,0,0.0350674260662
10422,1000063,1,942,839,103,0.890658,0.109342,0.890658,92,11,943,840,103,0.890774,0.109226,0.890774,92,11,1, merged,0,0,0.160934900105
10423,1000004,2,482,403,79,0.8361,0.1639,1.726874,68,11,483,404,79,0.836439,0.163561,1.727329,68,11,1, merged,0,0,0.0117957965345
10423,1000063,1,943,840,103,0.890774,0.109226,0.890774,92,11,944,841,103,0.89089,0.10911,0.89089,92,11,-1, merged,0,0,0.000390083902878
10429,1000023,2,143,127,16,0.888112,0.111888,1.806811,14,2,144,128,16,0.888889,0.111111,1.808244,14,2,1, merged,0,0,3.67089067975e-06
10456,1000592,2,21,17,4,0.809524,0.190476,1.47619,3,1,22,18,4,0.818182,0.181818,1.545455,3,1,1, merged,0,0,0.0622911696676
10457,1000592,2,22,18,4,0.818182,0.181818,1.545455,3,1,24,20,4,0.833333,0.166667,1.602564,3,1,1, merged,0,0,0.032143276601
10458,1000592,2,24,20,4,0.833333,0.166667,1.602564,3,1,25,21,4,0.84,0.16,1.625714,3,1,1, merged,0,0,0.338623659389
10470,1000014,1,370,321,49,0.867568,0.132432,0.867568,47,2,371,322,49,0.867925,0.132075,0.867925,47,2,1, merged,0,0,0.514238133303
10470,1000328,3,152,93,59,0.611842,0.388158,2.22015,58,1,153,94,59,0.614379,0.385621,2.226206,58,1,1, merged,0,0,0.957980599647
10475,1000121,3,269,234,35,0.869888,0.130112,2.138247,34,1,270,235,35,0.87037,0.12963,2.142426,34,1,1, merged,0,0,0.185409031071
10475,1000328,1,153,94,59,0.614379,0.385621,0.614379,58,1,154,95,59,0.616883,0.383117,0.616883,58,1,1, merged,0,0,0.371597409856
10475,1000329,2,289,189,100,0.653979,0.346021,1.268358,95,5,290,190,100,0.655172,0.344828,1.272056,95,5,1, merged,0,0,0.344551064409
10482,1000003,1,364,304,60,0.835165,0.164835,0.835165,54,6,366,306,60,0.836066,0.163934,0.836066,54,6,-1, merged,0,0,0.0811606294158
10493,1000009,1,259,216,43,0.833977,0.166023,0.833977,37,6,261,217,44,0.831418,0.168582,0.831418,38,6,1, merged,1,1,0.0793622464005
10496,1000004,2,484,405,79,0.836777,0.163223,1.788194,68,11,485,406,79,0.837113,0.162887,1.788726,68,11,1, merged,0,0,0.0377059569075
10496,1000011,1,247,235,12,0.951417,0.048583,0.951417,10,2,248,236,12,0.951613,0.048387,0.951613,10,2,1, merged,0,0,0.0049864498645
10516,1000063,1,955,851,104,0.891099,0.108901,0.891099,92,12,956,852,104,0.891213,0.108787,0.891213,92,12,-1, merged,0,0,0.033740183204
10519,1000091,1,75,55,20,0.733333,0.266667,0.733333,19,1,76,56,20,0.736842,0.263158,0.736842,19,1,-1, abandoned,0,0,0.150973167522
10519,1000328,2,154,95,59,0.616883,0.383117,1.350216,58,1,155,96,59,0.619355,0.380645,1.356197,58,1,-1, abandoned,0,0,0.377972978341
10538,1000004,1,485,406,79,0.837113,0.162887,0.837113,68,11,488,408,80,0.836066,0.163934,0.836066,69,11,1, merged,1,1,0.0238381339478
10538,1000014,2,373,324,49,0.868633,0.131367,1.705746,47,2,374,325,49,0.868984,0.131016,1.70505,47,2,-1, merged,0,0,0.00172806932754
10538,1000063,3,968,864,104,0.892562,0.107438,2.598308,92,12,969,865,104,0.892673,0.107327,2.597722,92,12,1, merged,0,0,0.000850435659073
10543,1000009,1,261,217,44,0.831418,0.168582,0.831418,38,6,262,218,44,0.832061,0.167939,0.832061,38,6,1, merged,0,0,0.936942937513
10549,1000005,1,55,42,13,0.763636,0.236364,0.763636,13,0,56,42,14,0.75,0.25,0.75,14,0,1, merged,1,1,0.0176870748299
10551,1000004,2,488,408,80,0.836066,0.163934,1.70505,69,11,489,409,80,0.836401,0.163599,1.705734,69,11,1, merged,0,0,0.037955465587
10551,1000014,1,374,325,49,0.868984,0.131016,0.868984,47,2,375,326,49,0.869333,0.130667,0.869333,47,2,1, merged,0,0,0.00338735387885
10557,1000130,3,81,66,15,0.814815,0.185185,1.719987,14,1,82,67,15,0.817073,0.182927,1.696158,14,1,1, merged,0,0,0.354500666811
10569,1000592,2,27,22,5,0.814815,0.185185,1.542088,4,1,28,23,5,0.821429,0.178571,1.571429,4,1,1, merged,0,0,0.54132231405
10577,1000004,2,489,409,80,0.836401,0.163599,1.755632,69,11,490,410,80,0.836735,0.163265,1.752444,69,11,-1, abandoned,0,0,0.433780251286
10577,1000070,1,260,239,21,0.919231,0.080769,0.919231,17,4,261,239,22,0.915709,0.084291,0.915709,18,4,1, abandoned,1,1,0.549994513935
10580,1000004,2,490,410,80,0.836735,0.163265,1.706416,69,11,491,410,81,0.835031,0.164969,1.702405,70,11,1, abandoned,1,1,0.00113784135241
10580,1000014,1,376,327,49,0.869681,0.130319,0.869681,47,2,377,327,50,0.867374,0.132626,0.867374,48,2,1, abandoned,1,1,0.000965287504259
10582,1000070,1,261,239,22,0.915709,0.084291,0.915709,18,4,262,239,23,0.912214,0.087786,0.912214,19,4,1, merged,1,1,2.09699351258e-05
10583,1000005,1,56,42,14,0.75,0.25,0.75,14,0,57,43,14,0.754386,0.245614,0.754386,14,0,1, merged,0,0,0.217292337946
10585,1000007,2,320,275,45,0.859375,0.140625,1.776456,38,7,323,278,45,0.860681,0.139319,1.776384,38,7,-1, merged,0,0,0.174230337035
10585,1000015,1,603,553,50,0.917081,0.082919,0.917081,45,5,605,554,51,0.915702,0.084298,0.915702,46,5,1, merged,1,1,0.127421238995
10587,1000007,1,323,278,45,0.860681,0.139319,0.860681,38,7,324,279,45,0.861111,0.138889,0.861111,38,7,1, merged,0,0,0.654203589587
10587,1000153,2,370,343,27,0.927027,0.072973,1.787708,22,5,371,344,27,0.927224,0.072776,1.788335,22,5,1, merged,0,0,0.505044774629
10588,1000004,1,491,410,81,0.835031,0.164969,0.835031,70,11,495,414,81,0.836364,0.163636,0.836364,70,11,-1, merged,0,0,0
10595,1000592,2,28,23,5,0.821429,0.178571,1.633929,4,1,30,25,5,0.833333,0.166667,1.656863,4,1,1, merged,0,0,0.0636849132323
10596,1000007,1,324,279,45,0.861111,0.138889,0.861111,38,7,325,280,45,0.861538,0.138462,0.861538,38,7,-1, merged,0,0,0
10597,1000043,4,88,68,20,0.772727,0.227273,2.356814,19,1,90,70,20,0.777778,0.222222,2.360537,19,1,-1, merged,0,0,0.354765191514
10597,1000153,3,371,344,27,0.927224,0.072776,1.584086,22,5,372,345,27,0.927419,0.072581,1.582759,22,5,-1, merged,0,0,0.273618647221
10598,1000329,1,291,191,100,0.656357,0.343643,0.656357,95,5,292,192,100,0.657534,0.342466,0.657534,95,5,1, merged,0,0,0.0950935553988
10608,1000063,1,971,867,104,0.892894,0.107106,0.892894,92,12,972,868,104,0.893004,0.106996,0.893004,92,12,-1, abandoned,0,0,0.00508488129428
10626,1000063,1,977,873,104,0.893552,0.106448,0.893552,92,12,978,874,104,0.893661,0.106339,0.893661,92,12,-1, merged,0,0,0.322739901098
10633,1000118,2,349,310,39,0.888252,0.111748,1.701202,39,0,350,311,39,0.888571,0.111429,1.697082,39,0,1, merged,0,0,0.525850576539
10651,1000109,3,208,167,41,0.802885,0.197115,2.164252,40,1,209,168,41,0.803828,0.196172,2.190562,40,1,1, merged,0,0,0.709160905771
10652,1000199,1,101,81,20,0.80198,0.19802,0.80198,20,0,102,82,20,0.803922,0.196078,0.803922,20,0,1, merged,0,0,0.487942898649
10668,1000199,1,102,82,20,0.803922,0.196078,0.803922,20,0,104,84,20,0.807692,0.192308,0.807692,20,0,-1, merged,0,0,0.522719773153
10673,1000328,3,155,96,59,0.619355,0.380645,2.021683,58,1,156,97,59,0.621795,0.378205,2.0288,58,1,1, merged,0,0,0.510872900699
10677,1000004,1,495,414,81,0.836364,0.163636,0.836364,70,11,497,415,82,0.83501,0.16499,0.83501,71,11,-1, merged,1,0,0.0933727061958
10678,1000004,2,497,415,82,0.83501,0.16499,1.492015,71,11,498,416,82,0.835341,0.164659,1.493995,71,11,1, merged,0,0,0.0136314595856
10678,1000121,3,270,235,35,0.87037,0.12963,2.362385,34,1,271,236,35,0.870849,0.129151,2.364844,34,1,1, merged,0,0,0.0180967567297
10678,1000329,4,294,194,100,0.659864,0.340136,3.022249,95,5,295,195,100,0.661017,0.338983,3.025861,95,5,1, merged,0,0,0.02014475824
10681,1000014,3,378,328,50,0.867725,0.132275,2.438592,48,2,380,329,51,0.865789,0.134211,2.433648,49,2,1, merged,1,1,0.0112068426958
10681,1000070,2,262,239,23,0.912214,0.087786,1.570868,19,4,264,240,24,0.909091,0.090909,1.567859,20,4,1, merged,1,1,0.00921711575039
10683,1000327,1,43,28,15,0.651163,0.348837,0.651163,12,3,44,29,15,0.659091,0.340909,0.659091,12,3,-1, merged,0,0,0.205648219871
10693,1000121,2,271,236,35,0.870849,0.129151,1.625086,34,1,272,237,35,0.871324,0.128676,1.627626,34,1,1, merged,0,0,0.482052543965
10696,1000329,1,295,195,100,0.661017,0.338983,0.661017,95,5,297,197,100,0.6633,0.3367,0.6633,95,5,-1, abandoned,0,0,0.654245880862
10701,1000070,4,264,240,24,0.909091,0.090909,2.450869,20,4,265,241,24,0.909434,0.090566,2.538138,20,4,1, merged,0,0,0.355109463819
10701,1000327,1,44,29,15,0.659091,0.340909,0.659091,12,3,45,30,15,0.666667,0.333333,0.666667,12,3,-1, merged,0,0,0.29745419341
10709,1000121,3,272,237,35,0.871324,0.128676,2.290926,34,1,273,238,35,0.871795,0.128205,2.292336,34,1,1, merged,0,0,0.535282585951
10709,1000329,1,297,197,100,0.6633,0.3367,0.6633,95,5,299,198,101,0.662207,0.337793,0.662207,96,5,1, merged,1,1,0.918420735383
10710,1000026,1,148,132,16,0.891892,0.108108,0.891892,14,2,150,134,16,0.893333,0.106667,0.893333,14,2,-1, merged,0,0,0.0296147319465
10734,1000105,3,154,121,33,0.785714,0.214286,2.340429,31,2,155,122,33,0.787097,0.212903,2.341041,31,2,1, merged,0,0,0.0110954523224
10744,1000043,1,91,71,20,0.78022,0.21978,0.78022,19,1,92,72,20,0.782609,0.217391,0.782609,19,1,1, merged,0,0,0.0116456871003
10745,1000023,2,148,131,17,0.885135,0.114865,1.54873,15,2,149,132,17,0.885906,0.114094,1.551044,15,2,1, merged,0,0,0.340595346492
10745,1000063,3,992,888,104,0.895161,0.104839,2.443891,92,12,993,889,104,0.895267,0.104733,2.446311,92,12,1, merged,0,0,0.325247318865
10748,1000007,2,327,282,45,0.862385,0.137615,0.862385,38,7,328,283,45,0.862805,0.137195,1.862805,38,7,1, merged,0,0,0.348325438199
10749,1000043,2,92,72,20,0.782609,0.217391,1.449275,19,1,93,73,20,0.784946,0.215054,1.43712,19,1,1, merged,0,0,0.932060301508
10749,1000327,1,45,30,15,0.666667,0.333333,0.666667,12,3,46,30,16,0.652174,0.347826,0.652174,13,3,1, merged,1,1,0.594642857143
10771,1000327,1,46,30,16,0.652174,0.347826,0.652174,13,3,47,31,16,0.659574,0.340426,0.659574,13,3,1, merged,0,0,0.0722947325079
10775,1000014,2,380,329,51,0.865789,0.134211,1.536961,49,2,381,330,51,0.866142,0.133858,1.538787,49,2,1, merged,0,0,0.111899767773
10782,1000121,2,274,239,35,0.872263,0.127737,1.566707,34,1,275,240,35,0.872727,0.127273,1.548403,34,1,-1, abandoned,0,0,0.546752612484
10783,1000327,1,47,31,16,0.659574,0.340426,0.659574,13,3,48,32,16,0.666667,0.333333,0.666667,13,3,1, merged,0,0,0.0539384070697
10784,1000121,3,275,240,35,0.872727,0.127273,2.393231,34,1,278,240,38,0.863309,0.136691,2.329976,37,1,1, merged,1,1,0.164529178325
10785,1000121,2,278,240,38,0.863309,0.136691,1.679976,37,1,279,241,38,0.863799,0.136201,1.667078,37,1,1, merged,0,0,0.493718695459
10792,1000063,1,994,890,104,0.895372,0.104628,0.895372,92,12,995,891,104,0.895477,0.104523,0.895477,92,12,1, merged,0,0,0.776920198468
10793,1000011,1,254,240,14,0.944882,0.055118,0.944882,12,2,255,240,15,0.941176,0.058824,0.941176,13,2,1, merged,1,1,1.35182207931
10793,1000015,2,612,561,51,0.916667,0.083333,1.861549,46,5,613,562,51,0.916803,0.083197,1.857979,46,5,1, merged,0,0,1.0676824501
10844,1000328,2,156,97,59,0.621795,0.378205,1.506751,58,1,157,98,59,0.624204,0.375796,1.509666,58,1,1, merged,0,0,0.567827360605
10862,1000121,1,280,242,38,0.864286,0.135714,0.864286,37,1,281,243,38,0.864769,0.135231,0.864769,37,1,1, merged,0,0,0.0284412268553
10869,1000327,1,48,32,16,0.666667,0.333333,0.666667,13,3,49,33,16,0.673469,0.326531,0.673469,13,3,1, merged,0,0,0.200896969697
10869,1000328,2,157,98,59,0.624204,0.375796,1.29087,58,1,158,99,59,0.626582,0.373418,1.300052,58,1,1, merged,0,0,0.146902153381
10870,1000015,2,622,570,52,0.916399,0.083601,1.754783,47,5,624,572,52,0.916667,0.083333,1.758251,47,5,-1, merged,0,0,0.0501408811475
10872,1000327,1,49,33,16,0.673469,0.326531,0.673469,13,3,50,34,16,0.68,0.32,0.68,13,3,1, merged,0,0,0.633641215107
10876,1000007,1,332,287,45,0.864458,0.135542,0.864458,38,7,333,288,45,0.864865,0.135135,0.864865,38,7,1, merged,0,0,0.241196860028
10876,1000011,2,255,240,15,0.941176,0.058824,1.805634,13,2,256,241,15,0.941406,0.058594,1.806271,13,2,1, merged,0,0,0.304812613959
10878,1000327,1,50,34,16,0.68,0.32,0.68,13,3,51,35,16,0.686275,0.313725,0.686275,13,3,-1, merged,0,0,0.376745572696
10878,1000328,3,158,99,59,0.626582,0.373418,1.982138,58,1,159,100,59,0.628931,0.371069,1.996428,58,1,1, merged,0,0,0.485624155097
10886,1000007,1,333,288,45,0.864865,0.135135,0.864865,38,7,334,289,45,0.865269,0.134731,0.865269,38,7,1, merged,0,0,0.000162513542795
10891,1000327,1,51,35,16,0.686275,0.313725,0.686275,13,3,52,36,16,0.692308,0.307692,0.692308,13,3,-1, merged,0,0,0.10320491079
10891,1000328,4,159,100,59,0.628931,0.371069,2.096455,58,1,160,101,59,0.63125,0.36875,3.107063,58,1,1, merged,0,0,0.288575028621
10894,1000007,1,334,289,45,0.865269,0.134731,0.865269,38,7,335,290,45,0.865672,0.134328,0.865672,38,7,1, merged,0,0,1.294
10894,1000153,2,376,349,27,0.928191,0.071809,1.793461,22,5,377,350,27,0.928382,0.071618,1.794054,22,5,1, merged,0,0,1.03508035229
10897,1000007,2,335,290,45,0.865672,0.134328,1.696554,38,7,337,292,45,0.866469,0.133531,1.688933,38,7,-1, merged,0,0,0.0327354319893
10897,1000009,1,272,226,46,0.830882,0.169118,0.830882,40,6,276,227,49,0.822464,0.177536,0.822464,43,6,1, merged,1,1,0.0213139212953
10897,1000015,3,624,572,52,0.916667,0.083333,2.613221,47,5,625,572,53,0.9152,0.0848,2.604133,48,5,1, merged,1,1,0.0230972945805
10897,1000026,4,150,134,16,0.893333,0.106667,3.506554,14,2,151,135,16,0.89404,0.10596,3.498172,14,2,-1, merged,0,0,0.00874800553133
10897,1000153,5,377,350,27,0.928382,0.071618,4.434936,22,5,378,351,27,0.928571,0.071429,4.426744,22,5,1, merged,0,0,0.0231607676681
10905,1000327,1,52,36,16,0.692308,0.307692,0.692308,13,3,53,37,16,0.698113,0.301887,0.698113,13,3,1, merged,0,0,0.636685552408
10905,1000328,3,160,101,59,0.63125,0.36875,1.323558,58,1,161,102,59,0.63354,0.36646,2.331654,58,1,1, merged,0,0,0.587313432836
10915,1000004,1,502,420,82,0.836653,0.163347,0.836653,71,11,503,421,82,0.836978,0.163022,0.836978,71,11,1, merged,0,0,0
10915,1000023,2,151,134,17,0.887417,0.112583,1.724071,15,2,152,135,17,0.888158,0.111842,1.725136,15,2,1, merged,0,0,0
10915,1000063,4,1006,902,104,0.89662,0.10338,3.318804,92,12,1007,903,104,0.896723,0.103277,3.325563,92,12,1, merged,0,0,0
10915,1000327,3,53,37,16,0.698113,0.301887,2.422184,13,3,54,38,16,0.703704,0.296296,2.42884,13,3,1, merged,0,0,0
10918,1000121,1,282,244,38,0.865248,0.134752,0.865248,37,1,283,245,38,0.865724,0.134276,0.865724,37,1,1, merged,0,0,0.0794495790998
10918,1000328,2,161,102,59,0.63354,0.36646,1.498789,58,1,162,103,59,0.635802,0.364198,1.501527,58,1,1, merged,0,0,0.158511803358
10921,1000327,1,54,38,16,0.703704,0.296296,0.703704,13,3,55,39,16,0.709091,0.290909,0.709091,13,3,-1, merged,0,0,0.144038594073
10924,1000121,2,283,245,38,0.865724,0.134276,1.530176,37,1,284,246,38,0.866197,0.133803,1.529564,37,1,1, merged,0,0,0.00906753591547
10924,1000329,1,301,200,101,0.664452,0.335548,0.664452,96,5,303,201,102,0.663366,0.336634,0.663366,97,5,1, merged,1,1,0.0046159199425
10935,1000063,1,1007,903,104,0.896723,0.103277,0.896723,92,12,1008,904,104,0.896825,0.103175,0.896825,92,12,1, merged,0,0,0.00536068853862
10940,1000118,2,352,313,39,0.889205,0.110795,1.699064,39,0,353,314,39,0.889518,0.110482,1.702018,39,0,1, merged,0,0,0.160070930965
10951,1000063,1,1011,907,104,0.897132,0.102868,0.897132,92,12,1012,908,104,0.897233,0.102767,0.897233,92,12,1, merged,0,0,0.0281998316672
10951,1000121,2,284,246,38,0.866197,0.133803,1.763329,37,1,285,247,38,0.866667,0.133333,1.7639,37,1,1, merged,0,0,0.161215138758
10966,1000118,2,353,314,39,0.889518,0.110482,1.889518,39,0,354,315,39,0.889831,0.110169,1.889831,39,0,1, merged,0,0,0.159377804396
10967,1000118,2,354,315,39,0.889831,0.110169,1.889831,39,0,355,316,39,0.890141,0.109859,1.890141,39,0,1, merged,0,0,0.134433046939
10974,1000023,1,152,135,17,0.888158,0.111842,0.888158,15,2,153,136,17,0.888889,0.111111,0.888889,15,2,1, merged,0,0,0.00313798836243
10974,1000063,2,1025,920,105,0.897561,0.102439,1.785719,92,13,1026,921,105,0.897661,0.102339,1.78655,92,13,1, merged,0,0,0.0051043537415
10982,1000063,1,1026,921,105,0.897661,0.102339,0.897661,92,13,1029,924,105,0.897959,0.102041,0.897959,92,13,-1, merged,0,0,0.0848447187223
10995,1000004,2,504,422,82,0.837302,0.162698,1.660831,71,11,505,423,82,0.837624,0.162376,1.670957,71,11,1, merged,0,0,0.127940759653
10996,1000327,1,55,39,16,0.709091,0.290909,0.709091,13,3,56,40,16,0.714286,0.285714,0.714286,13,3,1, merged,0,0,0.372987029379
11007,1000105,2,159,126,33,0.792453,0.207547,1.506739,31,2,160,127,33,0.79375,0.20625,1.483405,31,2,1, merged,0,0,0.247790187108
11007,1000327,1,56,40,16,0.714286,0.285714,0.714286,13,3,58,40,18,0.689655,0.310345,0.689655,13,5,-1, merged,1,1,0.322251782816
11016,1000063,1,1029,924,105,0.897959,0.102041,0.897959,92,13,1031,926,105,0.898157,0.101843,0.898157,92,13,-1, merged,0,0,0.124877056735
11016,1000328,2,163,104,59,0.638037,0.361963,1.535996,58,1,164,105,59,0.640244,0.359756,1.538401,58,1,1, merged,0,0,0.106160660091
11024,1000014,2,383,332,51,0.866841,0.133159,1.764998,49,2,384,333,51,0.867188,0.132812,1.765542,49,2,1, merged,0,0,0.115260020201
11024,1000063,1,1031,926,105,0.898157,0.101843,0.898157,92,13,1033,928,105,0.898354,0.101646,0.898354,92,13,-1, merged,0,0,0.743762556353
11059,1000063,1,1045,938,107,0.897608,0.102392,0.897608,93,14,1046,939,107,0.897706,0.102294,0.897706,93,14,-1, merged,0,0,0
11060,1000118,1,357,318,39,0.890756,0.109244,0.890756,39,0,359,319,40,0.888579,0.111421,0.888579,40,0,1, merged,1,1,0.17523047004
11100,1000327,1,58,40,18,0.689655,0.310345,0.689655,13,5,61,42,19,0.688525,0.311475,0.688525,14,5,1, merged,1,1,0.441818420141
11100,1000328,3,164,105,59,0.640244,0.359756,1.993265,58,1,166,106,60,0.638554,0.361446,1.98721,59,1,1, merged,1,1,0.571355065259
11100,1000329,2,303,201,102,0.663366,0.336634,1.353022,97,5,306,202,104,0.660131,0.339869,1.348655,99,5,1, merged,1,1,0.514523971515
11106,1000327,1,61,42,19,0.688525,0.311475,0.688525,14,5,62,43,19,0.693548,0.306452,0.693548,14,5,1, merged,0,0,0.894459338695
11106,1000328,2,166,106,60,0.638554,0.361446,1.327079,59,1,167,107,60,0.640719,0.359281,1.334267,59,1,1, merged,0,0,1.14755102041
11106,1000329,3,307,203,104,0.661238,0.338762,1.988317,99,5,308,204,104,0.662338,0.337662,1.996605,99,5,1, merged,0,0,1.04172829132
11110,1000003,1,389,326,63,0.838046,0.161954,0.838046,57,6,390,327,63,0.838462,0.161538,0.838462,57,6,1, merged,0,0,0.0441315692761
11114,1000014,3,384,333,51,0.867188,0.132812,2.169196,49,2,385,334,51,0.867532,0.132468,2.172769,49,2,-1, abandoned,0,0,0.145307033347
11114,1000328,2,167,107,60,0.640719,0.359281,1.302009,59,1,168,108,60,0.642857,0.357143,1.305237,59,1,-1, abandoned,0,0,0.169822425617
11114,1000329,1,310,205,105,0.66129,0.33871,0.66129,100,5,311,206,105,0.662379,0.337621,0.662379,100,5,-1, abandoned,0,0,0.160964745041
11120,1000004,1,508,426,82,0.838583,0.161417,0.838583,71,11,509,427,82,0.8389,0.1611,0.8389,71,11,1, merged,0,0,0.0692160154159
11120,1000026,2,151,135,16,0.89404,0.10596,1.732622,14,2,152,136,16,0.894737,0.105263,1.733637,14,2,1, merged,0,0,0.169049213376
11121,1000023,2,153,136,17,0.888889,0.111111,1.787081,15,2,154,137,17,0.88961,0.11039,1.788189,15,2,-1, merged,0,0,0
11121,1000063,1,1051,944,107,0.898192,0.101808,0.898192,93,14,1055,948,107,0.898578,0.101422,0.898578,93,14,-1, merged,0,0,0.00312223194396
11128,1000014,2,388,337,51,0.868557,0.131443,1.767135,49,2,389,338,51,0.868895,0.131105,1.767569,49,2,1, merged,0,0,0.115549676661
11128,1000063,1,1055,948,107,0.898578,0.101422,0.898578,93,14,1056,949,107,0.898674,0.101326,0.898674,93,14,1, merged,0,0,0.668640932059
11129,1000005,1,57,43,14,0.754386,0.245614,0.754386,14,0,59,44,15,0.745763,0.254237,0.745763,14,1,-1, merged,1,0,0.109053870452
11147,1000023,1,154,137,17,0.88961,0.11039,0.88961,15,2,156,139,17,0.891026,0.108974,0.891026,15,2,-1, merged,0,0,0.00120900710292
11147,1000063,2,1056,949,107,0.898674,0.101326,1.788285,93,14,1057,950,107,0.89877,0.10123,1.789796,93,14,1, merged,0,0,0.00194003024165
11156,1000004,3,516,434,82,0.841085,0.158915,2.526306,71,11,519,437,82,0.842004,0.157996,2.50887,71,11,-1, merged,0,0,0.0519281946211
11156,1000014,1,389,338,51,0.868895,0.131105,0.868895,49,2,394,340,54,0.862944,0.137056,0.862944,52,2,1, merged,1,1,0.030205655527
11156,1000120,2,49,40,9,0.816327,0.183673,1.685221,8,1,51,41,10,0.803922,0.196078,1.666866,9,1,1, merged,1,1,0.107745098039
11181,1000003,1,391,328,63,0.838875,0.161125,0.838875,57,6,392,329,63,0.839286,0.160714,0.839286,57,6,1, merged,0,0,0.470442349529
11181,1000054,3,27,23,4,0.851852,0.148148,2.258294,2,2,28,24,4,0.857143,0.142857,2.275376,2,2,1, merged,0,0,1.41020278834
11184,1000043,2,95,75,20,0.789474,0.210526,1.482751,19,1,96,76,20,0.791667,0.208333,1.486227,19,1,1, merged,0,0,0.949853658537
11188,1000043,2,96,76,20,0.791667,0.208333,1.486227,19,1,97,77,20,0.793814,0.206186,1.489648,19,1,1, merged,0,0,0.314591122224
11193,1000015,2,643,590,53,0.917574,0.082426,1.917574,48,5,644,591,53,0.917702,0.082298,1.917702,48,5,1, merged,0,0,0.331785967382
11193,1000153,3,381,353,28,0.926509,0.073491,2.844083,23,5,382,354,28,0.926702,0.073298,2.844403,23,5,1, merged,0,0,0.337336117474
11209,1000043,2,97,77,20,0.793814,0.206186,1.489648,19,1,98,78,20,0.795918,0.204082,1.494265,19,1,1, merged,0,0,0.0584479567269
11221,1000153,1,382,354,28,0.926702,0.073298,0.926702,23,5,384,356,28,0.927083,0.072917,0.927083,23,5,-1, abandoned,0,0,0.443193804697
11222,1000014,2,394,340,54,0.862944,0.137056,1.706694,52,2,395,341,54,0.863291,0.136709,1.681473,52,2,1, merged,0,0,0.567464802515
11222,1000592,1,32,27,5,0.84375,0.15625,0.84375,4,1,33,27,6,0.818182,0.181818,0.818182,5,1,1, merged,1,1,0.753684210526
11226,1000121,2,285,247,38,0.866667,0.133333,1.588889,37,1,286,248,38,0.867133,0.132867,1.576224,37,1,-1, abandoned,0,0,0.432241262421
11228,1000026,2,154,138,16,0.896104,0.103896,1.823377,14,2,155,139,16,0.896774,0.103226,1.824235,14,2,1, merged,0,0,0.00930954228084
11228,1000153,1,385,357,28,0.927273,0.072727,0.927273,23,5,386,358,28,0.927461,0.072539,0.927461,23,5,1, merged,0,0,0.00343416630133
11234,1000327,2,62,43,19,0.693548,0.306452,1.479956,14,5,63,44,19,0.698413,0.301587,1.479365,14,5,-1, merged,0,0,0.0724893814733
11244,1000118,1,361,321,40,0.889197,0.110803,0.889197,40,0,362,322,40,0.889503,0.110497,0.889503,40,0,1, merged,0,0,0.13509298923
11250,1000118,1,362,322,40,0.889503,0.110497,0.889503,40,0,363,323,40,0.889807,0.110193,0.889807,40,0,1, merged,0,0,0.0510212803315
11257,1000118,2,363,323,40,0.889807,0.110193,1.702307,40,0,364,324,40,0.89011,0.10989,1.703903,40,0,1, merged,0,0,0.160701858625
11261,1000327,3,63,44,19,0.698413,0.301587,2.059343,14,5,64,45,19,0.703125,0.296875,2.066365,14,5,-1, abandoned,0,0,0.0672840524943
11261,1000329,1,313,207,106,0.661342,0.338658,0.661342,101,5,314,208,106,0.66242,0.33758,0.66242,101,5,-1, abandoned,0,0,0.111786559115
11269,1000023,1,156,139,17,0.891026,0.108974,0.891026,15,2,157,140,17,0.89172,0.10828,0.89172,15,2,1, merged,0,0,0.00506884498001
11269,1000063,2,1073,965,108,0.899348,0.100652,1.790373,93,15,1074,966,108,0.899441,0.100559,1.791161,93,15,1, merged,0,0,0.00543596720415
11270,1000014,2,395,341,54,0.863291,0.136709,1.565332,52,2,396,342,54,0.863636,0.136364,1.566888,52,2,1, merged,0,0,0.0662340004704
11276,1000004,1,523,441,82,0.843212,0.156788,0.843212,71,11,524,442,82,0.843511,0.156489,0.843511,71,11,-1, merged,0,0,0.368436213992
11276,1000592,2,35,29,6,0.828571,0.171429,1.671784,5,1,36,30,6,0.833333,0.166667,1.676845,5,1,1, merged,0,0,0.774352331606
11277,1000063,2,1075,967,108,0.899535,0.100465,1.607227,93,15,1076,968,108,0.899628,0.100372,1.611749,93,15,1, merged,0,0,0.087672592255
11277,1000327,1,65,46,19,0.707692,0.292308,0.707692,14,5,66,47,19,0.712121,0.287879,0.712121,14,5,1, merged,0,0,0.570153061224
11285,1000091,2,79,59,20,0.746835,0.253165,1.529854,19,1,81,60,21,0.740741,0.259259,1.516442,20,1,1, merged,1,1,0.432746343341
11297,1000009,1,283,234,49,0.826855,0.173145,0.826855,43,6,285,235,50,0.824561,0.175439,0.824561,43,7,-1, merged,1,1,1.01547667148
11297,1000015,3,653,600,53,0.918836,0.081164,2.673712,48,5,654,601,53,0.91896,0.08104,2.671727,48,5,1, merged,0,0,1.02417322597
11297,1000153,2,389,361,28,0.928021,0.071979,1.754876,23,5,390,362,28,0.928205,0.071795,1.752767,23,5,1, merged,0,0,1.04578067431
11307,1000121,1,290,252,38,0.868966,0.131034,0.868966,37,1,291,253,38,0.869416,0.130584,0.869416,37,1,1, merged,0,0,0.55749457153
11308,1000121,1,291,253,38,0.869416,0.130584,0.869416,37,1,292,254,38,0.869863,0.130137,0.869863,37,1,1, merged,0,0,0.560822074801
11309,1000121,1,292,254,38,0.869863,0.130137,0.869863,37,1,293,255,38,0.870307,0.129693,0.870307,37,1,1, merged,0,0,0.280805263817
11310,1000121,1,293,255,38,0.870307,0.129693,0.870307,37,1,294,256,38,0.870748,0.129252,0.870748,37,1,1, merged,0,0,0.285078557806
11311,1000121,1,294,256,38,0.870748,0.129252,0.870748,37,1,295,257,38,0.871186,0.128814,0.871186,37,1,1, merged,0,0,0.160543266444
11312,1000121,1,295,257,38,0.871186,0.128814,0.871186,37,1,296,258,38,0.871622,0.128378,0.871622,37,1,1, merged,0,0,0.285991609689
11313,1000121,1,296,258,38,0.871622,0.128378,0.871622,37,1,297,259,38,0.872054,0.127946,0.872054,37,1,1, merged,0,0,0.104820385058
11315,1000121,3,297,259,38,0.872054,0.127946,2.19956,37,1,298,259,39,0.869128,0.130872,2.185545,38,1,1, merged,1,1,0.0539957879301
11315,1000327,1,66,47,19,0.712121,0.287879,0.712121,14,5,67,48,19,0.716418,0.283582,0.716418,14,5,-1, merged,0,0,0.0786141281468
11318,1000014,1,396,342,54,0.863636,0.136364,0.863636,52,2,398,343,55,0.861809,0.138191,0.861809,53,2,1, merged,1,1,0.506519507187
11318,1000109,2,210,169,41,0.804762,0.195238,1.668398,40,1,213,171,42,0.802817,0.197183,1.664626,41,1,1, merged,1,1,0.0175373134328
11350,1000121,1,298,259,39,0.869128,0.130872,0.869128,38,1,299,260,39,0.869565,0.130435,0.869565,38,1,1, merged,0,0,0.27829090251
11351,1000121,1,299,260,39,0.869565,0.130435,0.869565,38,1,300,261,39,0.87,0.13,0.87,38,1,1, merged,0,0,0.2786121415
11368,1000329,1,315,209,106,0.663492,0.336508,0.663492,101,5,316,210,106,0.664557,0.335443,0.664557,101,5,1, merged,0,0,0.110130467487
11369,1000329,1,316,210,106,0.664557,0.335443,0.664557,101,5,317,211,106,0.665615,0.334385,0.665615,101,5,1, merged,0,0,0.0362454988831
11372,1000015,1,658,605,53,0.919453,0.080547,0.919453,48,5,660,605,55,0.916667,0.083333,0.916667,50,5,1, abandoned,1,1,0.127100328506
11375,1000327,1,67,48,19,0.716418,0.283582,0.716418,14,5,68,49,19,0.720588,0.279412,0.720588,14,5,1, merged,0,0,0.281641163837
11375,1000328,2,169,109,60,0.64497,0.35503,1.361388,59,1,170,110,60,0.647059,0.352941,1.367647,59,1,1, merged,0,0,0.213113578955
11378,1000327,1,68,49,19,0.720588,0.279412,0.720588,14,5,69,50,19,0.724638,0.275362,0.724638,14,5,1, merged,0,0,0.877938808374
11378,1000328,2,170,110,60,0.647059,0.352941,1.367647,59,1,171,111,60,0.649123,0.350877,1.37376,59,1,1, merged,0,0,0.695654919793
11379,1000592,2,39,32,7,0.820513,0.179487,1.820513,6,1,40,33,7,0.825,0.175,1.825,6,1,1, merged,0,0,0.167889908257
11380,1000592,2,40,33,7,0.825,0.175,1.825,6,1,41,34,7,0.829268,0.170732,1.829268,6,1,1, merged,0,0,0.178537670522
11383,1000592,1,41,34,7,0.829268,0.170732,0.829268,6,1,42,34,8,0.809524,0.190476,0.809524,7,1,1, merged,1,1,0.0186335403727
11384,1000592,2,42,34,8,0.809524,0.190476,1.809524,7,1,43,35,8,0.813953,0.186047,1.813953,7,1,1, merged,0,0,0.24901511479
11388,1000327,1,69,50,19,0.724638,0.275362,0.724638,14,5,70,51,19,0.728571,0.271429,0.728571,14,5,1, merged,0,0,0.397991967871
11389,1000592,2,43,35,8,0.813953,0.186047,1.813953,7,1,44,36,8,0.818182,0.181818,1.818182,7,1,1, merged,0,0,0.471008403361
11390,1000592,2,44,36,8,0.818182,0.181818,1.818182,7,1,45,37,8,0.822222,0.177778,1.679365,7,1,1, merged,0,0,0.237119010522
11391,1000592,2,45,37,8,0.822222,0.177778,1.679365,7,1,46,38,8,0.826087,0.173913,1.603865,7,1,1, merged,0,0,0.352547232887
11392,1000592,2,46,38,8,0.826087,0.173913,1.603865,7,1,47,39,8,0.829787,0.170213,1.55706,7,1,1, merged,0,0,0.359948729022
11393,1000592,2,47,39,8,0.829787,0.170213,1.55706,7,1,48,40,8,0.833333,0.166667,1.583333,7,1,1, merged,0,0,0.249704706372
11394,1000592,2,48,40,8,0.833333,0.166667,1.583333,7,1,49,41,8,0.836735,0.163265,1.55102,7,1,1, merged,0,0,0.257820567457
11418,1000153,2,391,363,28,0.928389,0.071611,1.75696,23,5,392,364,28,0.928571,0.071429,1.751001,23,5,1, merged,0,0,1.00696961491
11421,1000329,2,317,211,106,0.665615,0.334385,1.547194,101,5,318,212,106,0.666667,0.333333,1.549784,101,5,1, merged,0,0,0.209590490496
11422,1000007,2,338,293,45,0.866864,0.133136,1.795435,38,7,339,294,45,0.867257,0.132743,1.793653,38,7,1, merged,0,0,1.35079834418
11422,1000153,1,392,364,28,0.928571,0.071429,0.928571,23,5,394,365,29,0.926396,0.073604,0.926396,24,5,1, merged,1,1,1.01438950562
11423,1000327,1,74,55,19,0.743243,0.256757,0.743243,14,5,75,56,19,0.746667,0.253333,0.746667,14,5,1, merged,0,0,0.704216388226
11423,1000329,2,318,212,106,0.666667,0.333333,1.40991,101,5,319,213,106,0.667712,0.332288,1.414378,101,5,1, merged,0,0,0.689006696429
11431,1000328,1,171,111,60,0.649123,0.350877,0.649123,59,1,172,111,61,0.645349,0.354651,0.645349,60,1,1, abandoned,1,1,0.214084838554
11431,1000329,2,319,213,106,0.667712,0.332288,1.316834,101,5,320,213,107,0.665625,0.334375,1.310974,102,5,1, abandoned,1,1,0.158644574912
11435,1000328,2,172,111,61,0.645349,0.354651,1.42105,60,1,173,112,61,0.647399,0.352601,1.425177,60,1,1, merged,0,0,1.16242618419
11445,1000329,3,322,215,107,0.667702,0.332298,2.295751,102,5,323,216,107,0.668731,0.331269,2.317479,102,5,1, merged,0,0,0.647579453067
11449,1000329,2,323,216,107,0.668731,0.331269,0.668731,102,5,324,217,107,0.669753,0.330247,1.669753,102,5,1, merged,0,0,0.94186310183
11450,1000329,2,324,217,107,0.669753,0.330247,0.669753,102,5,325,218,107,0.670769,0.329231,1.670769,102,5,1, merged,0,0,0.293977036059
11451,1000327,1,75,56,19,0.746667,0.253333,0.746667,14,5,77,58,19,0.753247,0.246753,0.753247,14,5,-1, merged,0,0,0.859484126984
11451,1000592,2,50,42,8,0.84,0.16,1.586667,7,1,51,43,8,0.843137,0.156863,1.596384,7,1,1, merged,0,0,0.865134099617
11452,1000004,2,525,443,82,0.84381,0.15619,1.597056,71,11,526,444,82,0.844106,0.155894,1.600517,71,11,1, merged,0,0,0.0959767684101
11452,1000327,1,77,58,19,0.753247,0.246753,0.753247,14,5,78,59,19,0.75641,0.24359,0.75641,14,5,1, merged,0,0,0.0979213465335
11454,1000327,1,78,59,19,0.75641,0.24359,0.75641,14,5,80,60,20,0.75,0.25,0.75,15,5,-1, merged,1,0,0.171312330088
11459,1000592,2,51,43,8,0.843137,0.156863,1.557423,7,1,52,44,8,0.846154,0.153846,1.579487,7,1,1, merged,0,0,0.368234384864
11460,1000063,2,1077,969,108,0.899721,0.100279,1.837775,93,15,1078,970,108,0.899814,0.100186,1.838411,93,15,1, merged,0,0,0.000580727956549
11462,1000063,2,1078,970,108,0.899814,0.100186,1.838945,93,15,1079,971,108,0.899907,0.100093,1.839562,93,15,1, merged,0,0,8.0898415411e-05
11463,1000592,2,52,44,8,0.846154,0.153846,1.579487,7,1,53,45,8,0.849057,0.150943,1.599057,7,1,1, merged,0,0,0.27051744393
11480,1000118,2,370,330,40,0.891892,0.108108,1.742191,40,0,371,331,40,0.892183,0.107817,1.743374,40,0,1, merged,0,0,0.174652616875
11490,1000329,2,325,218,107,0.670769,0.329231,1.374769,102,5,326,219,107,0.671779,0.328221,1.376958,102,5,1, merged,0,0,1.0523021129
11493,1000004,4,526,444,82,0.844106,0.155894,3.141418,71,11,527,445,82,0.844402,0.155598,3.072014,71,11,1, merged,0,0,0.0461824564424
11495,1000327,1,80,60,20,0.75,0.25,0.75,15,5,81,61,20,0.753086,0.246914,0.753086,15,5,-1, abandoned,0,0,0
11519,1000120,2,51,41,10,0.803922,0.196078,1.557008,9,1,52,42,10,0.807692,0.192308,1.56379,9,1,1, merged,0,0,0.0890151515152
11519,1000327,1,81,61,20,0.753086,0.246914,0.753086,15,5,82,62,20,0.756098,0.243902,0.756098,15,5,1, merged,0,0,0.200396825397
11520,1000120,2,52,42,10,0.807692,0.192308,1.56379,9,1,53,43,10,0.811321,0.188679,1.570357,9,1,1, merged,0,0,0.0155806122123
11520,1000327,1,82,62,20,0.756098,0.243902,0.756098,15,5,83,63,20,0.759036,0.240964,0.759036,15,5,1, merged,0,0,0.0419487467074
11522,1000091,2,81,60,21,0.740741,0.259259,1.499777,20,1,82,61,21,0.743902,0.256098,1.505807,20,1,1, merged,0,0,0.433425330917
11522,1000327,1,83,63,20,0.759036,0.240964,0.759036,15,5,84,64,20,0.761905,0.238095,0.761905,15,5,1, merged,0,0,0.234646962233
11523,1000091,2,82,61,21,0.743902,0.256098,1.505807,20,1,83,62,21,0.746988,0.253012,1.511694,20,1,1, merged,0,0,0.225377384383
11523,1000327,1,84,64,20,0.761905,0.238095,0.761905,15,5,85,65,20,0.764706,0.235294,0.764706,15,5,1, merged,0,0,0.0887942332896
11529,1000007,1,339,294,45,0.867257,0.132743,0.867257,38,7,344,298,46,0.866279,0.133721,0.866279,39,7,-1, merged,1,0,0.0672566662447
11529,1000009,2,287,237,50,0.825784,0.174216,1.693041,43,7,288,238,50,0.826389,0.173611,1.692668,43,7,-1, merged,0,0,0.0438330698563
11529,1000534,3,5,2,3,0.4,0.6,2.093041,3,0,6,2,4,0.333333,0.666667,2.026001,4,0,1, merged,1,1,0.0544570502431
11534,1000014,2,400,345,55,0.8625,0.1375,1.694433,53,2,401,346,55,0.862843,0.137157,1.697554,53,2,1, merged,0,0,0.258521625739
11537,1000003,2,402,338,64,0.840796,0.159204,1.675507,58,6,404,340,64,0.841584,0.158416,1.67765,58,6,-1, merged,0,0,0.15294416076
11538,1000003,2,404,340,64,0.841584,0.158416,1.67765,58,6,405,341,64,0.841975,0.158025,1.671244,58,6,-1, abandoned,0,0,0.626828132278
11543,1000003,2,405,341,64,0.841975,0.158025,1.671244,58,6,406,342,64,0.842365,0.157635,1.667761,58,6,-1, merged,0,0,0.151739160266
11554,1000329,1,328,221,107,0.67378,0.32622,0.67378,102,5,330,223,107,0.675758,0.324242,0.675758,102,5,-1, merged,0,0,0.130310690976
11560,1000327,1,85,65,20,0.764706,0.235294,0.764706,15,5,86,66,20,0.767442,0.232558,0.767442,15,5,-1, merged,0,0,0.0377711758421
11560,1000329,2,334,226,108,0.676647,0.323353,1.441353,103,5,336,228,108,0.678571,0.321429,1.446013,103,5,-1, merged,0,0,0.0698323537055
11562,1000327,5,86,66,20,0.767442,0.232558,3.799294,15,5,88,68,20,0.772727,0.227273,3.800951,15,5,-1, abandoned,0,0,0
11562,1000328,1,173,112,61,0.647399,0.352601,0.647399,60,1,174,112,62,0.643678,0.356322,0.643678,61,1,1, abandoned,1,1,0
11562,1000329,2,336,228,108,0.678571,0.321429,1.32597,103,5,338,229,109,0.677515,0.322485,1.321193,104,5,1, abandoned,1,1,0
11563,1000327,1,88,68,20,0.772727,0.227273,0.772727,15,5,89,69,20,0.775281,0.224719,0.775281,15,5,-1, merged,0,0,0.00293318555841
11563,1000329,3,338,229,109,0.677515,0.322485,1.450242,104,5,340,231,109,0.679412,0.320588,1.954693,104,5,-1, merged,0,0,0.0035537379542
11588,1000003,2,412,347,65,0.842233,0.157767,1.617514,59,6,416,350,66,0.841346,0.158654,1.610577,60,6,1, merged,1,1,0.000936714481147
11588,1000121,4,301,262,39,0.870432,0.129568,3.154612,38,1,302,263,39,0.870861,0.129139,3.165648,38,1,1, merged,0,0,0.00254504676405
11588,1000327,1,89,69,20,0.775281,0.224719,0.775281,15,5,91,70,21,0.769231,0.230769,0.769231,16,5,1, merged,1,1,0.00385695232844
11598,1000327,2,91,70,21,0.769231,0.230769,1.538462,16,5,92,71,21,0.771739,0.228261,1.557453,16,5,1, merged,0,0,0.207443490499
11605,1000327,4,92,71,21,0.771739,0.228261,2.90366,16,5,93,72,21,0.774194,0.225806,2.922542,16,5,1, merged,0,0,0.0703369862531
11605,1000329,1,342,233,109,0.681287,0.318713,0.681287,104,5,344,234,110,0.680233,0.319767,0.680233,105,5,1, merged,1,1,0.0620632004801
11611,1000014,2,406,351,55,0.864532,0.135468,1.758282,53,2,407,352,55,0.864865,0.135135,1.759275,53,2,1, merged,0,0,0.00195982361587
11611,1000023,1,160,143,17,0.89375,0.10625,0.89375,15,2,161,144,17,0.89441,0.10559,0.89441,15,2,1, merged,0,0,0
11612,1000124,1,136,134,2,0.985294,0.014706,0.985294,2,0,140,136,4,0.971429,0.028571,0.971429,4,0,1, merged,1,1,0.0103877530128
11614,1000327,1,93,72,21,0.774194,0.225806,0.774194,16,5,95,72,23,0.757895,0.242105,0.757895,18,5,1, merged,1,1,0.254080384127
11619,1000327,1,95,72,23,0.757895,0.242105,0.757895,18,5,96,72,24,0.75,0.25,0.75,19,5,1, merged,1,1,0.515068493151
11624,1000327,2,102,78,24,0.764706,0.235294,1.584582,19,5,103,79,24,0.76699,0.23301,1.581805,19,5,-1, abandoned,0,0,0.196578151933
11625,1000327,1,103,79,24,0.76699,0.23301,0.76699,19,5,104,80,24,0.769231,0.230769,0.769231,19,5,1, merged,0,0,0.589961389961
11626,1000327,1,104,80,24,0.769231,0.230769,0.769231,19,5,107,82,25,0.766355,0.233645,0.766355,20,5,1, merged,1,1,0.11867771781
11627,1000327,1,107,82,25,0.766355,0.233645,0.766355,20,5,108,82,26,0.759259,0.240741,0.759259,21,5,1, merged,1,1,0.00622263962313
11628,1000327,2,108,82,26,0.759259,0.240741,1.569075,21,5,109,83,26,0.761468,0.238532,1.566346,21,5,1, merged,0,0,0.616820418204
11630,1000327,1,109,83,26,0.761468,0.238532,0.761468,21,5,110,84,26,0.763636,0.236364,0.763636,21,5,1, merged,0,0,0.307512743811
11631,1000043,1,100,80,20,0.8,0.2,0.8,19,1,101,80,21,0.792079,0.207921,0.792079,20,1,1, abandoned,1,1,0
11631,1000130,2,86,71,15,0.825581,0.174419,1.625581,14,1,87,72,15,0.827586,0.172414,1.619665,14,1,-1, abandoned,0,0,0.380435951648
11638,1000124,2,140,136,4,0.971429,0.028571,1.735065,4,0,141,137,4,0.971631,0.028369,1.737397,4,0,1, merged,0,0,0.309834407787
11638,1000327,1,110,84,26,0.763636,0.236364,0.763636,21,5,111,85,26,0.765766,0.234234,0.765766,21,5,1, merged,0,0,0.402018348624
11642,1000118,2,375,335,40,0.893333,0.106667,1.779888,40,0,376,336,40,0.893617,0.106383,1.780646,40,0,1, merged,0,0,0.157827363612
11645,1000043,2,101,80,21,0.792079,0.207921,1.492079,20,1,102,81,21,0.794118,0.205882,1.508403,20,1,1, merged,0,0,0.0704076685053
11649,1000327,1,111,85,26,0.765766,0.234234,0.765766,21,5,112,86,26,0.767857,0.232143,0.767857,21,5,1, merged,0,0,0
11649,1000329,2,344,234,110,0.680233,0.319767,1.445998,105,5,345,235,110,0.681159,0.318841,1.449017,105,5,1, merged,0,0,0.000385505011565
11663,1000327,2,112,86,26,0.767857,0.232143,1.53633,21,5,113,87,26,0.769912,0.230088,1.542858,21,5,-1, merged,0,0,0.116581346385
11670,1000063,2,1093,985,108,0.901189,0.098811,1.582349,93,15,1094,986,108,0.90128,0.09872,1.583361,93,15,1, merged,0,0,0.0394548208627
11670,1000329,1,345,235,110,0.681159,0.318841,0.681159,105,5,346,236,110,0.682081,0.317919,0.682081,105,5,1, merged,0,0,0.0222764910988
11676,1000004,3,527,445,82,0.844402,0.155598,2.718715,71,11,528,446,82,0.844697,0.155303,2.719697,71,11,-1, abandoned,0,0,0.200241641625
11676,1000015,2,670,614,56,0.916418,0.083582,1.874313,51,5,672,616,56,0.916667,0.083333,1.875,51,5,-1, abandoned,0,0,0.456708383316
11676,1000153,4,395,366,29,0.926582,0.073418,3.645297,24,5,396,367,29,0.926768,0.073232,3.646465,24,5,-1, abandoned,0,0,0.439067656766
11680,1000043,1,102,81,21,0.794118,0.205882,0.794118,20,1,103,82,21,0.796117,0.203883,0.796117,20,1,1, merged,0,0,0.858845789972
11680,1000130,2,87,72,15,0.827586,0.172414,1.621704,14,1,88,73,15,0.829545,0.170455,1.625662,14,1,1, merged,0,0,0.768975069252
11688,1000329,1,346,236,110,0.682081,0.317919,0.682081,105,5,349,238,111,0.681948,0.318052,0.681948,106,5,1, merged,1,1,0.0797205408776
11689,1000329,2,349,238,111,0.681948,0.318052,1.515282,106,5,351,240,111,0.683761,0.316239,1.49955,106,5,-1, merged,0,0,0.157735973897
11693,1000023,2,163,146,17,0.895706,0.104294,1.665617,15,2,164,147,17,0.896341,0.103659,1.646341,15,2,1, merged,0,0,0
11693,1000327,1,113,87,26,0.769912,0.230088,0.769912,21,5,120,90,30,0.75,0.25,0.75,21,9,-1, merged,1,1,0
11695,1000328,1,174,112,62,0.643678,0.356322,0.643678,61,1,175,113,62,0.645714,0.354286,0.645714,61,1,1, merged,0,0,0.285803683175
11695,1000329,2,351,240,111,0.683761,0.316239,1.327439,106,5,352,241,111,0.684659,0.315341,1.330373,106,5,1, merged,0,0,0.196493721867
11710,1000091,3,83,62,21,0.746988,0.253012,2.26763,20,1,85,63,22,0.741176,0.258824,2.26597,20,2,-1, merged,1,0,0.121755800009
11710,1000327,1,120,90,30,0.75,0.25,0.75,21,9,121,91,30,0.752066,0.247934,0.752066,21,9,-1, merged,0,0,0
11710,1000592,4,53,45,8,0.849057,0.150943,3.116687,7,1,54,46,8,0.851852,0.148148,3.117822,7,1,1, merged,0,0,0.0968563416073
11718,1000063,2,1095,987,108,0.90137,0.09863,1.803934,93,15,1096,988,108,0.90146,0.09854,1.804521,93,15,1, merged,0,0,0.0819010264633
11736,1000023,2,165,148,17,0.89697,0.10303,1.606272,15,2,166,149,17,0.89759,0.10241,1.608015,15,2,1, merged,0,0,0.000842295205015
11742,1000124,2,142,138,4,0.971831,0.028169,0.971831,4,0,143,139,4,0.972028,0.027972,1.972028,4,0,1, merged,0,0,0.248956762192
11750,1000327,2,121,91,30,0.752066,0.247934,1.441142,21,9,122,92,30,0.754098,0.245902,1.444906,21,9,-1, merged,0,0,0
11750,1000328,5,178,116,62,0.651685,0.348315,3.655104,61,1,179,117,62,0.653631,0.346369,3.664621,61,1,1, merged,0,0,0.191409598381
11750,1000329,1,357,246,111,0.689076,0.310924,0.689076,106,5,359,248,111,0.690808,0.309192,0.690808,106,5,-1, merged,0,0,0.151418650841
11750,1000592,4,54,46,8,0.851852,0.148148,3.003418,7,1,55,47,8,0.854545,0.145455,3.01099,7,1,1, merged,0,0,0.109774355761
11772,1000012,2,280,254,26,0.907143,0.092857,1.865476,25,1,281,255,26,0.907473,0.092527,1.866236,25,1,1, merged,0,0,0.365748431155
11780,1000328,2,179,117,62,0.653631,0.346369,1.345298,61,1,180,118,62,0.655556,0.344444,1.348926,61,1,1, merged,0,0,0.997833627278
11780,1000329,1,360,249,111,0.691667,0.308333,0.691667,106,5,362,251,111,0.69337,0.30663,0.69337,106,5,-1, merged,0,0,0.937763278388
11781,1000328,2,180,118,62,0.655556,0.344444,1.348926,61,1,181,119,62,0.657459,0.342541,1.352514,61,1,-1, abandoned,0,0,1.00153543538
11781,1000329,1,362,251,111,0.69337,0.30663,0.69337,106,5,364,253,111,0.695055,0.304945,0.695055,106,5,-1, abandoned,0,0,0.940704908284
11788,1000121,2,302,263,39,0.870861,0.129139,1.56485,38,1,303,264,39,0.871287,0.128713,1.56611,38,1,1, merged,0,0,0.0767157019258
11788,1000329,1,366,254,112,0.693989,0.306011,0.693989,107,5,367,255,112,0.694823,0.305177,0.694823,107,5,1, merged,0,0,0.13488714938
11789,1000329,1,367,255,112,0.694823,0.305177,0.694823,107,5,368,255,113,0.692935,0.307065,0.692935,108,5,1, merged,1,1,0.0688215062992
11790,1000329,2,368,255,113,0.692935,0.307065,1.692935,108,5,369,256,113,0.693767,0.306233,1.693767,108,5,1, merged,0,0,0.965286796537
11792,1000063,3,1101,993,108,0.901907,0.098093,2.559067,93,15,1103,995,108,0.902085,0.097915,2.563703,93,15,-1, merged,0,0,0.769062954825
11792,1000327,1,122,92,30,0.754098,0.245902,0.754098,21,9,124,94,30,0.758065,0.241935,0.758065,21,9,-1, merged,0,0,0.222773958068
11797,1000329,1,370,257,113,0.694595,0.305405,0.694595,108,5,372,258,114,0.693548,0.306452,0.693548,109,5,1, merged,1,1,0.107719262734
11802,1000063,1,1104,996,108,0.902174,0.097826,0.902174,93,15,1105,997,108,0.902262,0.097738,0.902262,93,15,1, merged,0,0,0.00546438509714
11815,1000327,1,124,94,30,0.758065,0.241935,0.758065,21,9,125,95,30,0.76,0.24,0.76,21,9,-1, merged,0,0,0.0574617558063
11819,1000063,1,1110,1001,109,0.901802,0.098198,0.901802,93,16,1111,1002,109,0.90189,0.09811,0.90189,93,16,1, merged,0,0,0.00804291932764
11821,1000124,2,144,140,4,0.972222,0.027778,1.732222,4,0,145,141,4,0.972414,0.027586,1.735572,4,0,1, merged,0,0,0.157979722118
11822,1000004,2,528,446,82,0.844697,0.155303,1.762586,71,11,529,446,83,0.8431,0.1569,1.761229,72,11,1, merged,1,1,0.397012320687
11822,1000015,1,682,626,56,0.917889,0.082111,0.917889,51,5,684,628,56,0.918129,0.081871,0.918129,51,5,-1, merged,0,0,0.925006524782
11823,1000091,3,85,63,22,0.741176,0.258824,2.273106,20,2,88,66,22,0.75,0.25,2.267262,20,2,-1, merged,0,0,0.422107279693
11823,1000327,1,125,95,30,0.76,0.24,0.76,21,9,127,95,32,0.748031,0.251969,0.748031,23,9,1, merged,1,1,0.778335857311
11851,1000153,2,396,367,29,0.926768,0.073232,1.835165,24,5,399,370,29,0.927318,0.072682,1.833685,24,5,-1, merged,0,0,0.208095889292
11860,1000327,2,128,96,32,0.75,0.25,1.445767,23,9,129,96,33,0.744186,0.255814,1.439724,24,9,1, merged,1,1,0.1568477333
11860,1000329,1,378,263,115,0.695767,0.304233,0.695767,109,6,381,265,116,0.695538,0.304462,0.695538,110,6,-1, merged,1,0,0.161352260347
11864,1000327,3,129,96,33,0.744186,0.255814,1.739724,24,9,130,97,33,0.746154,0.253846,1.715216,24,9,1, merged,0,0,0.00760637052181
11864,1000329,2,381,265,116,0.695538,0.304462,0.995538,110,6,382,266,116,0.696335,0.303665,0.969062,110,6,-1, merged,0,0,0.0118144824461
11876,1000070,3,274,250,24,0.912409,0.087591,2.672409,20,4,275,251,24,0.912727,0.087273,2.563077,20,4,1, merged,0,0,0.0982064279877
11883,1000063,2,1126,1017,109,0.903197,0.096803,1.80675,93,16,1127,1018,109,0.903283,0.096717,1.807323,93,16,1, merged,0,0,0.0235758127123
11891,1000014,3,412,357,55,0.866505,0.133495,2.483946,53,2,413,358,55,0.866828,0.133172,2.48663,53,2,1, merged,0,0,0.300757503164
11891,1000121,2,303,264,39,0.871287,0.128713,1.617441,38,1,304,265,39,0.871711,0.128289,1.619802,38,1,1, merged,0,0,0.219176900848
11891,1000327,1,130,97,33,0.746154,0.253846,0.746154,24,9,131,98,33,0.748092,0.251908,0.748092,24,9,1, merged,0,0,0.281381435001
11892,1000328,4,181,119,62,0.657459,0.342541,2.623532,61,1,182,120,62,0.659341,0.340659,2.808246,61,1,1, merged,0,0,1.0062237395
11894,1000063,3,1127,1018,109,0.903283,0.096717,2.704647,93,16,1128,1019,109,0.903369,0.096631,2.707483,93,16,1, merged,0,0,0.00676257370963
11898,1000328,1,183,121,62,0.661202,0.338798,0.661202,61,1,184,122,62,0.663043,0.336957,0.663043,61,1,-1, abandoned,0,0,0.124847623017
11902,1000327,1,131,98,33,0.748092,0.251908,0.748092,24,9,132,99,33,0.75,0.25,0.75,24,9,-1, abandoned,0,0,0
11911,1000004,2,529,446,83,0.8431,0.1569,1.585957,72,11,530,447,83,0.843396,0.156604,1.583509,72,11,-1, abandoned,0,0,0
11915,1000043,4,104,83,21,0.798077,0.201923,3.272153,20,1,105,84,21,0.8,0.2,3.247227,20,1,-1, abandoned,0,0,0.284841992376
11915,1000063,1,1128,1019,109,0.903369,0.096631,0.903369,93,16,1129,1019,110,0.902569,0.097431,0.902569,94,16,1, abandoned,1,1,0.0435317585083
11916,1000091,2,88,66,22,0.75,0.25,1.413043,20,2,90,66,24,0.733333,0.266667,1.394624,22,2,1, merged,1,1,0.468619567298
11916,1000328,1,184,122,62,0.663043,0.336957,0.663043,61,1,186,123,63,0.66129,0.33871,0.66129,62,1,1, merged,1,1,1.16149295284
11918,1000121,2,304,265,39,0.871711,0.128289,1.621711,38,1,305,266,39,0.872131,0.127869,1.624011,38,1,1, merged,0,0,0.548902333067
11918,1000327,1,132,99,33,0.75,0.25,0.75,24,9,133,100,33,0.75188,0.24812,0.75188,24,9,1, merged,0,0,0.64384057971
11920,1000327,1,133,100,33,0.75188,0.24812,0.75188,24,9,134,101,33,0.753731,0.246269,0.753731,24,9,1, merged,0,0,0.0206766773225
11921,1000007,2,344,298,46,0.866279,0.133721,0.866279,39,7,346,300,46,0.867052,0.132948,1.867052,39,7,-1, merged,0,0,1.32004675628
11922,1000004,5,530,447,83,0.843396,0.156604,4.299194,72,11,532,449,83,0.843985,0.156015,4.32686,72,11,-1, merged,0,0,0.0494185736498
11922,1000063,2,1129,1019,110,0.902569,0.097431,1.6563,94,16,1130,1020,110,0.902655,0.097345,1.659798,94,16,-1, merged,0,0,0
11922,1000327,1,134,101,33,0.753731,0.246269,0.753731,24,9,140,106,34,0.757143,0.242857,0.757143,25,9,-1, merged,1,0,0.0301772123713
11922,1000592,6,55,47,8,0.854545,0.145455,5.153739,7,1,57,47,10,0.824561,0.175439,5.151421,9,1,1, merged,1,1,0.0957089894371
11925,1000329,2,383,267,116,0.697128,0.302872,1.646768,110,6,384,268,116,0.697917,0.302083,1.647917,110,6,1, merged,0,0,0.124554671051
11927,1000070,2,275,251,24,0.912727,0.087273,1.66987,20,4,276,252,24,0.913043,0.086957,1.671909,20,4,1, merged,0,0,0.707952016831
11927,1000327,1,140,106,34,0.757143,0.242857,0.757143,25,9,141,107,34,0.758865,0.241135,0.758865,25,9,1, merged,0,0,0.638501934771
11936,1000121,3,305,266,39,0.872131,0.127869,2.392851,38,1,306,266,40,0.869281,0.130719,2.394346,38,2,-1, merged,1,1,0
11936,1000132,2,85,69,16,0.811765,0.188235,1.52072,14,2,86,70,16,0.813953,0.186047,1.525065,14,2,-1, merged,0,0,0
11938,1000327,1,141,107,34,0.758865,0.241135,0.758865,25,9,142,108,34,0.760563,0.239437,0.760563,25,9,1, merged,0,0,0.585982339956
11942,1000070,2,276,252,24,0.913043,0.086957,1.673607,20,4,277,253,24,0.913357,0.086643,1.671978,20,4,1, merged,0,0,0.732754018805
11942,1000327,1,142,108,34,0.760563,0.239437,0.760563,25,9,145,110,35,0.758621,0.241379,0.758621,26,9,-1, merged,1,0,0.63391184573
11944,1000015,2,691,635,56,0.918958,0.081042,1.877721,51,5,692,636,56,0.919075,0.080925,1.878259,51,5,-1, merged,0,0,0.925090504038
11945,1000329,1,384,268,116,0.697917,0.302083,0.697917,110,6,385,269,116,0.698701,0.301299,0.698701,110,6,1, merged,0,0,0.407735392068
11949,1000124,2,145,141,4,0.972414,0.027586,1.755022,4,0,146,142,4,0.972603,0.027397,1.758317,4,0,1, merged,0,0,0.251400350088
11949,1000166,1,69,54,15,0.782609,0.217391,0.782609,14,1,70,55,15,0.785714,0.214286,0.785714,14,1,1, merged,0,0,1.472
11958,1000124,2,146,142,4,0.972603,0.027397,1.758317,4,0,147,143,4,0.972789,0.027211,1.761522,4,0,1, merged,0,0,0.120427397128
11958,1000166,1,70,55,15,0.785714,0.214286,0.785714,14,1,71,56,15,0.788732,0.211268,0.788732,14,1,1, merged,0,0,0.700768662592
11959,1000043,2,106,85,21,0.801887,0.198113,1.560507,20,1,107,86,21,0.803738,0.196262,1.55884,20,1,1, merged,0,0,0.468094568071
11959,1000327,1,145,110,35,0.758621,0.241379,0.758621,26,9,147,111,36,0.755102,0.244898,0.755102,27,9,1, merged,1,1,0.285405714224
11961,1000105,2,163,130,33,0.797546,0.202454,1.497804,31,2,165,132,33,0.8,0.2,1.499229,31,2,-1, merged,0,0,0.394487964677
11961,1000329,1,387,271,116,0.700258,0.299742,0.700258,110,6,389,272,117,0.699229,0.300771,0.699229,111,6,1, merged,1,1,0.89834584196
11964,1000007,1,348,302,46,0.867816,0.132184,0.867816,39,7,349,303,46,0.868195,0.131805,0.868195,39,7,1, merged,0,0,1.31099125364
11967,1000121,1,306,266,40,0.869281,0.130719,0.869281,38,2,308,268,40,0.87013,0.12987,0.87013,38,2,-1, merged,0,0,0.268354172768
11967,1000327,2,147,111,36,0.755102,0.244898,1.624383,27,9,148,111,37,0.75,0.25,1.62013,28,9,1, merged,1,1,0.390662562989
11967,1000328,3,186,123,63,0.66129,0.33871,2.285673,62,1,187,124,63,0.663102,0.336898,2.283231,62,1,-1, merged,0,0,0.475447688318
11968,1000121,2,308,268,40,0.87013,0.12987,1.62013,38,2,312,271,41,0.86859,0.13141,1.610312,39,2,-1, abandoned,1,0,0.268890550699
11968,1000327,1,148,111,37,0.75,0.25,0.75,28,9,151,112,39,0.741722,0.258278,0.741722,30,9,1, abandoned,1,1,0.394501508404
11971,1000091,2,90,66,24,0.733333,0.266667,1.475055,22,2,91,67,24,0.736264,0.263736,1.474826,22,2,1, merged,0,0,0.424779946422
11971,1000327,1,151,112,39,0.741722,0.258278,0.741722,30,9,153,113,40,0.738562,0.261438,0.738562,31,9,1, merged,1,1,0.79598384215
11971,1000328,3,187,124,63,0.663102,0.336898,2.138157,62,1,188,125,63,0.664894,0.335106,2.139719,62,1,1, merged,0,0,0.960849763634
11976,1000091,2,91,67,24,0.736264,0.263736,1.401157,22,2,92,68,24,0.73913,0.26087,1.405797,22,2,-1, abandoned,0,0,0.0650865096845
11976,1000328,1,188,125,63,0.664894,0.335106,0.664894,62,1,189,126,63,0.666667,0.333333,0.666667,62,1,-1, abandoned,0,0,0.0697947081366
11979,1000329,2,389,272,117,0.699229,0.300771,1.41034,111,6,390,273,117,0.7,0.3,1.412177,111,6,1, merged,0,0,0.239781229459
11995,1000063,1,1134,1023,111,0.902116,0.097884,0.902116,95,16,1135,1024,111,0.902203,0.097797,0.902203,95,16,1, merged,0,0,0.767781283542
11995,1000327,2,153,113,40,0.738562,0.261438,1.640678,31,9,154,114,40,0.74026,0.25974,1.642462,31,9,1, merged,0,0,0.234797944943
12003,1000014,2,413,358,55,0.866828,0.133172,1.767326,53,2,414,359,55,0.86715,0.13285,1.76814,53,2,1, merged,0,0,0.301965304271
12006,1000014,2,415,360,55,0.86747,0.13253,1.646813,53,2,416,361,55,0.867788,0.132212,1.643489,53,2,1, merged,0,0,0.0159625642655
12009,1000004,2,533,450,83,0.844278,0.155722,1.712066,72,11,534,451,83,0.844569,0.155431,1.710598,72,11,1, merged,0,0,0.00149712713442
12009,1000014,1,416,361,55,0.867788,0.132212,0.867788,53,2,418,362,56,0.866029,0.133971,0.866029,54,2,1, merged,1,1,0.000160449257922
12010,1000023,1,178,161,17,0.904494,0.095506,0.904494,15,2,179,162,17,0.905028,0.094972,0.905028,15,2,1, merged,0,0,0.000211737044112
12010,1000121,2,314,273,41,0.869427,0.130573,1.773921,39,2,315,274,41,0.869841,0.130159,1.774869,39,2,1, merged,0,0,0.00149665494172
12018,1000043,1,107,86,21,0.803738,0.196262,0.803738,20,1,108,87,21,0.805556,0.194444,0.805556,20,1,-1, merged,0,0,0.807613741876
12018,1000130,2,89,74,15,0.831461,0.168539,1.635199,14,1,90,74,16,0.822222,0.177778,1.627778,15,1,1, merged,1,1,0.932049518569
12029,1000121,2,316,275,41,0.870253,0.129747,1.624099,39,2,317,276,41,0.870662,0.129338,1.628238,39,2,1, merged,0,0,0.0448848650816
12042,1000121,1,317,276,41,0.870662,0.129338,0.870662,39,2,318,277,41,0.871069,0.128931,0.871069,39,2,1, merged,0,0,0.017174434966
12042,1000327,2,154,114,40,0.74026,0.25974,1.610922,31,9,155,115,40,0.741935,0.258065,1.613005,31,9,1, merged,0,0,0.0265615216336
12044,1000023,1,179,162,17,0.905028,0.094972,0.905028,15,2,180,163,17,0.905556,0.094444,0.905556,15,2,1, merged,0,0,0.00295291830476
12044,1000063,2,1139,1028,111,0.902546,0.097454,1.807574,95,16,1140,1029,111,0.902632,0.097368,1.808187,95,16,1, merged,0,0,0.0051707465952
12057,1000329,3,390,273,117,0.7,0.3,2.447436,111,6,391,274,117,0.700767,0.299233,2.450987,111,6,1, merged,0,0,0.0832063369433
12062,1000023,5,180,163,17,0.905556,0.094444,3.999643,15,2,181,164,17,0.906077,0.093923,3.984515,15,2,1, merged,0,0,0.0374110634732
12062,1000121,4,320,278,42,0.86875,0.13125,3.094087,40,2,321,278,43,0.866044,0.133956,3.078438,41,2,1, merged,1,1,0.135201332245
12064,1000004,1,535,452,83,0.84486,0.15514,0.84486,72,11,537,454,83,0.845438,0.154562,0.845438,72,11,-1, merged,0,0,0.0397190603052
12064,1000329,3,391,274,117,0.700767,0.299233,2.255186,111,6,393,275,118,0.699746,0.300254,2.256862,112,6,1, merged,1,1,0.0214669051878
12078,1000063,2,1140,1029,111,0.902632,0.097368,1.803622,95,16,1141,1030,111,0.902717,0.097283,1.805156,95,16,1, merged,0,0,0.164265407878
12109,1000026,2,157,141,16,0.898089,0.101911,1.753262,14,2,159,143,16,0.899371,0.100629,1.749711,14,2,-1, merged,0,0,0.232815917883
12110,1000327,1,155,115,40,0.741935,0.258065,0.741935,31,9,156,116,40,0.74359,0.25641,0.74359,31,9,1, merged,0,0,0.288274791345
12115,1000327,2,156,116,40,0.74359,0.25641,1.443335,31,9,157,117,40,0.745223,0.254777,1.445731,31,9,1, merged,0,0,0.886214360352
12115,1000329,1,393,275,118,0.699746,0.300254,0.699746,112,6,394,276,118,0.700508,0.299492,0.700508,112,6,1, merged,0,0,1.01391761352
12116,1000327,3,157,117,40,0.745223,0.254777,2.186471,31,9,158,118,40,0.746835,0.253165,2.198101,31,9,1, merged,0,0,0.891087264327
12116,1000329,2,394,276,118,0.700508,0.299492,1.441248,112,6,395,277,118,0.701266,0.298734,1.451266,112,6,1, merged,0,0,1.0165837585
12127,1000004,2,537,454,83,0.845438,0.154562,1.667355,72,11,538,455,83,0.845725,0.154275,1.645725,72,11,-1, abandoned,0,0,0.0219128329298
12127,1000015,3,694,638,56,0.919308,0.080692,2.586664,51,5,695,639,56,0.919424,0.080576,2.565149,51,5,-1, abandoned,0,0,0
12128,1000004,2,538,455,83,0.845725,0.154275,1.645725,72,11,541,457,84,0.844732,0.155268,1.616884,73,11,-1, merged,1,0,0.0228758169935
12136,1000121,2,321,278,43,0.866044,0.133956,1.643821,41,2,322,279,43,0.86646,0.13354,1.647282,41,2,1, merged,0,0,0.152614794176
12147,1000328,2,189,126,63,0.666667,0.333333,1.367932,62,1,190,127,63,0.668421,0.331579,1.370441,62,1,1, merged,0,0,0.105534660251
12147,1000329,1,395,277,118,0.701266,0.298734,0.701266,112,6,396,278,118,0.70202,0.29798,0.70202,112,6,1, merged,0,0,0.0805564671976
12153,1000023,1,182,165,17,0.906593,0.093407,0.906593,15,2,183,165,18,0.901639,0.098361,0.901639,16,2,1, merged,1,1,0.00134388532179
12153,1000063,2,1144,1033,111,0.902972,0.097028,1.809565,95,16,1147,1035,112,0.902354,0.097646,1.803993,96,16,-1, merged,1,0,0.00202862616928
12181,1000063,2,1154,1042,112,0.902946,0.097054,1.805385,96,16,1155,1043,112,0.90303,0.09697,1.805943,96,16,1, merged,0,0,1.01717360698e-06
12188,1000063,2,1158,1046,112,0.903282,0.096718,1.806194,96,16,1159,1047,112,0.903365,0.096635,1.806747,96,16,1, merged,0,0,0.00016342542319
12206,1000063,2,1176,1062,114,0.903061,0.096939,1.806443,98,16,1177,1063,114,0.903144,0.096856,1.80699,98,16,1, merged,0,0,0.00047428894202
12211,1000004,2,541,457,84,0.844732,0.155268,1.747958,73,11,542,458,84,0.845018,0.154982,1.748408,73,11,1, merged,0,0,0.000247716780988
12211,1000063,1,1178,1064,114,0.903226,0.096774,0.903226,98,16,1180,1066,114,0.90339,0.09661,0.90339,98,16,-1, merged,0,0,9.39661220808e-06
12220,1000003,1,428,360,68,0.841121,0.158879,0.841121,62,6,429,361,68,0.841492,0.158508,0.841492,62,6,1, merged,0,0,0.0319591565073
12220,1000026,2,159,143,16,0.899371,0.100629,1.740493,14,2,160,144,16,0.9,0.1,1.741492,14,2,1, merged,0,0,0.0905562051218
12222,1000004,1,542,458,84,0.845018,0.154982,0.845018,73,11,543,459,84,0.845304,0.154696,0.845304,73,11,1, merged,0,0,0.00544516020825
12222,1000063,4,1186,1072,114,0.903879,0.096121,3.460464,98,16,1187,1073,114,0.90396,0.09604,3.462589,98,16,1, merged,0,0,0.0155822056389
12223,1000063,2,1187,1073,114,0.90396,0.09604,1.727489,98,16,1188,1074,114,0.90404,0.09596,1.728858,98,16,1, merged,0,0,0.00276181386187
12224,1000063,2,1188,1074,114,0.90404,0.09596,1.728858,98,16,1189,1074,115,0.90328,0.09672,1.722121,99,16,1, merged,1,1,0.00284298594753
12231,1000063,2,1189,1074,115,0.90328,0.09672,1.722121,99,16,1191,1075,116,0.902603,0.097397,1.715552,100,16,1, merged,1,1,0.00162449742111
12253,1000121,1,325,282,43,0.867692,0.132308,0.867692,41,2,326,282,44,0.865031,0.134969,0.865031,42,2,1, merged,1,1,0.445551711386
12259,1000124,2,149,145,4,0.973154,0.026846,1.770452,4,0,150,146,4,0.973333,0.026667,1.773333,4,0,1, merged,0,0,0.0643694804847
12259,1000166,1,74,59,15,0.797297,0.202703,0.797297,14,1,75,60,15,0.8,0.2,0.8,14,1,1, merged,0,0,0.372311671335
12262,1000327,1,159,119,40,0.748428,0.251572,0.748428,31,9,161,121,40,0.751553,0.248447,0.751553,31,9,-1, merged,0,0,0.592950581395
12263,1000121,1,329,284,45,0.863222,0.136778,0.863222,43,2,331,286,45,0.864048,0.135952,0.864048,43,2,-1, merged,0,0,0.0700207155086
12264,1000009,1,307,253,54,0.824104,0.175896,0.824104,47,7,308,254,54,0.824675,0.175325,0.824675,47,7,1, merged,0,0,0.482935940462
12264,1000153,2,402,372,30,0.925373,0.074627,1.749477,24,6,403,373,30,0.925558,0.074442,1.750234,24,6,1, merged,0,0,0.507054504555
12265,1000121,2,331,286,45,0.864048,0.135952,1.647832,43,2,332,287,45,0.864458,0.135542,1.653932,43,2,1, merged,0,0,0.273141346717
12268,1000121,4,332,287,45,0.864458,0.135542,3.082258,43,2,333,288,45,0.864865,0.135135,3.086851,43,2,1, merged,0,0,0.284413983602
12268,1000327,3,161,121,40,0.751553,0.248447,2.217801,31,9,162,122,40,0.753086,0.246914,2.221986,31,9,1, merged,0,0,0.434100011726
12268,1000329,1,396,278,118,0.70202,0.29798,0.70202,112,6,397,279,118,0.702771,0.297229,0.702771,112,6,1, merged,0,0,0.507504524569
12269,1000327,1,162,122,40,0.753086,0.246914,0.753086,31,9,163,123,40,0.754601,0.245399,0.754601,31,9,1, merged,0,0,0.874102405072
12269,1000329,2,397,279,118,0.702771,0.297229,1.455857,112,6,398,280,118,0.703518,0.296482,1.458119,112,6,1, merged,0,0,1.0182968493
12270,1000327,1,163,123,40,0.754601,0.245399,0.754601,31,9,164,124,40,0.756098,0.243902,0.756098,31,9,1, merged,0,0,0.291249081159
12279,1000003,1,429,361,68,0.841492,0.158508,0.841492,62,6,430,361,69,0.839535,0.160465,0.839535,63,6,1, merged,1,1,0.918919292427
12279,1000004,2,543,459,84,0.845304,0.154696,1.686796,73,11,544,460,84,0.845588,0.154412,1.685123,73,11,1, merged,0,0,0.482958934342
12281,1000121,2,333,288,45,0.864865,0.135135,1.654339,43,2,334,289,45,0.865269,0.134731,1.657477,43,2,1, merged,0,0,0.020195449486
12302,1000003,1,430,361,69,0.839535,0.160465,0.839535,63,6,431,362,69,0.839907,0.160093,0.839907,63,6,1, merged,0,0,0.700027628125
12307,1000329,2,398,280,118,0.703518,0.296482,1.418319,112,6,399,281,118,0.704261,0.295739,1.420088,112,6,1, merged,0,0,0.121734824478
12308,1000004,1,547,463,84,0.846435,0.153565,0.846435,73,11,549,465,84,0.846995,0.153005,0.846995,73,11,-1, merged,0,0,0.431796654405
12308,1000120,2,54,44,10,0.814815,0.185185,1.66125,9,1,55,45,10,0.818182,0.181818,1.665176,9,1,1, merged,0,0,0.397593582888
12311,1000327,1,164,124,40,0.756098,0.243902,0.756098,31,9,165,124,41,0.751515,0.248485,0.751515,32,9,1, merged,1,1,0.0803149182712
12319,1000121,4,334,289,45,0.865269,0.134731,2.821045,43,2,335,290,45,0.865672,0.134328,3.066363,43,2,1, merged,0,0,0
12319,1000327,2,165,124,41,0.751515,0.248485,1.251515,32,9,166,124,42,0.746988,0.253012,1.496988,33,9,1, merged,1,1,0
12319,1000329,3,399,281,118,0.704261,0.295739,1.955776,112,6,405,285,120,0.703704,0.296296,2.200692,114,6,-1, merged,1,0,0
12337,1000063,3,1197,1080,117,0.902256,0.097744,2.056102,101,16,1199,1082,117,0.902419,0.097581,2.024641,101,16,-1, abandoned,0,0,0.0249438804564
12361,1000329,2,406,286,120,0.704433,0.295567,1.422291,114,6,407,287,120,0.70516,0.29484,1.424021,114,6,-1, abandoned,0,0,0.262226496326
12369,1000121,2,335,290,45,0.865672,0.134328,1.615672,43,2,336,291,45,0.866071,0.133929,1.624692,43,2,1, merged,0,0,0.094233084773
12376,1000329,1,409,289,120,0.706601,0.293399,0.706601,114,6,411,290,121,0.705596,0.294404,0.705596,115,6,1, merged,1,1,0.0289673920198
12378,1000124,2,154,150,4,0.974026,0.025974,0.974026,4,0,155,151,4,0.974194,0.025806,1.974194,4,0,1, merged,0,0,0.0477766780038
12387,1000328,2,193,130,63,0.673575,0.326425,1.379886,62,1,194,131,63,0.675258,0.324742,1.38228,62,1,1, merged,0,0,1.16027540048
12387,1000329,1,412,291,121,0.706311,0.293689,0.706311,115,6,413,292,121,0.707022,0.292978,0.707022,115,6,1, merged,0,0,1.04339028232
12391,1000327,2,166,124,42,0.746988,0.253012,1.45401,33,9,167,125,42,0.748503,0.251497,1.456232,33,9,1, merged,0,0,0.647026349658
12391,1000329,1,413,292,121,0.707022,0.292978,0.707022,115,6,414,293,121,0.707729,0.292271,0.707729,115,6,1, merged,0,0,0.669969733656
12393,1000121,2,337,292,45,0.866469,0.133531,1.614972,43,2,338,293,45,0.866864,0.133136,1.616864,43,2,1, merged,0,0,0.305684511765
12393,1000327,1,167,125,42,0.748503,0.251497,0.748503,33,9,168,126,42,0.75,0.25,0.75,33,9,1, merged,0,0,0.120799512987
12394,1000121,1,338,293,45,0.866864,0.133136,0.866864,43,2,339,293,46,0.864307,0.135693,0.864307,43,3,-1, merged,1,1,0.14317733748
12408,1000091,1,96,71,25,0.739583,0.260417,0.739583,23,2,97,72,25,0.742268,0.257732,0.742268,23,2,1, merged,0,0,0.158787790137
12408,1000328,2,194,131,63,0.675258,0.324742,1.414841,62,1,195,132,63,0.676923,0.323077,1.419191,62,1,1, merged,0,0,0.211287975862
12413,1000063,2,1201,1084,117,0.902581,0.097419,1.652581,101,16,1202,1085,117,0.902662,0.097338,1.702662,101,16,1, merged,0,0,0.000859999428921
12415,1000063,2,1202,1085,117,0.902662,0.097338,1.766969,101,16,1203,1086,117,0.902743,0.097257,1.767449,101,16,1, merged,0,0,2.69912812324e-05
12415,1000121,1,339,293,46,0.864307,0.135693,0.864307,43,3,340,294,46,0.864706,0.135294,0.864706,43,3,1, merged,0,0,4.90069111963e-12
12425,1000121,1,341,295,46,0.865103,0.134897,0.865103,43,3,342,296,46,0.865497,0.134503,0.865497,43,3,1, merged,0,0,0.282116890227
12427,1000329,2,414,293,121,0.707729,0.292271,1.435002,115,6,415,294,121,0.708434,0.291566,1.458434,115,6,1, merged,0,0,0.679190355228
12435,1000004,2,551,467,84,0.84755,0.15245,1.84755,73,11,552,468,84,0.847826,0.152174,1.847826,73,11,1, merged,0,0,0.201627198937
12438,1000153,1,404,374,30,0.925743,0.074257,0.925743,24,6,406,375,31,0.923645,0.076355,0.923645,24,7,-1, merged,1,0,0
12441,1000124,1,156,152,4,0.974359,0.025641,0.974359,4,0,157,153,4,0.974522,0.025478,0.974522,4,0,-1, merged,0,0,0.151295024696
12442,1000130,3,98,81,17,0.826531,0.173469,1.604308,16,1,99,82,17,0.828283,0.171717,2.598925,16,1,1, merged,0,0,0.424905660377
12447,1000063,1,1203,1086,117,0.902743,0.097257,0.902743,101,16,1206,1087,119,0.901327,0.098673,0.901327,103,16,-1, merged,1,0,0.173762878153
12447,1000327,3,168,126,42,0.75,0.25,2.152743,33,9,169,127,42,0.751479,0.248521,2.252806,33,9,1, merged,0,0,0.727966101695
12451,1000014,1,427,370,57,0.866511,0.133489,0.866511,55,2,428,371,57,0.866822,0.133178,0.866822,55,2,1, merged,0,0,0.0175608088108
12451,1000015,2,699,643,56,0.919886,0.080114,1.786396,51,5,700,644,56,0.92,0.08,1.786822,51,5,1, merged,0,0,0.0264978583614
12452,1000014,1,428,371,57,0.866822,0.133178,0.866822,55,2,429,372,57,0.867133,0.132867,0.867133,55,2,1, merged,0,0,0.00407892968114
12452,1000026,2,160,144,16,0.9,0.1,1.766822,14,2,161,145,16,0.900621,0.099379,1.767754,14,2,1, merged,0,0,0.00252190777508
12456,1000014,1,430,373,57,0.867442,0.132558,0.867442,55,2,432,374,58,0.865741,0.134259,0.865741,56,2,1, merged,1,1,0.0469703682918
12456,1000015,2,700,644,56,0.92,0.08,1.787442,51,5,701,645,56,0.920114,0.079886,1.785855,51,5,1, merged,0,0,0.0674521222263
12458,1000014,1,432,374,58,0.865741,0.134259,0.865741,56,2,434,375,59,0.864055,0.135945,0.864055,57,2,1, merged,1,1,0.0214365209159
12458,1000015,2,702,646,56,0.920228,0.079772,1.785969,51,5,703,647,56,0.920341,0.079659,1.784397,51,5,1, merged,0,0,0.0307244457416
12460,1000327,1,169,127,42,0.751479,0.248521,0.751479,33,9,170,128,42,0.752941,0.247059,0.752941,33,9,1, merged,0,0,0.19747569769
12461,1000327,1,170,128,42,0.752941,0.247059,0.752941,33,9,171,129,42,0.754386,0.245614,0.754386,33,9,-1, merged,0,0,0.199921387765
12463,1000121,2,342,296,46,0.865497,0.134503,1.619883,43,3,343,297,46,0.865889,0.134111,1.621703,43,3,1, merged,0,0,0.447194460445
12463,1000327,1,171,129,42,0.754386,0.245614,0.754386,33,9,172,130,42,0.755814,0.244186,0.755814,33,9,1, merged,0,0,0.578181818182
12472,1000015,1,707,651,56,0.920792,0.079208,0.920792,51,5,708,652,56,0.920904,0.079096,0.920904,51,5,-1, abandoned,0,0,0.0789869376672
12472,1000153,2,406,375,31,0.923645,0.076355,1.844437,24,7,407,376,31,0.923833,0.076167,1.844737,24,7,-1, abandoned,0,0,0.0807672881681
12473,1000004,3,552,468,84,0.847826,0.152174,2.530376,73,11,554,470,84,0.848375,0.151625,2.530403,73,11,-1, merged,0,0,0.145002701845
12473,1000014,2,435,376,59,0.864368,0.135632,1.68255,57,2,442,379,63,0.857466,0.142534,1.682027,61,2,-1, merged,1,0,0.16918712254
12473,1000120,1,55,45,10,0.818182,0.181818,0.818182,9,1,57,47,10,0.824561,0.175439,0.824561,9,1,-1, merged,0,0,0.124737780179
12474,1000004,2,554,470,84,0.848375,0.151625,1.672937,73,11,556,472,84,0.848921,0.151079,1.679429,73,11,-1, merged,0,0,0.218350779037
12474,1000120,1,57,47,10,0.824561,0.175439,0.824561,9,1,59,49,10,0.830508,0.169492,0.830508,9,1,-1, merged,0,0,0.206329378786
12475,1000004,2,556,472,84,0.848921,0.151079,1.679429,73,11,560,476,84,0.85,0.15,1.686066,73,11,-1, merged,0,0,0.438717923126
12475,1000120,1,59,49,10,0.830508,0.169492,0.830508,9,1,61,51,10,0.836066,0.163934,0.836066,9,1,-1, merged,0,0,0.457142857143
12476,1000004,2,560,476,84,0.85,0.15,1.686066,73,11,564,479,85,0.849291,0.150709,1.690561,74,11,-1, merged,1,0,0.0732606810613
12476,1000120,1,61,51,10,0.836066,0.163934,0.836066,9,1,63,53,10,0.84127,0.15873,0.84127,9,1,-1, merged,0,0,0.0792498531597
12478,1000121,1,344,297,47,0.863372,0.136628,0.863372,44,3,345,298,47,0.863768,0.136232,0.863768,44,3,1, merged,0,0,0.54931695169
12478,1000329,2,415,294,121,0.708434,0.291566,1.571806,115,6,416,294,122,0.706731,0.293269,1.570499,115,7,-1, merged,1,1,0.956275409572
12479,1000121,1,345,298,47,0.863768,0.136232,0.863768,44,3,346,298,48,0.861272,0.138728,0.861272,45,3,1, merged,1,1,0.550012233384
12479,1000328,3,195,132,63,0.676923,0.323077,2.247422,62,1,196,133,63,0.678571,0.321429,2.247977,62,1,-1, merged,0,0,1.01761577483
12479,1000329,2,416,294,122,0.706731,0.293269,1.570499,115,7,418,296,122,0.708134,0.291866,1.569406,115,7,-1, merged,0,0,0.958846122909
12480,1000121,1,346,298,48,0.861272,0.138728,0.861272,45,3,347,299,48,0.861671,0.138329,0.861671,45,3,-1, abandoned,0,0,0.285232519023
12480,1000328,3,196,133,63,0.678571,0.321429,2.247977,62,1,197,134,63,0.680203,0.319797,2.250705,62,1,-1, abandoned,0,0,0.572537888068
12480,1000329,2,418,296,122,0.708134,0.291866,1.569406,115,7,419,297,122,0.708831,0.291169,1.570502,115,7,-1, abandoned,0,0,0.519783902576
12481,1000121,1,347,299,48,0.861671,0.138329,0.861671,45,3,348,300,48,0.862069,0.137931,0.862069,45,3,1, merged,0,0,0.571287373185
12481,1000328,3,197,134,63,0.680203,0.319797,2.250705,62,1,198,135,63,0.681818,0.318182,2.253411,62,1,1, merged,0,0,1.16214122635
12481,1000329,2,419,297,122,0.708831,0.291169,1.570502,115,7,420,298,122,0.709524,0.290476,1.571593,115,7,1, merged,0,0,1.04941629558
12483,1000121,1,348,300,48,0.862069,0.137931,0.862069,45,3,349,301,48,0.862464,0.137536,0.862464,45,3,1, merged,0,0,0.0955172131794
12483,1000327,2,172,130,42,0.755814,0.244186,1.617883,33,9,173,131,42,0.757225,0.242775,1.61969,33,9,1, merged,0,0,0.0424512952776
12484,1000327,1,173,131,42,0.757225,0.242775,0.757225,33,9,174,131,43,0.752874,0.247126,0.752874,34,9,1, merged,1,1,0.0321914486954
12484,1000592,2,58,48,10,0.827586,0.172414,1.584812,9,1,60,49,11,0.816667,0.183333,1.56954,10,1,1, merged,1,1,0.0665640067927
12486,1000091,1,98,73,25,0.744898,0.255102,0.744898,23,2,100,74,26,0.74,0.26,0.74,24,2,1, merged,1,1,0.195405818303
12506,1000014,2,442,379,63,0.857466,0.142534,1.759038,61,2,443,380,63,0.857788,0.142212,1.758614,61,2,-1, abandoned,0,0,0.164656494123
12506,1000063,1,1209,1090,119,0.901572,0.098428,0.901572,103,16,1210,1090,120,0.900826,0.099174,0.900826,104,16,1, abandoned,1,1,0.0529170472516
12516,1000014,2,443,380,63,0.857788,0.142212,1.593082,61,2,444,381,63,0.858108,0.141892,1.588877,61,2,1, merged,0,0,0.245178972757
12516,1000091,1,102,75,27,0.735294,0.264706,0.735294,25,2,104,76,28,0.730769,0.269231,0.730769,26,2,1, merged,1,1,0.198059725208
12529,1000003,2,431,362,69,0.839907,0.160093,1.669365,63,6,432,363,69,0.840278,0.159722,1.671047,63,6,1, merged,0,0,0.082285271078
12533,1000328,2,199,136,63,0.683417,0.316583,1.392941,62,1,200,137,63,0.685,0.315,1.395214,62,1,-1, merged,0,0,0.0851459242002
12533,1000329,1,420,298,122,0.709524,0.290476,0.709524,115,7,421,299,122,0.710214,0.289786,0.710214,115,7,-1, merged,0,0,0.0544849818301
12533,1000592,3,60,49,11,0.816667,0.183333,2.209608,10,1,63,50,13,0.793651,0.206349,2.188865,12,1,1, merged,1,1,0.057416837963
12534,1000329,1,421,299,122,0.710214,0.289786,0.710214,115,7,422,300,122,0.7109,0.2891,0.7109,115,7,-1, merged,0,0,0.138516548838
12534,1000592,2,63,50,13,0.793651,0.206349,1.503865,12,1,64,51,13,0.796875,0.203125,1.507775,12,1,1, merged,0,0,0.15311338674
12538,1000005,2,59,44,15,0.745763,0.254237,1.608891,14,1,61,45,16,0.737705,0.262295,1.598816,15,1,1, merged,1,1,0.0228770945379
12538,1000121,1,358,309,49,0.863128,0.136872,0.863128,46,3,360,310,50,0.861111,0.138889,0.861111,47,3,1, merged,1,1,0.0193422272113
12541,1000004,3,565,480,85,0.849558,0.150442,2.161822,74,11,566,481,85,0.849823,0.150177,2.274697,74,11,1, merged,0,0,0.143885900904
12541,1000120,4,63,53,10,0.84127,0.15873,3.003092,9,1,64,54,10,0.84375,0.15625,3.118447,9,1,1, merged,0,0,0.111658456486
12541,1000329,2,424,302,122,0.712264,0.287736,1.312264,115,7,425,302,123,0.710588,0.289412,1.424874,116,7,1, merged,1,1,0.168966989186
12544,1000063,1,1214,1094,120,0.901153,0.098847,0.901153,104,16,1215,1095,120,0.901235,0.098765,0.901235,104,16,1, merged,0,0,0.0879099086605
12544,1000121,2,360,310,50,0.861111,0.138889,1.762264,47,3,361,311,50,0.861496,0.138504,1.76273,47,3,1, merged,0,0,0.296684767147
12549,1000130,1,99,82,17,0.828283,0.171717,0.828283,16,1,101,84,17,0.831683,0.168317,0.831683,16,1,-1, merged,0,0,0.0108442714508
12563,1000130,1,102,85,17,0.833333,0.166667,0.833333,16,1,104,85,19,0.817308,0.182692,0.817308,16,3,-1, merged,1,1,0.0402844975884
12565,1000121,1,361,311,50,0.861496,0.138504,0.861496,47,3,362,312,50,0.861878,0.138122,0.861878,47,3,1, merged,0,0,0.210583478042
12566,1000007,2,352,306,46,0.869318,0.130682,1.811403,39,7,355,308,47,0.867606,0.132394,1.810354,40,7,-1, merged,1,0,0.131326729154
12566,1000011,1,259,244,15,0.942085,0.057915,0.942085,13,2,262,247,15,0.942748,0.057252,0.942748,13,2,-1, merged,0,0,0.166613391352
12575,1000091,2,109,79,30,0.724771,0.275229,1.438724,28,2,110,80,30,0.727273,0.272727,1.44189,28,2,1, merged,0,0,0.452097819216
12575,1000329,1,430,307,123,0.713953,0.286047,0.713953,116,7,431,308,123,0.714617,0.285383,0.714617,116,7,1, merged,0,0,0.362332631465
12576,1000327,2,174,131,43,0.752874,0.247126,1.467491,34,9,175,132,43,0.754286,0.245714,1.468571,34,9,1, merged,0,0,0.0512177877019
12576,1000329,1,431,308,123,0.714617,0.285383,0.714617,116,7,434,310,124,0.714286,0.285714,0.714286,117,7,-1, merged,1,0,0.0744167324421
12586,1000004,2,568,483,85,0.850352,0.149648,1.694102,74,11,570,485,85,0.850877,0.149123,1.697031,74,11,1, merged,0,0,0.00151345906817
12586,1000120,1,64,54,10,0.84375,0.15625,0.84375,9,1,65,55,10,0.846154,0.153846,0.846154,9,1,1, merged,0,0,0.0153715581707
12598,1000063,2,1222,1101,121,0.900982,0.099018,1.123204,105,16,1224,1103,121,0.901144,0.098856,1.173871,105,16,-1, merged,0,0,0.0176410744581
12599,1000063,2,1224,1103,121,0.901144,0.098856,1.173871,105,16,1230,1108,122,0.900813,0.099187,1.136107,106,16,-1, merged,1,0,0.0141362603268
12602,1000063,2,1230,1108,122,0.900813,0.099187,1.136107,106,16,1231,1109,122,0.900894,0.099106,1.123116,106,16,-1, abandoned,0,0,0.517980686688
12606,1000063,2,1231,1109,122,0.900894,0.099106,1.804563,106,16,1232,1110,122,0.900974,0.099026,1.805084,106,16,1, merged,0,0,1.29456400323e-06
12615,1000063,2,1232,1110,122,0.900974,0.099026,1.123196,106,16,1236,1113,123,0.900485,0.099515,1.127758,107,16,-1, merged,1,0,0.450941748486
12624,1000592,2,67,53,14,0.791045,0.208955,1.541045,13,1,68,54,14,0.794118,0.205882,1.558824,13,1,1, merged,0,0,0.133421296296
12627,1000592,2,68,54,14,0.794118,0.205882,1.558824,13,1,69,55,14,0.797101,0.202899,1.574879,13,1,1, merged,0,0,0.133881845029
12636,1000063,1,1246,1123,123,0.901284,0.098716,0.901284,107,16,1247,1123,124,0.900561,0.099439,0.900561,108,16,1, merged,1,1,0.000116089768618
12648,1000023,2,186,168,18,0.903226,0.096774,1.804421,16,2,187,169,18,0.903743,0.096257,1.805017,16,2,1, merged,0,0,0
12648,1000063,1,1255,1131,124,0.901195,0.098805,0.901195,108,16,1256,1132,124,0.901274,0.098726,0.901274,108,16,1, merged,0,0,0.00150820084208
12667,1000124,2,159,155,4,0.974843,0.025157,1.774843,4,0,160,156,4,0.975,0.025,1.777632,4,0,1, merged,0,0,0.0843554678309
12667,1000166,1,75,60,15,0.8,0.2,0.8,14,1,76,61,15,0.802632,0.197368,0.802632,14,1,1, merged,0,0,0.500184104413
12676,1000014,2,448,385,63,0.859375,0.140625,1.626817,61,2,450,386,64,0.857778,0.142222,1.627009,61,3,-1, merged,1,1,0.260084493448
12680,1000109,2,215,173,42,0.804651,0.195349,1.627081,41,1,216,174,42,0.805556,0.194444,1.62963,41,1,1, merged,0,0,0.880781414995
12691,1000043,2,110,89,21,0.809091,0.190909,1.593574,20,1,111,90,21,0.810811,0.189189,1.597136,20,1,-1, merged,0,0,0.212895371549
12691,1000130,3,105,86,19,0.819048,0.180952,2.412621,16,3,107,87,20,0.813084,0.186916,2.41022,17,3,1, merged,1,1,0.242136978492
12706,1000005,2,79,61,18,0.772152,0.227848,1.530946,17,1,80,61,19,0.7625,0.2375,1.518719,18,1,1, merged,1,1,0.0379041543192
12709,1000004,2,574,489,85,0.851916,0.148084,1.71001,74,11,575,490,85,0.852174,0.147826,1.710581,74,11,1, merged,0,0,0.117429805616
12709,1000014,1,451,387,64,0.858093,0.141907,0.858093,61,3,452,388,64,0.858407,0.141593,0.858407,61,3,1, merged,0,0,0.00134753314497
12710,1000121,1,363,313,50,0.862259,0.137741,0.862259,47,3,365,314,51,0.860274,0.139726,0.860274,48,3,1, merged,1,1,0.0587509884678
12733,1000007,2,355,308,47,0.867606,0.132394,1.670423,40,7,361,312,49,0.864266,0.135734,1.64805,42,7,-1, merged,1,0,0.02415382396
12733,1000009,3,310,255,55,0.822581,0.177419,2.493003,48,7,312,256,56,0.820513,0.179487,2.468563,49,7,-1, merged,1,0,0.018199817092
12733,1000153,4,407,376,31,0.923833,0.076167,3.416836,24,7,409,377,32,0.92176,0.07824,3.390323,25,7,-1, merged,1,0,0.0187665855769
12736,1000003,2,434,365,69,0.841014,0.158986,1.619495,63,6,436,367,69,0.841743,0.158257,1.615328,63,6,-1, merged,0,0,0.95546840456
12740,1000007,2,361,312,49,0.864266,0.135734,1.696327,42,7,362,313,49,0.864641,0.135359,1.697974,42,7,1, merged,0,0,0.0270728721535
12774,1000004,2,575,490,85,0.852174,0.147826,1.637888,74,11,577,492,85,0.852686,0.147314,1.635872,74,11,-1, merged,0,0,0.0114316239316
12786,1000014,2,454,390,64,0.859031,0.140969,1.780599,61,3,455,391,64,0.859341,0.140659,1.774925,61,3,1, merged,0,0,0.0776580635163
12786,1000070,1,306,282,24,0.921569,0.078431,0.921569,20,4,308,282,26,0.915584,0.084416,0.915584,20,6,-1, merged,1,1,0.086243288981
12786,1000327,4,175,132,43,0.754286,0.245714,3.483603,34,9,176,133,43,0.755682,0.244318,3.480187,34,9,1, merged,0,0,0.070885212728
12799,1000120,3,65,55,10,0.846154,0.153846,1.601836,9,1,66,56,10,0.848485,0.151515,2.605547,9,1,1, merged,0,0,0.226735964986
12799,1000327,2,176,133,43,0.755682,0.244318,0.755682,34,9,177,134,43,0.757062,0.242938,1.757062,34,9,1, merged,0,0,0.403253325622
12802,1000327,1,177,134,43,0.757062,0.242938,0.757062,34,9,178,135,43,0.758427,0.241573,0.758427,34,9,1, merged,0,0,0.115696493253
12807,1000004,2,577,492,85,0.852686,0.147314,1.675816,74,11,578,493,85,0.852941,0.147059,1.670509,74,11,-1, abandoned,0,0,0.0224330744876
12807,1000592,3,72,58,14,0.805556,0.194444,2.481371,13,1,73,59,14,0.808219,0.191781,2.478728,13,1,-1, abandoned,0,0,0.0298560931736
12809,1000004,2,578,493,85,0.852941,0.147059,0.852941,74,11,579,494,85,0.853195,0.146805,1.853195,74,11,1, merged,0,0,0.000854153320521
12811,1000124,2,161,157,4,0.975155,0.024845,1.777787,4,0,162,158,4,0.975309,0.024691,1.780503,4,0,1, merged,0,0,0.0604778765203
12811,1000166,1,76,61,15,0.802632,0.197368,0.802632,14,1,77,62,15,0.805195,0.194805,0.805195,14,1,1, merged,0,0,0.350524248931
12813,1000327,1,178,135,43,0.758427,0.241573,0.758427,34,9,179,136,43,0.759777,0.240223,0.759777,34,9,1, merged,0,0,0.413023561905
12816,1000124,2,162,158,4,0.975309,0.024691,1.780503,4,0,163,159,4,0.97546,0.02454,1.783152,4,0,1, merged,0,0,0.265230916487
12816,1000166,1,77,62,15,0.805195,0.194805,0.805195,14,1,78,63,15,0.807692,0.192308,0.807692,14,1,1, merged,0,0,1.55106382979
12817,1000120,1,66,56,10,0.848485,0.151515,0.848485,9,1,67,57,10,0.850746,0.149254,0.850746,9,1,1, merged,0,0,0.468778280543
12823,1000014,2,459,395,64,0.860566,0.139434,0.860566,61,3,460,396,64,0.86087,0.13913,1.86087,61,3,1, merged,0,0,0
12824,1000120,1,70,60,10,0.857143,0.142857,0.857143,9,1,71,61,10,0.859155,0.140845,0.859155,9,1,1, merged,0,0,0
12832,1000004,4,579,494,85,0.853195,0.146805,1.853195,74,11,580,495,85,0.853448,0.146552,3.853448,74,11,1, merged,0,0,0.00854316339664
12836,1000121,1,366,315,51,0.860656,0.139344,0.860656,48,3,367,315,52,0.858311,0.141689,0.858311,49,3,1, merged,1,1,0.004607470336
12855,1000005,1,83,62,21,0.746988,0.253012,0.746988,20,1,84,62,22,0.738095,0.261905,0.738095,21,1,1, abandoned,1,1,0.387436159346
12855,1000070,4,309,283,26,0.915858,0.084142,3.425636,20,6,311,284,27,0.913183,0.086817,3.078314,21,6,1, abandoned,1,1,0.702126349952
12868,1000121,4,368,316,52,0.858696,0.141304,3.565525,49,3,369,317,52,0.859079,0.140921,3.356122,49,3,1, merged,0,0,0.264454656352
12877,1000023,1,187,169,18,0.903743,0.096257,0.903743,16,2,188,170,18,0.904255,0.095745,0.904255,16,2,1, merged,0,0,0.00185718967634
12878,1000004,2,582,497,85,0.853952,0.146048,1.715063,74,11,584,499,85,0.854452,0.145548,1.708998,74,11,-1, merged,0,0,0.0269550394204
12886,1000063,2,1274,1148,126,0.901099,0.098901,1.161968,109,17,1276,1150,126,0.901254,0.098746,1.181254,109,17,-1, merged,0,0,0.0198905764148
12898,1000118,2,402,361,41,0.89801,0.10199,1.83551,41,0,403,362,41,0.898263,0.101737,1.780616,41,0,1, merged,0,0,0.0619665837972
12911,1000327,1,179,136,43,0.759777,0.240223,0.759777,34,9,180,137,43,0.761111,0.238889,0.761111,34,9,1, merged,0,0,0.013789649558
12913,1000124,3,163,159,4,0.97546,0.02454,2.497438,4,0,164,160,4,0.97561,0.02439,2.535736,4,0,1, merged,0,0,0.161601483076
12913,1000166,1,78,63,15,0.807692,0.192308,0.807692,14,1,79,64,15,0.810127,0.189873,0.810127,14,1,1, merged,0,0,0.134615384615
12915,1000124,2,164,160,4,0.97561,0.02439,1.785736,4,0,165,161,4,0.975758,0.024242,1.788258,4,0,1, merged,0,0,0.157018173123
12915,1000166,1,79,64,15,0.810127,0.189873,0.810127,14,1,80,65,15,0.8125,0.1875,0.8125,14,1,1, merged,0,0,0.136243386243
12916,1000124,2,165,161,4,0.975758,0.024242,1.788258,4,0,166,162,4,0.975904,0.024096,1.790718,4,0,1, merged,0,0,0.158396079837
12916,1000166,1,80,65,15,0.8125,0.1875,0.8125,14,1,81,66,15,0.814815,0.185185,0.814815,14,1,1, merged,0,0,0.146437994723
12921,1000012,1,282,256,26,0.907801,0.092199,0.907801,25,1,283,257,26,0.908127,0.091873,0.908127,25,1,1, merged,0,0,0.341385677226
12921,1000014,2,460,396,64,0.86087,0.13913,1.768671,61,3,461,397,64,0.861171,0.138829,1.769299,61,3,1, merged,0,0,0.353733861344
12928,1000014,5,461,397,64,0.861171,0.138829,4.151528,61,3,462,398,64,0.861472,0.138528,4.126977,61,3,1, merged,0,0,0.0209325879378
12928,1000070,1,314,287,27,0.914013,0.085987,0.914013,21,6,316,288,28,0.911392,0.088608,0.911392,21,7,-1, merged,1,0,0.0357185254074
12928,1000121,6,369,317,52,0.859079,0.140921,5.010607,49,3,370,318,52,0.859459,0.140541,4.986436,49,3,1, merged,0,0,0.0406931500103
12931,1000014,2,462,398,64,0.861472,0.138528,1.622583,61,3,463,399,64,0.861771,0.138229,1.624202,61,3,1, merged,0,0,0.511554742431
12931,1000327,1,180,137,43,0.761111,0.238889,0.761111,34,9,181,138,43,0.762431,0.237569,0.762431,34,9,1, merged,0,0,0.813404967412
12932,1000329,2,442,318,124,0.719457,0.280543,1.469457,117,7,443,319,124,0.72009,0.27991,1.52009,117,7,1, merged,0,0,0.107504415751
12933,1000120,1,73,63,10,0.863014,0.136986,0.863014,9,1,75,64,11,0.853333,0.146667,0.853333,10,1,1, merged,1,1,0.0190830830184
12933,1000124,2,166,162,4,0.975904,0.024096,1.838917,4,0,168,163,5,0.970238,0.029762,1.823571,5,0,1, merged,1,1,0.0110165732298
12936,1000327,1,181,138,43,0.762431,0.237569,0.762431,34,9,182,139,43,0.763736,0.236264,0.763736,34,9,1, merged,0,0,0.0903478729344
12936,1000329,2,443,319,124,0.72009,0.27991,1.482521,117,7,444,320,124,0.720721,0.279279,1.484457,117,7,1, merged,0,0,0.104650898016
12945,1000015,1,723,665,58,0.919779,0.080221,0.919779,53,5,725,665,60,0.917241,0.082759,0.917241,55,5,1, abandoned,1,1,0
12952,1000014,2,463,399,64,0.861771,0.138229,1.584374,61,3,465,400,65,0.860215,0.139785,1.580352,62,3,1, merged,1,1,0.00516462233699
12952,1000121,3,370,318,52,0.859459,0.140541,2.443833,49,3,371,319,52,0.859838,0.140162,2.44019,49,3,1, merged,0,0,0.0108708090171
12953,1000015,2,725,665,60,0.917241,0.082759,1.680978,55,5,726,666,60,0.917355,0.082645,1.682383,55,5,1, merged,0,0,0.855976238473
12953,1000327,1,182,139,43,0.763736,0.236264,0.763736,34,9,183,140,43,0.765027,0.234973,0.765027,34,9,1, merged,0,0,0.531059683313
12954,1000014,2,465,400,65,0.860215,0.139785,1.580936,62,3,468,402,66,0.858974,0.141026,1.579957,63,3,-1, merged,1,0,0.508796566594
12954,1000121,3,371,319,52,0.859838,0.140162,2.440774,49,3,373,320,53,0.857909,0.142091,2.437865,50,3,1, merged,1,1,0.58474813471
12954,1000329,1,444,320,124,0.720721,0.279279,0.720721,117,7,448,323,125,0.720982,0.279018,0.720982,118,7,-1, merged,1,0,0.903775892379
12955,1000004,3,585,500,85,0.854701,0.145299,2.29582,74,11,586,501,85,0.854949,0.145051,2.293257,74,11,-1, merged,0,0,0.0159204537717
12955,1000121,4,373,320,53,0.857909,0.142091,3.153728,50,3,376,321,55,0.853723,0.146277,3.14698,52,3,1, merged,1,1,0.0186536617315
12955,1000329,2,448,323,125,0.720982,0.279018,1.441119,118,7,451,325,126,0.720621,0.279379,1.438308,119,7,-1, merged,1,0,0.021782539905
12956,1000121,2,376,321,55,0.853723,0.146277,1.574344,52,3,378,322,56,0.851852,0.148148,1.573706,53,3,1, merged,1,1,0.0454948422513
12956,1000329,1,451,325,126,0.720621,0.279379,0.720621,119,7,453,327,126,0.721854,0.278146,0.721854,119,7,-1, merged,0,0,0.0707205298988
12957,1000121,2,378,322,56,0.851852,0.148148,1.573706,53,3,380,323,57,0.85,0.15,1.570879,54,3,1, merged,1,1,0.0349535257489
12957,1000329,1,453,327,126,0.721854,0.278146,0.721854,119,7,455,328,127,0.720879,0.279121,0.720879,120,7,1, merged,1,1,0.0545582605561
12958,1000121,2,380,323,57,0.85,0.15,1.570879,54,3,383,325,58,0.848564,0.151436,1.570665,55,3,1, merged,1,1,0.0664746652502
12958,1000329,1,455,328,127,0.720879,0.279121,0.720879,120,7,457,330,127,0.722101,0.277899,0.722101,120,7,-1, merged,0,0,0.103684167215
12962,1000009,2,316,260,56,0.822785,0.177215,1.681759,49,7,317,261,56,0.823344,0.176656,1.680487,49,7,1, merged,0,0,0.988837518922
12962,1000014,1,468,402,66,0.858974,0.141026,0.858974,63,3,469,402,67,0.857143,0.142857,0.857143,63,4,-1, merged,1,1,0.71717562724
12970,1000004,1,586,501,85,0.854949,0.145051,0.854949,74,11,588,503,85,0.855442,0.144558,0.855442,74,11,-1, merged,0,0,0.000839102160688
12970,1000014,2,471,404,67,0.857749,0.142251,1.712698,63,4,472,405,67,0.858051,0.141949,1.713493,63,4,1, merged,0,0,0
12975,1000003,1,445,375,70,0.842697,0.157303,0.842697,64,6,447,376,71,0.841163,0.158837,0.841163,65,6,-1, merged,1,0,0.0193508261934
12977,1000004,2,588,503,85,0.855442,0.144558,1.582715,74,11,589,504,85,0.855688,0.144312,1.585417,74,11,-1, merged,0,0,0.0115703082788
12977,1000091,1,110,80,30,0.727273,0.272727,0.727273,28,2,111,81,30,0.72973,0.27027,0.72973,28,2,-1, merged,0,0,0.028315339254
12978,1000327,1,183,140,43,0.765027,0.234973,0.765027,34,9,187,143,44,0.764706,0.235294,0.764706,35,9,-1, merged,1,0,0.412432747162
12978,1000328,2,201,138,63,0.686567,0.313433,1.451594,62,1,202,138,64,0.683168,0.316832,1.447874,63,1,1, merged,1,1,0.53905884732
12979,1000015,2,729,669,60,0.917695,0.082305,1.682401,55,5,730,670,60,0.917808,0.082192,1.683766,55,5,1, merged,0,0,0.0214135916215
12979,1000327,1,187,143,44,0.764706,0.235294,0.764706,35,9,188,144,44,0.765957,0.234043,0.765957,35,9,1, merged,0,0,0.124558967334
12980,1000327,1,188,144,44,0.765957,0.234043,0.765957,35,9,190,144,46,0.757895,0.242105,0.757895,37,9,1, merged,1,1,0.0239234385074
12980,1000328,2,202,138,64,0.683168,0.316832,1.449126,63,1,204,139,65,0.681373,0.318627,1.439267,64,1,1, merged,1,1,0.057572935715
12980,1000329,3,459,332,127,0.723312,0.276688,2.172437,120,7,461,334,127,0.724512,0.275488,2.163779,120,7,-1, merged,0,0,0.0342424489939
12981,1000327,1,190,144,46,0.757895,0.242105,0.757895,37,9,191,145,46,0.759162,0.240838,0.759162,37,9,1, merged,0,0,0.846542492595
12981,1000328,2,204,139,65,0.681373,0.318627,1.439267,64,1,206,140,66,0.679612,0.320388,1.438774,64,2,-1, merged,1,1,1.08931711146
12982,1000327,1,191,145,46,0.759162,0.240838,0.759162,37,9,192,146,46,0.760417,0.239583,0.760417,37,9,1, merged,0,0,0.848219263811
12982,1000328,2,206,140,66,0.679612,0.320388,1.438774,64,2,207,141,66,0.681159,0.318841,1.441576,64,2,1, merged,0,0,1.09635408499
12984,1000120,1,76,65,11,0.855263,0.144737,0.855263,10,1,77,66,11,0.857143,0.142857,0.857143,10,1,1, merged,0,0,0.249722222222
12984,1000124,2,171,166,5,0.97076,0.02924,1.826023,5,0,172,167,5,0.97093,0.02907,1.828073,5,0,1, merged,0,0,0.313589382194
13003,1000121,2,383,325,58,0.848564,0.151436,1.573672,55,3,384,326,58,0.848958,0.151042,1.57466,55,3,1, merged,0,0,0.0327513228929
13003,1000329,1,462,335,127,0.725108,0.274892,0.725108,120,7,463,336,127,0.725702,0.274298,0.725702,120,7,1, merged,0,0,0.0267527618848
13013,1000329,1,463,336,127,0.725702,0.274298,0.725702,120,7,466,339,127,0.727468,0.272532,0.727468,120,7,-1, abandoned,0,0,0.122542982517
13014,1000329,2,466,339,127,0.727468,0.272532,1.449876,120,7,467,340,127,0.728051,0.271949,1.451385,120,7,1, merged,0,0,0.369611912043
13015,1000070,1,319,291,28,0.912226,0.087774,0.912226,21,7,320,292,28,0.9125,0.0875,0.9125,21,7,1, merged,0,0,0.71072541166
13016,1000329,1,467,340,127,0.728051,0.271949,0.728051,120,7,470,342,128,0.72766,0.27234,0.72766,121,7,-1, abandoned,1,0,1.02389564078
13023,1000004,2,595,510,85,0.857143,0.142857,1.715494,74,11,596,511,85,0.857383,0.142617,1.716032,74,11,1, merged,0,0,0.042249033579
13023,1000014,1,473,406,67,0.858351,0.141649,0.858351,63,4,474,407,67,0.85865,0.14135,0.85865,63,4,1, merged,0,0,0.0667031810291
13026,1000063,3,1282,1156,126,0.901716,0.098284,2.077197,109,17,1283,1157,126,0.901793,0.098207,2.094587,109,17,1, merged,0,0,0.0309575793481
13036,1000063,2,1284,1158,126,0.901869,0.098131,1.187583,109,17,1286,1160,126,0.902022,0.097978,1.192344,109,17,-1, merged,0,0,0.218982494802
13043,1000063,3,1288,1162,126,0.902174,0.097826,2.099985,109,17,1289,1163,126,0.90225,0.09775,2.113175,109,17,1, merged,0,0,0.12421748356
13047,1000063,2,1291,1164,127,0.901627,0.098373,1.829163,110,17,1292,1165,127,0.901703,0.098297,1.82976,110,17,1, merged,0,0,0.42105512795
13048,1000063,2,1292,1165,127,0.901703,0.098297,1.82976,110,17,1293,1166,127,0.901779,0.098221,1.83035,110,17,1, merged,0,0,0.419979305302
13059,1000124,2,173,168,5,0.971098,0.028902,1.785913,5,0,174,169,5,0.971264,0.028736,1.788338,5,0,1, merged,0,0,0.262476525822
13059,1000166,1,81,66,15,0.814815,0.185185,0.814815,14,1,82,67,15,0.817073,0.182927,0.817073,14,1,1, merged,0,0,1.54526315789
13060,1000327,1,192,146,46,0.760417,0.239583,0.760417,37,9,197,151,46,0.766497,0.233503,0.766497,37,9,-1, merged,0,0,0.00118184175621
13063,1000327,2,197,151,46,0.766497,0.233503,1.266497,37,9,198,152,46,0.767677,0.232323,1.257873,37,9,-1, abandoned,0,0,0.0234434875524
13072,1000014,1,480,413,67,0.860417,0.139583,0.860417,63,4,481,414,67,0.860707,0.139293,0.860707,63,4,1, merged,0,0,0.0247170617126
13072,1000015,2,734,674,60,0.918256,0.081744,1.778673,55,5,735,675,60,0.918367,0.081633,1.779074,55,5,1, merged,0,0,0.10709380022
13085,1000015,1,735,675,60,0.918367,0.081633,0.918367,55,5,737,676,61,0.917232,0.082768,0.917232,56,5,1, merged,1,1,0.182830432809
13085,1000026,2,161,145,16,0.900621,0.099379,1.818988,14,2,163,147,16,0.90184,0.09816,1.819073,14,2,-1, merged,0,0,0.107587136224
13090,1000130,2,112,92,20,0.821429,0.178571,1.607753,17,3,113,93,20,0.823009,0.176991,1.611144,17,3,1, merged,0,0,0.0584118827255
13091,1000130,1,113,93,20,0.823009,0.176991,0.823009,17,3,115,95,20,0.826087,0.173913,0.826087,17,3,-1, merged,0,0,0.018734454693
13094,1000003,2,451,379,72,0.840355,0.159645,1.609105,66,6,452,380,72,0.840708,0.159292,1.612313,66,6,1, merged,0,0,0.329352100756
13098,1000004,2,598,513,85,0.85786,0.14214,1.775204,74,11,599,514,85,0.858097,0.141903,1.774313,74,11,-1, merged,0,0,0
13098,1000015,1,738,677,61,0.917344,0.082656,0.917344,56,5,740,678,62,0.916216,0.083784,0.916216,57,5,1, merged,1,1,0.547154107952
13103,1000005,1,84,62,22,0.738095,0.261905,0.738095,21,1,85,63,22,0.741176,0.258824,0.741176,21,1,1, merged,0,0,0.185887250719
13128,1000015,2,743,681,62,0.916555,0.083445,1.738777,57,5,744,682,62,0.916667,0.083333,1.740196,57,5,1, merged,0,0,0.471610465674
13130,1000327,1,198,152,46,0.767677,0.232323,0.767677,37,9,199,153,46,0.768844,0.231156,0.768844,37,9,1, merged,0,0,0.0127118644068
13135,1000007,1,371,321,50,0.865229,0.134771,0.865229,43,7,373,322,51,0.863271,0.136729,0.863271,43,8,-1, merged,1,0,1.50886203424
13135,1000009,2,320,263,57,0.821875,0.178125,1.687104,50,7,321,264,57,0.82243,0.17757,1.685701,50,7,1, merged,0,0,1.02765491134
13140,1000015,2,744,682,62,0.916667,0.083333,1.685511,57,5,745,683,62,0.916779,0.083221,1.686779,57,5,1, merged,0,0,0.547951345147
13140,1000327,1,199,153,46,0.768844,0.231156,0.768844,37,9,200,154,46,0.77,0.23,0.77,37,9,1, merged,0,0,0.814348702444
13147,1000327,1,200,154,46,0.77,0.23,0.77,37,9,201,154,47,0.766169,0.233831,0.766169,38,9,1, merged,1,1,0.773560354374
13148,1000327,1,201,154,47,0.766169,0.233831,0.766169,38,9,204,156,48,0.764706,0.235294,0.764706,39,9,1, merged,1,1,0.822132548901
13149,1000327,1,204,156,48,0.764706,0.235294,0.764706,39,9,205,156,49,0.760976,0.239024,0.760976,40,9,1, merged,1,1,0.278205727359
13150,1000121,1,386,328,58,0.849741,0.150259,0.849741,55,3,387,329,58,0.850129,0.149871,0.850129,55,3,-1, abandoned,0,0,0.0767659301347
13152,1000091,4,111,81,30,0.72973,0.27027,3.001151,28,2,112,82,30,0.732143,0.267857,3.012436,28,2,1, merged,0,0,0.0510106026624
13152,1000329,2,477,347,130,0.727463,0.272537,1.452629,122,8,480,350,130,0.729167,0.270833,1.457925,122,8,-1, merged,0,0,0.0201840244282
13164,1000121,2,388,330,58,0.850515,0.149485,1.611491,55,3,391,332,59,0.849105,0.150895,1.607559,56,3,-1, merged,1,0,0.0550610514335
13164,1000327,1,205,156,49,0.760976,0.239024,0.760976,40,9,207,157,50,0.758454,0.241546,0.758454,41,9,-1, merged,1,0,0
13164,1000329,3,480,350,130,0.729167,0.270833,2.340658,122,8,484,353,131,0.729339,0.270661,2.336898,123,8,-1, merged,1,0,0.0688966485275
13165,1000327,1,207,157,50,0.758454,0.241546,0.758454,41,9,209,158,51,0.755981,0.244019,0.755981,42,9,-1, merged,1,0,0
13165,1000329,2,484,353,131,0.729339,0.270661,1.487793,123,8,488,354,134,0.72541,0.27459,1.481391,126,8,1, merged,1,1,0.115090621056
13166,1000327,1,209,158,51,0.755981,0.244019,0.755981,42,9,211,160,51,0.758294,0.241706,0.758294,42,9,-1, merged,0,0,0
13166,1000329,2,488,354,134,0.72541,0.27459,1.481391,126,8,494,358,136,0.724696,0.275304,1.48299,128,8,-1, merged,1,0,0.116391219037
13167,1000329,1,494,358,136,0.724696,0.275304,0.724696,128,8,495,359,136,0.725253,0.274747,0.725253,128,8,-1, abandoned,0,0,0.0875519574653
13169,1000327,1,211,160,51,0.758294,0.241706,0.758294,42,9,213,161,52,0.755869,0.244131,0.755869,43,9,-1, merged,1,0,0
13169,1000329,2,496,360,136,0.725806,0.274194,1.4841,128,8,500,362,138,0.724,0.276,1.479869,130,8,-1, merged,1,0,0.117570669332
13170,1000070,2,323,295,28,0.913313,0.086687,1.669181,21,7,324,296,28,0.91358,0.08642,1.67059,21,7,1, merged,0,0,0.704290120057
13170,1000327,1,213,161,52,0.755869,0.244131,0.755869,43,9,214,162,52,0.757009,0.242991,0.757009,43,9,1, merged,0,0,0.594190871369
13172,1000004,3,600,515,85,0.858333,0.141667,2.396365,74,11,601,516,85,0.858569,0.141431,2.394666,74,11,-1, abandoned,0,0,0.216675886953
13172,1000327,1,214,162,52,0.757009,0.242991,0.757009,43,9,215,162,53,0.753488,0.246512,0.753488,44,9,1, abandoned,1,1,0
13172,1000329,4,500,362,138,0.724,0.276,3.120365,130,8,501,362,139,0.722555,0.277445,3.117221,131,8,1, abandoned,1,1,0.481452127785
13173,1000327,1,215,162,53,0.753488,0.246512,0.753488,44,9,216,163,53,0.75463,0.24537,0.75463,44,9,1, merged,0,0,0.833274117937
13174,1000327,2,216,163,53,0.75463,0.24537,1.538802,44,9,217,164,53,0.75576,0.24424,1.541475,44,9,1, merged,0,0,0.834740707877
13175,1000327,1,217,164,53,0.75576,0.24424,0.75576,44,9,218,165,53,0.756881,0.243119,0.756881,44,9,1, merged,0,0,0.836204264539
13176,1000327,1,218,165,53,0.756881,0.243119,0.756881,44,9,219,166,53,0.757991,0.242009,0.757991,44,9,1, merged,0,0,0.39007172988
13177,1000105,2,173,139,34,0.803468,0.196532,1.561459,31,3,174,140,34,0.804598,0.195402,1.563689,31,3,1, merged,0,0,0.317136280173
13177,1000327,1,219,166,53,0.757991,0.242009,0.757991,44,9,220,167,53,0.759091,0.240909,0.759091,44,9,1, merged,0,0,0.33509578595
13178,1000105,2,174,140,34,0.804598,0.195402,1.563689,31,3,175,141,34,0.805714,0.194286,1.565895,31,3,1, merged,0,0,0.299306451993
13178,1000327,1,220,167,53,0.759091,0.240909,0.759091,44,9,221,168,53,0.760181,0.239819,0.760181,44,9,1, merged,0,0,0.316786672051
13179,1000327,1,221,168,53,0.760181,0.239819,0.760181,44,9,222,169,53,0.761261,0.238739,0.761261,44,9,1, merged,0,0,0.630355920602
13183,1000063,2,1295,1168,127,0.901931,0.098069,1.204961,110,17,1300,1172,128,0.901538,0.098462,1.191012,111,17,-1, merged,1,0,0.496039315555
13189,1000063,3,1300,1172,128,0.901538,0.098462,2.096995,111,17,1302,1174,128,0.90169,0.09831,2.104232,111,17,-1, merged,0,0,0.220672717796
13202,1000063,2,1304,1176,128,0.90184,0.09816,1.20184,111,17,1307,1179,128,0.902066,0.097934,1.204391,111,17,-1, merged,0,0,0.220694665494
13226,1000003,4,460,386,74,0.83913,0.16087,3.125642,68,6,465,391,74,0.84086,0.15914,3.146019,68,6,-1, merged,0,0,0.0146555801037
13226,1000329,2,501,362,139,0.722555,0.277445,1.502727,131,8,502,363,139,0.723108,0.276892,1.505159,131,8,-1, merged,0,0,0.0407592090872
13234,1000004,1,601,516,85,0.858569,0.141431,0.858569,74,11,602,517,85,0.858804,0.141196,0.858804,74,11,-1, merged,0,0,0.00088599465327
13234,1000153,2,410,378,32,0.921951,0.078049,1.78052,25,7,412,380,32,0.92233,0.07767,1.781134,25,7,-1, merged,0,0,0.000251235608503
13243,1000118,1,411,367,44,0.892944,0.107056,0.892944,43,1,412,368,44,0.893204,0.106796,0.893204,43,1,1, merged,0,0,0.174840857118
13250,1000327,2,222,169,53,0.761261,0.238739,1.6637,44,9,223,170,53,0.762332,0.237668,1.665558,44,9,1, merged,0,0,0.292816752137
13253,1000124,2,174,169,5,0.971264,0.028736,1.788338,5,0,175,170,5,0.971429,0.028571,1.790706,5,0,1, merged,0,0,0.263792091986
13253,1000166,1,82,67,15,0.817073,0.182927,0.817073,14,1,83,68,15,0.819277,0.180723,0.819277,14,1,1, merged,0,0,1.55170603675
13254,1000043,1,116,94,22,0.810345,0.189655,0.810345,20,2,118,95,23,0.805085,0.194915,0.805085,20,3,-1, merged,1,0,0.157087011115
13260,1000003,2,468,393,75,0.839744,0.160256,1.756745,69,6,469,394,75,0.840085,0.159915,1.757198,69,6,1, merged,0,0,0.193848982798
13260,1000015,1,747,685,62,0.917001,0.082999,0.917001,57,5,748,686,62,0.917112,0.082888,0.917112,57,5,1, merged,0,0,0.218116152288
13261,1000124,2,175,170,5,0.971429,0.028571,1.790706,5,0,176,171,5,0.971591,0.028409,1.793019,5,0,1, merged,0,0,0.265106732348
13261,1000166,1,83,68,15,0.819277,0.180723,0.819277,14,1,84,69,15,0.821429,0.178571,0.821429,14,1,1, merged,0,0,1.55811518325
13272,1000009,2,321,264,57,0.82243,0.17757,1.731521,50,7,322,265,57,0.822981,0.177019,1.736025,50,7,1, merged,0,0,0.260122315979
13273,1000004,2,602,517,85,0.858804,0.141196,1.683622,74,11,604,517,87,0.85596,0.14404,1.682047,74,13,-1, merged,1,1,0.0198843323625
13274,1000003,1,469,394,75,0.840085,0.159915,0.840085,69,6,470,395,75,0.840426,0.159574,0.840426,69,6,-1, merged,0,0,0.0576918990362
13282,1000004,1,605,518,87,0.856198,0.143802,0.856198,74,13,606,518,88,0.854785,0.145215,0.854785,74,14,-1, merged,1,1,0.44675058548
13282,1000328,3,211,145,66,0.687204,0.312796,2.26651,64,2,212,146,66,0.688679,0.311321,2.267123,64,2,1, merged,0,0,1.17062991337
13282,1000329,2,502,363,139,0.723108,0.276892,1.579306,131,8,503,364,139,0.723658,0.276342,1.578444,131,8,1, merged,0,0,1.02713982853
13284,1000109,2,216,174,42,0.805556,0.194444,1.430556,41,1,217,175,42,0.806452,0.193548,1.399044,41,1,1, merged,0,0,0.278792994284
13285,1000199,2,104,84,20,0.807692,0.192308,1.400285,20,0,105,85,20,0.809524,0.190476,1.395731,20,0,1, merged,0,0,0.312357631915
13287,1000199,2,105,85,20,0.809524,0.190476,1.395731,20,0,106,86,20,0.811321,0.188679,1.391966,20,0,1, merged,0,0,0.72830663005
13288,1000199,2,106,86,20,0.811321,0.188679,1.391966,20,0,107,86,21,0.803738,0.196262,1.379496,20,1,-1, merged,1,1,1.46512219959
13293,1000121,1,391,332,59,0.849105,0.150895,0.849105,56,3,392,333,59,0.84949,0.15051,0.84949,56,3,1, merged,0,0,0.155435304999
13296,1000004,1,606,518,88,0.854785,0.145215,0.854785,74,14,609,520,89,0.853859,0.146141,0.853859,75,14,-1, merged,1,0,0.0987436106854
13296,1000015,3,748,686,62,0.917112,0.082888,2.629041,57,5,749,687,62,0.917223,0.082777,2.621082,57,5,1, merged,0,0,0.232723643805
13296,1000120,2,77,66,11,0.857143,0.142857,1.711928,10,1,80,68,12,0.85,0.15,1.703859,11,1,-1, merged,1,0,0.0796988730832
13301,1000124,2,176,171,5,0.971591,0.028409,1.793019,5,0,177,172,5,0.971751,0.028249,1.795281,5,0,1, merged,0,0,0.085065214279
13301,1000166,1,84,69,15,0.821429,0.178571,0.821429,14,1,85,70,15,0.823529,0.176471,0.823529,14,1,1, merged,0,0,0.488874437678
13305,1000121,2,392,333,59,0.84949,0.15051,1.573148,56,3,393,334,59,0.849873,0.150127,1.572095,56,3,-1, abandoned,0,0,0.0218969270404
13305,1000329,1,503,364,139,0.723658,0.276342,0.723658,131,8,504,364,140,0.722222,0.277778,0.722222,132,8,1, abandoned,1,1,0.0120555957781
13307,1000004,2,609,520,89,0.853859,0.146141,1.616191,75,14,611,521,90,0.8527,0.1473,1.611629,76,14,1, merged,1,1,0
13307,1000327,1,223,170,53,0.762332,0.237668,0.762332,44,9,224,170,54,0.758929,0.241071,0.758929,45,9,1, merged,1,1,0
13312,1000091,3,113,83,30,0.734513,0.265487,2.257164,28,2,114,84,30,0.736842,0.263158,2.261621,28,2,-1, merged,0,0,0.00356432895213
13324,1000329,3,504,364,140,0.722222,0.277778,2.079365,132,8,505,365,140,0.722772,0.277228,2.264439,132,8,1, merged,0,0,0.0679679346895
13328,1000063,2,1315,1186,129,0.901901,0.098099,1.204227,112,17,1316,1187,129,0.901976,0.098024,1.220158,112,17,1, merged,0,0,0.204190570444
13329,1000063,2,1316,1187,129,0.901976,0.098024,1.220158,112,17,1318,1189,129,0.902124,0.097876,1.221273,112,17,-1, merged,0,0,0.220694078844
13330,1000063,2,1318,1189,129,0.902124,0.097876,1.221273,112,17,1321,1191,130,0.90159,0.09841,1.22159,113,17,-1, merged,1,0,0.220851902268
13331,1000063,2,1321,1191,130,0.90159,0.09841,1.22159,113,17,1322,1192,130,0.901664,0.098336,1.234997,113,17,1, merged,0,0,0.223275299521
13332,1000063,2,1322,1192,130,0.901664,0.098336,1.234997,113,17,1323,1193,130,0.901738,0.098262,1.247892,113,17,1, merged,0,0,0.221356585198
13333,1000063,2,1323,1193,130,0.901738,0.098262,1.247892,113,17,1324,1194,130,0.901813,0.098187,1.260303,113,17,1, merged,0,0,0.496167355107
13334,1000063,2,1324,1194,130,0.901813,0.098187,1.260303,113,17,1325,1195,130,0.901887,0.098113,1.272257,113,17,1, merged,0,0,0.496527059771
13368,1000070,3,324,296,28,0.91358,0.08642,2.547509,21,7,325,297,28,0.913846,0.086154,2.562735,21,7,1, merged,0,0,0.141336670358
13368,1000327,2,224,170,54,0.758929,0.241071,1.633929,45,9,225,171,54,0.76,0.24,1.648889,45,9,1, merged,0,0,0.118923327896
13369,1000124,2,177,172,5,0.971751,0.028249,1.795281,5,0,178,173,5,0.97191,0.02809,1.797492,5,0,1, merged,0,0,0.125184936501
13369,1000166,1,85,70,15,0.823529,0.176471,0.823529,14,1,86,71,15,0.825581,0.174419,0.825581,14,1,1, merged,0,0,0.722683159279
13390,1000329,1,505,365,140,0.722772,0.277228,0.722772,132,8,507,367,140,0.723866,0.276134,0.723866,132,8,-1, merged,0,0,1.01891572956
13396,1000003,1,470,395,75,0.840426,0.159574,0.840426,69,6,476,399,77,0.838235,0.161765,0.838235,71,6,-1, merged,1,0,0.0338436833788
13397,1000070,1,325,297,28,0.913846,0.086154,0.913846,21,7,327,299,28,0.914373,0.085627,0.914373,21,7,-1, merged,0,0,0.0599448621664
13397,1000121,2,393,334,59,0.849873,0.150127,1.763719,56,3,394,335,59,0.850254,0.149746,1.764627,56,3,1, merged,0,0,0.0483250186756
13411,1000014,3,483,416,67,0.861284,0.138716,2.534701,63,4,485,417,68,0.859794,0.140206,2.52627,64,4,1, merged,1,1,0.000235368394773
13411,1000121,2,395,336,59,0.850633,0.149367,1.673418,56,3,397,337,60,0.848866,0.151134,1.666477,57,3,1, merged,1,1,0.000302053043092
13412,1000012,1,285,259,26,0.908772,0.091228,0.908772,25,1,286,259,27,0.905594,0.094406,0.905594,26,1,1, merged,1,1,0
13412,1000120,2,80,68,12,0.85,0.15,1.758772,11,1,81,69,12,0.851852,0.148148,1.757446,11,1,1, merged,0,0,0
13417,1000003,1,476,399,77,0.838235,0.161765,0.838235,71,6,479,400,79,0.835073,0.164927,0.835073,73,6,1, merged,1,1,0.0342506940589
13420,1000109,2,220,178,42,0.809091,0.190909,1.384848,41,1,221,179,42,0.809955,0.190045,1.39819,41,1,1, merged,0,0,0.415319420913
13422,1000005,1,86,64,22,0.744186,0.255814,0.744186,21,1,87,64,23,0.735632,0.264368,0.735632,22,1,1, abandoned,1,1,0.00790254667355
13425,1000009,3,323,266,57,0.823529,0.176471,2.68394,50,7,324,267,57,0.824074,0.175926,2.685028,50,7,-1, abandoned,0,0,0.0165413364603
13425,1000011,2,262,247,15,0.942748,0.057252,1.860411,13,2,264,249,15,0.943182,0.056818,1.860954,13,2,-1, abandoned,0,0,0.0227750179095
13425,1000015,1,753,691,62,0.917663,0.082337,0.917663,57,5,754,692,62,0.917772,0.082228,0.917772,57,5,-1, abandoned,0,0,0.0172545095823
13431,1000121,1,398,338,60,0.849246,0.150754,0.849246,57,3,399,339,60,0.849624,0.150376,0.849624,57,3,1, merged,0,0,0.0872136134704
13433,1000003,3,479,400,79,0.835073,0.164927,2.357403,73,6,482,403,79,0.8361,0.1639,2.30023,73,6,-1, merged,0,0,0.169235171874
13433,1000121,4,399,339,60,0.849624,0.150376,3.207027,57,3,400,339,61,0.8475,0.1525,3.14773,58,3,1, merged,1,1,0.199990163431
13433,1000329,2,515,372,143,0.72233,0.27767,1.52233,135,8,520,377,143,0.725,0.275,1.46413,135,8,-1, merged,0,0,0.320051688293
13438,1000015,1,755,693,62,0.917881,0.082119,0.917881,57,5,756,694,62,0.917989,0.082011,0.917989,57,5,-1, merged,0,0,1.02111290019
13438,1000153,2,415,383,32,0.922892,0.077108,1.840772,25,7,416,384,32,0.923077,0.076923,1.841066,25,7,1, merged,0,0,1.01327802375
13442,1000153,1,416,384,32,0.923077,0.076923,0.923077,25,7,418,385,33,0.921053,0.078947,0.921053,26,7,1, merged,1,1,0.0045486851457
13449,1000327,3,225,171,54,0.76,0.24,2.279681,45,9,226,172,54,0.761062,0.238938,2.282682,45,9,1, merged,0,0,0.422670650525
13449,1000329,1,523,380,143,0.726577,0.273423,0.726577,135,8,524,381,143,0.727099,0.272901,0.727099,135,8,1, merged,0,0,0.509210723435
13450,1000121,2,400,339,61,0.8475,0.1525,1.608562,58,3,401,340,61,0.84788,0.15212,1.609995,58,3,1, merged,0,0,0.0643895815448
13450,1000327,1,226,172,54,0.761062,0.238938,0.761062,45,9,227,173,54,0.762115,0.237885,0.762115,45,9,-1, merged,0,0,0.0391992973871
13451,1000121,3,401,340,61,0.84788,0.15212,2.480684,58,3,402,340,62,0.845771,0.154229,2.478478,59,3,1, merged,1,1,0.265525181913
13451,1000327,1,227,173,54,0.762115,0.237885,0.762115,45,9,229,174,55,0.759825,0.240175,0.759825,46,9,1, merged,1,1,0.318339050513
13453,1000327,1,229,174,55,0.759825,0.240175,0.759825,46,9,231,176,55,0.761905,0.238095,0.761905,46,9,-1, merged,0,0,0.319939204248
13454,1000063,1,1330,1200,130,0.902256,0.097744,0.902256,113,17,1332,1201,131,0.901652,0.098348,0.901652,113,18,-1, merged,1,1,6.25293106144e-05
13458,1000063,1,1333,1202,131,0.901725,0.098275,0.901725,113,18,1335,1204,131,0.901873,0.098127,0.901873,113,18,1, merged,0,0,0.00295259721311
13460,1000063,1,1335,1204,131,0.901873,0.098127,0.901873,113,18,1336,1205,131,0.901946,0.098054,0.901946,113,18,1, merged,0,0,0.00397562599396
13461,1000327,1,231,176,55,0.761905,0.238095,0.761905,46,9,232,177,55,0.762931,0.237069,0.762931,46,9,-1, abandoned,0,0,0
13475,1000118,1,420,374,46,0.890476,0.109524,0.890476,45,1,421,375,46,0.890736,0.109264,0.890736,45,1,1, merged,0,0,0.0318651134682
13479,1000063,2,1337,1206,131,0.902019,0.097981,1.27239,113,18,1339,1208,131,0.902166,0.097834,1.277166,113,18,-1, merged,0,0,0.0778960202958
13497,1000063,1,1339,1208,131,0.902166,0.097834,0.902166,113,18,1342,1210,132,0.901639,0.098361,0.901639,114,18,-1, abandoned,1,0,0.194666339035
13505,1000327,1,232,177,55,0.762931,0.237069,0.762931,46,9,233,178,55,0.763948,0.236052,0.763948,46,9,1, merged,0,0,0.0146956553567
13506,1000327,1,233,178,55,0.763948,0.236052,0.763948,46,9,234,179,55,0.764957,0.235043,0.764957,46,9,1, merged,0,0,0.040594382755
13514,1000043,2,120,97,23,0.808333,0.191667,1.604252,20,3,121,98,23,0.809917,0.190083,1.607215,20,3,1, merged,0,0,0.117394951989
13517,1000007,1,380,327,53,0.860526,0.139474,0.860526,45,8,381,328,53,0.860892,0.139108,0.860892,45,8,-1, merged,0,0,0
13541,1000124,1,179,174,5,0.972067,0.027933,0.972067,5,0,180,175,5,0.972222,0.027778,0.972222,5,0,1, merged,0,0,0.0318198223769
13541,1000329,2,524,381,143,0.727099,0.272901,1.699166,135,8,525,382,143,0.727619,0.272381,1.699841,135,8,1, merged,0,0,0.0626660137241
13542,1000121,1,402,340,62,0.845771,0.154229,0.845771,59,3,404,341,63,0.844059,0.155941,0.844059,60,3,1, merged,1,1,0.00613830575199
13542,1000329,4,525,382,143,0.727619,0.272381,3.047506,135,8,528,385,143,0.729167,0.270833,3.038435,135,8,-1, merged,0,0,0.00897306572467
13559,1000327,1,235,180,55,0.765957,0.234043,0.765957,46,9,236,181,55,0.766949,0.233051,0.766949,46,9,1, merged,0,0,0.788828903654
13559,1000329,3,528,385,143,0.729167,0.270833,2.179335,135,8,529,386,143,0.729679,0.270321,2.196628,135,8,1, merged,0,0,0.935191197691
13562,1000130,1,118,98,20,0.830508,0.169492,0.830508,17,3,119,99,20,0.831933,0.168067,0.831933,17,3,1, merged,0,0,0.0535744749766
13570,1000130,1,119,99,20,0.831933,0.168067,0.831933,17,3,120,100,20,0.833333,0.166667,0.833333,17,3,1, merged,0,0,0.0454381808435
13575,1000091,2,114,84,30,0.736842,0.263158,1.508901,28,2,115,85,30,0.73913,0.26087,1.512853,28,2,1, merged,0,0,0.409842105263
13576,1000132,2,96,80,16,0.833333,0.166667,1.333333,14,2,97,81,16,0.835052,0.164948,1.435052,14,2,1, merged,0,0,1.44468438538
13582,1000328,2,213,147,66,0.690141,0.309859,1.419819,64,2,214,148,66,0.691589,0.308411,1.420402,64,2,1, merged,0,0,0.482946561224
13582,1000329,1,529,386,143,0.729679,0.270321,0.729679,135,8,531,387,144,0.728814,0.271186,0.728814,136,8,1, merged,1,1,0.464941750926
13595,1000005,2,87,64,23,0.735632,0.264368,1.690178,22,1,89,65,24,0.730337,0.269663,1.665821,23,1,1, merged,1,1,0.0879878765386
13596,1000005,2,89,65,24,0.730337,0.269663,1.665821,23,1,91,66,25,0.725275,0.274725,1.641064,24,1,1, merged,1,1,0.149989571436
13597,1000121,1,405,342,63,0.844444,0.155556,0.844444,60,3,407,342,65,0.840295,0.159705,0.840295,62,3,1, merged,1,1,0.0265371649047
13597,1000329,3,531,387,144,0.728814,0.271186,2.419412,136,8,532,388,144,0.729323,0.270677,2.369618,136,8,1, merged,0,0,0.0162181984773
13601,1000004,2,611,521,90,0.8527,0.1473,1.712494,76,14,612,522,90,0.852941,0.147059,1.713023,76,14,1, merged,0,0,0.129377514057
13601,1000014,1,485,417,68,0.859794,0.140206,0.859794,64,4,486,418,68,0.860082,0.139918,0.860082,64,4,1, merged,0,0,0.214122618864
13602,1000004,2,612,522,90,0.852941,0.147059,1.713023,76,14,613,523,90,0.853181,0.146819,1.713551,76,14,1, merged,0,0,0.0378439602905
13602,1000014,1,486,418,68,0.860082,0.139918,0.860082,64,4,487,419,68,0.86037,0.13963,0.86037,64,4,1, merged,0,0,0.00672153635117
13610,1000007,1,381,328,53,0.860892,0.139108,0.860892,45,8,384,329,55,0.856771,0.143229,0.856771,47,8,1, merged,1,1,0.00515699568375
13610,1000153,2,419,386,33,0.921241,0.078759,1.782133,26,7,422,387,35,0.917062,0.082938,1.773832,28,7,-1, merged,1,0,0.00401602542306
13620,1000121,2,407,342,65,0.840295,0.159705,1.749386,62,3,408,343,65,0.840686,0.159314,1.746936,62,3,1, merged,0,0,0.0415105231282
13628,1000118,1,431,384,47,0.890951,0.109049,0.890951,46,1,432,385,47,0.891204,0.108796,0.891204,46,1,1, merged,0,0,0.0538703133064
13630,1000063,1,1344,1212,132,0.901786,0.098214,0.901786,114,18,1346,1214,132,0.901932,0.098068,0.901932,114,18,-1, merged,0,0,0.000343167127708
13631,1000130,2,123,103,20,0.837398,0.162602,1.626016,17,3,124,104,20,0.83871,0.16129,1.629032,17,3,1, merged,0,0,0.987839305103
13635,1000043,2,122,99,23,0.811475,0.188525,1.650185,20,3,124,100,24,0.806452,0.193548,1.646452,21,3,1, merged,1,1,0.309915653949
13635,1000130,1,124,104,20,0.83871,0.16129,0.83871,17,3,125,105,20,0.84,0.16,0.84,17,3,-1, merged,0,0,0.258417679786
13637,1000004,3,613,523,90,0.853181,0.146819,2.470041,76,14,614,524,90,0.85342,0.14658,2.471474,76,14,1, merged,0,0,0.0454636290967
13637,1000121,1,408,343,65,0.840686,0.159314,0.840686,62,3,409,344,65,0.841076,0.158924,0.841076,62,3,1, merged,0,0,0.0116160813602
13643,1000327,2,238,183,55,0.768908,0.231092,1.457796,46,9,240,183,57,0.7625,0.2375,1.436413,48,9,1, merged,1,1,0.0471480969354
13644,1000004,1,614,524,90,0.85342,0.14658,0.85342,76,14,615,524,91,0.852033,0.147967,0.852033,77,14,1, merged,1,1,0.368691308691
13647,1000327,1,240,183,57,0.7625,0.2375,0.7625,48,9,242,184,58,0.760331,0.239669,0.760331,49,9,1, merged,1,1,0.0116684062
13655,1000121,1,410,345,65,0.841463,0.158537,0.841463,62,3,412,346,66,0.839806,0.160194,0.839806,63,3,1, merged,1,1,0.0706822505983
13655,1000327,2,242,184,58,0.760331,0.239669,1.601794,49,9,244,185,59,0.758197,0.241803,1.598003,50,9,1, merged,1,1,0.0568359750108
13659,1000043,1,126,102,24,0.809524,0.190476,0.809524,21,3,127,103,24,0.811024,0.188976,0.811024,21,3,1, merged,0,0,0.0781967275648
13659,1000121,2,412,346,66,0.839806,0.160194,1.64933,63,3,413,347,66,0.840194,0.159806,1.651217,63,3,1, merged,0,0,0.139108042854
13663,1000015,2,758,696,62,0.918206,0.081794,0.918206,57,5,759,697,62,0.918314,0.081686,1.918314,57,5,1, merged,0,0,0.277066585971
13669,1000121,2,413,347,66,0.840194,0.159806,1.571035,63,3,414,348,66,0.84058,0.15942,1.571923,63,3,1, merged,0,0,0.0172053887732
13669,1000329,1,535,391,144,0.730841,0.269159,0.730841,136,8,536,392,144,0.731343,0.268657,0.731343,136,8,-1, merged,0,0,0.021467960172
13676,1000007,1,387,332,55,0.857881,0.142119,0.857881,47,8,388,333,55,0.858247,0.141753,0.858247,47,8,1, merged,0,0,1.43766510439
13676,1000009,2,326,269,57,0.825153,0.174847,1.683035,50,7,327,270,57,0.825688,0.174312,1.683935,50,7,1, merged,0,0,1.04624991285
13686,1000063,1,1347,1215,132,0.902004,0.097996,0.902004,114,18,1348,1215,133,0.901335,0.098665,0.901335,114,19,-1, merged,1,1,0.00660667588403
13688,1000329,1,536,392,144,0.731343,0.268657,0.731343,136,8,537,393,144,0.731844,0.268156,0.731844,136,8,1, merged,0,0,0
13696,1000015,2,765,703,62,0.918954,0.081046,1.646227,57,5,766,704,62,0.91906,0.08094,1.65819,57,5,1, merged,0,0,0.550660691531
13697,1000327,1,245,186,59,0.759184,0.240816,0.759184,50,9,246,187,59,0.760163,0.239837,0.760163,50,9,-1, abandoned,0,0,0.635434305425
13698,1000121,2,414,348,66,0.84058,0.15942,1.633683,63,3,415,349,66,0.840964,0.159036,1.640964,63,3,1, merged,0,0,0.267295288408
13698,1000329,4,539,395,144,0.732839,0.267161,3.214522,136,8,540,396,144,0.733333,0.266667,3.223504,136,8,1, merged,0,0,0.351672015731
13699,1000327,2,246,187,59,0.760163,0.239837,1.426829,50,9,247,188,59,0.761134,0.238866,1.439705,50,9,1, merged,0,0,0.693621013133
13708,1000118,1,434,387,47,0.891705,0.108295,0.891705,46,1,435,388,47,0.891954,0.108046,0.891954,46,1,1, merged,0,0,0.312220789552
13716,1000327,2,248,189,59,0.762097,0.237903,1.48937,50,9,250,190,60,0.76,0.24,1.51,50,10,-1, merged,1,0,0.354284533218
13717,1000327,2,250,190,60,0.76,0.24,1.426667,50,10,252,191,61,0.757937,0.242063,1.434407,50,11,-1, merged,1,0,0.355712444987
13718,1000121,3,415,349,66,0.840964,0.159036,2.267434,63,3,417,351,66,0.841727,0.158273,2.200701,63,3,-1, merged,0,0,0.0632856366791
13720,1000327,3,252,191,61,0.757937,0.242063,2.362184,50,11,254,192,62,0.755906,0.244094,2.360072,50,12,-1, merged,1,0,0.722104779412
13720,1000329,4,540,396,144,0.733333,0.266667,3.095517,136,8,541,397,144,0.733826,0.266174,3.093898,136,8,1, merged,0,0,0.677360663289
13721,1000063,1,1349,1216,133,0.901408,0.098592,0.901408,114,19,1350,1217,133,0.901481,0.098519,0.901481,114,19,1, merged,0,0,0.00405655073417
13729,1000063,2,1351,1218,133,0.901554,0.098446,1.809404,114,19,1352,1219,133,0.901627,0.098373,1.80979,114,19,1, merged,0,0,3.66965323181e-06
13731,1000004,3,615,524,91,0.852033,0.147967,2.420472,77,14,616,524,92,0.850649,0.149351,2.426829,77,15,-1, merged,1,1,0.0625190318649
13731,1000063,1,1354,1221,133,0.901773,0.098227,0.901773,114,19,1356,1222,134,0.90118,0.09882,0.90118,114,20,-1, merged,1,1,0.0415476365589
13736,1000063,1,1360,1226,134,0.901471,0.098529,0.901471,114,20,1362,1227,135,0.900881,0.099119,0.900881,115,20,1, merged,1,1,1.12187487376e-05
13750,1000063,2,1373,1237,136,0.900947,0.099053,1.753888,116,20,1375,1238,137,0.900364,0.099636,1.757506,117,20,1, merged,1,1,0.000840147004925
13754,1000004,1,616,524,92,0.850649,0.149351,0.850649,77,15,617,525,92,0.850891,0.149109,0.850891,77,15,1, merged,0,0,0.0522016337916
13754,1000063,2,1377,1240,137,0.900508,0.099492,1.751158,117,20,1378,1241,137,0.900581,0.099419,1.751472,117,20,1, merged,0,0,0.00159555532954
13779,1000005,1,91,66,25,0.725275,0.274725,0.725275,24,1,92,67,25,0.728261,0.271739,0.728261,24,1,1, merged,0,0,0.0811001277624
13779,1000091,2,115,85,30,0.73913,0.26087,1.464405,28,2,116,86,30,0.741379,0.258621,1.46964,28,2,1, merged,0,0,0.128004373216
13780,1000005,1,92,67,25,0.728261,0.271739,0.728261,24,1,93,68,25,0.731183,0.268817,0.731183,24,1,1, merged,0,0,0.122817664498
13780,1000091,2,116,86,30,0.741379,0.258621,1.46964,28,2,117,87,30,0.74359,0.25641,1.474773,28,2,1, merged,0,0,0.192459704933
13781,1000005,1,93,68,25,0.731183,0.268817,0.731183,24,1,94,69,25,0.734043,0.265957,0.734043,24,1,1, merged,0,0,0.0708538928132
13781,1000091,2,117,87,30,0.74359,0.25641,1.474773,28,2,118,88,30,0.745763,0.254237,1.479805,28,2,1, merged,0,0,0.110278841878
13782,1000005,1,94,69,25,0.734043,0.265957,0.734043,24,1,95,70,25,0.736842,0.263158,0.736842,24,1,1, merged,0,0,0.127991573233
13782,1000091,2,118,88,30,0.745763,0.254237,1.479805,28,2,119,89,30,0.747899,0.252101,1.484741,28,2,1, merged,0,0,0.194632135001
13783,1000005,1,95,70,25,0.736842,0.263158,0.736842,24,1,96,71,25,0.739583,0.260417,0.739583,24,1,1, merged,0,0,0.103207581388
13783,1000091,2,119,89,30,0.747899,0.252101,1.484741,28,2,120,90,30,0.75,0.25,1.489583,28,2,1, merged,0,0,0.156064419619
13788,1000003,2,488,409,79,0.838115,0.161885,1.588115,73,6,489,410,79,0.838446,0.161554,1.590512,73,6,1, merged,0,0,0.307914445291
13788,1000091,1,120,90,30,0.75,0.25,0.75,28,2,121,91,30,0.752066,0.247934,0.752066,28,2,1, merged,0,0,0.699565595667
13789,1000003,2,489,410,79,0.838446,0.161554,1.590512,73,6,490,411,79,0.838776,0.161224,1.592874,73,6,1, merged,0,0,0.309319883264
13789,1000091,1,121,91,30,0.752066,0.247934,0.752066,28,2,122,92,30,0.754098,0.245902,0.754098,28,2,1, merged,0,0,0.70126334999
13790,1000005,1,100,75,25,0.75,0.25,0.75,24,1,101,76,25,0.752475,0.247525,0.752475,24,1,1, merged,0,0,0.0514520505158
13790,1000091,2,122,92,30,0.754098,0.245902,1.504098,28,2,123,93,30,0.756098,0.243902,1.508573,28,2,1, merged,0,0,0.0778955204902
13791,1000005,1,101,76,25,0.752475,0.247525,0.752475,24,1,102,77,25,0.754902,0.245098,0.754902,24,1,1, merged,0,0,0.104183011132
13791,1000091,2,123,93,30,0.756098,0.243902,1.508573,28,2,124,94,30,0.758065,0.241935,1.512966,28,2,1, merged,0,0,0.156270786107
13792,1000005,1,102,77,25,0.754902,0.245098,0.754902,24,1,103,78,25,0.757282,0.242718,0.757282,24,1,1, merged,0,0,0.131627632072
13792,1000091,2,124,94,30,0.758065,0.241935,1.512966,28,2,125,95,30,0.76,0.24,1.517282,28,2,1, merged,0,0,0.195993239528
13793,1000005,1,103,78,25,0.757282,0.242718,0.757282,24,1,104,79,25,0.759615,0.240385,0.759615,24,1,1, merged,0,0,0.054532906853
13793,1000091,2,125,95,30,0.76,0.24,1.517282,28,2,126,96,30,0.761905,0.238095,1.52152,28,2,1, merged,0,0,0.0792838708359
13794,1000005,1,104,79,25,0.759615,0.240385,0.759615,24,1,105,80,25,0.761905,0.238095,0.761905,24,1,1, merged,0,0,0.0760975107686
13794,1000091,2,126,96,30,0.761905,0.238095,1.52152,28,2,127,97,30,0.76378,0.23622,1.525684,28,2,1, merged,0,0,0.112252325112
13795,1000005,1,105,80,25,0.761905,0.238095,0.761905,24,1,106,81,25,0.764151,0.235849,0.764151,24,1,1, merged,0,0,0.138387826245
13795,1000091,2,127,97,30,0.76378,0.23622,1.525684,28,2,128,98,30,0.765625,0.234375,1.529776,28,2,1, merged,0,0,0.198896358083
13801,1000005,2,106,81,25,0.764151,0.235849,1.538587,24,1,107,82,25,0.766355,0.233645,1.542475,24,1,1, merged,0,0,0.14434916024
13801,1000091,1,133,103,30,0.774436,0.225564,0.774436,28,2,134,104,30,0.776119,0.223881,0.776119,28,2,1, merged,0,0,0.201169969976
13812,1000091,2,138,108,30,0.782609,0.217391,1.529977,28,2,139,109,30,0.784173,0.215827,1.534173,28,2,1, merged,0,0,0.133732114838
13813,1000091,1,139,109,30,0.784173,0.215827,0.784173,28,2,140,109,31,0.778571,0.221429,0.778571,29,2,1, merged,1,1,0.0576623649873
13827,1000327,4,257,194,63,0.754864,0.245136,2.94928,51,12,258,195,63,0.755814,0.244186,2.906549,51,12,1, merged,0,0,0.0863578008083
13829,1000327,1,258,195,63,0.755814,0.244186,0.755814,51,12,260,197,63,0.757692,0.242308,0.757692,51,12,1, merged,0,0,0.0467904063724
13837,1000327,1,260,197,63,0.757692,0.242308,0.757692,51,12,261,197,64,0.754789,0.245211,0.754789,52,12,1, merged,1,1,0.282011108411
13847,1000327,3,261,197,64,0.754789,0.245211,2.318359,52,12,263,198,65,0.752852,0.247148,2.280376,53,12,-1, abandoned,1,0,0.584930793651
13849,1000105,3,182,144,38,0.791209,0.208791,2.362242,35,3,184,146,38,0.793478,0.206522,2.357393,35,3,-1, merged,0,0,0.0695361630506
13849,1000327,2,263,198,65,0.752852,0.247148,1.571034,53,12,264,199,65,0.753788,0.246212,1.563914,53,12,-1, merged,0,0,0.0649815396158
13849,1000592,1,77,63,14,0.818182,0.181818,0.818182,13,1,79,64,15,0.810127,0.189873,0.810127,14,1,1, merged,1,1,0.0535250207354
13850,1000109,2,222,180,42,0.810811,0.189189,1.634885,41,1,224,182,42,0.8125,0.1875,1.629014,41,1,-1, merged,0,0,6.02786558811e-09
13854,1000130,2,127,107,20,0.84252,0.15748,1.629921,17,3,128,108,20,0.84375,0.15625,1.632812,17,3,1, merged,0,0,0
13862,1000026,1,166,150,16,0.903614,0.096386,0.903614,14,2,167,151,16,0.904192,0.095808,0.904192,14,2,1, merged,0,0,0.506848030019
13865,1000120,2,81,69,12,0.851852,0.148148,1.851852,11,1,82,70,12,0.853659,0.146341,1.853659,11,1,1, merged,0,0,0.579343629344
13866,1000327,2,264,199,65,0.753788,0.246212,1.455916,53,12,265,200,65,0.754717,0.245283,1.442217,53,12,-1, abandoned,0,0,0.703539321599
13866,1000329,3,541,397,144,0.733826,0.266174,2.189742,136,8,542,398,144,0.734317,0.265683,2.176534,136,8,-1, abandoned,0,0,1.00835025436
13869,1000015,2,774,712,62,0.919897,0.080103,1.919897,57,5,775,713,62,0.92,0.08,1.92,57,5,1, merged,0,0,0
13870,1000015,2,775,713,62,0.92,0.08,1.92,57,5,776,714,62,0.920103,0.079897,1.920103,57,5,1, merged,0,0,0
13872,1000327,3,265,200,65,0.754717,0.245283,2.242596,53,12,266,201,65,0.755639,0.244361,2.204252,53,12,-1, merged,0,0,0.16482935669
13873,1000327,4,266,201,65,0.755639,0.244361,2.972827,53,12,268,203,65,0.757463,0.242537,2.948968,53,12,-1, merged,0,0,0.670921691445
13873,1000328,3,214,148,66,0.691589,0.308411,2.217188,64,2,216,149,67,0.689815,0.310185,2.191505,65,2,1, merged,1,1,0.966678977692
13877,1000105,2,184,146,38,0.793478,0.206522,1.637818,35,3,185,146,39,0.789189,0.210811,1.631912,36,3,1, merged,1,1,0.0341169984357
13877,1000121,1,424,358,66,0.84434,0.15566,0.84434,63,3,426,359,67,0.842723,0.157277,0.842723,64,3,1, merged,1,1,0.0373044703946
13879,1000327,1,268,203,65,0.757463,0.242537,0.757463,53,12,269,203,66,0.754647,0.245353,0.754647,54,12,1, merged,1,1,0
13879,1000329,2,542,398,144,0.734317,0.265683,1.49178,136,8,545,399,146,0.73211,0.26789,1.486757,138,8,1, merged,1,1,0.361064234872
13883,1000327,1,269,203,66,0.754647,0.245353,0.754647,54,12,271,205,66,0.756458,0.243542,0.756458,54,12,-1, merged,0,0,0.639809926082
13883,1000592,2,79,64,15,0.810127,0.189873,1.564773,14,1,80,65,15,0.8125,0.1875,1.568958,14,1,1, merged,0,0,0.797161394972
13884,1000109,1,224,182,42,0.8125,0.1875,0.8125,41,1,225,182,43,0.808889,0.191111,0.808889,42,1,1, merged,1,1,0
13889,1000327,3,271,205,66,0.756458,0.243542,2.150168,54,12,272,206,66,0.757353,0.242647,2.17402,54,12,1, merged,0,0,0.628839050132
13892,1000327,2,272,206,66,0.757353,0.242647,1.43008,54,12,273,207,66,0.758242,0.241758,1.436813,54,12,1, merged,0,0,0.638088959212
13893,1000004,1,618,526,92,0.851133,0.148867,0.851133,77,15,619,526,93,0.849758,0.150242,0.849758,77,16,-1, merged,1,1,0.00239020015556
13895,1000063,3,1382,1245,137,0.900868,0.099132,2.184032,117,20,1383,1246,137,0.90094,0.09906,2.189034,117,20,1, merged,0,0,0.430326357689
13896,1000063,3,1383,1246,137,0.90094,0.09906,2.189034,117,20,1384,1247,137,0.901012,0.098988,2.187457,117,20,1, merged,0,0,0.482938854447
13898,1000063,1,1384,1247,137,0.901012,0.098988,0.901012,117,20,1385,1247,138,0.900361,0.099639,0.900361,117,21,-1, merged,1,1,0.0330200504768
13900,1000063,3,1385,1247,138,0.900361,0.099639,1.961621,117,21,1386,1248,138,0.900433,0.099567,1.970863,117,21,1, merged,0,0,0.23898106956
13900,1000070,4,337,309,28,0.916914,0.083086,2.878535,21,7,338,310,28,0.91716,0.08284,2.888023,21,7,1, merged,0,0,0.680314169355
13901,1000063,3,1386,1248,138,0.900433,0.099567,2.196926,117,21,1387,1249,138,0.900505,0.099495,2.19512,117,21,1, merged,0,0,0.385757606288
13902,1000063,3,1387,1249,138,0.900505,0.099495,2.19512,117,21,1389,1251,138,0.900648,0.099352,2.182968,117,21,-1, merged,0,0,0.389343964441
13904,1000063,3,1389,1251,138,0.900648,0.099352,2.182968,117,21,1391,1253,138,0.900791,0.099209,2.179151,117,21,-1, merged,0,0,0.191110106662
13907,1000063,3,1391,1253,138,0.900791,0.099209,2.179151,117,21,1392,1254,138,0.900862,0.099138,2.188035,117,21,1, merged,0,0,0.363603603725
13919,1000121,2,428,360,68,0.841121,0.158879,1.524455,65,3,429,361,68,0.841492,0.158508,1.508159,65,3,1, merged,0,0,0.0518152576962
13932,1000004,1,619,526,93,0.849758,0.150242,0.849758,77,16,622,529,93,0.850482,0.149518,0.850482,77,16,-1, merged,0,0,0.0384896144402
13932,1000014,2,492,424,68,0.861789,0.138211,1.711546,64,4,494,425,69,0.860324,0.139676,1.710806,65,4,1, merged,1,1,0.00747079597935
13933,1000063,2,1396,1258,138,0.901146,0.098854,1.809941,117,21,1397,1259,138,0.901217,0.098783,1.807366,117,21,1, merged,0,0,4.22119058348e-06
13935,1000007,1,389,334,55,0.858612,0.141388,0.858612,47,8,390,335,55,0.858974,0.141026,0.858974,47,8,1, merged,0,0,0.720538199773
13935,1000011,2,266,251,15,0.943609,0.056391,1.802221,13,2,267,252,15,0.94382,0.05618,1.802795,13,2,1, merged,0,0,0.909197853843
13936,1000003,1,492,412,80,0.837398,0.162602,0.837398,74,6,493,413,80,0.837728,0.162272,0.837728,74,6,-1, merged,0,0,0.972464181565
13937,1000004,1,622,529,93,0.850482,0.149518,0.850482,77,16,623,530,93,0.850722,0.149278,0.850722,77,16,-1, abandoned,0,0,0.039711502108
13957,1000070,2,339,311,28,0.917404,0.082596,1.584071,21,7,340,312,28,0.917647,0.082353,1.59457,21,7,1, merged,0,0,0.684452539331
13958,1000121,2,431,362,69,0.839907,0.160093,1.51683,66,3,432,363,69,0.840278,0.159722,1.522096,66,3,1, merged,0,0,0.000740597452124
13959,1000121,3,432,363,69,0.840278,0.159722,2.364616,66,3,433,364,69,0.840647,0.159353,2.370964,66,3,1, merged,0,0,0.267173246008
13965,1000121,4,433,364,69,0.840647,0.159353,3.020813,66,3,434,365,69,0.841014,0.158986,3.020812,66,3,1, merged,0,0,0.136068835593
13965,1000327,2,273,207,66,0.758242,0.241758,1.448057,54,12,274,208,66,0.759124,0.240876,1.447197,54,12,1, merged,0,0,0.10910636826
13965,1000328,1,216,149,67,0.689815,0.310185,0.689815,65,2,218,150,68,0.688073,0.311927,0.688073,66,2,1, merged,1,1,0.287500623174
13965,1000329,3,545,399,146,0.73211,0.26789,2.180167,138,8,546,400,146,0.732601,0.267399,2.179798,138,8,1, merged,0,0,0.180793751629
13974,1000070,2,343,315,28,0.918367,0.081633,1.918367,21,7,344,316,28,0.918605,0.081395,1.775748,21,7,1, merged,0,0,0.553610935525
13978,1000011,2,268,253,15,0.94403,0.05597,1.864644,13,2,269,254,15,0.944238,0.055762,1.863675,13,2,1, merged,0,0,0.304079518744
13978,1000015,1,781,719,62,0.920615,0.079385,0.920615,57,5,782,719,63,0.919437,0.080563,0.919437,58,5,1, merged,1,1,0.175924766009
13981,1000329,2,546,400,146,0.732601,0.267399,1.419168,138,8,547,400,147,0.731261,0.268739,1.426914,139,8,1, abandoned,1,1,0
13984,1000327,2,274,208,66,0.759124,0.240876,1.454776,54,12,275,209,66,0.76,0.24,1.46,54,12,1, merged,0,0,0.693505593506
13986,1000327,1,275,209,66,0.76,0.24,0.76,54,12,276,210,66,0.76087,0.23913,0.76087,54,12,-1, abandoned,0,0,0
13987,1000003,2,493,413,80,0.837728,0.162272,1.612118,74,6,494,414,80,0.838057,0.161943,1.613814,74,6,1, merged,0,0,0.590032245827
14002,1000005,1,110,84,26,0.763636,0.236364,0.763636,25,1,111,85,26,0.765766,0.234234,0.765766,25,1,-1, merged,0,0,0.0320887281304
14002,1000121,2,435,366,69,0.841379,0.158621,1.605016,66,3,436,367,69,0.841743,0.158257,1.607509,66,3,1, merged,0,0,0.0345301918426
14003,1000121,2,436,367,69,0.841743,0.158257,1.625834,66,3,437,368,69,0.842105,0.157895,1.628622,66,3,1, merged,0,0,0.0702437061034
14008,1000327,2,284,215,69,0.757042,0.242958,1.486772,54,15,285,216,69,0.757895,0.242105,1.490038,54,15,1, merged,0,0,0.124747160082
14009,1000004,1,623,530,93,0.850722,0.149278,0.850722,77,16,626,533,93,0.851438,0.148562,0.851438,77,16,-1, merged,0,0,0.00605638687079
14011,1000329,2,547,400,147,0.731261,0.268739,1.231261,139,8,548,401,147,0.731752,0.268248,1.065085,139,8,-1, abandoned,0,0,0.961606064527
14015,1000121,3,438,369,69,0.842466,0.157534,2.278443,66,3,440,370,70,0.840909,0.159091,2.266263,67,3,1, merged,1,1,0.0681666926636
14015,1000329,2,548,401,147,0.731752,0.268248,1.435977,139,8,550,402,148,0.730909,0.269091,1.425354,140,8,1, merged,1,1,0.0906472301657
14016,1000105,2,185,146,39,0.789189,0.210811,1.483634,36,3,186,147,39,0.790323,0.209677,1.479512,36,3,1, merged,0,0,0.0664752273221
14021,1000004,3,626,533,93,0.851438,0.148562,2.373044,77,16,627,534,93,0.851675,0.148325,2.37498,77,16,-1, abandoned,0,0,0.0338829775494
14021,1000329,2,550,402,148,0.730909,0.269091,1.521607,140,8,551,403,148,0.731397,0.268603,1.523305,140,8,-1, abandoned,0,0,0.0542093290622
14027,1000004,2,627,534,93,0.851675,0.148325,1.752962,77,16,629,536,93,0.852146,0.147854,1.75279,77,16,-1, merged,0,0,0.00652432686812
14027,1000014,3,495,426,69,0.860606,0.139394,2.613568,65,4,497,427,70,0.859155,0.140845,2.611945,66,4,1, merged,1,1,0.00275801239385
14027,1000063,1,1398,1260,138,0.901288,0.098712,0.901288,117,21,1399,1260,139,0.900643,0.099357,0.900643,118,21,1, merged,1,1,0.000591756340286
14028,1000004,1,629,536,93,0.852146,0.147854,0.852146,77,16,631,538,93,0.852615,0.147385,0.852615,77,16,-1, merged,0,0,0.125683808323
14028,1000329,3,551,403,148,0.731397,0.268603,2.25021,140,8,552,404,148,0.731884,0.268116,2.280151,140,8,1, merged,0,0,0.206893418899
14041,1000063,1,1412,1268,144,0.898017,0.101983,0.898017,123,21,1413,1268,145,0.897381,0.102619,0.897381,124,21,1, merged,1,1,0.00024463947183
14043,1000063,1,1413,1268,145,0.897381,0.102619,0.897381,124,21,1414,1268,146,0.896747,0.103253,0.896747,125,21,1, merged,1,1,0.00576570855809
14050,1000063,1,1421,1274,147,0.896552,0.103448,0.896552,126,21,1422,1274,148,0.895921,0.104079,0.895921,127,21,1, merged,1,1,0.000498684616285
14068,1000118,2,440,393,47,0.893182,0.106818,1.804947,46,1,441,394,47,0.893424,0.106576,1.799221,46,1,1, merged,0,0,0.0282725342083
14080,1000327,1,285,216,69,0.757895,0.242105,0.757895,54,15,288,218,70,0.756944,0.243056,0.756944,55,15,1, merged,1,1,0.182759097533
14086,1000166,1,87,72,15,0.827586,0.172414,0.827586,14,1,90,74,16,0.822222,0.177778,0.822222,15,1,1, merged,1,1,0.505735789607
14100,1000011,1,269,254,15,0.944238,0.055762,0.944238,13,2,270,255,15,0.944444,0.055556,0.944444,13,2,-1, merged,0,0,0.111359097066
14103,1000004,3,632,539,93,0.852848,0.147152,1.584732,77,16,633,540,93,0.853081,0.146919,1.585933,77,16,1, merged,0,0,0.0681370969664
14103,1000329,1,552,404,148,0.731884,0.268116,0.731884,140,8,554,406,148,0.732852,0.267148,0.732852,140,8,-1, merged,0,0,0.0036085931911
14104,1000005,1,111,85,26,0.765766,0.234234,0.765766,25,1,112,86,26,0.767857,0.232143,0.767857,25,1,1, merged,0,0,0.157597717263
14106,1000329,2,554,406,148,0.732852,0.267148,1.422041,140,8,555,407,148,0.733333,0.266667,1.413333,140,8,-1, abandoned,0,0,0.697071653089
14110,1000015,1,787,724,63,0.919949,0.080051,0.919949,58,5,788,725,63,0.920051,0.079949,0.920051,58,5,1, merged,0,0,0.110248366636
14119,1000004,3,633,540,93,0.853081,0.146919,2.599452,77,16,634,541,93,0.853312,0.146688,2.59495,77,16,-1, merged,0,0,0.0197193752948
14119,1000009,2,328,271,57,0.82622,0.17378,1.746372,50,7,329,271,58,0.823708,0.176292,1.741637,51,7,1, merged,1,1,0.0471969458089
14119,1000015,1,789,726,63,0.920152,0.079848,0.920152,58,5,792,727,65,0.917929,0.082071,0.917929,60,5,1, merged,1,1,0.0482254530471
14124,1000329,3,555,407,148,0.733333,0.266667,2.225833,140,8,556,408,148,0.733813,0.266187,2.232838,140,8,1, merged,0,0,0.162801956721
14124,1000592,2,80,65,15,0.8125,0.1875,1.4925,14,1,81,66,15,0.814815,0.185185,1.499025,14,1,1, merged,0,0,0.169445768756
14127,1000199,2,111,89,22,0.801802,0.198198,1.433381,21,1,114,90,24,0.789474,0.210526,1.404858,23,1,1, merged,1,1,0.879598825832
14128,1000199,1,114,90,24,0.789474,0.210526,0.789474,23,1,115,91,24,0.791304,0.208696,0.791304,23,1,1, merged,0,0,1.46329423265
14132,1000199,1,118,94,24,0.79661,0.20339,0.79661,23,1,119,95,24,0.798319,0.201681,0.798319,23,1,1, merged,0,0,1.48150485437
14134,1000327,1,289,219,70,0.757785,0.242215,0.757785,55,15,291,221,70,0.75945,0.24055,0.75945,55,15,-1, merged,0,0,0.655262104842
14134,1000592,2,81,66,15,0.814815,0.185185,1.5726,14,1,82,67,15,0.817073,0.182927,1.576523,14,1,1, merged,0,0,0.783845547675
14137,1000199,1,119,95,24,0.798319,0.201681,0.798319,23,1,121,96,25,0.793388,0.206612,0.793388,24,1,1, merged,1,1,1.50140640155
14145,1000592,1,83,67,16,0.807229,0.192771,0.807229,15,1,85,68,17,0.8,0.2,0.8,16,1,1, merged,1,1,0.389285813149
14150,1000026,1,169,153,16,0.905325,0.094675,0.905325,14,2,170,154,16,0.905882,0.094118,0.905882,14,2,1, merged,0,0,0.510043397396
14152,1000592,3,85,68,17,0.8,0.2,1.7375,16,1,86,69,17,0.802326,0.197674,2.743502,16,1,1, merged,0,0,0.148225728551
14156,1000004,1,634,541,93,0.853312,0.146688,0.853312,77,16,638,545,93,0.854232,0.145768,0.854232,77,16,-1, merged,0,0,0.451322201841
14157,1000329,1,556,408,148,0.733813,0.266187,0.733813,140,8,557,409,148,0.734291,0.265709,0.734291,140,8,-1, merged,0,0,1.01183332267
14158,1000329,2,557,409,148,0.734291,0.265709,1.536616,140,8,558,410,148,0.734767,0.265233,1.539365,140,8,1, merged,0,0,0.957426354606
14158,1000592,1,86,69,17,0.802326,0.197674,0.802326,16,1,87,70,17,0.804598,0.195402,0.804598,16,1,1, merged,0,0,0.745640432099
14169,1000063,1,1439,1288,151,0.895066,0.104934,0.895066,130,21,1441,1290,151,0.895212,0.104788,0.895212,130,21,-1, merged,0,0,0.309662507989
14169,1000070,4,344,316,28,0.918605,0.081395,3.098501,21,7,345,317,28,0.918841,0.081159,3.107471,21,7,1, merged,0,0,0.785481252618
14172,1000105,3,186,147,39,0.790323,0.209677,2.307213,36,3,187,148,39,0.791444,0.208556,2.310491,36,3,1, merged,0,0,0.0250039081388
14172,1000329,2,558,410,148,0.734767,0.265233,1.51689,140,8,560,412,148,0.735714,0.264286,1.519048,140,8,1, merged,0,0,0.0313876622342
14174,1000091,3,141,110,31,0.780142,0.219858,2.299189,29,2,143,112,31,0.783217,0.216783,2.299622,29,2,-1, merged,0,0,0.468013631938
14174,1000329,2,560,412,148,0.735714,0.264286,1.519048,140,8,561,413,148,0.736185,0.263815,1.516405,140,8,-1, merged,0,0,0.959078633669
14175,1000329,2,561,413,148,0.736185,0.263815,1.516405,140,8,562,414,148,0.736655,0.263345,1.518076,140,8,1, merged,0,0,1.01464211903
14176,1000063,3,1442,1291,151,0.895284,0.104716,2.188703,130,21,1443,1292,151,0.895357,0.104643,2.192316,130,21,1, merged,0,0,0.372254939758
14185,1000063,3,1443,1292,151,0.895357,0.104643,2.192316,130,21,1444,1293,151,0.895429,0.104571,2.19361,130,21,1, merged,0,0,0.169220522817
14195,1000063,1,1445,1293,152,0.89481,0.10519,0.89481,131,21,1446,1294,152,0.894882,0.105118,0.894882,131,21,1, merged,0,0,0.279280416274
14195,1000327,2,291,221,70,0.75945,0.24055,1.65426,55,15,292,222,70,0.760274,0.239726,1.655156,55,15,1, merged,0,0,0.594656662119
14206,1000063,1,1449,1297,152,0.8951,0.1049,0.8951,131,21,1450,1298,152,0.895172,0.104828,0.895172,131,21,1, merged,0,0,0.00365873900139
14221,1000118,2,442,395,47,0.893665,0.106335,1.690275,46,1,443,396,47,0.893905,0.106095,1.687201,46,1,1, merged,0,0,0.0844446104645
14222,1000091,1,143,112,31,0.783217,0.216783,0.783217,29,2,144,113,31,0.784722,0.215278,0.784722,29,2,1, merged,0,0,0.510308191403
14222,1000329,2,562,414,148,0.736655,0.263345,1.519872,140,8,563,415,148,0.737123,0.262877,1.521845,140,8,1, merged,0,0,1.0181158962
14226,1000004,1,638,545,93,0.854232,0.145768,0.854232,77,16,639,546,93,0.85446,0.14554,0.85446,77,16,-1, merged,0,0,0.00620875975414
14226,1000014,2,497,427,70,0.859155,0.140845,1.713387,66,4,499,429,70,0.859719,0.140281,1.71418,66,4,-1, merged,0,0,0.00869534208161
14226,1000153,3,425,390,35,0.917647,0.082353,2.631034,28,7,426,391,35,0.91784,0.08216,2.63202,28,7,1, merged,0,0,0.00987070326908
14237,1000109,1,227,184,43,0.810573,0.189427,0.810573,42,1,228,184,44,0.807018,0.192982,0.807018,43,1,1, merged,1,1,1.39462316176
14253,1000004,2,639,546,93,0.85446,0.14554,1.612036,77,16,640,547,93,0.854688,0.145313,1.613077,77,16,-1, abandoned,0,0,0.420390313467
14253,1000327,1,297,225,72,0.757576,0.242424,0.757576,57,15,298,226,72,0.758389,0.241611,0.758389,57,15,-1, abandoned,0,0,0.615672091621
14254,1000004,2,640,547,93,0.854688,0.145313,1.538898,77,16,641,548,93,0.854914,0.145086,1.543226,77,16,1, merged,0,0,0.0218013110432
14255,1000014,1,500,430,70,0.86,0.14,0.86,66,4,501,431,70,0.860279,0.139721,0.860279,66,4,1, merged,0,0,0.124491975953
14264,1000121,2,445,375,70,0.842697,0.157303,1.662572,67,3,446,376,70,0.843049,0.156951,1.665135,67,3,1, merged,0,0,0.000149950241541
14272,1000070,3,348,320,28,0.91954,0.08046,1.67954,21,7,350,321,29,0.917143,0.082857,2.007951,21,8,-1, merged,1,0,0.546694322012
14272,1000327,2,300,228,72,0.76,0.24,0.76,57,15,301,228,73,0.757475,0.242525,1.090808,58,15,1, merged,1,1,0.550956037338
14273,1000328,2,220,152,68,0.690909,0.309091,1.50202,66,2,221,152,69,0.687783,0.312217,1.50097,66,3,-1, merged,1,1,0.163814162717
14273,1000592,1,90,73,17,0.811111,0.188889,0.811111,16,1,91,74,17,0.813187,0.186813,0.813187,16,1,1, merged,0,0,0
14276,1000327,1,301,228,73,0.757475,0.242525,0.757475,58,15,302,228,74,0.754967,0.245033,0.754967,58,16,-1, merged,1,1,0.498359668924
14278,1000091,2,144,113,31,0.784722,0.215278,1.521845,29,2,147,114,33,0.77551,0.22449,1.513563,31,2,1, merged,1,1,0.157733187777
14278,1000328,4,221,152,69,0.687783,0.312217,3.022814,66,3,222,153,69,0.689189,0.310811,3.009204,66,3,1, merged,0,0,0.203442982019
14278,1000329,1,563,415,148,0.737123,0.262877,0.737123,140,8,565,417,148,0.738053,0.261947,0.738053,140,8,-1, merged,0,0,0.122498997038
14278,1000592,3,91,74,17,0.813187,0.186813,2.335032,16,1,93,75,18,0.806452,0.193548,2.320015,17,1,1, merged,1,1,0.136270711788
14289,1000121,2,446,376,70,0.843049,0.156951,1.577563,67,3,447,377,70,0.8434,0.1566,1.578695,67,3,1, merged,0,0,0
14289,1000329,5,565,417,148,0.738053,0.261947,3.782306,140,8,566,417,149,0.736749,0.263251,3.781945,140,9,-1, merged,1,1,0.160194765566
14294,1000009,1,333,273,60,0.81982,0.18018,0.81982,53,7,335,275,60,0.820896,0.179104,0.820896,53,7,-1, merged,0,0,0.0223955249186
14299,1000327,1,303,229,74,0.755776,0.244224,0.755776,58,16,304,230,74,0.756579,0.243421,0.756579,58,16,-1, abandoned,0,0,0.159009386344
14300,1000327,2,304,230,74,0.756579,0.243421,1.530772,58,16,305,231,74,0.757377,0.242623,1.528654,58,16,1, merged,0,0,0.160741122418
14301,1000327,2,305,231,74,0.757377,0.242623,1.528654,58,16,306,232,74,0.75817,0.24183,1.530657,58,16,1, merged,0,0,0.157138565205
14307,1000329,2,570,421,149,0.738596,0.261404,1.430904,140,9,572,422,150,0.737762,0.262238,1.421307,141,9,1, merged,1,1,0.110813031816
14309,1000007,1,395,340,55,0.860759,0.139241,0.860759,47,8,397,342,55,0.861461,0.138539,0.861461,47,8,1, merged,0,0,0.054937327521
14309,1000153,2,430,395,35,0.918605,0.081395,1.779364,28,7,431,396,35,0.918794,0.081206,1.780254,28,7,1, merged,0,0,0.0429937673638
14310,1000153,1,431,396,35,0.918794,0.081206,0.918794,28,7,432,397,35,0.918981,0.081019,0.918981,28,7,-1, abandoned,0,0,0.0287124516954
14312,1000004,2,645,552,93,0.855814,0.144186,1.673996,77,16,646,553,93,0.856037,0.143963,1.676933,77,16,1, merged,0,0,0.0890404303903
14312,1000043,1,132,108,24,0.818182,0.181818,0.818182,21,3,134,110,24,0.820896,0.179104,0.820896,21,3,-1, merged,0,0,0.121192747452
14322,1000327,2,307,233,74,0.758958,0.241042,1.638958,58,16,310,236,74,0.76129,0.23871,1.613142,58,16,-1, merged,0,0,0.32221863191
14331,1000166,1,90,74,16,0.822222,0.177778,0.822222,15,1,92,76,16,0.826087,0.173913,0.826087,15,1,1, merged,0,0,0.735356654948
14332,1000120,3,82,70,12,0.853659,0.146341,2.44592,11,1,83,71,12,0.855422,0.144578,2.452662,11,1,1, merged,0,0,0.11080806213
14334,1000004,2,646,553,93,0.856037,0.143963,1.56437,77,16,647,554,93,0.85626,0.14374,1.57626,77,16,1, merged,0,0,0.0112771614559
14335,1000120,2,83,71,12,0.855422,0.144578,1.762398,11,1,84,72,12,0.857143,0.142857,1.765189,11,1,1, merged,0,0,0.0362595419847
14337,1000004,2,647,554,93,0.85626,0.14374,1.551382,77,16,648,555,93,0.856481,0.143519,1.555277,77,16,1, merged,0,0,0.0123739688359
14338,1000327,1,310,236,74,0.76129,0.23871,0.76129,58,16,311,237,74,0.762058,0.237942,0.762058,58,16,1, merged,0,0,0.000674460431655
14343,1000070,1,353,324,29,0.917847,0.082153,0.917847,21,8,355,325,30,0.915493,0.084507,0.915493,21,9,-1, merged,1,0,0.15627422465
14345,1000004,1,650,556,94,0.855385,0.144615,0.855385,77,17,652,558,94,0.855828,0.144172,0.855828,77,17,-1, merged,0,0,0.466281150048
14345,1000329,3,572,422,150,0.737762,0.262238,2.295528,141,9,573,423,150,0.73822,0.26178,2.291723,141,9,1, merged,0,0,1.0168370315
14346,1000070,5,355,325,30,0.915493,0.084507,4.58216,21,9,357,326,31,0.913165,0.086835,4.169744,22,9,-1, merged,1,0,0
14347,1000004,2,652,558,94,0.855828,0.144172,1.712971,77,17,654,560,94,0.856269,0.143731,1.634047,77,17,-1, merged,0,0,0.0205851811129
14347,1000023,7,189,171,18,0.904762,0.095238,5.857719,16,2,190,172,18,0.905263,0.094737,5.783583,16,2,1, merged,0,0,0.000807250577918
14347,1000043,4,134,110,24,0.820896,0.179104,3.269161,21,3,135,111,24,0.822222,0.177778,3.192339,21,3,1, merged,0,0,0.0189830508475
14347,1000121,8,449,379,70,0.844098,0.155902,6.701817,67,3,450,380,70,0.844444,0.155556,6.628027,67,3,1, merged,0,0,0.0120422465699
14351,1000063,2,1450,1298,152,0.895172,0.104828,1.8034,131,21,1455,1303,152,0.895533,0.104467,1.80405,131,21,-1, merged,0,0,0.0718300069215
14355,1000003,1,497,417,80,0.839034,0.160966,0.839034,74,6,498,418,80,0.839357,0.160643,0.839357,74,6,1, merged,0,0,0.146618501971
14355,1000091,2,147,114,33,0.77551,0.22449,1.614544,31,2,149,116,33,0.778523,0.221477,1.617881,31,2,1, merged,0,0,0.348349288031
14360,1000328,2,222,153,69,0.689189,0.310811,1.427409,66,3,223,154,69,0.690583,0.309417,1.429713,66,3,1, merged,0,0,0
14360,1000329,1,573,423,150,0.73822,0.26178,0.73822,141,9,575,425,150,0.73913,0.26087,0.73913,141,9,-1, merged,0,0,0
14367,1000329,2,575,425,150,0.73913,0.26087,1.44028,141,9,576,426,150,0.739583,0.260417,1.444129,141,9,1, merged,0,0,0.126993196092
14373,1000015,1,804,739,65,0.919154,0.080846,0.919154,60,5,805,739,66,0.918012,0.081988,0.918012,61,5,1, merged,1,1,0.000120775568291
14373,1000026,2,171,155,16,0.906433,0.093567,1.825587,14,2,172,155,17,0.901163,0.098837,1.819175,15,2,1, merged,1,1,0.00300848071153
14373,1000153,3,432,397,35,0.918981,0.081019,2.744568,28,7,433,398,35,0.919169,0.080831,2.738344,28,7,1, merged,0,0,0.000213729528506
14374,1000109,2,228,184,44,0.807018,0.192982,1.434925,43,1,229,185,44,0.80786,0.19214,1.421497,43,1,1, merged,0,0,0.430876070227
14377,1000329,1,576,426,150,0.739583,0.260417,0.739583,141,9,578,428,150,0.740484,0.259516,0.740484,141,9,-1, merged,0,0,0.347712958975
14381,1000199,1,124,99,25,0.798387,0.201613,0.798387,24,1,125,99,26,0.792,0.208,0.792,24,2,-1, merged,1,1,0
14387,1000199,1,130,104,26,0.8,0.2,0.8,24,2,132,106,26,0.80303,0.19697,0.80303,24,2,-1, abandoned,0,0,0.884904761905
14389,1000329,2,578,428,150,0.740484,0.259516,1.651596,141,9,580,429,151,0.739655,0.260345,1.640754,142,9,1, merged,1,1,0.0179554011005
14397,1000004,2,655,561,94,0.856489,0.143511,1.583761,77,17,657,563,94,0.856925,0.143075,1.598305,77,17,-1, merged,0,0,0.0495716995806
14397,1000121,4,451,380,71,0.842572,0.157428,3.201202,68,3,452,381,71,0.84292,0.15708,3.218427,68,3,1, merged,0,0,0.0622588570244
14400,1000004,2,657,563,94,0.856925,0.143075,1.758024,77,17,658,564,94,0.857143,0.142857,1.748447,77,17,-1, merged,0,0,0
14400,1000043,4,135,111,24,0.822222,0.177778,2.580247,21,3,136,112,24,0.823529,0.176471,3.571977,21,3,1, merged,0,0,0
14402,1000063,3,1455,1303,152,0.895533,0.104467,2.194294,131,21,1456,1304,152,0.895604,0.104396,2.197552,131,21,1, merged,0,0,0.384472858665
14407,1000063,3,1456,1304,152,0.895604,0.104396,2.197552,131,21,1457,1305,152,0.895676,0.104324,2.205051,131,21,1, merged,0,0,0.345587335689
14408,1000063,3,1457,1305,152,0.895676,0.104324,2.205051,131,21,1458,1306,152,0.895748,0.104252,2.212382,131,21,1, merged,0,0,0.345912493538
14411,1000327,2,311,237,74,0.762058,0.237942,1.610399,58,16,312,238,74,0.762821,0.237179,1.611877,58,16,1, merged,0,0,0.0557776780411
14413,1000063,3,1458,1306,152,0.895748,0.104252,2.212382,131,21,1459,1307,152,0.895819,0.104181,2.21955,131,21,1, merged,0,0,0.167379244427
14415,1000063,3,1459,1307,152,0.895819,0.104181,2.21955,131,21,1460,1308,152,0.89589,0.10411,2.226562,131,21,1, merged,0,0,0.167554889797
14426,1000063,3,1460,1308,152,0.89589,0.10411,2.226562,131,21,1461,1309,152,0.895962,0.104038,2.22032,131,21,1, merged,0,0,0.167441375364
14427,1000153,1,433,398,35,0.919169,0.080831,0.919169,28,7,435,400,35,0.91954,0.08046,0.91954,28,7,-1, merged,0,0,0.351172769548
14443,1000105,3,188,149,39,0.792553,0.207447,2.274482,36,3,189,150,39,0.793651,0.206349,2.262635,36,3,1, merged,0,0,0.661306893892
14443,1000329,2,582,431,151,0.74055,0.25945,1.481929,142,9,585,433,152,0.740171,0.259829,1.468984,143,9,1, merged,1,1,0.731466262976
14445,1000121,3,452,381,71,0.84292,0.15708,2.47468,68,3,453,382,71,0.843267,0.156733,2.485231,68,3,1, merged,0,0,0.117919817968
14445,1000328,2,223,154,69,0.690583,0.309417,1.631759,66,3,224,155,69,0.691964,0.308036,1.641964,66,3,1, merged,0,0,0.126240918042
14448,1000329,1,585,433,152,0.740171,0.259829,0.740171,143,9,587,435,152,0.741056,0.258944,0.741056,143,9,-1, abandoned,0,0,0.0613331550143
14449,1000004,1,658,564,94,0.857143,0.142857,0.857143,77,17,659,565,94,0.85736,0.14264,0.85736,77,17,-1, merged,0,0,0.42319210259
14449,1000070,2,361,330,31,0.914127,0.085873,1.77127,22,9,362,331,31,0.914365,0.085635,1.771724,22,9,1, merged,0,0,0.796678372097
14449,1000121,3,453,382,71,0.843267,0.156733,2.614537,68,3,454,383,71,0.843612,0.156388,2.615337,68,3,1, merged,0,0,0.63499754541
14454,1000091,1,149,116,33,0.778523,0.221477,0.778523,31,2,150,117,33,0.78,0.22,0.78,31,2,1, merged,0,0,0.0793242195075
14460,1000329,1,587,435,152,0.741056,0.258944,0.741056,143,9,588,436,152,0.741497,0.258503,0.741497,143,9,-1, merged,0,0,0
14462,1000121,2,455,384,71,0.843956,0.156044,1.543956,68,3,456,385,71,0.844298,0.155702,1.547595,68,3,1, merged,0,0,0.632102917683
14468,1000199,2,132,106,26,0.80303,0.19697,1.416667,24,2,133,107,26,0.804511,0.195489,1.426734,24,2,1, merged,0,0,1.55504281637
14471,1000091,1,150,117,33,0.78,0.22,0.78,31,2,151,118,33,0.781457,0.218543,0.781457,31,2,1, merged,0,0,0.0953758564826
14471,1000121,6,456,385,71,0.844298,0.155702,4.541922,68,3,457,386,71,0.844639,0.155361,4.54983,68,3,1, merged,0,0,0.0552540546035
14471,1000328,4,224,155,69,0.691964,0.308036,2.955688,66,3,225,156,69,0.693333,0.306667,2.962818,66,3,1, merged,0,0,0.123790707624
14471,1000329,5,589,437,152,0.741935,0.258065,3.697624,143,9,590,438,152,0.742373,0.257627,3.705191,143,9,1, merged,0,0,0.0735694992478
14476,1000091,1,151,118,33,0.781457,0.218543,0.781457,31,2,152,119,33,0.782895,0.217105,0.782895,31,2,1, merged,0,0,0.2391935331
14476,1000328,4,225,156,69,0.693333,0.306667,2.962818,66,3,226,157,69,0.69469,0.30531,2.969838,66,3,1, merged,0,0,0.310837484123
14476,1000329,5,590,438,152,0.742373,0.257627,3.705191,143,9,591,439,152,0.742809,0.257191,3.712647,143,9,1, merged,0,0,0.184755792515
14477,1000166,2,92,76,16,0.826087,0.173913,1.826087,15,1,93,77,16,0.827957,0.172043,1.827957,15,1,1, merged,0,0,0.263054255228
14488,1000109,3,230,186,44,0.808696,0.191304,2.245077,43,1,231,186,45,0.805195,0.194805,2.251419,43,2,-1, merged,1,1,1.39521857923
14492,1000070,2,363,332,31,0.914601,0.085399,1.627367,22,9,364,333,31,0.914835,0.085165,1.630625,22,9,1, merged,0,0,0.0885466656993
14499,1000121,2,459,388,71,0.845316,0.154684,1.668845,68,3,460,389,71,0.845652,0.154348,1.678986,68,3,1, merged,0,0,0.0470889844418
14501,1000130,1,132,112,20,0.848485,0.151515,0.848485,17,3,133,113,20,0.849624,0.150376,0.849624,17,3,1, merged,0,0,0.144202109061
14517,1000004,2,662,568,94,0.858006,0.141994,1.58682,77,17,670,575,95,0.858209,0.141791,1.563127,78,17,-1, merged,1,0,0.0993597179976
14517,1000327,4,313,239,74,0.763578,0.236422,3.207541,58,16,316,241,75,0.762658,0.237342,3.103563,59,16,-1, merged,1,0,0.100380083984
14526,1000121,1,468,397,71,0.848291,0.151709,0.848291,68,3,472,399,73,0.845339,0.154661,0.845339,70,3,-1, merged,1,0,0.101539575627
14526,1000329,2,592,440,152,0.743243,0.256757,1.591534,143,9,593,441,152,0.743676,0.256324,1.589015,143,9,1, merged,0,0,0.114890022495
14529,1000063,2,1461,1309,152,0.895962,0.104038,1.65862,131,21,1463,1311,152,0.896104,0.103896,1.65711,131,21,-1, merged,0,0,0
14529,1000327,1,316,241,75,0.762658,0.237342,0.762658,59,16,318,242,76,0.761006,0.238994,0.761006,60,16,1, merged,1,1,0
14531,1000327,1,318,242,76,0.761006,0.238994,0.761006,60,16,320,243,77,0.759375,0.240625,0.759375,61,16,-1, merged,1,0,0
14531,1000328,4,226,157,69,0.69469,0.30531,2.455697,66,3,227,158,69,0.696035,0.303965,2.45541,66,3,-1, merged,0,0,0
14535,1000004,1,671,576,95,0.85842,0.14158,0.85842,78,17,672,577,95,0.858631,0.141369,0.858631,78,17,-1, abandoned,0,0,0.0213050888727
14535,1000329,2,595,443,152,0.744538,0.255462,1.602958,143,9,596,444,152,0.744966,0.255034,1.603597,143,9,-1, abandoned,0,0,0.0192334888983
14537,1000121,4,475,401,74,0.844211,0.155789,3.146288,71,3,476,402,74,0.844538,0.155462,3.166187,71,3,1, merged,0,0,0.296235781239
14537,1000592,1,94,76,18,0.808511,0.191489,0.808511,17,1,95,76,19,0.8,0.2,0.8,18,1,1, merged,1,1,0.31556349762
14538,1000592,2,95,76,19,0.8,0.2,1.651852,18,1,96,77,19,0.802083,0.197917,1.65001,18,1,1, merged,0,0,0.111052502406
14539,1000004,2,672,577,95,0.858631,0.141369,1.578631,78,17,675,579,96,0.857778,0.142222,1.588547,79,17,-1, merged,1,0,0.0025950436265
14539,1000121,3,476,402,74,0.844538,0.155462,2.423169,71,3,478,403,75,0.843096,0.156904,2.431643,72,3,1, merged,1,1,0.00339583475301
14559,1000118,2,452,405,47,0.896018,0.103982,1.696018,46,1,453,406,47,0.896247,0.103753,1.701803,46,1,1, merged,0,0,0.245481670427
14569,1000120,2,84,72,12,0.857143,0.142857,1.857143,11,1,85,73,12,0.858824,0.141176,1.858824,11,1,1, merged,0,0,0.323067173638
14572,1000199,3,138,112,26,0.811594,0.188406,2.192029,24,2,139,113,26,0.81295,0.18705,2.220478,24,2,1, merged,0,0,1.56702932829
14582,1000109,2,231,186,45,0.805195,0.194805,1.443493,43,2,232,187,45,0.806034,0.193966,1.451868,43,2,1, merged,0,0,1.29624242424
14589,1000070,2,369,338,31,0.915989,0.084011,1.915989,22,9,370,339,31,0.916216,0.083784,1.916216,22,9,1, merged,0,0,0.700918801255
14591,1000063,2,1467,1315,152,0.896387,0.103613,1.896387,131,21,1468,1316,152,0.896458,0.103542,1.896458,131,21,1, merged,0,0,0
14591,1000120,3,87,75,12,0.862069,0.137931,2.758456,11,1,88,76,12,0.863636,0.136364,2.760094,11,1,1, merged,0,0,0
14597,1000003,2,498,418,80,0.839357,0.160643,1.839357,74,6,499,419,80,0.839679,0.160321,1.839679,74,6,1, merged,0,0,0.34392513351
14598,1000120,2,89,77,12,0.865169,0.134831,1.865169,11,1,90,78,12,0.866667,0.133333,1.866667,11,1,1, merged,0,0,0.0399336809856
14599,1000120,2,90,78,12,0.866667,0.133333,1.866667,11,1,91,79,12,0.868132,0.131868,1.868132,11,1,1, merged,0,0,0.329227941176
14600,1000120,2,91,79,12,0.868132,0.131868,1.868132,11,1,93,81,12,0.870968,0.129032,1.799539,11,1,-1, merged,0,0,0.565201465201
14601,1000120,3,93,81,12,0.870968,0.129032,2.625928,11,1,94,82,12,0.87234,0.12766,2.63326,11,1,1, merged,0,0,0.341058394161
14604,1000063,2,1468,1316,152,0.896458,0.103542,1.829791,131,21,1469,1317,152,0.896528,0.103472,1.834028,131,21,1, merged,0,0,0.11522838046
14604,1000120,3,94,82,12,0.87234,0.12766,2.702132,11,1,95,83,12,0.873684,0.126316,2.707712,11,1,1, merged,0,0,0.0253724033058
14606,1000120,2,95,83,12,0.873684,0.126316,1.811184,11,1,96,84,12,0.875,0.125,1.816176,11,1,1, merged,0,0,0.364088729017
14607,1000063,2,1469,1317,152,0.896528,0.103472,1.837705,131,21,1470,1318,152,0.896599,0.103401,1.841043,131,21,1, merged,0,0,0.0872911674419
14608,1000063,2,1470,1318,152,0.896599,0.103401,1.841043,131,21,1471,1319,152,0.896669,0.103331,1.844037,131,21,1, merged,0,0,0.0059330665403
14610,1000063,2,1471,1319,152,0.896669,0.103331,1.844037,131,21,1472,1320,152,0.896739,0.103261,1.846739,131,21,1, merged,0,0,0.17313556859
14616,1000166,1,93,77,16,0.827957,0.172043,0.827957,15,1,95,79,16,0.831579,0.168421,0.831579,15,1,1, merged,0,0,0.239179109728
14620,1000014,1,509,438,71,0.860511,0.139489,0.860511,67,4,511,440,71,0.861057,0.138943,0.861057,67,4,-1, merged,0,0,0.172411840076
14620,1000329,2,596,444,152,0.744966,0.255034,1.605477,143,9,598,446,152,0.745819,0.254181,1.606876,143,9,-1, merged,0,0,0.311401291693
14621,1000121,4,478,403,75,0.843096,0.156904,3.195231,72,3,479,404,75,0.843424,0.156576,3.17665,72,3,1, merged,0,0,0.0321553497873
14621,1000592,2,96,77,19,0.802083,0.197917,1.523733,18,1,97,77,20,0.793814,0.206186,1.503814,19,1,1, merged,1,1,0.0307849074263
14622,1000007,1,401,346,55,0.862843,0.137157,0.862843,47,8,402,347,55,0.863184,0.136816,0.863184,47,8,1, merged,0,0,0.0641474185392
14623,1000007,2,402,347,55,0.863184,0.136816,1.738184,47,8,404,349,55,0.863861,0.136139,1.72593,47,8,-1, merged,0,0,0.0910856332949
14624,1000109,1,232,187,45,0.806034,0.193966,0.806034,43,2,233,188,45,0.806867,0.193133,0.806867,43,2,1, merged,0,0,1.44881925522
14624,1000199,3,139,113,26,0.81295,0.18705,2.436375,24,2,140,114,26,0.814286,0.185714,2.440118,24,2,1, merged,0,0,1.56142587347
14626,1000121,2,479,404,75,0.843424,0.156576,1.589243,72,3,481,406,75,0.844075,0.155925,1.590742,72,3,-1, merged,0,0,0
14626,1000329,1,598,446,152,0.745819,0.254181,0.745819,143,9,600,448,152,0.746667,0.253333,0.746667,143,9,-1, merged,0,0,0
14630,1000007,1,404,349,55,0.863861,0.136139,0.863861,47,8,405,350,55,0.864198,0.135802,0.864198,47,8,-1, merged,0,0,0.0185804157938
14632,1000015,2,810,744,66,0.918519,0.081481,1.73461,61,5,811,745,66,0.918619,0.081381,1.736801,61,5,1, merged,0,0,0.00870128268003
14633,1000166,2,95,79,16,0.831579,0.168421,1.831579,15,1,96,80,16,0.833333,0.166667,1.833333,15,1,1, merged,0,0,1.60982800983
14642,1000130,2,134,114,20,0.850746,0.149254,1.647739,17,3,135,115,20,0.851852,0.148148,1.644444,17,3,1, merged,0,0,0.489651886014
14643,1000091,1,152,119,33,0.782895,0.217105,0.782895,31,2,155,121,34,0.780645,0.219355,0.780645,32,2,-1, merged,1,0,0.259484737437
14643,1000328,2,227,158,69,0.696035,0.303965,1.47893,66,3,229,160,69,0.69869,0.30131,1.479335,66,3,-1, merged,0,0,0.579031203757
14643,1000592,3,97,77,20,0.793814,0.206186,2.272744,19,1,98,77,21,0.785714,0.214286,2.265049,20,1,1, merged,1,1,0.415648871117
14646,1000121,1,481,406,75,0.844075,0.155925,0.844075,72,3,482,407,75,0.844398,0.155602,0.844398,72,3,1, merged,0,0,0.0816455992655
14647,1000153,2,435,400,35,0.91954,0.08046,0.91954,28,7,436,401,35,0.919725,0.080275,1.919725,28,7,1, merged,0,0,1.02644707109
14648,1000070,1,370,339,31,0.916216,0.083784,0.916216,22,9,371,340,31,0.916442,0.083558,0.916442,22,9,-1, abandoned,0,0,0.716906195705
14648,1000105,2,191,152,39,0.795812,0.204188,1.712028,36,3,192,153,39,0.796875,0.203125,1.713317,36,3,-1, abandoned,0,0,0.619249379869
14649,1000121,1,482,407,75,0.844398,0.155602,0.844398,72,3,484,409,75,0.845041,0.154959,0.845041,72,3,-1, merged,0,0,0.00800286662086
14650,1000004,2,675,579,96,0.857778,0.142222,1.721975,79,17,676,580,96,0.857988,0.142012,1.718282,79,17,1, merged,0,0,0.145429976793
14650,1000007,1,405,350,55,0.864198,0.135802,0.864198,47,8,408,351,57,0.860294,0.139706,0.860294,49,8,1, merged,1,1,0.395953258961
14658,1000009,1,342,281,61,0.821637,0.178363,0.821637,54,7,343,282,61,0.822157,0.177843,0.822157,54,7,1, merged,0,0,0.36238048515
14658,1000015,2,811,745,66,0.918619,0.081381,1.740256,61,5,812,746,66,0.918719,0.081281,1.740877,61,5,1, merged,0,0,0.35395037635
14664,1000070,2,371,340,31,0.916442,0.083558,0.916442,22,9,372,341,31,0.916667,0.083333,1.916667,22,9,1, merged,0,0,0.0819572538078
14665,1000091,2,155,121,34,0.780645,0.219355,1.565661,32,2,156,122,34,0.782051,0.217949,1.567766,32,2,1, merged,0,0,0.0494245939753
14676,1000130,1,135,115,20,0.851852,0.148148,0.851852,17,3,139,119,20,0.856115,0.143885,0.856115,17,3,-1, merged,0,0,0.243884070989
14682,1000004,2,676,580,96,0.857988,0.142012,1.569527,79,17,677,581,96,0.858198,0.141802,1.572484,79,17,1, merged,0,0,0.0204310165435
14686,1000329,1,601,449,152,0.747088,0.252912,0.747088,143,9,602,450,152,0.747508,0.252492,0.747508,143,9,1, merged,0,0,0.0207982012366
14687,1000004,1,677,581,96,0.858198,0.141802,0.858198,79,17,678,582,96,0.858407,0.141593,0.858407,79,17,-1, merged,0,0,0.0324366414485
14687,1000043,2,139,114,25,0.820144,0.179856,1.678342,22,3,140,114,26,0.814286,0.185714,1.672693,23,3,1, merged,1,1,0.0485453710786
14689,1000118,3,453,406,47,0.896247,0.103753,2.664628,46,1,454,407,47,0.896476,0.103524,2.640512,46,1,1, merged,0,0,0.122682878891
14694,1000004,2,678,582,96,0.858407,0.141593,1.755356,79,17,679,583,96,0.858616,0.141384,1.755704,79,17,-1, abandoned,0,0,0.159824512426
14694,1000063,1,1475,1323,152,0.896949,0.103051,0.896949,131,21,1477,1325,152,0.897089,0.102911,0.897089,131,21,-1, abandoned,0,0,0.346493108942
14710,1000091,2,156,122,34,0.782051,0.217949,1.480741,32,2,157,123,34,0.783439,0.216561,1.474427,32,2,-1, merged,0,0,0.861003953108
14710,1000328,1,229,160,69,0.69869,0.30131,0.69869,66,3,233,161,72,0.690987,0.309013,0.690987,69,3,1, merged,1,1,0.431027667984
14719,1000199,2,141,115,26,0.815603,0.184397,1.468664,24,2,142,116,26,0.816901,0.183099,1.476901,24,2,1, merged,0,0,0.000319442285654
14728,1000121,1,484,409,75,0.845041,0.154959,0.845041,72,3,485,410,75,0.845361,0.154639,0.845361,72,3,1, merged,0,0,0
14729,1000070,2,374,343,31,0.917112,0.082888,0.917112,22,9,375,344,31,0.917333,0.082667,1.417333,22,9,-1, abandoned,0,0,0.159289872031
14731,1000003,2,500,420,80,0.84,0.16,1.84,74,6,501,421,80,0.840319,0.159681,1.840319,74,6,1, merged,0,0,0.02171558206
14743,1000070,1,375,344,31,0.917333,0.082667,0.917333,22,9,376,345,31,0.917553,0.082447,0.917553,22,9,1, merged,0,0,0.0550216830988
14743,1000105,3,192,153,39,0.796875,0.203125,2.214208,36,3,193,154,39,0.797927,0.202073,2.315481,36,3,1, merged,0,0,0.0718502367912
14749,1000199,2,143,117,26,0.818182,0.181818,1.478182,24,2,144,117,27,0.8125,0.1875,1.459559,25,2,1, merged,1,1,0.00049888708948
14753,1000007,1,410,353,57,0.860976,0.139024,0.860976,49,8,412,354,58,0.859223,0.140777,0.859223,49,9,-1, merged,1,0,0.620638725329
14753,1000009,2,349,288,61,0.825215,0.174785,1.686191,54,7,350,289,61,0.825714,0.174286,1.684938,54,7,1, merged,0,0,0.549866793303
14754,1000120,2,97,85,12,0.876289,0.123711,1.623797,11,1,98,86,12,0.877551,0.122449,1.625478,11,1,1, merged,0,0,0.0059869143011
14754,1000329,1,602,450,152,0.747508,0.252492,0.747508,143,9,603,451,152,0.747927,0.252073,0.747927,143,9,1, merged,0,0,0.0149256599113
14755,1000109,2,233,188,45,0.806867,0.193133,1.630396,43,2,234,189,45,0.807692,0.192308,1.624359,43,2,-1, merged,0,0,0.849358108108
14757,1000014,3,513,442,71,0.861598,0.138402,2.633718,67,4,514,443,71,0.861868,0.138132,2.639201,67,4,1, merged,0,0,0.0612110300267
14761,1000003,3,501,421,80,0.840319,0.159681,2.419415,74,6,502,422,80,0.840637,0.159363,2.407839,74,6,-1, abandoned,0,0,0.419228949056
14761,1000329,2,603,451,152,0.747927,0.252073,1.579096,143,9,604,451,153,0.746689,0.253311,1.567202,144,9,1, abandoned,1,1,0.246222130471
14763,1000329,4,604,451,153,0.746689,0.253311,3.235432,144,9,606,453,153,0.747525,0.252475,3.236781,144,9,-1, abandoned,0,0,0
14766,1000003,2,502,422,80,0.840637,0.159363,1.620399,74,6,505,424,81,0.839604,0.160396,1.605686,75,6,-1, merged,1,0,0.468635264265
14771,1000592,2,98,77,21,0.785714,0.214286,1.585714,20,1,101,78,23,0.772277,0.227723,1.536983,22,1,1, merged,1,1,0.0722457854763
14773,1000091,3,157,123,34,0.783439,0.216561,2.40387,32,2,159,124,35,0.779874,0.220126,2.399667,33,2,1, merged,1,1,0.413846520496
14785,1000063,1,1483,1331,152,0.897505,0.102495,0.897505,131,21,1485,1332,153,0.89697,0.10303,0.89697,132,21,1, merged,1,1,0.385206260751
14796,1000063,2,1487,1333,154,0.896436,0.103564,1.850981,132,22,1488,1334,154,0.896505,0.103495,1.851308,132,22,1, merged,0,0,0.00369658246131
14797,1000063,2,1488,1334,154,0.896505,0.103495,1.851308,132,22,1489,1335,154,0.896575,0.103425,1.851631,132,22,1, merged,0,0,0.0037154748855
14810,1000063,1,1489,1335,154,0.896575,0.103425,0.896575,132,22,1490,1336,154,0.896644,0.103356,0.896644,132,22,1, merged,0,0,0.326076390339
14821,1000063,2,1490,1336,154,0.896644,0.103356,1.851952,132,22,1491,1337,154,0.896714,0.103286,1.852269,132,22,1, merged,0,0,0.00374438411617
14844,1000063,1,1496,1342,154,0.897059,0.102941,0.897059,132,22,1499,1344,155,0.896598,0.103402,0.896598,133,22,-1, merged,1,0,0.0407929329818
14851,1000120,2,98,86,12,0.877551,0.122449,1.662117,11,1,99,87,12,0.878788,0.121212,1.664044,11,1,1, merged,0,0,0.346085858586
14865,1000329,2,606,453,153,0.747525,0.252475,0.747525,144,9,607,454,153,0.747941,0.252059,1.747941,144,9,1, merged,0,0,0.727984290623
14867,1000121,2,488,413,75,0.846311,0.153689,1.63979,72,3,489,414,75,0.846626,0.153374,1.642325,72,3,1, merged,0,0,0
14880,1000004,2,687,588,99,0.855895,0.144105,1.702521,81,18,689,590,99,0.856313,0.143687,1.699809,81,18,-1, merged,0,0,0.121128150073
14880,1000121,1,489,414,75,0.846626,0.153374,0.846626,72,3,492,415,77,0.843496,0.156504,0.843496,74,3,1, merged,1,1,0.158660606039
14880,1000329,4,607,454,153,0.747941,0.252059,3.163425,144,9,608,455,153,0.748355,0.251645,3.154587,144,9,-1, merged,0,0,0.256835957184
14881,1000329,2,608,455,153,0.748355,0.251645,1.454777,144,9,609,455,154,0.747126,0.252874,1.447126,145,9,1, abandoned,1,1,0
14883,1000004,1,689,590,99,0.856313,0.143687,0.856313,81,18,691,590,101,0.853835,0.146165,0.853835,81,20,-1, merged,1,1,0.161770958375
14883,1000121,2,492,415,77,0.843496,0.156504,1.699809,74,3,493,415,78,0.841785,0.158215,1.69562,74,4,-1, merged,1,1,0.211937968507
14883,1000329,4,609,455,154,0.747126,0.252874,3.226936,145,9,610,456,154,0.747541,0.252459,3.21928,145,9,1, merged,0,0,0.343370762121
14890,1000105,2,193,154,39,0.797927,0.202073,1.73036,36,3,195,156,39,0.8,0.2,1.733333,36,3,1, merged,0,0,0.0618565328245
14894,1000121,2,493,415,78,0.841785,0.158215,1.589326,74,4,494,416,78,0.842105,0.157895,1.590059,74,4,1, merged,0,0,0.607332780094
14894,1000329,1,610,456,154,0.747541,0.252459,0.747541,145,9,611,457,154,0.747954,0.252046,0.747954,145,9,1, merged,0,0,0.929657683049
14897,1000327,2,322,245,77,0.76087,0.23913,1.492298,61,16,323,246,77,0.76161,0.23839,1.488883,61,16,1, merged,0,0,0.0734086879875
14898,1000327,1,323,246,77,0.76161,0.23839,0.76161,61,16,325,248,77,0.763077,0.236923,0.763077,61,16,1, merged,0,0,0.0619472782266
14903,1000004,1,691,590,101,0.853835,0.146165,0.853835,81,20,692,591,101,0.854046,0.145954,0.854046,81,20,-1, abandoned,0,0,0.372061196824
14911,1000015,3,819,753,66,0.919414,0.080586,2.741636,61,5,820,754,66,0.919512,0.080488,2.643688,61,5,1, merged,0,0,0.0854212118568
14920,1000014,2,516,445,71,0.862403,0.137597,1.704508,67,4,517,446,71,0.862669,0.137331,1.703395,67,4,1, merged,0,0,0.656572368837
14920,1000121,1,494,416,78,0.842105,0.157895,0.842105,74,4,496,417,79,0.840726,0.159274,0.840726,75,4,1, merged,1,1,0.464146412213
14921,1000003,2,506,425,81,0.839921,0.160079,1.667507,75,6,507,426,81,0.840237,0.159763,1.669004,75,6,1, merged,0,0,0.146473468913
14923,1000327,1,326,249,77,0.763804,0.236196,0.763804,61,16,327,250,77,0.764526,0.235474,0.764526,61,16,1, merged,0,0,0.00140176831957
14933,1000121,3,496,417,79,0.840726,0.159274,2.316248,75,4,498,419,79,0.841365,0.158635,2.311518,75,4,-1, merged,0,0,0.132435418889
14946,1000328,1,233,161,72,0.690987,0.309013,0.690987,69,3,234,162,72,0.692308,0.307692,0.692308,69,3,1, merged,0,0,1.15583883504
14954,1000070,5,377,346,31,0.917772,0.082228,4.584211,22,9,378,347,31,0.917989,0.082011,4.555103,22,9,1, merged,0,0,0.724134808853
14955,1000121,1,502,423,79,0.842629,0.157371,0.842629,75,4,503,424,79,0.842942,0.157058,0.842942,75,4,1, merged,0,0,0.305652888031
14969,1000023,2,192,174,18,0.90625,0.09375,1.862534,16,2,193,175,18,0.906736,0.093264,1.857823,16,2,1, merged,0,0,0.00596875463921
14974,1000118,2,465,415,50,0.892473,0.107527,1.539532,49,1,466,416,50,0.892704,0.107296,1.559371,49,1,1, merged,0,0,0.25349488792
14985,1000327,1,328,251,77,0.765244,0.234756,0.765244,61,16,329,252,77,0.765957,0.234043,0.765957,61,16,1, merged,0,0,0.0347202992526
14994,1000014,2,517,446,71,0.862669,0.137331,1.862669,67,4,518,447,71,0.862934,0.137066,1.529601,67,4,1, merged,0,0,0.0514294348596
14998,1000124,2,182,177,5,0.972527,0.027473,1.807579,5,0,183,178,5,0.972678,0.027322,1.809412,5,0,1, merged,0,0,0.0515192446875
14998,1000166,1,97,81,16,0.835052,0.164948,0.835052,15,1,98,82,16,0.836735,0.163265,0.836735,15,1,1, merged,0,0,0.308800526423
14999,1000004,1,694,593,101,0.854467,0.145533,0.854467,81,20,695,594,101,0.854676,0.145324,0.854676,81,20,-1, merged,0,0,0.118078713791
14999,1000121,2,503,424,79,0.842942,0.157058,1.697409,75,4,506,426,80,0.841897,0.158103,1.696573,76,4,-1, merged,1,0,0.160394653236
14999,1000327,4,329,252,77,0.765957,0.234043,3.211733,61,16,331,252,79,0.761329,0.238671,3.204244,61,18,-1, merged,1,1,0.171077091791
14999,1000329,3,612,458,154,0.748366,0.251634,2.445775,145,9,615,459,156,0.746341,0.253659,2.442915,147,9,1, merged,1,1,0.254903507709
15000,1000063,1,1508,1352,156,0.896552,0.103448,0.896552,134,22,1513,1355,158,0.895572,0.104428,0.895572,136,22,-1, merged,1,0,0.0867634587951
15003,1000105,3,195,156,39,0.8,0.2,2.363008,36,3,196,157,39,0.80102,0.19898,2.365431,36,3,1, merged,0,0,0.669964765014
15006,1000120,3,99,87,12,0.878788,0.121212,2.478788,11,1,100,88,12,0.88,0.12,2.213333,11,1,1, merged,0,0,0.578875
15017,1000121,3,506,426,80,0.841897,0.158103,2.398925,76,4,507,427,80,0.842209,0.157791,2.40213,76,4,1, merged,0,0,0.0181665926623
15017,1000327,2,331,252,79,0.761329,0.238671,1.557028,61,18,332,253,79,0.762048,0.237952,1.559921,61,18,1, merged,0,0,0.0137091638749
15030,1000124,2,183,178,5,0.972678,0.027322,1.73544,5,0,184,179,5,0.972826,0.027174,1.736299,5,0,1, merged,0,0,0.0483708565868
15030,1000327,1,333,254,79,0.762763,0.237237,0.762763,61,18,334,255,79,0.763473,0.236527,0.763473,61,18,1, merged,0,0,0.121102217014
15031,1000120,2,100,88,12,0.88,0.12,1.793043,11,1,101,89,12,0.881188,0.118812,1.797855,11,1,1, merged,0,0,0.0600290369256
15041,1000014,1,519,448,71,0.863198,0.136802,0.863198,67,4,520,449,71,0.863462,0.136538,0.863462,67,4,1, merged,0,0,0.0873880922777
15041,1000329,2,616,460,156,0.746753,0.253247,1.609952,147,9,617,461,156,0.747164,0.252836,1.610625,147,9,1, merged,0,0,0.157470028102
15043,1000121,2,507,427,80,0.842209,0.157791,1.605682,76,4,508,428,80,0.84252,0.15748,1.606699,76,4,1, merged,0,0,0.355542527471
15043,1000327,1,334,255,79,0.763473,0.236527,0.763473,61,18,335,256,79,0.764179,0.235821,0.764179,61,18,-1, merged,0,0,0.410165886857
15044,1000003,2,508,427,81,0.840551,0.159449,1.556969,75,6,509,428,81,0.840864,0.159136,1.540864,75,6,-1, abandoned,0,0,0.17136426452
15044,1000004,3,696,595,101,0.854885,0.145115,2.411854,81,20,697,596,101,0.855093,0.144907,2.395958,81,20,-1, abandoned,0,0,0.150553838172
15050,1000329,2,617,461,156,0.747164,0.252836,1.519441,147,9,618,462,156,0.747573,0.252427,1.522083,147,9,1, merged,0,0,0.697383951549
15050,1000592,1,101,78,23,0.772277,0.227723,0.772277,22,1,102,79,23,0.77451,0.22549,0.77451,22,1,1, merged,0,0,0.48379814077
15055,1000105,2,196,157,39,0.80102,0.19898,0.80102,36,3,197,158,39,0.80203,0.19797,1.80203,36,3,1, merged,0,0,0.158723731242
15058,1000121,2,509,429,80,0.842829,0.157171,1.607008,76,4,510,430,80,0.843137,0.156863,1.608018,76,4,1, merged,0,0,0.62807008719
15058,1000327,1,335,256,79,0.764179,0.235821,0.764179,61,18,336,257,79,0.764881,0.235119,0.764881,61,18,1, merged,0,0,0.629120645709
15061,1000004,3,697,596,101,0.855093,0.144907,2.498231,81,20,698,597,101,0.855301,0.144699,2.532384,81,20,1, merged,0,0,0.113720446442
15061,1000121,1,510,430,80,0.843137,0.156863,0.843137,76,4,512,432,80,0.84375,0.15625,0.84375,76,4,-1, merged,0,0,0.153155359283
15062,1000121,2,512,432,80,0.84375,0.15625,1.632394,76,4,514,434,80,0.844358,0.155642,1.631192,76,4,-1, merged,0,0,0.21234947296
15067,1000121,1,514,434,80,0.844358,0.155642,0.844358,76,4,515,435,80,0.84466,0.15534,0.84466,76,4,1, merged,0,0,0.00946183604182
15067,1000592,2,103,80,23,0.776699,0.223301,1.621057,22,1,104,81,23,0.778846,0.221154,1.623506,22,1,1, merged,0,0,0.0508242167768
15068,1000121,1,515,435,80,0.84466,0.15534,0.84466,76,4,516,436,80,0.844961,0.155039,0.844961,76,4,1, merged,0,0,0.596333132409
15068,1000592,2,104,81,23,0.778846,0.221154,1.623506,22,1,105,82,23,0.780952,0.219048,1.625914,22,1,1, merged,0,0,0.769783464567
15084,1000004,2,698,597,101,0.855301,0.144699,1.636253,81,20,700,599,101,0.855714,0.144286,1.638733,81,20,1, merged,0,0,0.0314285714286
15084,1000592,1,105,82,23,0.780952,0.219048,0.780952,22,1,106,83,23,0.783019,0.216981,0.783019,22,1,1, merged,0,0,0.0648330058939
15092,1000118,2,467,417,50,0.892934,0.107066,1.596637,49,1,468,418,50,0.893162,0.106838,1.607448,49,1,1, merged,0,0,0.473116364848
15101,1000023,2,193,175,18,0.906736,0.093264,1.858087,16,2,194,176,18,0.907216,0.092784,1.858829,16,2,1, merged,0,0,0.0493985535581
15108,1000118,1,472,422,50,0.894068,0.105932,0.894068,49,1,473,423,50,0.894292,0.105708,0.894292,49,1,1, merged,0,0,0.0136545134725
15126,1000120,2,101,89,12,0.881188,0.118812,1.719753,11,1,102,90,12,0.882353,0.117647,1.721639,11,1,1, merged,0,0,0.388833746898
15129,1000003,1,509,428,81,0.840864,0.159136,0.840864,75,6,510,429,81,0.841176,0.158824,0.841176,75,6,-1, merged,0,0,0.128629642707
15129,1000004,4,700,599,101,0.855714,0.144286,3.09722,81,20,702,601,101,0.856125,0.143875,3.063003,81,20,-1, merged,0,0,0.117847080827
15129,1000328,2,234,162,72,0.692308,0.307692,1.533172,69,3,239,165,74,0.690377,0.309623,1.531553,71,3,-1, merged,1,0,0.28736612774
15129,1000329,5,618,462,156,0.747573,0.252427,3.844793,147,9,619,463,156,0.747981,0.252019,3.810984,147,9,-1, merged,0,0,0.253811062158
15131,1000043,3,142,116,26,0.816901,0.183099,2.735107,23,3,143,117,26,0.818182,0.181818,2.734192,23,3,1, merged,0,0,0.0658351139979
15131,1000070,1,379,348,31,0.918206,0.081794,0.918206,22,9,381,349,32,0.91601,0.08399,0.91601,23,9,1, merged,1,1,0.053824027637
15132,1000327,2,336,257,79,0.764881,0.235119,1.364881,61,18,337,257,80,0.762611,0.237389,1.429278,61,19,-1, merged,1,1,0.595215852795
15149,1000043,1,143,117,26,0.818182,0.181818,0.818182,23,3,144,118,26,0.819444,0.180556,0.819444,23,3,1, merged,0,0,0.154724979074
15149,1000329,2,625,469,156,0.7504,0.2496,1.568582,147,9,626,470,156,0.750799,0.249201,1.570243,147,9,1, merged,0,0,0.236136255496
15150,1000329,2,626,470,156,0.750799,0.249201,1.469549,147,9,627,471,156,0.751196,0.248804,1.478469,147,9,1, merged,0,0,0.19288557
15155,1000121,4,516,436,80,0.844961,0.155039,3.096738,76,4,517,437,80,0.845261,0.154739,3.101093,76,4,1, merged,0,0,0.0694733902725
15155,1000329,5,627,471,156,0.751196,0.248804,3.847934,147,9,628,472,156,0.751592,0.248408,3.852685,147,9,1, merged,0,0,0.0919072516311
15160,1000014,2,521,450,71,0.863724,0.136276,1.697057,67,4,522,451,71,0.863985,0.136015,1.721128,67,4,1, merged,0,0,0.165575799862
15164,1000011,2,276,260,16,0.942029,0.057971,1.942029,14,2,277,261,16,0.942238,0.057762,1.942238,14,2,-1, merged,0,0,0.263117557933
15167,1000005,2,119,92,27,0.773109,0.226891,1.547757,25,2,120,93,27,0.775,0.225,1.550701,25,2,1, merged,0,0,0.439244410177
15167,1000105,3,197,158,39,0.80203,0.19797,2.349788,36,3,198,159,39,0.80303,0.19697,2.353731,36,3,1, merged,0,0,0.509707886045
15169,1000014,3,522,451,71,0.863985,0.136015,2.592741,67,4,523,452,71,0.864245,0.135755,2.59442,67,4,1, merged,0,0,0.0943198467461
15169,1000043,5,144,118,26,0.819444,0.180556,4.328196,23,3,146,119,27,0.815068,0.184932,4.325719,23,4,-1, merged,1,1,0.123287687968
15169,1000070,4,381,349,32,0.91601,0.08399,3.508751,23,9,382,350,32,0.91623,0.08377,3.51065,23,9,1, merged,0,0,0.0991295058573
15169,1000120,1,103,91,12,0.883495,0.116505,0.883495,11,1,104,92,12,0.884615,0.115385,0.884615,11,1,1, merged,0,0,0.0428528961103
15169,1000121,2,517,437,80,0.845261,0.154739,1.728756,76,4,518,438,80,0.84556,0.15444,1.730175,76,4,1, merged,0,0,0.0662919740154
15173,1000070,2,382,350,32,0.91623,0.08377,1.91623,23,9,383,351,32,0.916449,0.083551,1.916449,23,9,1, merged,0,0,0.0827155815762
15182,1000063,2,1522,1364,158,0.896189,0.103811,1.647772,136,22,1523,1365,158,0.896257,0.103743,1.647046,136,22,-1, abandoned,0,0,0
15182,1000329,1,632,475,157,0.751582,0.248418,0.751582,148,9,634,476,158,0.750789,0.249211,0.750789,149,9,1, abandoned,1,1,0
15184,1000004,1,703,601,102,0.854908,0.145092,0.854908,82,20,704,602,102,0.855114,0.144886,0.855114,82,20,1, merged,0,0,0
15184,1000043,2,146,119,27,0.815068,0.184932,1.669976,23,4,147,120,27,0.816327,0.183673,1.67144,23,4,1, merged,0,0,0
15191,1000004,2,704,602,102,0.855114,0.144886,1.605902,82,20,705,603,102,0.855319,0.144681,1.604925,82,20,1, merged,0,0,0.00477405614625
15191,1000329,1,634,476,158,0.750789,0.249211,0.750789,149,9,635,476,159,0.749606,0.250394,0.749606,150,9,1, merged,1,1,0.00059888208677
15197,1000327,2,339,259,80,0.764012,0.235988,1.511661,61,19,340,259,81,0.761765,0.238235,1.509809,62,19,1, abandoned,1,1,0.05226911796
15197,1000329,1,638,477,161,0.747649,0.252351,0.747649,150,11,639,478,161,0.748044,0.251956,0.748044,150,11,-1, abandoned,0,0,0.0827358485608
15209,1000120,1,106,94,12,0.886792,0.113208,0.886792,11,1,108,95,13,0.87963,0.12037,0.87963,12,1,1, merged,1,1,0
15210,1000120,2,108,95,13,0.87963,0.12037,1.765046,12,1,109,96,13,0.880734,0.119266,1.759522,12,1,1, merged,0,0,0.0353402023815
15211,1000120,1,109,96,13,0.880734,0.119266,0.880734,12,1,112,97,15,0.866071,0.133929,0.866071,14,1,1, merged,1,1,0.0417622009319
15212,1000120,1,112,97,15,0.866071,0.133929,0.866071,14,1,113,97,16,0.858407,0.141593,0.858407,15,1,1, merged,1,1,0.227272727273
15213,1000120,1,113,97,16,0.858407,0.141593,0.858407,15,1,115,97,18,0.843478,0.156522,0.843478,17,1,1, merged,1,1,0.236046511628
15214,1000120,2,115,97,18,0.843478,0.156522,1.718478,17,1,116,98,18,0.844828,0.155172,1.722186,17,1,1, merged,0,0,0.122501695727
15215,1000004,2,707,605,102,0.855728,0.144272,1.700556,82,20,709,606,103,0.854725,0.145275,1.693708,83,20,1, merged,1,1,0.0215107174945
15215,1000120,1,116,98,18,0.844828,0.155172,0.844828,17,1,118,99,19,0.838983,0.161017,0.838983,18,1,1, merged,1,1,0.254618937644
15217,1000120,1,118,99,19,0.838983,0.161017,0.838983,18,1,119,99,20,0.831933,0.168067,0.831933,19,1,1, merged,1,1,0.111614774682
15218,1000120,3,119,99,20,0.831933,0.168067,2.438157,19,1,120,100,20,0.833333,0.166667,2.431441,19,1,1, merged,0,0,0.0193735579116
15219,1000004,1,709,606,103,0.854725,0.145275,0.854725,83,20,711,608,103,0.855134,0.144866,0.855134,83,20,-1, abandoned,0,0,0
15219,1000120,5,120,100,20,0.833333,0.166667,4.050872,19,1,122,100,22,0.819672,0.180328,3.975657,21,1,1, abandoned,1,1,0
15221,1000004,1,711,608,103,0.855134,0.144866,0.855134,83,20,713,608,105,0.852735,0.147265,0.852735,85,20,1, abandoned,1,1,0
15221,1000120,4,122,100,22,0.819672,0.180328,3.255449,21,1,123,100,23,0.813008,0.186992,3.227604,22,1,1, abandoned,1,1,0
15222,1000004,1,713,608,105,0.852735,0.147265,0.852735,85,20,714,609,105,0.852941,0.147059,0.852941,85,20,-1, abandoned,0,0,0.0105844033391
15226,1000329,3,639,478,161,0.748044,0.251956,2.435178,150,11,641,479,162,0.74727,0.25273,2.32338,150,12,-1, merged,1,0,0.073463473161
15235,1000121,3,518,438,80,0.84556,0.15444,2.532001,76,4,519,439,80,0.845857,0.154143,2.529191,76,4,1, merged,0,0,0.154025833041
15235,1000327,4,340,259,81,0.761765,0.238235,3.293765,62,19,341,260,81,0.762463,0.237537,3.291654,62,19,1, merged,0,0,0.167056762999
15236,1000121,1,519,439,80,0.845857,0.154143,0.845857,76,4,521,440,81,0.84453,0.15547,0.84453,77,4,1, merged,1,1,0.0254424901529
15236,1000329,2,641,479,162,0.74727,0.25273,1.593127,150,12,642,479,163,0.746106,0.253894,1.590636,151,12,1, merged,1,1,0.0305179527203
15239,1000014,2,524,452,72,0.862595,0.137405,1.707125,67,5,526,453,73,0.861217,0.138783,1.702517,68,5,-1, merged,1,0,0
15239,1000121,1,521,440,81,0.84453,0.15547,0.84453,77,4,523,440,83,0.8413,0.1587,0.8413,79,4,1, merged,1,1,0.115783698039
15240,1000004,2,714,609,105,0.852941,0.147059,1.599047,85,20,715,610,105,0.853147,0.146853,1.599648,85,20,1, merged,0,0,0.0232175448045
15240,1000329,1,642,479,163,0.746106,0.253894,0.746106,151,12,643,480,163,0.746501,0.253499,0.746501,151,12,1, merged,0,0,0.021791460788
15250,1000014,2,526,453,73,0.861217,0.138783,1.607718,68,5,527,454,73,0.86148,0.13852,1.607217,68,5,1, merged,0,0,0.0735847984788
15250,1000329,1,643,480,163,0.746501,0.253499,0.746501,151,12,645,481,164,0.745736,0.254264,0.745736,152,12,1, merged,1,1,0.0543969265841
15255,1000015,1,836,770,66,0.921053,0.078947,0.921053,61,5,838,772,66,0.921241,0.078759,0.921241,61,5,-1, merged,0,0,0.187887702568
15255,1000153,2,437,402,35,0.919908,0.080092,1.840961,28,7,438,403,35,0.920091,0.079909,1.841332,28,7,1, merged,0,0,0.190506605479
15256,1000015,1,838,772,66,0.921241,0.078759,0.921241,61,5,840,773,67,0.920238,0.079762,0.920238,62,5,-1, merged,1,0,0.21031571004
15257,1000015,1,840,773,67,0.920238,0.079762,0.920238,62,5,841,774,67,0.920333,0.079667,0.920333,62,5,1, merged,0,0,0
15257,1000153,2,438,403,35,0.920091,0.079909,1.840329,28,7,439,403,36,0.917995,0.082005,1.838328,28,8,-1, merged,1,1,0.529952434714
15262,1000004,2,715,610,105,0.853147,0.146853,1.61561,85,20,718,613,105,0.85376,0.14624,1.616918,85,20,-1, merged,0,0,0.0223161453931
15262,1000327,1,341,260,81,0.762463,0.237537,0.762463,62,19,342,261,81,0.763158,0.236842,0.763158,62,19,-1, merged,0,0,0.00284690004218
15273,1000328,3,239,165,74,0.690377,0.309623,2.132718,71,3,240,166,74,0.691667,0.308333,2.144694,71,3,-1, abandoned,0,0,0.211304504181
15274,1000004,1,719,614,105,0.853964,0.146036,0.853964,85,20,721,616,105,0.854369,0.145631,0.854369,85,20,-1, merged,0,0,0.0197975133946
15274,1000043,2,148,121,27,0.817568,0.182432,1.671531,23,4,149,122,27,0.818792,0.181208,1.673161,23,4,1, merged,0,0,0.0265907772409
15279,1000063,1,1526,1368,158,0.896461,0.103539,0.896461,136,22,1527,1369,158,0.896529,0.103471,0.896529,136,22,1, merged,0,0,0.00369198706474
15299,1000063,2,1527,1369,158,0.896529,0.103471,0.896529,136,22,1528,1370,158,0.896597,0.103403,1.563264,136,22,-1, merged,0,0,0.00807176526566
15305,1000327,1,344,263,81,0.764535,0.235465,0.764535,62,19,345,263,82,0.762319,0.237681,0.762319,63,19,1, merged,1,1,0.21855390187
15305,1000329,2,647,483,164,0.746522,0.253478,1.511057,152,12,649,485,164,0.747304,0.252696,1.509622,152,12,-1, merged,0,0,0.317778164427
15306,1000329,1,649,485,164,0.747304,0.252696,0.747304,152,12,650,486,164,0.747692,0.252308,0.747692,152,12,1, merged,0,0,0.311662311912
15312,1000091,2,161,126,35,0.782609,0.217391,1.497283,33,2,162,127,35,0.783951,0.216049,1.499398,33,2,1, merged,0,0,0.156061183273
15313,1000328,1,240,166,74,0.691667,0.308333,0.691667,71,3,241,167,74,0.692946,0.307054,0.692946,71,3,1, merged,0,0,0.602270637985
15314,1000091,2,162,127,35,0.783951,0.216049,1.500167,33,2,163,128,35,0.785276,0.214724,1.502257,33,2,1, merged,0,0,0.522861426768
15315,1000091,3,163,128,35,0.785276,0.214724,2.195203,33,2,164,129,35,0.786585,0.213415,2.198542,33,2,1, merged,0,0,0.136723481555
15315,1000328,1,241,167,74,0.692946,0.307054,0.692946,71,3,242,168,74,0.694215,0.305785,0.694215,71,3,1, merged,0,0,0.21599395227
15323,1000004,2,721,616,105,0.854369,0.145631,1.663691,85,20,722,617,105,0.854571,0.145429,1.664697,85,20,1, merged,0,0,0
15323,1000109,1,236,191,45,0.809322,0.190678,0.809322,43,2,237,192,45,0.810127,0.189873,0.810127,43,2,1, merged,0,0,0.0667366211962
15351,1000023,1,196,178,18,0.908163,0.091837,0.908163,16,2,197,179,18,0.908629,0.091371,0.908629,16,2,1, merged,0,0,0.00409676000706
15352,1000014,1,531,457,74,0.86064,0.13936,0.86064,69,5,532,458,74,0.860902,0.139098,0.860902,69,5,1, merged,0,0,0.000979386242763
15352,1000063,2,1528,1370,158,0.896597,0.103403,1.757237,136,22,1529,1371,158,0.896664,0.103336,1.757567,136,22,1, merged,0,0,0.00352292102153
15362,1000014,2,532,458,74,0.860902,0.139098,1.781424,69,5,533,459,74,0.861163,0.138837,1.781779,69,5,1, merged,0,0,0.748111398205
15362,1000015,1,843,776,67,0.920522,0.079478,0.920522,62,5,844,777,67,0.920616,0.079384,0.920616,62,5,1, merged,0,0,1.09000607995
15363,1000004,2,722,617,105,0.854571,0.145429,1.705145,85,20,723,618,105,0.854772,0.145228,1.69093,85,20,1, merged,0,0,0.184746832637
15384,1000004,1,723,618,105,0.854772,0.145228,0.854772,85,20,725,620,105,0.855172,0.144828,0.855172,85,20,-1, merged,0,0,0.0142899607377
15384,1000070,2,383,351,32,0.916449,0.083551,1.771221,23,9,384,352,32,0.916667,0.083333,1.771839,23,9,1, merged,0,0,0.0221520729586
15385,1000130,2,139,119,20,0.856115,0.143885,1.660311,17,3,141,120,21,0.851064,0.148936,1.65796,18,3,1, merged,1,1,0.0287281199224
15388,1000004,1,726,621,105,0.855372,0.144628,0.855372,85,20,728,623,105,0.855769,0.144231,0.855769,85,20,-1, merged,0,0,0.462804449302
15402,1000130,1,141,120,21,0.851064,0.148936,0.851064,18,3,142,120,22,0.84507,0.15493,0.84507,19,3,1, merged,1,1,0.150625642711
15407,1000014,1,533,459,74,0.861163,0.138837,0.861163,69,5,534,460,74,0.861423,0.138577,0.861423,69,5,1, merged,0,0,0.641044266468
15409,1000070,3,385,353,32,0.916883,0.083117,2.666883,23,9,386,354,32,0.917098,0.082902,2.681804,23,9,1, merged,0,0,0.802170190344
15415,1000118,2,476,425,51,0.892857,0.107143,1.68318,50,1,477,426,51,0.893082,0.106918,1.684526,50,1,1, merged,0,0,0.20733865295
15419,1000091,2,164,129,35,0.786585,0.213415,1.505084,33,2,165,130,35,0.787879,0.212121,1.50713,33,2,1, merged,0,0,0.527885372382
15423,1000091,2,165,130,35,0.787879,0.212121,1.50713,33,2,166,130,36,0.783133,0.216867,1.498558,34,2,1, abandoned,1,1,0
15423,1000329,3,666,500,166,0.750751,0.249249,2.257881,152,14,667,500,167,0.749625,0.250375,2.248183,153,14,1, abandoned,1,1,0
15432,1000004,2,730,624,106,0.854795,0.145205,1.691873,85,21,731,625,106,0.854993,0.145007,1.678198,85,21,1, merged,0,0,0.370053512159
15435,1000004,2,731,625,106,0.854993,0.145007,1.670211,85,21,732,626,106,0.855191,0.144809,1.65733,85,21,1, merged,0,0,0.0712132642069
15436,1000004,2,732,626,106,0.855191,0.144809,1.65733,85,21,733,627,106,0.855389,0.144611,1.644862,85,21,1, merged,0,0,0.0714079846138
15443,1000004,1,733,627,106,0.855389,0.144611,0.855389,85,21,734,628,106,0.855586,0.144414,0.855586,85,21,1, merged,0,0,0.0224732793419
15443,1000120,2,123,100,23,0.813008,0.186992,1.668397,22,1,124,101,23,0.814516,0.185484,1.670102,22,1,1, merged,0,0,0.271396396396
15446,1000070,1,386,354,32,0.917098,0.082902,0.917098,23,9,388,355,33,0.914948,0.085052,0.914948,24,9,-1, merged,1,0,0.00662334070796
15446,1000124,3,186,181,5,0.973118,0.026882,1.890217,5,0,188,183,5,0.973404,0.026596,2.221686,5,0,-1, merged,0,0,0.0738923310062
15448,1000004,2,734,628,106,0.855586,0.144414,1.75225,85,21,735,629,106,0.855782,0.144218,1.752582,85,21,-1, abandoned,0,0,0.0758937338477
15448,1000063,1,1529,1371,158,0.896664,0.103336,0.896664,136,22,1531,1373,158,0.896799,0.103201,0.896799,136,22,-1, abandoned,0,0,0.130122160516
15449,1000118,2,478,427,51,0.893305,0.106695,1.711487,50,1,479,428,51,0.893528,0.106472,1.719615,50,1,1, merged,0,0,0.528889584798
15457,1000091,2,167,131,36,0.784431,0.215569,1.534056,34,2,168,132,36,0.785714,0.214286,1.536832,34,2,-1, merged,0,0,0.11990747964
15457,1000121,4,523,440,83,0.8413,0.1587,3.069571,79,4,527,441,86,0.836812,0.163188,3.069117,82,4,1, merged,1,1,0.0698559641915
15457,1000328,3,242,168,74,0.694215,0.305785,2.228271,71,3,243,169,74,0.695473,0.304527,2.232305,71,3,-1, merged,0,0,0.151490245982
15457,1000329,1,667,500,167,0.749625,0.250375,0.749625,153,14,671,504,167,0.751118,0.248882,0.751118,153,14,-1, merged,0,0,0.0921601680713
15460,1000063,1,1533,1375,158,0.896934,0.103066,0.896934,136,22,1535,1377,158,0.897068,0.102932,0.897068,136,22,1, merged,0,0,0.0841707189781
15465,1000063,1,1536,1378,158,0.897135,0.102865,0.897135,136,22,1537,1379,158,0.897202,0.102798,0.897202,136,22,1, merged,0,0,0.0687062621262
15472,1000014,2,538,463,75,0.860595,0.139405,1.860595,70,5,539,464,75,0.860853,0.139147,1.860853,70,5,1, merged,0,0,0.662220989024
15478,1000014,1,539,464,75,0.860853,0.139147,0.860853,70,5,540,465,75,0.861111,0.138889,0.861111,70,5,1, merged,0,0,0.516102791644
15478,1000592,2,112,88,24,0.785714,0.214286,1.646568,23,1,113,89,24,0.787611,0.212389,1.648722,23,1,1, merged,0,0,0.504993638677
15484,1000329,2,671,504,167,0.751118,0.248882,1.608261,153,14,672,505,167,0.751488,0.248512,1.626488,153,14,1, merged,0,0,0.712425842796
15487,1000004,1,735,629,106,0.855782,0.144218,0.855782,85,21,736,629,107,0.85462,0.14538,0.85462,86,21,1, merged,1,1,0.0492036885418
15487,1000592,3,114,90,24,0.789474,0.210526,2.478589,23,1,115,91,24,0.791304,0.208696,2.488029,23,1,1, merged,0,0,0.113788366237
15525,1000327,2,346,264,82,0.763006,0.236994,1.478431,63,19,347,265,82,0.763689,0.236311,1.477974,63,19,-1, abandoned,0,0,0.0122277303383
15525,1000592,3,115,91,24,0.791304,0.208696,2.269736,23,1,116,92,24,0.793103,0.206897,2.271078,23,1,-1, abandoned,0,0,0.0197031912853
15527,1000014,2,543,468,75,0.861878,0.138122,1.736878,70,5,544,469,75,0.862132,0.137868,1.751021,70,5,1, merged,0,0,0.590518401266
15531,1000004,1,736,629,107,0.85462,0.14538,0.85462,86,21,737,630,107,0.854817,0.145183,0.854817,86,21,-1, merged,0,0,0
15536,1000328,1,243,169,74,0.695473,0.304527,0.695473,71,3,245,170,75,0.693878,0.306122,0.693878,72,3,1, merged,1,1,0
15541,1000105,2,198,159,39,0.80303,0.19697,1.738928,36,3,199,160,39,0.80402,0.19598,1.740729,36,3,1, merged,0,0,0.629955901959
15548,1000121,2,527,441,86,0.836812,0.163188,1.634684,82,4,528,442,86,0.837121,0.162879,1.637121,82,4,1, merged,0,0,0.0122708634982
15551,1000004,1,737,630,107,0.854817,0.145183,0.854817,86,21,739,632,107,0.85521,0.14479,0.85521,86,21,-1, merged,0,0,0.0197693241603
15557,1000070,3,389,356,33,0.915167,0.084833,2.085622,24,9,390,357,33,0.915385,0.084615,2.181385,24,9,1, merged,0,0,0.701436823455
15557,1000121,1,528,442,86,0.837121,0.162879,0.837121,82,4,529,443,86,0.837429,0.162571,0.837429,82,4,1, merged,0,0,0.467052219543
15558,1000109,2,239,194,45,0.811715,0.188285,1.626232,43,2,242,195,47,0.805785,0.194215,1.60266,45,2,-1, merged,1,0,0.00101655809998
15571,1000014,1,545,470,75,0.862385,0.137615,0.862385,70,5,546,471,75,0.862637,0.137363,0.862637,70,5,1, merged,0,0,0.515936022595
15571,1000120,3,124,101,23,0.814516,0.185484,2.590196,22,1,125,102,23,0.816,0.184,2.592182,22,1,1, merged,0,0,0.355268595041
15574,1000003,1,519,437,82,0.842004,0.157996,0.842004,76,6,521,438,83,0.840691,0.159309,0.840691,77,6,1, merged,1,1,0.000724112961622
15574,1000120,2,125,102,23,0.816,0.184,1.658004,22,1,126,103,23,0.81746,0.18254,1.658151,22,1,1, merged,0,0,0.194845360825
15576,1000007,1,422,360,62,0.853081,0.146919,0.853081,52,10,424,361,63,0.851415,0.148585,0.851415,53,10,1, merged,1,1,0.0786098215661
15576,1000009,2,397,331,66,0.833753,0.166247,1.686834,58,8,398,332,66,0.834171,0.165829,1.685586,58,8,1, merged,0,0,0.066236704542
15578,1000007,2,425,362,63,0.851765,0.148235,1.685936,53,10,426,363,63,0.852113,0.147887,1.686699,53,10,-1, abandoned,0,0,1.26765311355
15578,1000009,1,398,332,66,0.834171,0.165829,0.834171,58,8,399,333,66,0.834586,0.165414,0.834586,58,8,-1, abandoned,0,0,1.10052682646
15581,1000004,1,739,632,107,0.85521,0.14479,0.85521,86,21,740,633,107,0.855405,0.144595,0.855405,86,21,1, merged,0,0,0.0311645880866
15581,1000328,2,245,170,75,0.693878,0.306122,1.549087,72,3,246,171,75,0.695122,0.304878,1.550527,72,3,1, merged,0,0,0.0423815791587
15581,1000592,4,116,92,24,0.793103,0.206897,3.184296,23,1,117,93,24,0.794872,0.205128,3.195399,23,1,1, merged,0,0,0.0755542855758
15584,1000329,1,673,506,167,0.751857,0.248143,0.751857,153,14,674,506,168,0.750742,0.249258,0.750742,154,14,1, merged,1,1,1.0172401358
15585,1000121,3,529,443,86,0.837429,0.162571,2.310393,82,4,530,444,86,0.837736,0.162264,2.332437,82,4,1, merged,0,0,0.00093342943346
15585,1000329,2,674,506,168,0.750742,0.249258,1.472964,154,14,675,507,168,0.751111,0.248889,1.494701,154,14,-1, merged,0,0,0.00115811222018
15590,1000118,1,480,429,51,0.89375,0.10625,0.89375,50,1,481,430,51,0.893971,0.106029,0.893971,50,1,1, merged,0,0,0
15591,1000105,2,199,160,39,0.80402,0.19598,1.642448,36,3,200,161,39,0.805,0.195,1.64413,36,3,1, merged,0,0,0.0865951226809
15599,1000004,1,740,633,107,0.855405,0.144595,0.855405,86,21,741,633,108,0.854251,0.145749,0.854251,86,22,-1, merged,1,1,0
15607,1000063,1,1539,1381,158,0.897336,0.102664,0.897336,136,22,1540,1382,158,0.897403,0.102597,0.897403,136,22,1, merged,0,0,0.0685884419872
15620,1000118,3,482,431,51,0.894191,0.105809,2.504591,50,1,484,432,52,0.892562,0.107438,2.453877,51,1,1, merged,1,1,0.155266306962
15624,1000070,1,393,360,33,0.916031,0.083969,0.916031,24,9,394,361,33,0.916244,0.083756,0.916244,24,9,1, merged,0,0,0.0796195325609
15626,1000118,2,484,432,52,0.892562,0.107438,1.619835,51,1,485,433,52,0.892784,0.107216,1.628078,51,1,1, merged,0,0,0.00654829280846
15643,1000014,2,550,474,76,0.861818,0.138182,1.750707,71,5,552,475,77,0.860507,0.139493,1.760507,71,6,-1, merged,1,1,0.295804494125
15644,1000014,2,552,475,77,0.860507,0.139493,1.760507,71,6,553,476,77,0.860759,0.139241,1.76985,71,6,1, merged,0,0,0.595366866393
15645,1000121,3,530,444,86,0.837736,0.162264,1.755918,82,4,531,445,86,0.838041,0.161959,2.75696,82,4,1, merged,0,0,0.452157587066
15646,1000121,2,531,445,86,0.838041,0.161959,1.838041,82,4,532,446,86,0.838346,0.161654,1.838346,82,4,1, merged,0,0,0.452627188974
15647,1000121,2,532,446,86,0.838346,0.161654,1.838346,82,4,533,447,86,0.838649,0.161351,1.838649,82,4,1, merged,0,0,0.125273221896
15653,1000014,2,553,476,77,0.860759,0.139241,1.76985,71,6,554,477,77,0.861011,0.138989,1.777677,71,6,1, merged,0,0,0.581116916533
15658,1000091,1,170,133,37,0.782353,0.217647,0.782353,35,2,171,134,37,0.783626,0.216374,0.783626,35,2,-1, abandoned,0,0,0.243329186436
15658,1000328,2,246,171,75,0.695122,0.304878,1.477475,72,3,247,171,76,0.692308,0.307692,1.475933,73,3,1, abandoned,1,1,0.310416645071
15658,1000329,3,679,510,169,0.751105,0.248895,2.228579,155,14,680,511,169,0.751471,0.248529,2.227404,155,14,-1, abandoned,0,0,0.222814910658
15665,1000004,3,742,634,108,0.854447,0.145553,2.38097,86,22,743,635,108,0.854643,0.145357,2.381396,86,22,1, merged,0,0,0.073744476476
15665,1000121,4,536,450,86,0.839552,0.160448,3.220523,82,4,537,451,86,0.839851,0.160149,3.221247,82,4,1, merged,0,0,0.0956877628915
15671,1000004,1,743,635,108,0.854643,0.145357,0.854643,86,22,746,638,108,0.855228,0.144772,0.855228,86,22,-1, merged,0,0,0.0102907056117
15674,1000329,1,680,511,169,0.751471,0.248529,0.751471,155,14,681,512,169,0.751836,0.248164,0.751836,155,14,-1, abandoned,0,0,0.0221327967807
15681,1000070,2,395,362,33,0.916456,0.083544,1.833122,24,9,396,363,33,0.916667,0.083333,1.77381,24,9,1, merged,0,0,0.555830363163
15683,1000121,1,537,451,86,0.839851,0.160149,0.839851,82,4,538,451,87,0.83829,0.16171,0.83829,83,4,1, merged,1,1,0
15684,1000004,1,746,638,108,0.855228,0.144772,0.855228,86,22,747,639,108,0.855422,0.144578,0.855422,86,22,-1, merged,0,0,0.0300755392393
15684,1000014,3,554,477,77,0.861011,0.138989,2.573382,71,6,555,478,77,0.861261,0.138739,2.591683,71,6,1, merged,0,0,0.0431090516152
15689,1000105,2,202,163,39,0.806931,0.193069,1.681931,36,3,203,164,39,0.807882,0.192118,1.641215,36,3,1, merged,0,0,0.264100137316
15690,1000124,1,192,187,5,0.973958,0.026042,0.973958,5,0,193,188,5,0.974093,0.025907,0.974093,5,0,1, merged,0,0,0.0229619281139
15705,1000003,2,521,438,83,0.840691,0.159309,1.661883,77,6,526,442,84,0.840304,0.159696,1.662673,78,6,-1, merged,1,0,0.0519626548126
15706,1000014,3,555,478,77,0.861261,0.138739,2.44643,71,6,556,479,77,0.861511,0.138489,2.455815,71,6,1, merged,0,0,0.598251610875
15706,1000329,2,681,512,169,0.751836,0.248164,1.585169,155,14,682,513,169,0.752199,0.247801,1.594305,155,14,1, merged,0,0,0.649742988043
15717,1000014,3,556,479,77,0.861511,0.138489,2.484232,71,6,557,479,78,0.859964,0.140036,2.480283,71,7,-1, merged,1,1,0
15717,1000091,1,172,135,37,0.784884,0.215116,0.784884,35,2,174,136,38,0.781609,0.218391,0.781609,36,2,1, merged,1,1,0.403784673249
15722,1000329,1,682,513,169,0.752199,0.247801,0.752199,155,14,683,514,169,0.752562,0.247438,0.752562,155,14,-1, merged,0,0,0.917623622282
15724,1000329,3,683,514,169,0.752562,0.247438,2.26172,155,14,684,515,169,0.752924,0.247076,2.255998,155,14,1, merged,0,0,0
15724,1000592,2,117,93,24,0.794872,0.205128,1.509158,23,1,119,94,25,0.789916,0.210084,1.503074,23,2,-1, merged,1,0,0
15726,1000329,2,686,517,169,0.753644,0.246356,1.54356,155,14,689,519,170,0.753266,0.246734,1.536599,156,14,-1, merged,1,0,0.0670611456737
15726,1000592,1,119,94,25,0.789916,0.210084,0.789916,23,2,120,94,26,0.783333,0.216667,0.783333,24,2,1, merged,1,1,0.0714804009911
15729,1000007,1,427,364,63,0.852459,0.147541,0.852459,53,10,429,366,63,0.853147,0.146853,0.853147,53,10,-1, merged,0,0,0.118018674715
15729,1000153,2,440,404,36,0.918182,0.081818,1.770641,28,8,442,406,36,0.918552,0.081448,1.771699,28,8,-1, merged,0,0,0.103873386138
15732,1000091,2,174,136,38,0.781609,0.218391,1.620319,36,2,175,137,38,0.782857,0.217143,1.622429,36,2,-1, abandoned,0,0,0.390315916098
15735,1000063,2,1552,1393,159,0.897552,0.102448,1.650817,137,22,1553,1394,159,0.897618,0.102382,1.651241,137,22,1, merged,0,0,0.00636201824991
15735,1000329,1,689,519,170,0.753266,0.246734,0.753266,156,14,690,520,170,0.753623,0.246377,0.753623,156,14,-1, merged,0,0,0.00329401285439
15739,1000004,1,748,640,108,0.855615,0.144385,0.855615,86,22,749,641,108,0.855808,0.144192,0.855808,86,22,1, merged,0,0,0.0737338357828
15739,1000592,4,120,94,26,0.783333,0.216667,3.077195,24,2,121,95,26,0.785124,0.214876,3.087901,24,2,1, merged,0,0,0.119567175674
15740,1000121,1,538,451,87,0.83829,0.16171,0.83829,83,4,540,452,88,0.837037,0.162963,0.837037,84,4,1, merged,1,1,0.602921138493
15740,1000329,2,690,520,170,0.753623,0.246377,1.591913,156,14,691,521,170,0.75398,0.24602,1.591017,156,14,-1, merged,0,0,0.871431196803
15746,1000063,1,1555,1396,159,0.897749,0.102251,0.897749,137,22,1557,1398,159,0.897881,0.102119,0.897881,137,22,-1, merged,0,0,0.376586212882
15749,1000063,1,1557,1398,159,0.897881,0.102119,0.897881,137,22,1558,1399,159,0.897946,0.102054,0.897946,137,22,1, merged,0,0,0.37649956213
15752,1000063,1,1558,1399,159,0.897946,0.102054,0.897946,137,22,1559,1400,159,0.898012,0.101988,0.898012,137,22,-1, merged,0,0,0.375964291524
15755,1000063,1,1559,1400,159,0.898012,0.101988,0.898012,137,22,1561,1402,159,0.898142,0.101858,0.898142,137,22,-1, merged,0,0,0.378463894848
15758,1000063,1,1561,1402,159,0.898142,0.101858,0.898142,137,22,1563,1403,160,0.897633,0.102367,0.897633,138,22,1, merged,1,1,0.167841025502
15761,1000118,1,485,433,52,0.892784,0.107216,0.892784,51,1,486,434,52,0.893004,0.106996,0.893004,51,1,1, merged,0,0,0.0790876192882
15778,1000014,1,557,479,78,0.859964,0.140036,0.859964,71,7,559,480,79,0.858676,0.141324,0.858676,71,8,-1, merged,1,1,0.000728862973761
15780,1000328,2,247,171,76,0.692308,0.307692,1.478974,73,3,248,172,76,0.693548,0.306452,1.481159,73,3,1, merged,0,0,0.605576679341
15787,1000004,2,749,641,108,0.855808,0.144192,1.664631,86,22,750,642,108,0.856,0.144,1.665756,86,22,1, merged,0,0,0.0299810410203
15787,1000105,1,204,165,39,0.808824,0.191176,0.808824,36,3,205,166,39,0.809756,0.190244,0.809756,36,3,1, merged,0,0,0.00142500890631
15789,1000109,2,245,198,47,0.808163,0.191837,1.613532,45,2,246,199,47,0.808943,0.191057,1.608943,45,2,1, merged,0,0,0.345939498507
15789,1000199,1,149,120,29,0.805369,0.194631,0.805369,27,2,150,120,30,0.8,0.2,0.8,28,2,1, merged,1,1,0.362800250698
15790,1000014,2,560,481,79,0.858929,0.141071,1.701034,71,8,561,482,79,0.85918,0.14082,1.70918,71,8,1, merged,0,0,0.143588963562
15801,1000070,2,396,363,33,0.916667,0.083333,1.753704,24,9,397,364,33,0.916877,0.083123,1.754215,24,9,1, merged,0,0,0.268704579377
15801,1000121,1,540,452,88,0.837037,0.162963,0.837037,84,4,541,453,88,0.837338,0.162662,0.837338,84,4,1, merged,0,0,0.20601791845
15802,1000014,1,564,483,81,0.856383,0.143617,0.856383,73,8,565,484,81,0.856637,0.143363,0.856637,73,8,1, merged,0,0,0.0231963993179
15802,1000023,2,197,179,18,0.908629,0.091371,1.765012,16,2,198,180,18,0.909091,0.090909,1.765728,16,2,1, merged,0,0,0.134643976311
15816,1000109,1,246,199,47,0.808943,0.191057,0.808943,45,2,247,200,47,0.809717,0.190283,0.809717,45,2,1, merged,0,0,0.333834090374
15816,1000199,2,151,121,30,0.801325,0.198675,1.610268,28,2,152,122,30,0.802632,0.197368,1.612348,28,2,1, merged,0,0,0.345228246943
15823,1000109,1,247,200,47,0.809717,0.190283,0.809717,45,2,249,202,47,0.811245,0.188755,0.811245,45,2,-1, merged,0,0,1.42136842105
15826,1000014,1,569,487,82,0.855888,0.144112,0.855888,73,9,570,488,82,0.85614,0.14386,0.85614,73,9,1, merged,0,0,0.0112887725214
15826,1000023,2,198,180,18,0.909091,0.090909,1.764978,16,2,199,181,18,0.909548,0.090452,1.765688,16,2,1, merged,0,0,0.0593445605592
15828,1000592,3,121,95,26,0.785124,0.214876,2.232094,24,2,123,97,26,0.788618,0.211382,2.243964,24,2,1, merged,0,0,0.747823494335
15841,1000124,3,196,191,5,0.97449,0.02551,2.518198,5,0,197,192,5,0.974619,0.025381,2.505321,5,0,1, merged,0,0,0.0158454036444
15852,1000003,2,529,445,84,0.84121,0.15879,1.599831,78,6,531,447,84,0.841808,0.158192,1.601584,78,6,-1, merged,0,0,0.000979673113638
15865,1000023,1,199,181,18,0.909548,0.090452,0.909548,16,2,200,181,19,0.905,0.095,0.905,17,2,1, merged,1,1,0.00190173420251
15865,1000063,2,1564,1404,160,0.897698,0.102302,1.807246,138,22,1568,1408,160,0.897959,0.102041,1.802959,138,22,-1, merged,0,0,0.00519179723734
15890,1000023,1,202,183,19,0.905941,0.094059,0.905941,17,2,203,184,19,0.906404,0.093596,0.906404,17,2,-1, merged,0,0,0.687249106238
15896,1000063,1,1573,1412,161,0.897648,0.102352,0.897648,139,22,1574,1413,161,0.897713,0.102287,0.897713,139,22,1, merged,0,0,0.0685725547995
15906,1000063,2,1575,1414,161,0.897778,0.102222,1.852323,139,22,1578,1417,161,0.897972,0.102028,1.847972,139,22,-1, merged,0,0,0.00372093497323
15909,1000105,2,207,168,39,0.811594,0.188406,1.638125,36,3,208,169,39,0.8125,0.1875,1.640783,36,3,1, merged,0,0,0.546552596942
15923,1000329,1,692,522,170,0.754335,0.245665,0.754335,156,14,694,524,170,0.755043,0.244957,0.755043,156,14,-1, merged,0,0,0.116571750073
15924,1000121,2,542,454,88,0.837638,0.162362,1.592682,84,4,543,455,88,0.837937,0.162063,1.594035,84,4,1, merged,0,0,0.0337016299226
15924,1000329,1,694,524,170,0.755043,0.244957,0.755043,156,14,697,527,170,0.756098,0.243902,0.756098,156,14,-1, merged,0,0,0.0366311798698
15927,1000004,1,750,642,108,0.856,0.144,0.856,86,22,751,643,108,0.856192,0.143808,0.856192,86,22,-1, merged,0,0,0.027817061152
15927,1000329,3,701,530,171,0.756063,0.243937,2.325974,157,14,702,531,171,0.75641,0.24359,2.327262,157,14,1, merged,0,0,0.0334385901959
15946,1000329,1,702,531,171,0.75641,0.24359,0.75641,157,14,705,532,173,0.75461,0.24539,0.75461,159,14,1, merged,1,1,0.110709802609
15952,1000070,1,399,366,33,0.917293,0.082707,0.917293,24,9,401,367,34,0.915212,0.084788,0.915212,25,9,1, merged,1,1,0.0828619276997
15964,1000118,2,487,435,52,0.893224,0.106776,1.727935,51,1,488,436,52,0.893443,0.106557,1.728834,51,1,1, merged,0,0,0.237332533317
15968,1000009,2,403,337,66,0.836228,0.163772,1.758592,58,8,404,338,66,0.836634,0.163366,1.759087,58,8,1, merged,0,0,0.114678913411
15968,1000015,1,863,796,67,0.922364,0.077636,0.922364,62,5,864,797,67,0.922454,0.077546,0.922454,62,5,1, merged,0,0,0.106091907268
15972,1000014,2,575,492,83,0.855652,0.144348,1.712795,74,9,576,493,83,0.855903,0.144097,1.719539,74,9,1, merged,0,0,0.724699551569
15977,1000327,1,347,265,82,0.763689,0.236311,0.763689,63,19,349,267,82,0.765043,0.234957,0.765043,63,19,-1, merged,0,0,0.228373401572
15977,1000328,2,248,172,76,0.693548,0.306452,1.457237,73,3,249,173,76,0.694779,0.305221,1.459822,73,3,1, merged,0,0,0.3608781577
15985,1000105,3,208,169,39,0.8125,0.1875,2.484741,36,3,209,170,39,0.813397,0.186603,2.493446,36,3,1, merged,0,0,0.617537067962
15988,1000121,2,543,455,88,0.837937,0.162063,1.779114,84,4,544,456,88,0.838235,0.161765,1.78268,84,4,1, merged,0,0,0.504631193165
15990,1000070,1,402,368,34,0.915423,0.084577,0.915423,25,9,403,369,34,0.915633,0.084367,0.915633,25,9,1, merged,0,0,0.709896328705
15998,1000003,2,531,447,84,0.841808,0.158192,1.540603,78,6,532,448,84,0.842105,0.157895,1.547988,78,6,1, merged,0,0,0.130064788978
16003,1000121,3,544,456,88,0.838235,0.161765,2.344503,84,4,546,457,89,0.836996,0.163004,2.325885,85,4,1, merged,1,1,0.0111017917534
16003,1000329,1,718,543,175,0.756267,0.243733,0.756267,161,14,720,544,176,0.755556,0.244444,0.755556,162,14,1, merged,1,1,0.00918998303043
16005,1000014,1,577,494,83,0.856153,0.143847,0.856153,74,9,581,497,84,0.855422,0.144578,0.855422,75,9,-1, merged,1,0,0.0201328916228
16005,1000023,2,205,186,19,0.907317,0.092683,1.76347,17,2,206,187,19,0.907767,0.092233,1.763189,17,2,-1, merged,0,0,0
16017,1000004,1,753,645,108,0.856574,0.143426,0.856574,86,22,754,646,108,0.856764,0.143236,0.856764,86,22,1, merged,0,0,0.0143075617195
16017,1000592,3,123,97,26,0.788618,0.211382,2.495192,24,2,124,98,26,0.790323,0.209677,2.504229,24,2,1, merged,0,0,0.0322717992197
16019,1000009,1,405,339,66,0.837037,0.162963,0.837037,58,8,406,340,66,0.837438,0.162562,0.837438,58,8,-1, merged,0,0,0.00904034526762
16019,1000015,2,866,799,67,0.922633,0.077367,1.75967,62,5,867,800,67,0.922722,0.077278,1.76016,62,5,-1, merged,0,0,0.00941677023222
16021,1000014,2,581,497,84,0.855422,0.144578,1.675422,75,9,582,497,85,0.853952,0.146048,1.668521,76,9,1, merged,1,1,0.0349111446678
16021,1000043,1,150,123,27,0.82,0.18,0.82,23,4,151,123,28,0.81457,0.18543,0.81457,24,4,1, merged,1,1,0.0448664888893
16035,1000327,2,349,267,82,0.765043,0.234957,1.485556,63,19,350,268,82,0.765714,0.234286,1.485102,63,19,1, merged,0,0,0.0908173469165
16037,1000014,2,582,497,85,0.853952,0.146048,1.770619,76,9,583,498,85,0.854202,0.145798,1.7711,76,9,1, merged,0,0,0.511360119048
16040,1000121,2,546,457,89,0.836996,0.163004,1.591844,85,4,547,458,89,0.837294,0.162706,1.592481,85,4,1, merged,0,0,0.155569306078
16040,1000329,1,722,545,177,0.754848,0.245152,0.754848,163,14,723,546,177,0.755187,0.244813,0.755187,163,14,-1, merged,0,0,0.217935361841
16049,1000130,2,146,123,23,0.842466,0.157534,1.662979,20,3,148,125,23,0.844595,0.155405,1.66105,20,3,-1, merged,0,0,0.0506040678997
16065,1000063,2,1580,1419,161,0.898101,0.101899,1.849082,139,22,1586,1425,161,0.898487,0.101513,1.840516,139,22,-1, merged,0,0,0.00561169822378
16087,1000063,1,1593,1432,161,0.898933,0.101067,0.898933,139,22,1594,1433,161,0.898996,0.101004,0.898996,139,22,1, merged,0,0,0.264958606308
16095,1000091,3,176,138,38,0.784091,0.215909,2.378999,36,2,178,139,39,0.780899,0.219101,2.375751,37,2,1, abandoned,1,1,0.275930172892
16095,1000329,1,725,547,178,0.754483,0.245517,0.754483,164,14,728,548,180,0.752747,0.247253,0.752747,166,14,-1, abandoned,1,0,0.47925688878
16096,1000329,1,728,548,180,0.752747,0.247253,0.752747,166,14,730,549,181,0.752055,0.247945,0.752055,167,14,-1, abandoned,1,0,0.479946084437
16107,1000014,1,583,498,85,0.854202,0.145798,0.854202,76,9,584,499,85,0.854452,0.145548,0.854452,76,9,1, merged,0,0,0
16108,1000063,1,1597,1436,161,0.899186,0.100814,0.899186,139,22,1598,1437,161,0.899249,0.100751,0.899249,139,22,-1, abandoned,0,0,0.0533697495118
16112,1000105,1,209,170,39,0.813397,0.186603,0.813397,36,3,212,171,41,0.806604,0.193396,0.806604,38,3,1, merged,1,1,0.0907526048708
16113,1000328,2,249,173,76,0.694779,0.305221,1.415591,73,3,250,174,76,0.696,0.304,1.413884,73,3,1, merged,0,0,0.195557980757
16115,1000004,2,755,647,108,0.856954,0.143046,1.609348,86,22,756,648,108,0.857143,0.142857,1.609875,86,22,1, merged,0,0,0.0119913343128
16115,1000329,1,731,550,181,0.752394,0.247606,0.752394,167,14,732,551,181,0.752732,0.247268,0.752732,167,14,1, merged,0,0,0.0111220187509
16117,1000007,2,436,372,64,0.853211,0.146789,1.795657,54,10,437,372,65,0.851259,0.148741,1.794319,55,10,1, merged,1,1,1.08755088517
16117,1000011,1,278,262,16,0.942446,0.057554,0.942446,14,2,281,265,16,0.94306,0.05694,0.94306,14,2,-1, merged,0,0,1.11305987742
16132,1000124,5,197,192,5,0.974619,0.025381,4.01074,5,0,198,192,6,0.969697,0.030303,3.991631,6,0,1, merged,1,1,0.0143539814684
16135,1000023,1,210,190,20,0.904762,0.095238,0.904762,18,2,212,192,20,0.90566,0.09434,0.90566,18,2,1, merged,0,0,0
16137,1000329,2,734,553,181,0.753406,0.246594,1.576935,167,14,735,554,181,0.753741,0.246259,1.587075,167,14,1, merged,0,0,0.00278316508959
16138,1000014,1,584,499,85,0.854452,0.145548,0.854452,76,9,585,499,86,0.852991,0.147009,0.852991,77,9,1, merged,1,1,0.163984462709
16147,1000003,1,537,452,85,0.841713,0.158287,0.841713,79,6,538,453,85,0.842007,0.157993,0.842007,79,6,-1, merged,0,0,0.120117154915
16158,1000004,1,756,648,108,0.857143,0.142857,0.857143,86,22,757,649,108,0.857332,0.142668,0.857332,86,22,-1, abandoned,0,0,0.475620519522
16158,1000014,2,585,499,86,0.852991,0.147009,1.710134,77,9,586,500,86,0.853242,0.146758,1.710574,77,9,-1, abandoned,0,0,0.540746309227
16158,1000120,3,133,110,23,0.827068,0.172932,2.537202,22,1,135,111,24,0.822222,0.177778,2.532796,23,1,1, abandoned,1,1,0.535041966427
16162,1000014,2,586,500,86,0.853242,0.146758,1.758903,77,9,587,501,86,0.853492,0.146508,1.759596,77,9,1, merged,0,0,0.061065757865
16162,1000023,1,212,192,20,0.90566,0.09434,0.90566,18,2,213,193,20,0.906103,0.093897,0.906103,18,2,1, merged,0,0,0.342643326906
16163,1000012,2,292,264,28,0.90411,0.09589,1.750263,27,1,295,265,30,0.898305,0.101695,1.7364,29,1,1, merged,1,1,0.0581252575197
16168,1000329,2,737,556,181,0.75441,0.24559,1.534582,167,14,740,558,182,0.754054,0.245946,1.528522,168,14,1, merged,1,1,0
16171,1000329,2,740,558,182,0.754054,0.245946,1.455547,168,14,741,559,182,0.754386,0.245614,1.45809,168,14,1, merged,0,0,0.621416557793
16173,1000153,1,446,410,36,0.919283,0.080717,0.919283,28,8,448,412,36,0.919643,0.080357,0.919643,28,8,-1, merged,0,0,0.266597973883
16179,1000003,2,541,456,85,0.842884,0.157116,1.666413,79,6,544,459,85,0.84375,0.15625,1.668425,79,6,-1, merged,0,0,0.370185938252
16182,1000121,5,547,458,89,0.837294,0.162706,3.909258,85,4,548,459,89,0.837591,0.162409,3.906484,85,4,-1, abandoned,0,0,0
16182,1000328,4,250,174,76,0.696,0.304,3.071964,73,3,251,174,77,0.693227,0.306773,3.068892,74,3,1, abandoned,1,1,0
16182,1000329,3,741,559,182,0.754386,0.245614,2.375964,168,14,743,559,184,0.752355,0.247645,2.375665,170,14,1, abandoned,1,1,0
16191,1000121,2,548,459,89,0.837591,0.162409,1.589947,85,4,549,459,90,0.836066,0.163934,1.58741,86,4,1, abandoned,1,1,0.0993310196687
16191,1000329,1,743,559,184,0.752355,0.247645,0.752355,170,14,744,559,185,0.751344,0.248656,0.751344,171,14,1, abandoned,1,1,0.144271096461
16192,1000063,2,1598,1437,161,0.899249,0.100751,1.841833,139,22,1599,1438,161,0.899312,0.100688,1.842169,139,22,1, merged,0,0,0.00367858842212
16219,1000063,1,1600,1439,161,0.899375,0.100625,0.899375,139,22,1604,1442,162,0.899002,0.100998,0.899002,140,22,-1, merged,1,0,0.0800469753386
16226,1000043,2,153,124,29,0.810458,0.189542,0.810458,25,4,154,125,29,0.811688,0.188312,1.811688,25,4,1, merged,0,0,0.0395945983164
16239,1000063,2,1611,1449,162,0.899441,0.100559,1.650785,140,22,1612,1450,162,0.899504,0.100496,1.650508,140,22,-1, merged,0,0,0.339814598939
16239,1000329,1,744,559,185,0.751344,0.248656,0.751344,171,14,747,561,186,0.751004,0.248996,0.751004,172,14,1, merged,1,1,0.199015373078
16240,1000023,2,215,195,20,0.906977,0.093023,1.849834,18,2,216,196,20,0.907407,0.092593,1.850535,18,2,1, merged,0,0,0.00283271571559
16252,1000070,2,406,372,34,0.916256,0.083744,1.706832,25,9,408,374,34,0.916667,0.083333,1.704231,25,9,-1, merged,0,0,0.567742036179
16272,1000043,2,155,126,29,0.812903,0.187097,1.47957,25,4,157,127,30,0.808917,0.191083,1.308917,26,4,1, abandoned,1,1,0.370646716187
16272,1000153,3,448,412,36,0.919643,0.080357,2.399213,28,8,449,413,36,0.919822,0.080178,2.228739,28,8,-1, abandoned,0,0,0.2798279072
16282,1000043,1,157,127,30,0.808917,0.191083,0.808917,26,4,158,128,30,0.810127,0.189873,0.810127,26,4,1, merged,0,0,0.0961908005603
16282,1000070,2,409,375,34,0.91687,0.08313,1.725788,25,9,411,376,35,0.914842,0.085158,1.724968,25,10,-1, merged,1,1,0.09211842669
16284,1000007,2,441,376,65,0.852608,0.147392,1.690446,55,10,442,377,65,0.852941,0.147059,1.691176,55,10,1, merged,0,0,0.0336841530477
16284,1000009,1,407,341,66,0.837838,0.162162,0.837838,58,8,408,342,66,0.838235,0.161765,0.838235,58,8,1, merged,0,0,0.0306116104448
16284,1000153,3,449,413,36,0.919822,0.080178,2.610267,28,8,450,414,36,0.92,0.08,2.611176,28,8,1, merged,0,0,0.0294652158673
16288,1000199,1,152,122,30,0.802632,0.197368,0.802632,28,2,153,123,30,0.803922,0.196078,0.803922,28,2,1, merged,0,0,0.828521332554
16289,1000121,2,549,459,90,0.836066,0.163934,1.757118,86,4,550,460,90,0.836364,0.163636,1.758103,86,4,1, merged,0,0,0.225702134159
16290,1000014,1,588,502,86,0.853741,0.146259,0.853741,77,9,590,504,86,0.854237,0.145763,0.854237,77,9,-1, merged,0,0,0.256368419556
16297,1000109,2,253,206,47,0.814229,0.185771,1.620199,45,2,256,207,49,0.808594,0.191406,1.602711,47,2,1, merged,1,1,0.56925475377
16298,1000007,2,442,377,65,0.852941,0.147059,1.691966,55,10,443,377,66,0.851016,0.148984,1.685967,56,10,1, merged,1,1,0.038717889363
16298,1000009,1,410,344,66,0.839024,0.160976,0.839024,58,8,412,344,68,0.834951,0.165049,0.834951,60,8,1, merged,1,1,0.0341567923693
16302,1000023,1,216,196,20,0.907407,0.092593,0.907407,18,2,217,196,21,0.903226,0.096774,0.903226,18,3,-1, merged,1,1,0.0048744381462
16302,1000063,2,1613,1451,162,0.899566,0.100434,1.806973,140,22,1614,1452,162,0.899628,0.100372,1.802854,140,22,1, merged,0,0,0.0037674745648
16310,1000070,1,411,376,35,0.914842,0.085158,0.914842,25,10,412,377,35,0.915049,0.084951,0.915049,25,10,1, merged,0,0,0
16313,1000014,2,591,505,86,0.854484,0.145516,1.617196,77,9,592,506,86,0.85473,0.14527,1.61811,77,9,1, merged,0,0,0.135524973226
16313,1000327,1,354,270,84,0.762712,0.237288,0.762712,65,19,355,271,84,0.76338,0.23662,0.76338,65,19,1, merged,0,0,0.219622671236
16323,1000004,2,757,649,108,0.857332,0.142668,1.608336,86,22,758,650,108,0.85752,0.14248,1.607854,86,22,1, merged,0,0,0.0115984754086
16323,1000329,1,747,561,186,0.751004,0.248996,0.751004,172,14,749,562,187,0.750334,0.249666,0.750334,172,15,-1, merged,1,1,0.0140417391431
16327,1000014,1,593,507,86,0.854975,0.145025,0.854975,77,9,595,509,86,0.855462,0.144538,0.855462,77,9,-1, merged,0,0,0
16328,1000004,2,758,650,108,0.85752,0.14248,1.73752,86,22,759,651,108,0.857708,0.142292,1.742323,86,22,1, merged,0,0,0.465539691982
16331,1000153,2,452,416,36,0.920354,0.079646,1.700842,28,8,453,417,36,0.92053,0.07947,1.702788,28,8,1, merged,0,0,0.00516723165017
16337,1000004,1,759,651,108,0.857708,0.142292,0.857708,86,22,760,652,108,0.857895,0.142105,0.857895,86,22,-1, merged,0,0,0.116350948958
16337,1000121,3,552,462,90,0.836957,0.163043,2.444998,86,4,553,463,90,0.837251,0.162749,2.445813,86,4,1, merged,0,0,0.153202715669
16337,1000329,2,749,562,187,0.750334,0.249666,1.608041,172,15,750,563,187,0.750667,0.249333,1.608561,172,15,1, merged,0,0,0.229144721186
16341,1000327,1,355,271,84,0.76338,0.23662,0.76338,65,19,356,271,85,0.761236,0.238764,0.761236,65,20,-1, merged,1,1,0.692777416878
16341,1000329,2,750,563,187,0.750667,0.249333,1.514047,172,15,751,564,187,0.750999,0.249001,1.512235,172,15,1, merged,0,0,0.96600168237
16343,1000153,3,453,417,36,0.92053,0.07947,2.59652,28,8,455,419,36,0.920879,0.079121,2.603652,28,8,1, merged,0,0,0.0469270883333
16346,1000121,3,553,463,90,0.837251,0.162749,2.087251,86,4,554,464,90,0.837545,0.162455,2.237545,86,4,1, merged,0,0,0.574712781825
16347,1000329,2,752,565,187,0.75133,0.24867,1.470628,172,15,753,566,187,0.75166,0.24834,1.47166,172,15,-1, abandoned,0,0,0.0496413362743
16352,1000109,2,257,208,49,0.809339,0.190661,1.603456,47,2,259,209,50,0.80695,0.19305,1.60257,48,2,1, merged,1,1,0.281912544267
16360,1000329,2,754,567,187,0.751989,0.248011,1.664558,172,15,755,568,187,0.752318,0.247682,1.665124,172,15,1, merged,0,0,0.205218037293
16361,1000118,1,499,447,52,0.895792,0.104208,0.895792,51,1,500,448,52,0.896,0.104,0.896,51,1,1, merged,0,0,0.105054049062
16361,1000132,2,107,89,18,0.831776,0.168224,1.727567,16,2,108,90,18,0.833333,0.166667,1.729333,16,2,1, merged,0,0,0.693254657914
16371,1000063,1,1617,1455,162,0.899814,0.100186,0.899814,140,22,1621,1458,163,0.899445,0.100555,0.899445,141,22,-1, merged,1,0,0.00375952475732
16376,1000063,1,1621,1458,163,0.899445,0.100555,0.899445,141,22,1622,1459,163,0.899507,0.100493,0.899507,141,22,1, merged,0,0,0.191755712659
16377,1000063,1,1622,1459,163,0.899507,0.100493,0.899507,141,22,1624,1460,164,0.899015,0.100985,0.899015,142,22,1, merged,1,1,0.189274916506
16381,1000105,2,213,172,41,0.807512,0.192488,1.657512,38,3,214,173,41,0.808411,0.191589,1.655386,38,3,-1, abandoned,0,0,0.13848246028
16384,1000023,1,217,196,21,0.903226,0.096774,0.903226,18,3,218,197,21,0.90367,0.09633,0.90367,18,3,-1, merged,0,0,0.00434551020688
16384,1000063,2,1624,1460,164,0.899015,0.100985,1.802241,142,22,1626,1462,164,0.899139,0.100861,1.802809,142,22,-1, merged,0,0,0.00310571552853
16388,1000043,2,159,129,30,0.811321,0.188679,1.311321,26,4,161,131,30,0.813665,0.186335,1.258109,26,4,-1, merged,0,0,0.683751115438
16389,1000043,2,161,131,30,0.813665,0.186335,1.258109,26,4,162,132,30,0.814815,0.185185,1.314815,26,4,1, merged,0,0,0.685633209016
16400,1000014,2,597,511,86,0.855946,0.144054,1.855946,77,9,598,511,87,0.854515,0.145485,1.479515,78,9,1, abandoned,1,1,0
16400,1000327,5,356,271,85,0.761236,0.238764,4.117182,65,20,357,272,85,0.761905,0.238095,3.695965,65,20,-1, abandoned,0,0,0.575433884298
16401,1000014,2,598,511,87,0.854515,0.145485,1.479515,78,9,599,512,87,0.854758,0.145242,1.410313,78,9,-1, abandoned,0,0,0.576986369331
16420,1000004,1,761,653,108,0.858081,0.141919,0.858081,86,22,762,653,109,0.856955,0.143045,0.856955,87,22,1, merged,1,1,0.0896297199667
16420,1000063,2,1626,1462,164,0.899139,0.100861,1.75722,142,22,1629,1465,164,0.899325,0.100675,1.75628,142,22,-1, merged,0,0,0.169712096706
16427,1000004,2,762,653,109,0.856955,0.143045,1.67177,87,22,763,654,109,0.857143,0.142857,1.673094,87,22,1, merged,0,0,0.0646621447962
16427,1000043,1,162,132,30,0.814815,0.185185,0.814815,26,4,163,133,30,0.815951,0.184049,0.815951,26,4,1, merged,0,0,0.147693701173
16429,1000015,2,872,805,67,0.923165,0.076835,1.923165,62,5,873,806,67,0.923253,0.076747,1.923253,62,5,1, merged,0,0,0.939347842458
16431,1000004,2,763,654,109,0.857143,0.142857,1.857143,87,22,765,655,110,0.856209,0.143791,1.522876,88,22,-1, merged,1,0,0.155252220947
16431,1000121,5,555,465,90,0.837838,0.162162,4.209858,86,4,556,465,91,0.836331,0.163669,3.874408,87,4,1, merged,1,1,0.204545240248
16431,1000327,3,357,272,85,0.761905,0.238095,2.619048,65,20,358,273,85,0.76257,0.23743,2.285446,65,20,-1, merged,0,0,0.225331832101
16431,1000329,4,757,570,187,0.752972,0.247028,3.37202,172,15,760,572,188,0.752632,0.247368,3.038077,173,15,1, merged,1,1,0.305508521348
16438,1000109,2,266,216,50,0.81203,0.18797,1.607651,48,2,267,217,50,0.812734,0.187266,1.609836,48,2,1, merged,0,0,1.13741567203
16468,1000121,1,556,465,91,0.836331,0.163669,0.836331,87,4,559,466,93,0.833631,0.166369,0.833631,89,4,-1, merged,1,0,0.307028525121
16468,1000329,2,763,574,189,0.752294,0.247706,1.588625,174,15,766,577,189,0.753264,0.246736,1.586895,174,15,-1, merged,0,0,0.458364623521
16470,1000329,2,766,577,189,0.753264,0.246736,1.591973,174,15,767,578,189,0.753585,0.246415,1.594855,174,15,1, merged,0,0,0
16480,1000063,1,1630,1466,164,0.899387,0.100613,0.899387,142,22,1633,1468,165,0.898959,0.101041,0.898959,143,22,-1, merged,1,0,0.160378390219
16481,1000063,2,1633,1468,165,0.898959,0.101041,1.810487,143,22,1635,1470,165,0.899083,0.100917,1.808416,143,22,-1, merged,0,0,0.160387801204
16482,1000070,2,416,381,35,0.915865,0.084135,1.858541,25,10,417,381,36,0.913669,0.086331,1.850378,26,10,1, merged,1,1,0.365275351228
16483,1000592,3,124,98,26,0.790323,0.209677,2.425243,24,2,125,99,26,0.792,0.208,2.44511,24,2,1, merged,0,0,0.770819112628
16484,1000592,2,125,99,26,0.792,0.208,1.581474,24,2,126,100,26,0.793651,0.206349,1.593651,24,2,1, merged,0,0,0.123073390235
16485,1000011,1,281,265,16,0.94306,0.05694,0.94306,14,2,283,266,17,0.939929,0.060071,0.939929,15,2,1, merged,1,1,0.448821873099
16486,1000011,2,283,266,17,0.939929,0.060071,0.939929,15,2,287,270,17,0.940767,0.059233,0.940767,15,2,-1, merged,0,0,0.139736513989
16489,1000063,1,1635,1470,165,0.899083,0.100917,0.899083,143,22,1637,1471,166,0.898595,0.101405,0.898595,144,22,1, merged,1,1,0.165385379388
16491,1000063,2,1637,1471,166,0.898595,0.101405,1.805757,144,22,1639,1473,166,0.898719,0.101281,1.803732,144,22,-1, merged,0,0,0.18039751611
16502,1000023,4,218,197,21,0.90367,0.09633,3.626756,18,3,219,198,21,0.90411,0.09589,3.629037,18,3,1, merged,0,0,0.00112102294119
16502,1000063,1,1639,1473,166,0.898719,0.101281,0.898719,144,22,1640,1474,166,0.89878,0.10122,0.89878,144,22,-1, merged,0,0,0.00103583890253
16504,1000118,2,503,451,52,0.89662,0.10338,1.688498,51,1,504,451,53,0.894841,0.105159,1.687771,52,1,1, abandoned,1,1,0
16505,1000063,1,1640,1474,166,0.89878,0.10122,0.89878,144,22,1641,1475,166,0.898842,0.101158,0.898842,144,22,1, merged,0,0,0.0568437132473
16510,1000014,1,603,516,87,0.855721,0.144279,0.855721,78,9,604,517,87,0.85596,0.14404,0.85596,78,9,1, merged,0,0,0.0391291875815
16510,1000015,2,874,807,67,0.923341,0.076659,1.779062,62,5,875,808,67,0.923429,0.076571,1.779389,62,5,1, merged,0,0,0.0576397727221
16511,1000153,2,464,427,37,0.920259,0.079741,1.704259,29,8,465,428,37,0.92043,0.07957,1.706144,29,8,1, merged,0,0,0.404163612447
16512,1000014,1,604,517,87,0.85596,0.14404,0.85596,78,9,605,518,87,0.856198,0.143802,0.856198,78,9,1, merged,0,0,0.121395083057
16514,1000063,1,1641,1475,166,0.898842,0.101158,0.898842,144,22,1642,1476,166,0.898904,0.101096,0.898904,144,22,1, merged,0,0,0.331435050873
16515,1000063,1,1642,1476,166,0.898904,0.101096,0.898904,144,22,1643,1477,166,0.898965,0.101035,0.898965,144,22,1, merged,0,0,0.325627655133
16516,1000063,1,1643,1477,166,0.898965,0.101035,0.898965,144,22,1644,1478,166,0.899027,0.100973,0.899027,144,22,1, merged,0,0,0.325678736333
16517,1000063,1,1644,1478,166,0.899027,0.100973,0.899027,144,22,1645,1479,166,0.899088,0.100912,0.899088,144,22,1, merged,0,0,0.339565244574
16518,1000063,1,1645,1479,166,0.899088,0.100912,0.899088,144,22,1646,1480,166,0.899149,0.100851,0.899149,144,22,1, merged,0,0,0.364597894332
16520,1000003,1,548,461,87,0.841241,0.158759,0.841241,81,6,553,465,88,0.840868,0.159132,0.840868,82,6,-1, merged,1,0,0.0312738826466
16520,1000015,2,875,808,67,0.923429,0.076571,1.764669,62,5,877,809,68,0.922463,0.077537,1.763331,63,5,1, merged,1,1,0.0315548493869
16524,1000009,2,412,344,68,0.834951,0.165049,1.556314,60,8,413,345,68,0.835351,0.164649,1.557573,60,8,1, merged,0,0,0.00604494096058
16532,1000063,1,1646,1480,166,0.899149,0.100851,0.899149,144,22,1648,1481,167,0.898665,0.101335,0.898665,145,22,-1, merged,1,0,0.0915011898188
16533,1000026,2,181,164,17,0.906077,0.093923,1.720204,15,2,182,165,17,0.906593,0.093407,1.722092,15,2,1, merged,0,0,0.657747428764
16533,1000109,1,269,219,50,0.814126,0.185874,0.814126,48,2,271,221,50,0.815498,0.184502,0.815498,48,2,1, merged,0,0,0.0612694300518
16538,1000014,1,607,520,87,0.856672,0.143328,0.856672,78,9,610,521,89,0.854098,0.145902,0.854098,80,9,1, merged,1,1,0.018103480135
16538,1000023,2,219,198,21,0.90411,0.09589,1.760782,18,3,221,199,22,0.900452,0.099548,1.754551,19,3,1, merged,1,1,0.0768940048748
16545,1000003,1,553,465,88,0.840868,0.159132,0.840868,82,6,554,466,88,0.841155,0.158845,0.841155,82,6,-1, merged,0,0,0.10501109345
16545,1000014,2,610,521,89,0.854098,0.145902,1.694966,80,9,612,523,89,0.854575,0.145425,1.69573,80,9,-1, merged,0,0,0.115957260466
16551,1000105,2,214,173,41,0.808411,0.191589,1.561997,38,3,216,173,43,0.800926,0.199074,1.552874,40,3,1, abandoned,1,1,0.281193434658
16551,1000124,4,205,198,7,0.965854,0.034146,3.37049,7,0,207,199,8,0.961353,0.038647,3.348397,8,0,-1, abandoned,1,0,0.0942151442291
16551,1000329,1,767,578,189,0.753585,0.246415,0.753585,174,15,770,579,191,0.751948,0.248052,0.751948,176,15,-1, abandoned,1,0,0.480332931616
16556,1000063,1,1648,1481,167,0.898665,0.101335,0.898665,145,22,1649,1482,167,0.898727,0.101273,0.898727,145,22,1, merged,0,0,0.324909430965
16587,1000329,1,771,580,191,0.75227,0.24773,0.75227,176,15,773,582,191,0.752911,0.247089,0.752911,176,15,-1, merged,0,0,0.108888294424
16590,1000329,2,773,582,191,0.752911,0.247089,1.596661,176,15,774,583,191,0.75323,0.24677,1.599384,176,15,1, merged,0,0,0
16593,1000004,2,765,655,110,0.856209,0.143791,1.681452,88,22,766,656,110,0.856397,0.143603,1.68332,88,22,1, merged,0,0,0.00148456057007
16595,1000004,2,766,656,110,0.856397,0.143603,1.856397,88,22,767,657,110,0.856584,0.143416,1.856584,88,22,1, merged,0,0,0.370341601735
16598,1000015,1,881,813,68,0.922815,0.077185,0.922815,63,5,883,815,68,0.92299,0.07701,0.92299,63,5,-1, merged,0,0,1.10669388672
16598,1000534,2,6,2,4,0.333333,0.666667,1.256148,4,0,7,3,4,0.428571,0.571429,1.351561,4,0,-1, merged,0,0,1.37379032258
16619,1000063,2,1649,1482,167,0.898727,0.101273,1.698727,145,22,1650,1483,167,0.898788,0.101212,1.703666,145,22,1, merged,0,0,0.329073949163
16626,1000121,2,562,469,93,0.83452,0.16548,1.55452,89,4,563,470,93,0.834813,0.165187,1.555512,89,4,1, merged,0,0,0.603715724072
16635,1000011,2,287,270,17,0.940767,0.059233,1.607433,15,2,288,271,17,0.940972,0.059028,1.690972,15,2,1, merged,0,0,0.896039127326
16639,1000124,2,208,200,8,0.961538,0.038462,1.714768,8,0,209,201,8,0.961722,0.038278,1.715271,8,0,1, merged,0,0,0.0924097371095
16639,1000329,1,774,583,191,0.75323,0.24677,0.75323,176,15,775,584,191,0.753548,0.246452,0.753548,176,15,1, merged,0,0,0.447026766783
16640,1000063,1,1652,1485,167,0.89891,0.10109,0.89891,145,22,1653,1486,167,0.898972,0.101028,0.898972,145,22,1, merged,0,0,0.283796136429
16646,1000327,1,358,273,85,0.76257,0.23743,0.76257,65,20,359,274,85,0.763231,0.236769,0.763231,65,20,-1, abandoned,0,0,0.0233327251504
16646,1000329,3,775,584,191,0.753548,0.246452,2.236816,176,15,776,585,191,0.753866,0.246134,2.23849,176,15,-1, abandoned,0,0,0.0435902289143
16669,1000023,1,221,199,22,0.900452,0.099548,0.900452,19,3,222,200,22,0.900901,0.099099,0.900901,19,3,1, merged,0,0,0
16669,1000063,2,1653,1486,167,0.898972,0.101028,1.799424,145,22,1654,1487,167,0.899033,0.100967,1.799934,145,22,1, merged,0,0,5.42604303345e-05
16671,1000023,1,222,200,22,0.900901,0.099099,0.900901,19,3,223,201,22,0.901345,0.098655,0.901345,19,3,1, merged,0,0,0.000145629300615
16671,1000063,2,1654,1487,167,0.899033,0.100967,1.799934,145,22,1655,1488,167,0.899094,0.100906,1.800439,145,22,1, merged,0,0,9.37216368731e-05
16672,1000105,2,217,174,43,0.801843,0.198157,1.512954,40,3,218,175,43,0.802752,0.197248,1.517038,40,3,1, merged,0,0,0.138711752869
16674,1000105,2,218,175,43,0.802752,0.197248,1.517038,40,3,220,177,43,0.804545,0.195455,1.514223,40,3,-1, merged,0,0,0.27862037902
16676,1000329,2,777,586,191,0.754183,0.245817,1.532425,176,15,778,587,191,0.754499,0.245501,1.529499,176,15,1, merged,0,0,0.191408421097
16678,1000121,2,570,477,93,0.836842,0.163158,1.591341,89,4,571,478,93,0.837128,0.162872,1.591942,89,4,1, merged,0,0,0.147769699411
16678,1000329,1,778,587,191,0.754499,0.245501,0.754499,176,15,779,588,191,0.754814,0.245186,0.754814,176,15,1, merged,0,0,0.21647379692
16679,1000121,2,571,478,93,0.837128,0.162872,1.591942,89,4,572,479,93,0.837413,0.162587,1.592541,89,4,1, merged,0,0,0.0596900829623
16679,1000329,1,779,588,191,0.754814,0.245186,0.754814,176,15,780,589,191,0.755128,0.244872,0.755128,176,15,1, merged,0,0,0.0990021628073
16693,1000004,2,768,658,110,0.856771,0.143229,1.584044,88,22,769,659,110,0.856957,0.143043,1.585054,88,22,1, merged,0,0,0.0257686211961
16702,1000124,2,209,201,8,0.961722,0.038278,1.800106,8,0,211,202,9,0.957346,0.042654,1.797346,8,1,-1, merged,1,1,0.0257369063247
16702,1000166,1,99,83,16,0.838384,0.161616,0.838384,15,1,100,84,16,0.84,0.16,0.84,15,1,1, merged,0,0,0.147425414277
16708,1000004,2,769,659,110,0.856957,0.143043,1.613302,88,22,770,660,110,0.857143,0.142857,1.613797,88,22,1, merged,0,0,0.0248482281519
16708,1000329,1,788,596,192,0.756345,0.243655,0.756345,177,15,789,597,192,0.756654,0.243346,0.756654,177,15,1, merged,0,0,0.0239190432383
16711,1000004,2,771,661,110,0.857328,0.142672,1.61429,88,22,772,662,110,0.857513,0.142487,1.613826,88,22,-1, merged,0,0,0.0795757060925
16711,1000329,1,790,598,192,0.756962,0.243038,0.756962,177,15,792,599,193,0.756313,0.243687,0.756313,178,15,1, merged,1,1,0.146491976027
16713,1000004,1,772,662,110,0.857513,0.142487,0.857513,88,22,773,663,110,0.857697,0.142303,0.857697,88,22,-1, abandoned,0,0,0.387043353452
16713,1000120,2,145,120,25,0.827586,0.172414,1.685099,24,1,146,121,25,0.828767,0.171233,1.686464,24,1,-1, abandoned,0,0,0
16715,1000329,2,792,599,193,0.756313,0.243687,1.590484,178,15,793,600,193,0.75662,0.24338,1.58662,178,15,-1, abandoned,0,0,0.966673466612
16716,1000592,2,126,100,26,0.793651,0.206349,1.593651,24,2,127,101,26,0.795276,0.204724,1.461942,24,2,-1, abandoned,0,0,0.29210818169
16722,1000592,2,127,101,26,0.795276,0.204724,1.658912,24,2,128,102,26,0.796875,0.203125,1.66644,24,2,1, merged,0,0,0.780372250423
16728,1000121,2,572,479,93,0.837413,0.162587,1.594033,89,4,573,480,93,0.837696,0.162304,1.592721,89,4,1, merged,0,0,0
16728,1000329,1,793,600,193,0.75662,0.24338,0.75662,178,15,796,601,195,0.755025,0.244975,0.755025,180,15,1, merged,1,1,0
16729,1000121,2,573,480,93,0.837696,0.162304,1.592721,89,4,574,481,93,0.837979,0.162021,1.591421,89,4,1, merged,0,0,0
16729,1000329,1,796,601,195,0.755025,0.244975,0.755025,180,15,799,602,197,0.753442,0.246558,0.753442,182,15,1, merged,1,1,0
16731,1000121,2,574,481,93,0.837979,0.162021,1.590479,89,4,575,482,93,0.838261,0.161739,1.589505,89,4,1, merged,0,0,0
16731,1000329,1,800,602,198,0.7525,0.2475,0.7525,183,15,804,604,200,0.751244,0.248756,0.751244,185,15,1, merged,1,1,0
16734,1000011,2,288,271,17,0.940972,0.059028,1.690972,15,2,289,272,17,0.941176,0.058824,1.607843,15,2,-1, abandoned,0,0,1.79698879552
16740,1000004,2,773,663,110,0.857697,0.142303,1.689912,88,22,774,664,110,0.857881,0.142119,1.691214,88,22,-1, merged,0,0,0.121162442622
16740,1000120,1,149,124,25,0.832215,0.167785,0.832215,24,1,150,125,25,0.833333,0.166667,0.833333,24,1,-1, merged,0,0,0.135334647371
16751,1000003,1,557,469,88,0.842011,0.157989,0.842011,82,6,558,470,88,0.842294,0.157706,0.842294,82,6,-1, merged,0,0,0.0320353764361
16751,1000007,3,445,379,66,0.851685,0.148315,2.437286,56,10,447,380,67,0.850112,0.149888,2.417406,57,10,1, merged,1,1,0.0439546797332
16751,1000015,4,887,818,69,0.92221,0.07779,3.359496,63,6,888,819,69,0.922297,0.077703,3.339703,63,6,1, merged,0,0,0.0388526416799
16753,1000329,2,809,606,203,0.749073,0.250927,1.599819,187,16,810,607,203,0.749383,0.250617,1.602324,187,16,1, merged,0,0,0
16754,1000329,2,810,607,203,0.749383,0.250617,1.602324,187,16,811,608,203,0.749692,0.250308,1.604764,187,16,1, merged,0,0,0
16757,1000329,2,811,608,203,0.749692,0.250308,1.149692,187,16,812,609,203,0.75,0.25,1.25,187,16,1, merged,0,0,0.620107033639
16762,1000327,2,359,274,85,0.763231,0.236769,1.551519,65,20,360,275,85,0.763889,0.236111,1.548642,65,20,1, merged,0,0,0
16763,1000327,2,360,275,85,0.763889,0.236111,1.548642,65,20,361,276,85,0.764543,0.235457,1.545793,65,20,1, merged,0,0,0
16765,1000327,2,361,276,85,0.764543,0.235457,1.545793,65,20,362,277,85,0.765193,0.234807,1.542971,65,20,1, merged,0,0,0
16767,1000327,2,362,277,85,0.765193,0.234807,1.540524,65,20,363,278,85,0.76584,0.23416,1.53777,65,20,1, merged,0,0,0
16781,1000329,2,812,609,203,0.75,0.25,1.525934,187,16,813,609,204,0.749077,0.250923,1.525937,188,16,1, abandoned,1,1,0
16782,1000014,1,617,527,90,0.854133,0.145867,0.854133,81,9,619,528,91,0.852989,0.147011,0.852989,82,9,1, merged,1,1,0
16782,1000120,3,151,126,25,0.834437,0.165563,2.410654,24,1,152,127,25,0.835526,0.164474,2.411287,24,1,1, merged,0,0,0
16788,1000329,1,813,609,204,0.749077,0.250923,0.749077,188,16,814,610,204,0.749386,0.250614,0.749386,188,16,1, merged,0,0,0.962344654564
16788,1000592,2,128,102,26,0.796875,0.203125,1.545952,24,2,129,103,26,0.79845,0.20155,1.547835,24,2,1, merged,0,0,0.74847972973
16789,1000121,1,578,485,93,0.8391,0.1609,0.8391,89,4,580,487,93,0.839655,0.160345,0.839655,89,4,-1, merged,0,0,0.630916475541
16789,1000329,2,814,610,204,0.749386,0.250614,1.588486,188,16,816,612,204,0.75,0.25,1.589655,188,16,1, merged,0,0,0.963273033337
16790,1000121,1,580,487,93,0.839655,0.160345,0.839655,89,4,581,488,93,0.839931,0.160069,0.839931,89,4,1, merged,0,0,0.148071350269
16790,1000329,2,816,612,204,0.75,0.25,1.589655,188,16,817,613,204,0.750306,0.249694,1.590237,188,16,1, merged,0,0,0.217875686416
16791,1000121,1,581,488,93,0.839931,0.160069,0.839931,89,4,582,489,93,0.840206,0.159794,0.840206,89,4,1, merged,0,0,0.148330153462
16791,1000329,2,817,613,204,0.750306,0.249694,1.590237,188,16,818,614,204,0.750611,0.249389,1.590817,188,16,1, merged,0,0,0.21845516458
16799,1000121,1,582,489,93,0.840206,0.159794,0.840206,89,4,583,490,93,0.84048,0.15952,0.84048,89,4,1, merged,0,0,0.317811942744
16799,1000328,3,251,174,77,0.693227,0.306773,2.284045,74,3,253,174,79,0.687747,0.312253,2.279143,74,5,-1, merged,1,1,0.574473697026
16799,1000329,2,818,614,204,0.750611,0.249389,1.590817,188,16,819,615,204,0.750916,0.249084,1.591396,188,16,1, merged,0,0,0.478865804712
16809,1000327,1,363,278,85,0.76584,0.23416,0.76584,65,20,365,279,86,0.764384,0.235616,0.764384,65,21,-1, merged,1,0,0.612417374882
16817,1000012,2,295,265,30,0.898305,0.101695,1.663011,29,1,296,265,31,0.89527,0.10473,1.617492,30,1,1, abandoned,1,1,0.251435325794
16822,1000070,2,430,394,36,0.916279,0.083721,1.811536,26,10,431,395,36,0.916473,0.083527,1.811937,26,10,1, merged,0,0,0.284666260478
16822,1000118,1,506,453,53,0.895257,0.104743,0.895257,52,1,507,454,53,0.895464,0.104536,0.895464,52,1,1, merged,0,0,0.125507379286
16824,1000004,2,774,664,110,0.857881,0.142119,1.756013,88,22,775,665,110,0.858065,0.141935,1.756319,88,22,1, merged,0,0,0.0132035548032
16824,1000063,1,1659,1490,169,0.898131,0.101869,0.898131,145,24,1661,1492,169,0.898254,0.101746,0.898254,145,24,-1, merged,0,0,0.001395628674
16827,1000063,1,1662,1493,169,0.898315,0.101685,0.898315,145,24,1663,1494,169,0.898376,0.101624,0.898376,145,24,1, merged,0,0,0.185748632985
16829,1000004,2,775,665,110,0.858065,0.141935,1.756441,88,22,778,667,111,0.857326,0.142674,1.754747,89,22,-1, merged,1,0,0
16829,1000063,1,1663,1494,169,0.898376,0.101624,0.898376,145,24,1667,1496,171,0.897421,0.102579,0.897421,147,24,-1, merged,1,0,0
16834,1000118,2,508,455,53,0.895669,0.104331,1.691689,52,1,509,455,54,0.89391,0.10609,1.679275,53,1,1, merged,1,1,9.31721973147e-05
16838,1000063,2,1667,1496,171,0.897421,0.102579,1.802791,147,24,1668,1497,171,0.897482,0.102518,1.800543,147,24,1, merged,0,0,0.146573626008
16848,1000063,1,1670,1499,171,0.897605,0.102395,0.897605,147,24,1671,1500,171,0.897666,0.102334,0.897666,147,24,1, merged,0,0,0.320441734181
16856,1000328,2,254,175,79,0.688976,0.311024,1.411749,74,5,255,176,79,0.690196,0.309804,1.413653,74,5,1, merged,0,0,0.108239816995
16857,1000328,2,255,176,79,0.690196,0.309804,1.413653,74,5,256,177,79,0.691406,0.308594,1.415544,74,5,1, merged,0,0,0.328337444553
16858,1000328,2,256,177,79,0.691406,0.308594,1.415544,74,5,257,178,79,0.692607,0.307393,1.417423,74,5,1, merged,0,0,1.1518809311
16861,1000121,2,584,491,93,0.840753,0.159247,1.53336,89,4,585,492,93,0.841026,0.158974,1.534824,89,4,1, merged,0,0,0.102677587198
16861,1000328,1,257,178,79,0.692607,0.307393,0.692607,74,5,258,179,79,0.693798,0.306202,0.693798,74,5,1, merged,0,0,0.194146921908
16862,1000023,2,225,203,22,0.902222,0.097778,1.596021,19,3,226,204,22,0.902655,0.097345,1.597636,19,3,1, merged,0,0,0.0367354364516
16862,1000328,1,258,179,79,0.693798,0.306202,0.693798,74,5,259,180,79,0.694981,0.305019,0.694981,74,5,1, merged,0,0,0.555253784506
16863,1000063,2,1676,1505,171,0.897971,0.102029,1.644366,147,24,1677,1506,171,0.898032,0.101968,1.644731,147,24,1, merged,0,0,0
16863,1000329,1,832,621,211,0.746394,0.253606,0.746394,195,16,833,622,211,0.746699,0.253301,0.746699,195,16,1, merged,0,0,0
16869,1000329,2,835,624,211,0.747305,0.252695,1.577305,195,16,837,626,211,0.747909,0.252091,1.574642,195,16,-1, merged,0,0,0.29051649626
16870,1000328,1,260,181,79,0.696154,0.303846,0.696154,74,5,261,182,79,0.697318,0.302682,0.697318,74,5,1, merged,0,0,0.576083884799
16870,1000329,2,837,626,211,0.747909,0.252091,1.444063,195,16,838,627,211,0.74821,0.25179,1.445528,195,16,1, merged,0,0,0.481216600417
16881,1000014,1,620,529,91,0.853226,0.146774,0.853226,82,9,622,531,91,0.853698,0.146302,0.853698,82,9,-1, merged,0,0,0.00125676970578
16881,1000329,2,840,628,212,0.747619,0.252381,1.600845,196,16,841,628,213,0.74673,0.25327,1.600428,197,16,1, merged,1,1,0
16884,1000023,1,226,204,22,0.902655,0.097345,0.902655,19,3,227,204,23,0.898678,0.101322,0.898678,20,3,1, merged,1,1,0.0081753585705
16884,1000329,3,841,628,213,0.74673,0.25327,2.374875,197,16,842,629,213,0.747031,0.252969,2.372539,197,16,1, merged,0,0,0.119735015281
16885,1000121,4,585,492,93,0.841026,0.158974,3.013359,89,4,586,492,94,0.83959,0.16041,3.007183,90,4,1, abandoned,1,1,0
16885,1000328,2,262,183,79,0.698473,0.301527,1.445504,74,5,264,184,80,0.69697,0.30303,1.442532,75,5,-1, abandoned,1,0,0
16885,1000329,1,842,629,213,0.747031,0.252969,0.747031,197,16,845,630,215,0.745562,0.254438,0.745562,199,16,-1, abandoned,1,0,0
16891,1000328,2,264,184,80,0.69697,0.30303,1.442532,75,5,265,184,81,0.69434,0.30566,1.437567,76,5,1, abandoned,1,1,0
16891,1000329,1,845,630,215,0.745562,0.254438,0.745562,199,16,849,631,218,0.743227,0.256773,0.743227,202,16,-1, abandoned,1,0,0
16892,1000328,2,265,184,81,0.69434,0.30566,1.437567,76,5,266,184,82,0.691729,0.308271,1.434385,77,5,1, abandoned,1,1,0
16892,1000329,1,849,631,218,0.743227,0.256773,0.743227,202,16,851,632,219,0.742656,0.257344,0.742656,203,16,-1, abandoned,1,0,0
16894,1000121,3,586,492,94,0.83959,0.16041,2.617368,90,4,587,492,95,0.83816,0.16184,2.36275,91,4,1, merged,1,1,0.0351934058185
16894,1000328,4,266,184,82,0.691729,0.308271,3.309098,77,5,269,186,83,0.69145,0.30855,3.0542,78,5,1, merged,1,1,0.0601970448246
16910,1000592,2,129,103,26,0.79845,0.20155,1.19845,24,2,131,104,27,0.793893,0.206107,1.127226,24,3,1, merged,1,0,0.0739544072505
16914,1000043,2,163,133,30,0.815951,0.184049,1.556302,26,4,164,133,31,0.810976,0.189024,1.550462,27,4,1, abandoned,1,1,0
16914,1000329,1,855,633,222,0.740351,0.259649,0.740351,206,16,856,633,223,0.739486,0.260514,0.739486,207,16,1, abandoned,1,1,0
16918,1000328,3,269,186,83,0.69145,0.30855,2.205272,78,5,270,187,83,0.692593,0.307407,2.202393,78,5,-1, abandoned,0,0,0.394720232969
16918,1000329,1,859,635,224,0.739232,0.260768,0.739232,208,16,860,635,225,0.738372,0.261628,0.738372,209,16,1, abandoned,1,1,0.323345048736
16920,1000109,2,272,222,50,0.816176,0.183824,1.620098,48,2,273,223,50,0.81685,0.18315,1.622045,48,2,1, merged,0,0,1.13826521814
16920,1000199,1,153,123,30,0.803922,0.196078,0.803922,28,2,154,124,30,0.805195,0.194805,0.805195,28,2,1, merged,0,0,1.20366492147
16921,1000109,2,273,223,50,0.81685,0.18315,1.622045,48,2,274,224,50,0.817518,0.182482,1.62397,48,2,1, merged,0,0,1.4652016546
16921,1000199,1,154,124,30,0.805195,0.194805,0.805195,28,2,155,125,30,0.806452,0.193548,0.806452,28,2,1, merged,0,0,1.52081395349
16924,1000014,2,625,534,91,0.8544,0.1456,1.592772,82,9,626,535,91,0.854633,0.145367,1.593309,82,9,1, merged,0,0,0
16924,1000329,1,860,635,225,0.738372,0.261628,0.738372,209,16,861,636,225,0.738676,0.261324,0.738676,209,16,1, merged,0,0,0
16926,1000328,1,270,187,83,0.692593,0.307407,0.692593,78,5,271,188,83,0.693727,0.306273,0.693727,78,5,1, merged,0,0,0.608445100693
16937,1000004,1,782,671,111,0.858056,0.141944,0.858056,89,22,783,672,111,0.858238,0.141762,0.858238,89,22,1, merged,0,0,0.042028510653
16942,1000328,2,271,188,83,0.693727,0.306273,1.422092,78,5,272,189,83,0.694853,0.305147,1.42387,78,5,1, merged,0,0,0
16944,1000121,2,588,493,95,0.838435,0.161565,1.623319,91,4,589,494,95,0.83871,0.16129,1.624837,91,4,1, merged,0,0,0.613947468115
16961,1000109,3,274,224,50,0.817518,0.182482,2.281286,48,2,275,225,50,0.818182,0.181818,2.265584,48,2,-1, merged,0,0,1.40139534884
16973,1000118,2,513,459,54,0.894737,0.105263,1.626444,53,1,514,460,54,0.894942,0.105058,1.633037,53,1,1, merged,0,0,0.10201239941
16991,1000063,1,1686,1515,171,0.898577,0.101423,0.898577,147,24,1687,1516,171,0.898637,0.101363,0.898637,147,24,1, merged,0,0,0.320981710929
16997,1000329,2,863,638,225,0.739282,0.260718,1.468298,209,16,864,639,225,0.739583,0.260417,1.469248,209,16,1, merged,0,0,0
17000,1000091,2,178,139,39,0.780899,0.219101,1.475752,37,2,179,140,39,0.782123,0.217877,1.474431,37,2,1, merged,0,0,0.108837190285
17000,1000328,1,272,189,83,0.694853,0.305147,0.694853,78,5,273,189,84,0.692308,0.307692,0.692308,79,5,1, merged,1,1,0.0588259706723
17001,1000091,2,179,140,39,0.782123,0.217877,1.609709,37,2,180,141,39,0.783333,0.216667,1.611765,37,2,1, merged,0,0,0.413066945242
17005,1000329,1,864,639,225,0.739583,0.260417,0.739583,209,16,865,639,226,0.738728,0.261272,0.738728,210,16,1, merged,1,1,0.227267351853
17011,1000105,2,221,178,43,0.80543,0.19457,1.53043,40,3,222,178,44,0.801802,0.198198,1.516088,41,3,1, merged,1,1,0
17011,1000124,3,211,202,9,0.957346,0.042654,2.487776,8,1,214,203,11,0.948598,0.051402,2.464686,10,1,1, merged,1,1,0
17016,1000063,2,1688,1517,171,0.898697,0.101303,1.823225,147,24,1690,1519,171,0.898817,0.101183,1.823548,147,24,-1, abandoned,0,0,0.181003029916
17017,1000070,1,434,398,36,0.917051,0.082949,0.917051,26,10,437,401,36,0.91762,0.08238,0.91762,26,10,-1, merged,0,0,0
17017,1000105,2,222,178,44,0.801802,0.198198,1.718852,41,3,224,179,45,0.799107,0.200893,1.716727,42,3,1, merged,1,1,0
17023,1000004,1,784,673,111,0.858418,0.141582,0.858418,89,22,785,674,111,0.858599,0.141401,0.858599,89,22,-1, merged,0,0,0.387762576927
17023,1000120,2,161,136,25,0.84472,0.15528,1.703139,24,1,162,137,25,0.845679,0.154321,1.704278,24,1,1, merged,0,0,0.502867383513
17025,1000592,2,133,105,28,0.789474,0.210526,0.789474,24,4,134,106,28,0.791045,0.208955,1.791045,24,4,1, merged,0,0,0
17030,1000328,1,274,190,84,0.693431,0.306569,0.693431,79,5,277,192,85,0.693141,0.306859,0.693141,80,5,1, merged,1,1,1.09440639269
17030,1000329,2,866,640,226,0.73903,0.26097,1.432461,210,16,867,641,226,0.739331,0.260669,1.432472,210,16,-1, merged,0,0,0.969124408578
17041,1000592,2,134,106,28,0.791045,0.208955,1.591045,24,4,135,107,28,0.792593,0.207407,1.602116,24,4,1, merged,0,0,0.0270204517057
17042,1000592,2,135,107,28,0.792593,0.207407,1.602116,24,4,136,108,28,0.794118,0.205882,1.612299,24,4,1, merged,0,0,0.269299674267
17044,1000070,4,438,402,36,0.917808,0.082192,3.554878,26,10,439,403,36,0.917995,0.082005,3.560488,26,10,1, merged,0,0,0
17044,1000105,1,224,179,45,0.799107,0.200893,0.799107,42,3,227,180,47,0.792952,0.207048,0.792952,44,3,1, merged,1,1,0
17044,1000124,3,216,205,11,0.949074,0.050926,2.63707,10,1,218,207,11,0.949541,0.050459,2.642493,10,1,-1, merged,0,0,0
17047,1000005,2,124,97,27,0.782258,0.217742,1.565591,25,2,125,97,28,0.776,0.224,1.551956,26,2,1, merged,1,1,0.0377177385234
17047,1000091,1,180,141,39,0.783333,0.216667,0.783333,37,2,183,142,41,0.775956,0.224044,0.775956,39,2,1, merged,1,1,0.0588819500958
17047,1000328,3,277,192,85,0.693141,0.306859,2.258732,80,5,278,193,85,0.694245,0.305755,2.246201,80,5,1, merged,0,0,0.0315306994869
17047,1000592,4,136,108,28,0.794118,0.205882,3.05285,24,4,137,109,28,0.79562,0.20438,3.041821,24,4,1, merged,0,0,0.0380159603941
17053,1000105,1,227,180,47,0.792952,0.207048,0.792952,44,3,229,181,48,0.790393,0.209607,0.790393,45,3,1, merged,1,1,0
17053,1000124,2,218,207,11,0.949541,0.050459,1.742493,10,1,219,207,12,0.945205,0.054795,1.735598,11,1,1, merged,1,1,0
17055,1000003,2,559,471,88,0.842576,0.157424,1.764961,82,6,560,471,89,0.841071,0.158929,1.76242,83,6,1, merged,1,1,0.217395361427
17055,1000015,1,889,820,69,0.922385,0.077615,0.922385,63,6,890,820,70,0.921348,0.078652,0.921348,64,6,1, merged,1,1,0
17055,1000153,3,469,432,37,0.921109,0.078891,2.686069,29,8,472,435,37,0.92161,0.07839,2.68403,29,8,-1, merged,0,0,0.267245470944
17064,1000007,1,452,385,67,0.85177,0.14823,0.85177,57,10,455,388,67,0.852747,0.147253,0.852747,57,10,-1, merged,0,0,0.302098749529
17064,1000153,2,472,435,37,0.92161,0.07839,1.77338,29,8,473,435,38,0.919662,0.080338,1.772409,29,9,-1, merged,1,1,0.275350072107
17079,1000070,3,440,404,36,0.918182,0.081818,2.608575,26,10,441,405,36,0.918367,0.081633,2.524428,26,10,1, merged,0,0,0
17079,1000105,1,229,181,48,0.790393,0.209607,0.790393,45,3,231,182,49,0.787879,0.212121,0.787879,46,3,1, merged,1,1,0
17083,1000105,1,231,182,49,0.787879,0.212121,0.787879,46,3,232,183,49,0.788793,0.211207,0.788793,46,3,1, merged,0,0,0.165275303534
17085,1000014,2,629,537,92,0.853736,0.146264,1.752859,83,9,630,538,92,0.853968,0.146032,1.753532,83,9,1, merged,0,0,0.075849778571
17085,1000023,1,228,205,23,0.899123,0.100877,0.899123,20,3,229,206,23,0.899563,0.100437,0.899563,20,3,1, merged,0,0,0.343045871259
17091,1000124,2,219,207,12,0.945205,0.054795,1.786872,11,1,220,208,12,0.945455,0.054545,1.78843,11,1,1, merged,0,0,0.0128091457027
17116,1000023,2,229,206,23,0.899563,0.100437,1.79838,20,3,231,206,25,0.891775,0.108225,1.789589,22,3,1, merged,1,1,0
17116,1000063,1,1690,1519,171,0.898817,0.101183,0.898817,147,24,1693,1520,173,0.897815,0.102185,0.897815,149,24,1, merged,1,1,0
17117,1000120,1,164,139,25,0.847561,0.152439,0.847561,24,1,166,140,26,0.843373,0.156627,0.843373,25,1,1, merged,1,1,0.0540592498672
17118,1000120,1,166,140,26,0.843373,0.156627,0.843373,25,1,167,141,26,0.844311,0.155689,0.844311,25,1,1, merged,0,0,0.0856931789486
17121,1000592,2,137,109,28,0.79562,0.20438,1.750166,24,4,139,111,28,0.798561,0.201439,1.715228,24,4,-1, merged,0,0,0.593161012386
17126,1000592,2,139,111,28,0.798561,0.201439,1.616743,24,4,140,112,28,0.8,0.2,1.626087,24,4,1, merged,0,0,0
17134,1000120,1,169,143,26,0.846154,0.153846,0.846154,25,1,170,144,26,0.847059,0.152941,0.847059,25,1,1, merged,0,0,0.231633173631
17144,1000105,1,233,184,49,0.7897,0.2103,0.7897,46,3,236,186,50,0.788136,0.211864,0.788136,47,3,1, merged,1,1,0.0572290581975
17155,1000063,1,1696,1523,173,0.897995,0.102005,0.897995,149,24,1697,1524,173,0.898055,0.101945,0.898055,149,24,1, merged,0,0,0.00379902298404
17157,1000063,1,1697,1524,173,0.898055,0.101945,0.898055,149,24,1702,1526,176,0.896592,0.103408,0.896592,152,24,-1, merged,1,0,0
17157,1000329,2,875,649,226,0.741714,0.258286,1.63977,210,16,877,650,227,0.741163,0.258837,1.637755,210,17,-1, merged,1,1,0
17168,1000121,2,593,498,95,0.839798,0.160202,1.679798,91,4,594,499,95,0.840067,0.159933,1.686221,91,4,1, merged,0,0,0
17169,1000109,2,278,228,50,0.820144,0.179856,1.617347,48,2,279,229,50,0.820789,0.179211,1.6194,48,2,1, merged,0,0,1.1358419244
17170,1000070,2,443,407,36,0.918736,0.081264,1.70445,26,10,445,409,36,0.919101,0.080899,1.702577,26,10,-1, merged,0,0,0.358471841626
17172,1000011,2,292,275,17,0.941781,0.058219,1.776643,15,2,293,276,17,0.94198,0.05802,1.778343,15,2,1, merged,0,0,0.0108924485126
17184,1000003,1,564,475,89,0.842199,0.157801,0.842199,83,6,567,478,89,0.843034,0.156966,0.843034,83,6,-1, merged,0,0,0.0898093695123
17188,1000109,2,279,229,50,0.820789,0.179211,1.628481,48,2,280,230,50,0.821429,0.178571,1.630346,48,2,1, merged,0,0,0.335390595423
17188,1000199,1,156,126,30,0.807692,0.192308,0.807692,28,2,157,127,30,0.808917,0.191083,0.808917,28,2,1, merged,0,0,0.346353689525
17189,1000004,2,788,677,111,0.859137,0.140863,1.590729,89,22,793,681,112,0.858764,0.141236,1.594745,90,22,-1, merged,1,0,0.0233250236022
17189,1000043,4,165,134,31,0.812121,0.187879,2.40285,27,4,166,135,31,0.813253,0.186747,2.741332,27,4,1, merged,0,0,0.0143391089789
17190,1000004,2,793,681,112,0.858764,0.141236,1.672017,90,22,794,682,112,0.858942,0.141058,1.667325,90,22,1, merged,0,0,0.0156819846993
17190,1000043,1,166,135,31,0.813253,0.186747,0.813253,27,4,167,135,32,0.808383,0.191617,0.808383,28,4,1, merged,1,1,0.0104566427031
17205,1000063,1,1703,1526,177,0.896066,0.103934,0.896066,153,24,1704,1527,177,0.896127,0.103873,0.896127,153,24,-1, merged,0,0,0.0199865992632
17231,1000004,1,794,682,112,0.858942,0.141058,0.858942,90,22,795,682,113,0.857862,0.142138,0.857862,91,22,1, abandoned,1,1,0.460579766371
17231,1000329,2,882,654,228,0.741497,0.258503,1.600439,211,17,883,655,228,0.741789,0.258211,1.599651,211,17,-1, abandoned,0,0,0.922798389007
17239,1000109,1,281,231,50,0.822064,0.177936,0.822064,48,2,282,232,50,0.822695,0.177305,0.822695,48,2,1, merged,0,0,0.874434156379
17239,1000199,2,157,127,30,0.808917,0.191083,1.630981,28,2,158,128,30,0.810127,0.189873,1.632822,28,2,1, merged,0,0,0.896332378223
17246,1000015,1,898,828,70,0.922049,0.077951,0.922049,64,6,901,830,71,0.921199,0.078801,0.921199,65,6,-1, merged,1,0,0.106564570488
17251,1000005,1,125,97,28,0.776,0.224,0.776,26,2,126,97,29,0.769841,0.230159,0.769841,27,2,1, merged,1,1,0.442461440022
17251,1000121,2,596,501,95,0.840604,0.159396,1.616604,91,4,597,502,95,0.840871,0.159129,1.610712,91,4,1, merged,0,0,0.499281160552
17257,1000121,5,597,502,95,0.840871,0.159129,3.79817,91,4,598,502,96,0.839465,0.160535,3.922208,92,4,1, merged,1,1,0.635136072725
17257,1000328,2,282,197,85,0.698582,0.301418,1.439281,80,5,283,198,85,0.699647,0.300353,1.440638,80,5,-1, merged,0,0,1.16629157139
17257,1000329,1,887,657,230,0.740699,0.259301,0.740699,213,17,888,658,230,0.740991,0.259009,0.740991,213,17,-1, merged,0,0,0
17283,1000004,3,800,687,113,0.85875,0.14125,2.513942,91,22,802,689,113,0.859102,0.140898,2.506438,91,22,-1, merged,0,0,0
17283,1000014,2,636,543,93,0.853774,0.146226,1.655192,84,9,638,545,93,0.854232,0.145768,1.647335,84,9,-1, merged,0,0,0
17283,1000592,1,141,113,28,0.801418,0.198582,0.801418,24,4,145,115,30,0.793103,0.206897,0.793103,26,4,-1, merged,1,0,0
17285,1000015,1,906,834,72,0.92053,0.07947,0.92053,66,6,908,835,73,0.919604,0.080396,0.919604,66,7,-1, merged,1,1,0.0966860291927
17285,1000534,2,7,3,4,0.428571,0.571429,1.349101,4,0,8,4,4,0.5,0.5,1.419604,4,0,1, merged,0,0,0.121804511278
17296,1000592,2,145,115,30,0.793103,0.206897,1.662669,26,4,146,116,30,0.794521,0.205479,1.669521,26,4,1, merged,0,0,0
17297,1000004,1,802,689,113,0.859102,0.140898,0.859102,91,22,804,691,113,0.859453,0.140547,0.859453,91,22,-1, merged,0,0,0
17298,1000118,1,521,465,56,0.892514,0.107486,0.892514,55,1,523,467,56,0.892925,0.107075,0.892925,55,1,1, merged,0,0,0
17302,1000121,3,598,502,96,0.839465,0.160535,2.366256,92,4,599,503,96,0.839733,0.160267,2.36246,92,4,1, merged,0,0,0.0523704063235
17302,1000328,2,284,199,85,0.700704,0.299296,1.526791,80,5,286,199,87,0.695804,0.304196,1.522727,80,7,-1, merged,1,1,0.068545353473
17303,1000004,2,804,691,113,0.859453,0.140547,1.686376,91,22,806,691,115,0.85732,0.14268,1.685071,91,24,-1, merged,1,1,0.0322462855704
17303,1000118,4,523,467,56,0.892925,0.107075,3.419034,55,1,524,468,56,0.89313,0.10687,3.418201,55,1,1, merged,0,0,0.000725689404935
17303,1000121,3,599,503,96,0.839733,0.160267,2.526109,92,4,600,504,96,0.84,0.16,2.525071,92,4,1, merged,0,0,0.010559622782
17313,1000011,2,300,281,19,0.936667,0.063333,1.686667,17,2,301,282,19,0.936877,0.063123,1.714655,17,2,1, merged,0,0,1.78550067966
17316,1000329,1,894,663,231,0.741611,0.258389,0.741611,214,17,898,665,233,0.740535,0.259465,0.740535,216,17,1, merged,1,1,0
17318,1000007,2,459,392,67,0.854031,0.145969,1.773634,57,10,460,393,67,0.854348,0.145652,1.774128,57,10,-1, abandoned,0,0,0.0165927872791
17318,1000014,3,640,547,93,0.854688,0.145313,2.628322,84,9,643,549,94,0.85381,0.14619,2.627938,85,9,-1, abandoned,1,0,0
17318,1000015,1,908,835,73,0.919604,0.080396,0.919604,66,7,910,837,73,0.91978,0.08022,0.91978,66,7,-1, abandoned,0,0,0.0144635556649
17332,1000014,1,643,549,94,0.85381,0.14619,0.85381,85,9,644,550,94,0.854037,0.145963,0.854037,85,9,1, merged,0,0,0
17332,1000327,2,366,280,86,0.765027,0.234973,1.618838,65,21,367,281,86,0.765668,0.234332,1.619705,65,21,1, merged,0,0,0
17342,1000121,2,602,505,97,0.83887,0.16113,1.550211,93,4,603,506,97,0.839138,0.160862,1.553423,93,4,1, merged,0,0,0.637277188467
17343,1000121,1,603,506,97,0.839138,0.160862,0.839138,93,4,606,508,98,0.838284,0.161716,0.838284,94,4,-1, merged,1,0,0.0277547534753
17344,1000328,2,286,199,87,0.695804,0.304196,1.537909,80,7,287,200,87,0.696864,0.303136,1.540148,80,7,1, merged,0,0,0
17346,1000121,2,606,508,98,0.838284,0.161716,1.535148,94,4,609,509,100,0.835796,0.164204,1.5289,96,4,1, merged,1,1,0
17346,1000328,1,287,200,87,0.696864,0.303136,0.696864,80,7,290,201,89,0.693103,0.306897,0.693103,82,7,1, merged,1,1,0
17346,1000329,3,899,666,233,0.740823,0.259177,2.275971,216,17,900,666,234,0.74,0.26,2.2689,217,17,1, merged,1,1,0
17347,1000121,2,609,509,100,0.835796,0.164204,1.5289,96,4,610,510,100,0.836066,0.163934,1.530224,96,4,1, merged,0,0,0
17347,1000328,1,290,201,89,0.693103,0.306897,0.693103,82,7,291,202,89,0.694158,0.305842,0.694158,82,7,1, merged,0,0,0
17347,1000329,3,900,666,234,0.74,0.26,2.2689,217,17,901,667,234,0.740289,0.259711,2.270512,217,17,1, merged,0,0,0
17348,1000121,2,610,510,100,0.836066,0.163934,1.576354,96,4,612,512,100,0.836601,0.163399,1.577178,96,4,1, merged,0,0,0
17348,1000329,1,901,667,234,0.740289,0.259711,0.740289,217,17,902,668,234,0.740576,0.259424,0.740576,217,17,1, merged,0,0,0
17349,1000329,1,902,668,234,0.740576,0.259424,0.740576,217,17,904,669,235,0.740044,0.259956,0.740044,218,17,1, merged,1,1,0
17350,1000329,1,904,669,235,0.740044,0.259956,0.740044,218,17,905,670,235,0.740331,0.259669,0.740331,218,17,1, merged,0,0,0
17352,1000328,2,291,202,89,0.694158,0.305842,1.43449,82,7,292,202,90,0.691781,0.308219,1.431582,83,7,1, merged,1,1,0
17352,1000329,1,905,670,235,0.740331,0.259669,0.740331,218,17,907,671,236,0.739802,0.260198,0.739802,219,17,1, merged,1,1,0
17355,1000091,2,187,146,41,0.780749,0.219251,1.520595,39,2,188,147,41,0.781915,0.218085,1.522046,39,2,1, merged,0,0,0
17355,1000329,1,911,674,237,0.739846,0.260154,0.739846,220,17,912,675,237,0.740132,0.259868,0.740132,220,17,1, merged,0,0,0
17356,1000091,2,188,147,41,0.781915,0.218085,1.522046,39,2,189,148,41,0.783069,0.216931,1.523485,39,2,1, merged,0,0,0
17356,1000329,1,912,675,237,0.740132,0.259868,0.740132,220,17,913,676,237,0.740416,0.259584,0.740416,220,17,1, merged,0,0,0
17360,1000121,1,613,513,100,0.836868,0.163132,0.836868,96,4,614,513,101,0.835505,0.164495,0.835505,97,4,1, merged,1,1,0.0074878225577
17360,1000329,3,913,676,237,0.740416,0.259584,2.371805,220,17,914,676,238,0.739606,0.260394,2.372408,221,17,1, merged,1,1,0.00795006751466
17360,1000592,2,146,116,30,0.794521,0.205479,1.631388,26,4,148,118,30,0.797297,0.202703,1.632802,26,4,-1, merged,0,0,0.0081346121026
17366,1000011,1,302,283,19,0.937086,0.062914,0.937086,17,2,304,285,19,0.9375,0.0625,0.9375,17,2,-1, merged,0,0,0.445785499076
17369,1000091,4,189,148,41,0.783069,0.216931,2.990926,39,2,190,148,42,0.778947,0.221053,2.984794,39,3,-1, merged,1,1,0
17369,1000328,2,292,202,90,0.691781,0.308219,1.431387,83,7,293,202,91,0.68942,0.31058,1.428503,83,8,-1, merged,1,1,0
17369,1000329,1,914,676,238,0.739606,0.260394,0.739606,221,17,916,677,239,0.739083,0.260917,0.739083,221,18,-1, merged,1,0,0
17379,1000014,2,647,552,95,0.853168,0.146832,1.591264,86,9,648,553,95,0.853395,0.146605,1.597581,86,9,1, merged,0,0,0.00247797356828
17382,1000121,2,615,514,101,0.835772,0.164228,1.575424,97,4,616,515,101,0.836039,0.163961,1.575974,97,4,1, merged,0,0,0
17382,1000329,1,918,679,239,0.739651,0.260349,0.739651,221,18,919,680,239,0.739935,0.260065,0.739935,221,18,1, merged,0,0,0
17386,1000328,2,293,202,91,0.68942,0.31058,1.427239,83,8,296,202,94,0.682432,0.317568,1.421462,86,8,1, abandoned,1,1,0
17386,1000329,3,919,680,239,0.739935,0.260065,2.167174,221,18,920,681,239,0.740217,0.259783,2.16168,221,18,-1, abandoned,0,0,0
17390,1000329,2,920,681,239,0.740217,0.259783,1.479247,221,18,922,682,240,0.739696,0.260304,1.477627,222,18,1, merged,1,1,0.959429909561
17391,1000003,1,569,480,89,0.843585,0.156415,0.843585,83,6,572,483,89,0.844406,0.155594,0.844406,83,6,-1, merged,0,0,0.320511915884
17395,1000120,2,173,147,26,0.849711,0.150289,1.587642,25,1,174,148,26,0.850575,0.149425,1.589705,25,1,1, merged,0,0,0
17402,1000091,1,190,148,42,0.778947,0.221053,0.778947,39,3,191,149,42,0.780105,0.219895,0.780105,39,3,1, merged,0,0,0
17402,1000328,4,296,202,94,0.682432,0.317568,2.935086,86,8,297,203,94,0.683502,0.316498,2.938379,86,8,1, merged,0,0,0
17402,1000329,3,923,683,240,0.739978,0.260022,2.252654,222,18,924,684,240,0.74026,0.25974,2.254878,222,18,1, merged,0,0,0
17406,1000007,1,460,393,67,0.854348,0.145652,0.854348,57,10,461,393,68,0.852495,0.147505,0.852495,58,10,1, merged,1,1,0
17415,1000003,2,572,483,89,0.844406,0.155594,1.698252,83,6,573,484,89,0.844677,0.155323,1.698748,83,6,1, merged,0,0,0.229640092321
17415,1000014,1,650,555,95,0.853846,0.146154,0.853846,86,9,651,556,95,0.854071,0.145929,0.854071,86,9,1, merged,0,0,0.184208064365
17424,1000327,3,368,282,86,0.766304,0.233696,1.82085,65,21,369,283,86,0.766938,0.233062,1.850271,65,21,1, merged,0,0,0
17426,1000327,2,369,283,86,0.766938,0.233062,1.266938,65,21,371,284,87,0.765499,0.234501,1.227037,66,21,1, merged,1,1,0
17464,1000004,2,818,702,116,0.858191,0.141809,1.796301,92,24,819,703,116,0.858364,0.141636,1.796676,92,24,1, merged,0,0,0.368616422947
17464,1000011,1,307,288,19,0.938111,0.061889,0.938111,17,2,308,289,19,0.938312,0.061688,0.938312,17,2,1, merged,0,0,0.70134083045
17470,1000004,2,819,703,116,0.858364,0.141636,1.742979,92,24,820,704,116,0.858537,0.141463,1.747425,92,24,1, merged,0,0,0
17470,1000592,4,151,121,30,0.801325,0.198675,3.370391,26,4,152,122,30,0.802632,0.197368,3.38339,26,4,1, merged,0,0,0
17486,1000120,1,182,156,26,0.857143,0.142857,0.857143,25,1,183,157,26,0.857923,0.142077,0.857923,25,1,1, merged,0,0,0.0525328478477
17487,1000120,1,183,157,26,0.857923,0.142077,0.857923,25,1,184,158,26,0.858696,0.141304,0.858696,25,1,1, merged,0,0,0.220469083156
17492,1000004,2,820,704,116,0.858537,0.141463,1.747425,92,24,821,705,116,0.858709,0.141291,1.720778,92,24,-1, merged,0,0,0
17492,1000592,3,152,122,30,0.802632,0.197368,2.550057,26,4,153,123,30,0.803922,0.196078,2.524699,26,4,1, merged,0,0,0
17494,1000121,3,621,520,101,0.837359,0.162641,2.317345,97,4,622,521,101,0.837621,0.162379,2.31935,97,4,1, merged,0,0,0
17494,1000329,1,924,684,240,0.74026,0.25974,0.74026,222,18,926,686,240,0.740821,0.259179,0.740821,222,18,-1, merged,0,0,0
17498,1000070,3,446,409,37,0.91704,0.08296,2.113469,27,10,447,410,37,0.917226,0.082774,2.283893,27,10,1, merged,0,0,0.118856218167
17503,1000120,1,184,158,26,0.858696,0.141304,0.858696,25,1,185,159,26,0.859459,0.140541,0.859459,25,1,1, merged,0,0,0.220510879849
17504,1000120,1,185,159,26,0.859459,0.140541,0.859459,25,1,186,160,26,0.860215,0.139785,0.860215,25,1,1, merged,0,0,0.225510204082
17505,1000120,1,186,160,26,0.860215,0.139785,0.860215,25,1,187,161,26,0.860963,0.139037,0.860963,25,1,1, merged,0,0,0.0403049381657
17507,1000004,5,824,707,117,0.85801,0.14199,3.827707,93,24,825,708,117,0.858182,0.141818,3.341515,93,24,1, merged,0,0,0.0269540277894
17508,1000004,1,825,708,117,0.858182,0.141818,0.858182,93,24,826,709,117,0.858354,0.141646,0.858354,93,24,1, merged,0,0,0.0272858892972
17508,1000043,2,169,137,32,0.810651,0.189349,1.668833,28,4,170,138,32,0.811765,0.188235,1.670118,28,4,1, merged,0,0,0.0420621626652
17516,1000118,2,527,471,56,0.893738,0.106262,1.634559,55,1,528,472,56,0.893939,0.106061,1.635319,55,1,1, merged,0,0,0.205089127636
17516,1000329,1,926,686,240,0.740821,0.259179,0.740821,222,18,928,688,240,0.741379,0.258621,0.741379,222,18,-1, merged,0,0,0.92581360162
17520,1000329,2,928,688,240,0.741379,0.258621,1.482288,222,18,929,689,240,0.741658,0.258342,1.483154,222,18,-1, abandoned,0,0,0.0238233585125
17538,1000063,2,1708,1531,177,0.89637,0.10363,1.638451,153,24,1709,1532,177,0.896431,0.103569,1.639094,153,24,1, merged,0,0,0.325488436063
17554,1000004,3,826,709,117,0.858354,0.141646,2.000011,93,24,827,710,117,0.858525,0.141475,1.932201,93,24,1, merged,0,0,0.0149981812093
17554,1000329,1,929,689,240,0.741658,0.258342,0.741658,222,18,932,690,242,0.740343,0.259657,0.740343,224,18,1, merged,1,1,0.0175207421192
17557,1000011,1,309,290,19,0.938511,0.061489,0.938511,17,2,310,291,19,0.93871,0.06129,0.93871,17,2,1, merged,0,0,0.701140766251
17557,1000120,2,191,164,27,0.858639,0.141361,1.79715,26,1,192,165,27,0.859375,0.140625,1.798085,26,1,1, merged,0,0,0.521437908497
17558,1000011,1,310,291,19,0.93871,0.06129,0.93871,17,2,311,292,19,0.938907,0.061093,0.938907,17,2,1, merged,0,0,0.351194337375
17558,1000120,2,192,165,27,0.859375,0.140625,1.798085,26,1,193,166,27,0.860104,0.139896,1.79901,26,1,1, merged,0,0,0.248148165507
17559,1000011,1,311,292,19,0.938907,0.061093,0.938907,17,2,312,293,19,0.939103,0.060897,0.939103,17,2,1, merged,0,0,0.702815993121
17559,1000120,2,193,166,27,0.860104,0.139896,1.79901,26,1,194,167,27,0.860825,0.139175,1.799927,26,1,1, merged,0,0,0.513541666667
17578,1000005,2,142,106,36,0.746479,0.253521,1.526584,34,2,144,107,37,0.743056,0.256944,1.519097,35,2,1, merged,1,1,0
17578,1000091,1,191,149,42,0.780105,0.219895,0.780105,39,3,192,149,43,0.776042,0.223958,0.776042,40,3,1, merged,1,1,0
17582,1000003,1,574,485,89,0.844948,0.155052,0.844948,83,6,575,485,90,0.843478,0.156522,0.843478,84,6,1, merged,1,1,0
17582,1000005,2,150,110,40,0.733333,0.266667,1.578281,38,2,152,111,41,0.730263,0.269737,1.573741,39,2,1, merged,1,1,0
17583,1000005,2,152,111,41,0.730263,0.269737,1.554506,39,2,153,112,41,0.732026,0.267974,1.551303,39,2,1, merged,0,0,0
17584,1000005,2,153,112,41,0.732026,0.267974,1.551303,39,2,154,113,41,0.733766,0.266234,1.548137,39,2,1, merged,0,0,0
17595,1000023,2,232,207,25,0.892241,0.107759,1.611868,22,3,233,208,25,0.892704,0.107296,1.619977,22,3,1, merged,0,0,0.132237693566
17596,1000014,2,655,559,96,0.853435,0.146565,1.69554,87,9,657,561,96,0.853881,0.146119,1.698037,87,9,1, merged,0,0,0
17599,1000014,4,657,561,96,0.853881,0.146119,3.55518,87,9,658,562,96,0.854103,0.145897,3.218282,87,9,1, merged,0,0,0.25502604401
17600,1000329,2,932,690,242,0.740343,0.259657,1.602412,224,18,933,691,242,0.740622,0.259378,1.607288,224,18,1, merged,0,0,0.13100040188
17604,1000004,4,828,711,117,0.858696,0.141304,3.184838,93,24,829,711,118,0.85766,0.14234,3.166421,94,24,1, abandoned,1,1,0
17604,1000329,2,933,691,242,0.740622,0.259378,1.483285,224,18,935,692,243,0.740107,0.259893,1.477775,225,18,-1, abandoned,1,0,0
17612,1000120,2,196,169,27,0.862245,0.137755,1.728912,26,1,197,170,27,0.862944,0.137056,1.733912,26,1,1, merged,0,0,0.196246885759
17613,1000109,2,282,232,50,0.822695,0.177305,1.618613,48,2,283,233,50,0.823322,0.176678,1.620619,48,2,1, merged,0,0,1.41223758321
17616,1000109,2,283,233,50,0.823322,0.176678,1.620619,48,2,284,234,50,0.823944,0.176056,1.622601,48,2,1, merged,0,0,0.0206332037562
17623,1000004,2,830,712,118,0.857831,0.142169,1.720775,94,24,831,713,118,0.858002,0.141998,1.721639,94,24,1, merged,0,0,0
17623,1000120,1,197,170,27,0.862944,0.137056,0.862944,26,1,198,171,27,0.863636,0.136364,0.863636,26,1,1, merged,0,0,0
17628,1000004,2,831,713,118,0.858002,0.141998,1.733002,94,24,832,714,118,0.858173,0.141827,1.742788,94,24,1, merged,0,0,0.375865602288
17628,1000592,3,153,123,30,0.803922,0.196078,2.536924,26,4,154,124,30,0.805195,0.194805,2.547983,26,4,1, merged,0,0,0.544254510921
17629,1000328,2,299,205,94,0.685619,0.314381,1.464688,86,8,300,206,94,0.686667,0.313333,1.466589,86,8,1, merged,0,0,1.0413162924
17639,1000014,1,658,562,96,0.854103,0.145897,0.854103,87,9,659,563,96,0.854325,0.145675,0.854325,87,9,1, merged,0,0,0.0285703914445
17639,1000070,2,452,414,38,0.915929,0.084071,1.770033,28,10,453,415,38,0.916115,0.083885,1.77044,28,10,1, merged,0,0,0.0430621133252
17640,1000120,1,199,172,27,0.864322,0.135678,0.864322,26,1,201,173,28,0.860697,0.139303,0.860697,27,1,1, merged,1,1,0.117603238629
17643,1000120,1,203,175,28,0.862069,0.137931,0.862069,27,1,204,176,28,0.862745,0.137255,0.862745,27,1,1, merged,0,0,0.120744010088
17644,1000120,1,204,176,28,0.862745,0.137255,0.862745,27,1,205,176,29,0.858537,0.141463,0.858537,28,1,1, abandoned,1,1,0
17645,1000120,1,205,176,29,0.858537,0.141463,0.858537,28,1,206,177,29,0.859223,0.140777,0.859223,28,1,1, merged,0,0,0.125629722922
17646,1000327,3,373,286,87,0.766756,0.233244,2.40312,66,21,374,287,87,0.76738,0.23262,2.100713,66,21,-1, abandoned,0,0,0.3056882391
17647,1000121,2,625,524,101,0.8384,0.1616,1.576068,97,4,626,525,101,0.838658,0.161342,1.576913,97,4,1, merged,0,0,0.61163956945
17649,1000121,1,628,527,101,0.839172,0.160828,0.839172,97,4,629,528,101,0.839428,0.160572,0.839428,97,4,1, merged,0,0,0
17649,1000328,2,300,206,94,0.686667,0.313333,1.525839,86,8,301,207,94,0.687708,0.312292,1.527135,86,8,1, merged,0,0,0
17650,1000121,1,629,528,101,0.839428,0.160572,0.839428,97,4,630,529,101,0.839683,0.160317,0.839683,97,4,1, merged,0,0,0
17650,1000328,2,301,207,94,0.687708,0.312292,1.527135,86,8,302,208,94,0.688742,0.311258,1.528424,86,8,1, merged,0,0,0
17651,1000121,1,630,529,101,0.839683,0.160317,0.839683,97,4,631,530,101,0.839937,0.160063,0.839937,97,4,1, merged,0,0,0
17651,1000328,2,302,208,94,0.688742,0.311258,1.528424,86,8,303,209,94,0.689769,0.310231,1.529706,86,8,1, merged,0,0,0
17652,1000014,2,659,563,96,0.854325,0.145675,0.854325,87,9,660,564,96,0.854545,0.145455,1.854545,87,9,1, merged,0,0,0.0591880575551
17663,1000329,1,936,693,243,0.740385,0.259615,0.740385,225,18,938,695,243,0.740938,0.259062,0.740938,225,18,-1, abandoned,0,0,0.20713149208
17683,1000329,3,940,697,243,0.741489,0.258511,1.408156,225,18,941,698,243,0.741764,0.258236,1.241764,225,18,-1, abandoned,0,0,0.624497644457
17684,1000121,4,636,534,102,0.839623,0.160377,2.652686,98,4,637,535,102,0.839874,0.160126,2.587402,98,4,1, merged,0,0,0.585433782831
17690,1000329,2,941,698,243,0.741764,0.258236,1.241764,225,18,942,699,243,0.742038,0.257962,1.275372,225,18,1, merged,0,0,0
17696,1000004,1,833,715,118,0.858343,0.141657,0.858343,94,24,837,718,119,0.857826,0.142174,0.857826,95,24,-1, merged,1,0,0.0485080231304
17696,1000121,2,637,535,102,0.839874,0.160126,1.698218,98,4,642,536,106,0.834891,0.165109,1.692717,102,4,1, merged,1,1,0.0650335507213
17696,1000329,3,943,700,243,0.742312,0.257688,2.44053,225,18,946,703,243,0.743129,0.256871,2.435845,225,18,-1, merged,0,0,0.0746440900703
17698,1000004,2,837,718,119,0.857826,0.142174,1.600955,95,24,839,720,119,0.858164,0.141836,1.601565,95,24,-1, merged,0,0,0
17698,1000329,1,946,703,243,0.743129,0.256871,0.743129,225,18,947,704,243,0.7434,0.2566,0.7434,225,18,-1, merged,0,0,0.115846052005
17699,1000063,1,1709,1532,177,0.896431,0.103569,0.896431,153,24,1710,1533,177,0.896491,0.103509,0.896491,153,24,1, merged,0,0,0.376062660757
17704,1000592,1,157,127,30,0.808917,0.191083,0.808917,26,4,158,128,30,0.810127,0.189873,0.810127,26,4,-1, abandoned,0,0,0.60515705579
17705,1000328,1,304,210,94,0.690789,0.309211,0.690789,86,8,305,211,94,0.691803,0.308197,0.691803,86,8,1, merged,0,0,0.304012420958
17707,1000004,2,839,720,119,0.858164,0.141836,1.601754,95,24,840,721,119,0.858333,0.141667,1.604096,95,24,1, merged,0,0,0.458006322258
17720,1000118,2,532,474,58,0.890977,0.109023,0.890977,57,1,534,475,59,0.889513,0.110487,0.889513,58,1,1, merged,1,1,0.0443656598151
17826,1000328,1,305,211,94,0.691803,0.308197,0.691803,86,8,306,212,94,0.69281,0.30719,0.69281,86,8,1, merged,0,0,1.09745967742
17827,1000015,3,924,850,74,0.919913,0.080087,2.484228,66,8,925,851,74,0.92,0.08,2.488802,66,8,1, merged,0,0,0.55986126458
17827,1000121,2,643,537,106,0.835148,0.164852,1.564314,102,4,645,538,107,0.834109,0.165891,1.568802,103,4,1, merged,1,1,0.52051286487
17829,1000329,1,947,704,243,0.7434,0.2566,0.7434,225,18,949,705,244,0.742887,0.257113,0.742887,226,18,1, merged,1,1,0.928020421158
17829,1000592,2,159,129,30,0.811321,0.188679,1.554721,26,4,161,131,30,0.813665,0.186335,1.556552,26,4,-1, merged,0,0,0.773522622345
17839,1000014,2,662,566,96,0.854985,0.145015,1.751537,87,9,663,567,96,0.855204,0.144796,1.751816,87,9,1, merged,0,0,0.0885076027066
17839,1000063,1,1711,1534,177,0.896552,0.103448,0.896552,153,24,1712,1535,177,0.896612,0.103388,0.896612,153,24,1, merged,0,0,0.163863962289
17851,1000004,1,840,721,119,0.858333,0.141667,0.858333,95,24,841,722,119,0.858502,0.141498,0.858502,95,24,-1, merged,0,0,0
17851,1000014,3,663,567,96,0.855204,0.144796,1.713537,87,9,664,568,96,0.855422,0.144578,2.213923,87,9,-1, merged,0,0,1.54694646332e-05
17852,1000014,3,664,568,96,0.855422,0.144578,2.597357,87,9,665,569,96,0.855639,0.144361,2.605639,87,9,1, merged,0,0,0
17859,1000091,2,194,150,44,0.773196,0.226804,1.608058,41,3,195,151,44,0.774359,0.225641,1.603188,41,3,1, merged,0,0,0.0737055396755
17861,1000023,4,233,208,25,0.892704,0.107296,3.700931,22,3,234,209,25,0.893162,0.106838,3.703102,22,3,1, merged,0,0,0.00445025772797
17862,1000023,4,234,209,25,0.893162,0.106838,3.703102,22,3,235,210,25,0.893617,0.106383,3.701675,22,3,1, merged,0,0,0.00114865144509
17873,1000004,2,841,722,119,0.858502,0.141498,1.73729,95,24,842,722,120,0.857482,0.142518,1.743196,95,25,-1, merged,1,1,0.000332041129052
17875,1000327,3,374,287,87,0.76738,0.23262,1.653094,66,21,375,288,87,0.768,0.232,2.656889,66,21,1, merged,0,0,0.030990738142
17878,1000070,4,454,416,38,0.9163,0.0837,3.2163,28,10,455,417,38,0.916484,0.083516,2.416484,28,10,-1, abandoned,0,0,0
17881,1000124,4,222,210,12,0.945946,0.054054,2.884986,11,1,223,211,12,0.946188,0.053812,3.081296,11,1,1, merged,0,0,0.14872307222
17888,1000004,3,843,723,120,0.857651,0.142349,2.543931,95,25,844,724,120,0.85782,0.14218,2.537121,95,25,1, merged,0,0,0
17888,1000120,2,213,184,29,0.86385,0.13615,1.68628,28,1,214,185,29,0.864486,0.135514,1.679301,28,1,1, merged,0,0,0
17890,1000014,2,665,569,96,0.855639,0.144361,1.594478,87,9,666,570,96,0.855856,0.144144,1.595277,87,9,1, merged,0,0,0
17901,1000329,1,951,706,245,0.742376,0.257624,0.742376,227,18,952,707,245,0.742647,0.257353,0.742647,227,18,1, merged,0,0,0.972102075144
17907,1000109,2,284,234,50,0.823944,0.176056,1.622601,48,2,285,235,50,0.824561,0.175439,1.624561,48,2,1, merged,0,0,0.27736320272
17919,1000004,2,845,725,120,0.857988,0.142012,1.797479,95,25,846,726,120,0.858156,0.141844,1.797839,95,25,1, merged,0,0,0.00652187720129
17919,1000011,1,314,295,19,0.93949,0.06051,0.93949,17,2,315,296,19,0.939683,0.060317,0.939683,17,2,1, merged,0,0,0.0160187953866
17921,1000004,1,847,727,120,0.858323,0.141677,0.858323,95,25,848,728,120,0.858491,0.141509,0.858491,95,25,1, merged,0,0,0.0068441075614
17921,1000011,2,315,296,19,0.939683,0.060317,1.798006,17,2,316,297,19,0.939873,0.060127,1.798364,17,2,1, merged,0,0,0.0177123346137
17934,1000121,1,645,538,107,0.834109,0.165891,0.834109,103,4,647,539,108,0.833076,0.166924,0.833076,104,4,1, merged,1,1,0.0209647121129
17936,1000004,1,848,728,120,0.858491,0.141509,0.858491,95,25,854,733,121,0.858314,0.141686,0.858314,96,25,-1, merged,1,0,0.101951756485
17936,1000592,3,163,133,30,0.815951,0.184049,2.507775,26,4,164,134,30,0.817073,0.182927,2.483079,26,4,1, merged,0,0,0.169178796126
17937,1000109,1,285,235,50,0.824561,0.175439,0.824561,48,2,286,236,50,0.825175,0.174825,0.825175,48,2,1, merged,0,0,0.423352121309
17938,1000109,1,286,236,50,0.825175,0.174825,0.825175,48,2,287,237,50,0.825784,0.174216,0.825784,48,2,1, merged,0,0,0.462518702189
17939,1000109,1,287,237,50,0.825784,0.174216,0.825784,48,2,288,238,50,0.826389,0.173611,0.826389,48,2,1, merged,0,0,0.866883441721
17946,1000004,1,854,733,121,0.858314,0.141686,0.858314,96,25,855,734,121,0.85848,0.14152,0.85848,96,25,1, merged,0,0,0.117750345666
17946,1000120,2,216,187,29,0.865741,0.134259,1.724055,28,1,217,188,29,0.866359,0.133641,1.724839,28,1,1, merged,0,0,0.176134042865
17949,1000004,1,856,735,121,0.858645,0.141355,0.858645,96,25,859,738,121,0.859139,0.140861,0.859139,96,25,-1, merged,0,0,0.0901285567221
17949,1000592,3,164,134,30,0.817073,0.182927,2.48341,26,4,165,135,30,0.818182,0.181818,2.463035,26,4,1, merged,0,0,0.133598062457
17950,1000592,2,165,135,30,0.818182,0.181818,1.603896,26,4,166,136,30,0.819277,0.180723,1.612381,26,4,1, merged,0,0,0.230712365591
17951,1000592,2,166,136,30,0.819277,0.180723,1.612381,26,4,167,137,30,0.820359,0.179641,1.620359,26,4,1, merged,0,0,0.11839993694
17954,1000004,1,861,740,121,0.859466,0.140534,0.859466,96,25,862,740,122,0.858469,0.141531,0.858469,97,25,1, merged,1,1,0.377401028999
17954,1000011,2,317,298,19,0.940063,0.059937,1.799529,17,2,319,299,20,0.937304,0.062696,1.795773,18,2,1, merged,1,1,0.707703200227
17956,1000329,1,952,707,245,0.742647,0.257353,0.742647,227,18,953,707,246,0.741868,0.258132,0.741868,227,19,-1, merged,1,1,0.480313552731
17962,1000014,1,669,573,96,0.856502,0.143498,0.856502,87,9,670,574,96,0.856716,0.143284,0.856716,87,9,1, merged,0,0,0
17962,1000327,2,375,288,87,0.768,0.232,1.624502,66,21,376,289,87,0.768617,0.231383,1.625333,66,21,1, merged,0,0,0
17965,1000014,1,670,574,96,0.856716,0.143284,0.856716,87,9,671,575,96,0.85693,0.14307,0.85693,87,9,1, merged,0,0,0
17965,1000327,2,376,289,87,0.768617,0.231383,1.625333,66,21,377,290,87,0.769231,0.230769,1.626161,66,21,1, merged,0,0,0
17966,1000014,3,671,575,96,0.85693,0.14307,2.43147,87,9,673,576,97,0.855869,0.144131,2.422107,88,9,1, merged,1,1,0
17966,1000327,4,377,290,87,0.769231,0.230769,3.200701,66,21,378,291,87,0.769841,0.230159,3.191948,66,21,1, merged,0,0,0
17966,1000329,1,958,712,246,0.743215,0.256785,0.743215,227,19,960,713,247,0.742708,0.257292,0.742708,228,19,1, merged,1,1,0
17972,1000121,2,647,539,108,0.833076,0.166924,1.525632,104,4,648,540,108,0.833333,0.166667,1.523656,104,4,-1, abandoned,0,0,0
17972,1000328,1,309,214,95,0.692557,0.307443,0.692557,87,8,310,214,96,0.690323,0.309677,0.690323,88,8,1, abandoned,1,1,0
17973,1000328,1,310,214,96,0.690323,0.309677,0.690323,88,8,311,214,97,0.688103,0.311897,0.688103,89,8,1, abandoned,1,1,0.994860650425
17973,1000329,2,960,713,247,0.742708,0.257292,1.433031,228,19,961,714,247,0.742976,0.257024,1.431079,228,19,-1, abandoned,0,0,0.905762348699
17995,1000023,2,236,211,25,0.894068,0.105932,1.828278,22,3,237,212,25,0.894515,0.105485,1.82958,22,3,1, merged,0,0,0.00491121391695
17996,1000023,2,237,212,25,0.894515,0.105485,1.82958,22,3,238,213,25,0.894958,0.105042,1.830855,22,3,1, merged,0,0,0.00247053356896
17997,1000118,2,541,479,62,0.885397,0.114603,1.635397,61,1,542,480,62,0.885609,0.114391,1.615339,61,1,-1, abandoned,0,0,0
18005,1000063,2,1718,1541,177,0.896973,0.103027,1.842807,153,24,1719,1541,178,0.896451,0.103549,1.84251,153,25,-1, merged,1,1,0.0111367999543
18010,1000118,3,542,480,62,0.885609,0.114391,2.365339,61,1,543,481,62,0.88582,0.11418,2.378217,61,1,1, merged,0,0,0.0659646181312
18012,1000328,2,314,216,98,0.687898,0.312102,1.430874,90,8,315,217,98,0.688889,0.311111,1.432132,90,8,-1, abandoned,0,0,0.0135794656726
18012,1000329,1,961,714,247,0.742976,0.257024,0.742976,228,19,962,715,247,0.743243,0.256757,0.743243,228,19,-1, abandoned,0,0,0.0107438256932
18023,1000329,1,962,715,247,0.743243,0.256757,0.743243,228,19,965,718,247,0.744041,0.255959,0.744041,228,19,-1, merged,0,0,0.550241203178
18026,1000004,2,868,746,122,0.859447,0.140553,1.799567,97,25,875,749,126,0.856,0.144,1.790524,101,25,1, merged,1,1,0.145312695115
18026,1000329,3,965,718,247,0.744041,0.255959,2.543608,228,19,969,718,251,0.74097,0.25903,2.531494,232,19,1, merged,1,1,0.187621985109
18031,1000063,1,1719,1541,178,0.896451,0.103549,0.896451,153,25,1720,1542,178,0.896512,0.103488,0.896512,153,25,1, merged,0,0,0.378237790716
18031,1000592,3,167,137,30,0.820359,0.179641,2.620752,26,4,169,137,32,0.810651,0.189349,2.611339,26,6,-1, merged,1,1,0.316176470588
18036,1000014,2,678,580,98,0.855457,0.144543,1.596427,89,9,679,581,98,0.85567,0.14433,1.596907,89,9,1, merged,0,0,0
18036,1000329,1,969,718,251,0.74097,0.25903,0.74097,232,19,970,719,251,0.741237,0.258763,0.741237,232,19,1, merged,0,0,0
18040,1000329,1,970,719,251,0.741237,0.258763,0.741237,232,19,971,719,252,0.740474,0.259526,0.740474,233,19,1, merged,1,1,0.0641847138087
18043,1000011,2,319,299,20,0.937304,0.062696,1.695546,18,2,321,301,20,0.937695,0.062305,1.691793,18,2,-1, merged,0,0,0.0527744910003
18044,1000003,1,581,489,92,0.841652,0.158348,0.841652,86,6,583,491,92,0.842196,0.157804,0.842196,86,6,-1, merged,0,0,0.0069948662498
18044,1000011,2,321,301,20,0.937695,0.062305,1.779347,18,2,324,304,20,0.938272,0.061728,1.780467,18,2,-1, merged,0,0,0.00378910224096
18044,1000015,3,925,851,74,0.92,0.08,2.699347,66,8,926,852,74,0.920086,0.079914,2.700554,66,8,1, merged,0,0,0.00773980964736
18054,1000014,3,681,583,98,0.856094,0.143906,2.639941,89,9,682,584,98,0.856305,0.143695,2.615939,89,9,1, merged,0,0,0.0539197337653
18054,1000023,2,238,213,25,0.894958,0.105042,1.783847,22,3,239,213,26,0.891213,0.108787,1.759634,23,3,1, merged,1,1,0.267268992544
18061,1000121,2,648,540,108,0.833333,0.166667,1.523207,104,4,650,540,110,0.830769,0.169231,1.51729,106,4,1, merged,1,1,0
18061,1000328,1,316,218,98,0.689873,0.310127,0.689873,90,8,319,219,100,0.68652,0.31348,0.68652,92,8,1, merged,1,1,0
18061,1000329,4,974,722,252,0.741273,0.258727,3.095466,233,19,975,722,253,0.740513,0.259487,3.090361,234,19,1, merged,1,1,0
18067,1000004,2,876,750,126,0.856164,0.143836,1.794436,101,25,877,751,126,0.856328,0.143672,1.79479,101,25,1, merged,0,0,0.355325006715
18067,1000011,1,324,304,20,0.938272,0.061728,0.938272,18,2,325,305,20,0.938462,0.061538,0.938462,18,2,1, merged,0,0,0.711506622517
18067,1000120,3,219,190,29,0.86758,0.13242,2.662016,28,1,220,191,29,0.868182,0.131818,2.662972,28,1,1, merged,0,0,0.582571428571
18068,1000166,2,100,84,16,0.84,0.16,1.728889,15,1,102,85,17,0.833333,0.166667,1.633333,16,1,1, merged,1,1,0.304148759109
18072,1000199,2,164,133,31,0.810976,0.189024,1.614897,29,2,166,135,31,0.813253,0.186747,1.618448,29,2,-1, merged,0,0,0.00220709751554
18076,1000011,1,326,306,20,0.93865,0.06135,0.93865,18,2,327,307,20,0.938838,0.061162,0.938838,18,2,1, merged,0,0,0.0218685407193
18076,1000120,2,220,191,29,0.868182,0.131818,1.806832,28,1,221,192,29,0.868778,0.131222,1.807616,28,1,1, merged,0,0,0.0972665148064
18083,1000109,2,288,238,50,0.826389,0.173611,1.634081,48,2,289,239,50,0.82699,0.17301,1.635907,48,2,1, merged,0,0,0.224326694069
18084,1000109,3,289,239,50,0.82699,0.17301,2.44916,48,2,290,240,50,0.827586,0.172414,2.452084,48,2,1, merged,0,0,0.168612646498
18084,1000199,2,166,135,31,0.813253,0.186747,1.62217,29,2,167,136,31,0.814371,0.185629,1.624498,29,2,1, merged,0,0,0.172822598234
18087,1000109,2,290,240,50,0.827586,0.172414,1.637713,48,2,291,241,50,0.828179,0.171821,1.639499,48,2,1, merged,0,0,0.169015971976
18091,1000109,3,291,241,50,0.828179,0.171821,2.453871,48,2,292,242,50,0.828767,0.171233,2.436187,48,2,1, merged,0,0,0.169418089307
18091,1000199,1,167,136,31,0.814371,0.185629,0.814371,29,2,171,137,34,0.80117,0.19883,0.80117,32,2,1, merged,1,1,0.173688369609
18102,1000328,1,321,221,100,0.688474,0.311526,0.688474,92,8,324,222,102,0.685185,0.314815,0.685185,94,8,1, abandoned,1,1,0
18102,1000329,2,979,726,253,0.741573,0.258427,1.430047,234,19,982,729,253,0.742363,0.257637,1.427548,234,19,-1, abandoned,0,0,0
18104,1000328,1,324,222,102,0.685185,0.314815,0.685185,94,8,326,222,104,0.680982,0.319018,0.680982,96,8,1, abandoned,1,1,0
18104,1000592,2,171,137,34,0.80117,0.19883,1.486355,26,8,173,139,34,0.803468,0.196532,1.48445,26,8,-1, abandoned,0,0,0
18110,1000003,2,583,491,92,0.842196,0.157804,1.657672,86,6,584,491,93,0.840753,0.159247,1.657321,87,6,1, abandoned,1,1,0
18111,1000109,2,292,242,50,0.828767,0.171233,1.635017,48,2,293,243,50,0.829352,0.170648,1.631821,48,2,1, merged,0,0,0.226432915398
18112,1000109,2,293,243,50,0.829352,0.170648,1.631821,48,2,294,244,50,0.829932,0.170068,1.627478,48,2,1, merged,0,0,0.690769586401
18116,1000329,2,982,729,253,0.742363,0.257637,1.520988,234,19,983,730,253,0.742625,0.257375,1.522092,234,19,1, merged,0,0,0.0981987104634
18119,1000121,4,653,543,110,0.831547,0.168453,2.679877,106,4,654,543,111,0.830275,0.169725,2.640816,107,4,1, abandoned,1,1,0
18122,1000327,3,378,291,87,0.769841,0.230159,1.882586,66,21,379,292,87,0.770449,0.229551,1.826004,66,21,1, merged,0,0,0
18124,1000121,2,654,543,111,0.830275,0.169725,1.512093,107,4,655,544,111,0.830534,0.169466,1.513314,107,4,1, merged,0,0,0.636959656804
18124,1000328,1,330,225,105,0.681818,0.318182,0.681818,97,8,331,226,105,0.682779,0.317221,0.682779,97,8,1, merged,0,0,1.07988505747
18136,1000070,3,458,419,39,0.914847,0.085153,2.114471,29,10,459,420,39,0.915033,0.084967,2.186686,29,10,1, merged,0,0,0.738282355021
18136,1000327,1,380,293,87,0.771053,0.228947,0.771053,66,21,381,294,87,0.771654,0.228346,0.771654,66,21,-1, merged,0,0,0.549810754372
18141,1000329,2,987,734,253,0.743668,0.256332,1.299223,234,19,988,735,253,0.743927,0.256073,1.322874,234,19,1, merged,0,0,0.213173269254
18143,1000004,2,879,753,126,0.856655,0.143345,1.687448,101,25,880,754,126,0.856818,0.143182,1.687868,101,25,1, merged,0,0,0.189543503489
18143,1000121,1,656,545,111,0.830793,0.169207,0.830793,107,4,657,546,111,0.83105,0.16895,0.83105,107,4,1, merged,0,0,0.260694352821
18143,1000329,3,988,735,253,0.743927,0.256073,2.431375,234,19,989,736,253,0.744186,0.255814,2.432054,234,19,1, merged,0,0,0.298790786008
18143,1000592,4,173,139,34,0.803468,0.196532,3.234843,26,8,175,139,36,0.794286,0.205714,3.22634,26,10,-1, merged,1,1,0.260807435942
18146,1000120,1,223,194,29,0.869955,0.130045,0.869955,28,1,225,196,29,0.871111,0.128889,0.871111,28,1,-1, merged,0,0,0.433314606742
18172,1000063,2,1726,1547,179,0.896292,0.103708,1.706719,153,26,1727,1548,179,0.896352,0.103648,1.707673,153,26,1, merged,0,0,0.00117861983617
18207,1000003,1,587,494,93,0.841567,0.158433,0.841567,87,6,589,496,93,0.842105,0.157895,0.842105,87,6,-1, merged,0,0,0
18208,1000070,1,459,420,39,0.915033,0.084967,0.915033,29,10,460,421,39,0.915217,0.084783,0.915217,29,10,1, merged,0,0,0.0262713720703
18208,1000105,2,241,190,51,0.788382,0.211618,1.703414,48,3,242,191,51,0.789256,0.210744,1.704474,48,3,1, merged,0,0,0.0346700612865
18208,1000121,3,657,546,111,0.83105,0.16895,2.534465,107,4,658,547,111,0.831307,0.168693,2.535781,107,4,1, merged,0,0,0.0308291978766
18209,1000026,2,190,173,17,0.910526,0.089474,1.665961,15,2,191,174,17,0.910995,0.089005,1.662346,15,2,1, merged,0,0,0.0108094519859
18233,1000007,2,465,397,68,0.853763,0.146237,1.774279,58,10,466,398,68,0.854077,0.145923,1.773605,58,10,-1, merged,0,0,0.405138489399
18233,1000015,1,931,857,74,0.920516,0.079484,0.920516,66,8,932,857,75,0.919528,0.080472,0.919528,67,8,1, merged,1,1,0
18233,1000153,3,477,439,38,0.920335,0.079665,2.694614,29,9,480,441,39,0.91875,0.08125,2.692355,30,9,-1, merged,1,0,0.367875257064
18241,1000120,1,229,199,30,0.868996,0.131004,0.868996,28,2,230,200,30,0.869565,0.130435,0.869565,28,2,1, merged,0,0,0.525231224565
18242,1000120,1,230,200,30,0.869565,0.130435,0.869565,28,2,231,201,30,0.87013,0.12987,0.87013,28,2,1, merged,0,0,0.529083518108
18243,1000120,1,231,201,30,0.87013,0.12987,0.87013,28,2,232,202,30,0.87069,0.12931,0.87069,28,2,1, merged,0,0,0.0734007981621
18244,1000329,1,989,736,253,0.744186,0.255814,0.744186,234,19,990,737,253,0.744444,0.255556,0.744444,234,19,-1, merged,0,0,0
18246,1000004,1,880,754,126,0.856818,0.143182,0.856818,101,25,881,755,126,0.856981,0.143019,0.856981,101,25,-1, merged,0,0,0
18246,1000121,2,658,547,111,0.831307,0.168693,1.688125,107,4,659,547,112,0.830046,0.169954,1.687026,107,5,-1, merged,1,1,0
18247,1000003,2,589,496,93,0.842105,0.157895,1.761633,87,6,590,497,93,0.842373,0.157627,1.760915,87,6,-1, abandoned,0,0,0.32256110312
18247,1000015,1,932,857,75,0.919528,0.080472,0.919528,67,8,933,857,76,0.918542,0.081458,0.918542,68,8,1, abandoned,1,1,0.31754997608
18248,1000091,2,198,153,45,0.772727,0.227273,1.46437,41,4,199,154,45,0.773869,0.226131,1.466177,41,4,-1, merged,0,0,0.241925765786
18248,1000328,1,347,240,107,0.691643,0.308357,0.691643,99,8,351,243,108,0.692308,0.307692,0.692308,100,8,1, merged,1,1,0.281524582568
18250,1000109,1,294,244,50,0.829932,0.170068,0.829932,48,2,295,245,50,0.830508,0.169492,0.830508,48,2,1, merged,0,0,0.603477431251
18252,1000166,2,102,85,17,0.833333,0.166667,1.633333,16,1,103,86,17,0.834951,0.165049,1.653133,16,1,1, merged,0,0,0.0636171709842
18254,1000012,1,296,265,31,0.89527,0.10473,0.89527,30,1,297,266,31,0.895623,0.104377,0.895623,30,1,1, merged,0,0,0.253402905333
18256,1000011,1,331,310,21,0.936556,0.063444,0.936556,19,2,332,311,21,0.936747,0.063253,0.936747,19,2,1, merged,0,0,0.865062755891
18256,1000015,2,933,857,76,0.918542,0.081458,1.855098,68,8,934,858,76,0.91863,0.08137,1.855377,68,8,1, merged,0,0,0.527370925591
18269,1000011,1,332,311,21,0.936747,0.063253,0.936747,19,2,333,311,22,0.933934,0.066066,0.933934,20,2,1, merged,1,1,0.0104560394412
18269,1000120,2,233,203,30,0.871245,0.128755,1.807992,28,2,234,204,30,0.871795,0.128205,1.805729,28,2,1, merged,0,0,0.0323756906077
18271,1000015,1,934,858,76,0.91863,0.08137,0.91863,68,8,935,859,76,0.918717,0.081283,0.918717,68,8,1, merged,0,0,0.105912992868
18271,1000153,2,480,441,39,0.91875,0.08125,1.83738,30,9,481,442,39,0.918919,0.081081,1.837635,30,9,1, merged,0,0,0.110156566801
18276,1000007,2,466,398,68,0.854077,0.145923,1.798522,58,10,467,399,68,0.85439,0.14561,1.799844,58,10,1, merged,0,0,0.0638245147831
18276,1000026,3,191,174,17,0.910995,0.089005,2.709516,15,2,192,175,17,0.911458,0.088542,2.711303,15,2,1, merged,0,0,0.134926314415
18280,1000120,1,234,204,30,0.871795,0.128205,0.871795,28,2,235,205,30,0.87234,0.12766,0.87234,28,2,1, merged,0,0,0.00118825039984
18281,1000329,1,990,737,253,0.744444,0.255556,0.744444,234,19,991,738,253,0.744702,0.255298,0.744702,234,19,1, merged,0,0,0
18289,1000004,3,883,757,126,0.857305,0.142695,1.657305,101,25,884,758,126,0.857466,0.142534,1.887769,101,25,1, merged,0,0,0.373544973545
18294,1000327,2,381,294,87,0.771654,0.228346,1.601719,66,21,382,294,88,0.769634,0.230366,1.594309,67,21,1, abandoned,1,1,0.228196887012
18295,1000070,2,461,422,39,0.915401,0.084599,1.607709,29,10,462,423,39,0.915584,0.084416,1.605925,29,10,1, merged,0,0,0.408950680862
18295,1000328,1,351,243,108,0.692308,0.307692,0.692308,100,8,352,243,109,0.690341,0.309659,0.690341,101,8,1, merged,1,1,0.342294476625
18310,1000063,2,1728,1549,179,0.896412,0.103588,1.798851,153,26,1732,1551,181,0.895497,0.104503,1.79574,155,26,1, merged,1,1,0.376316177463
18315,1000328,2,352,243,109,0.690341,0.309659,1.435043,101,8,353,244,109,0.691218,0.308782,1.436178,101,8,-1, abandoned,0,0,0
18315,1000329,1,991,738,253,0.744702,0.255298,0.744702,234,19,992,739,253,0.74496,0.25504,0.74496,234,19,-1, abandoned,0,0,0
18323,1000004,2,885,759,126,0.857627,0.142373,1.221263,101,25,890,763,127,0.857303,0.142697,1.214446,102,25,-1, merged,1,0,0.0291893043571
18333,1000063,2,1737,1556,181,0.895797,0.104203,1.796283,155,26,1738,1557,181,0.895857,0.104143,1.796584,155,26,1, merged,0,0,0.0246542986842
18347,1000329,2,993,740,253,0.745217,0.254783,1.541827,234,19,994,741,253,0.745473,0.254527,1.543226,234,19,1, merged,0,0,0.327597281321
18347,1000592,1,177,141,36,0.79661,0.20339,0.79661,26,10,178,142,36,0.797753,0.202247,0.797753,26,10,1, merged,0,0,0.309001369713
18350,1000070,2,463,424,39,0.915767,0.084233,1.639171,29,10,464,425,39,0.915948,0.084052,1.650642,29,10,1, merged,0,0,0.272169801803
18354,1000023,2,239,213,26,0.891213,0.108787,1.759634,23,3,240,214,26,0.891667,0.108333,1.763462,23,3,1, merged,0,0,0.674844670824
18356,1000015,1,935,859,76,0.918717,0.081283,0.918717,68,8,936,860,76,0.918803,0.081197,0.918803,68,8,1, merged,0,0,0.00491118200938
18356,1000121,2,659,547,112,0.830046,0.169954,1.748762,107,5,660,548,112,0.830303,0.169697,1.749106,107,5,1, merged,0,0,0.0250197619158
18358,1000120,2,235,205,30,0.87234,0.12766,1.744135,28,2,237,207,30,0.873418,0.126582,1.748418,28,2,-1, merged,0,0,0.102574649474
18365,1000004,1,891,764,127,0.857464,0.142536,0.857464,102,25,892,764,128,0.856502,0.143498,0.856502,103,25,1, merged,1,1,0.353389243876
18365,1000120,2,237,207,30,0.873418,0.126582,1.730881,28,2,238,208,30,0.87395,0.12605,1.730452,28,2,1, merged,0,0,0.531898340249
18380,1000592,2,178,142,36,0.797753,0.202247,1.682368,26,10,181,144,37,0.79558,0.20442,1.652723,26,11,-1, merged,1,0,0.777454025088
18381,1000592,2,181,144,37,0.79558,0.20442,1.652723,26,11,182,145,37,0.796703,0.203297,1.66337,26,11,1, merged,0,0,0.102554278416
18385,1000014,1,687,589,98,0.857351,0.142649,0.857351,89,9,688,590,98,0.857558,0.142442,0.857558,89,9,1, merged,0,0,0.0632966720957
18385,1000043,2,177,144,33,0.813559,0.186441,1.67091,29,4,178,145,33,0.814607,0.185393,1.672165,29,4,1, merged,0,0,0.0742298279982
18394,1000007,1,468,400,68,0.854701,0.145299,0.854701,58,10,469,401,68,0.855011,0.144989,0.855011,58,10,-1, merged,0,0,0.365301916345
18394,1000012,2,297,266,31,0.895623,0.104377,1.750324,30,1,298,267,31,0.895973,0.104027,1.750984,30,1,1, merged,0,0,0.250915671341
18411,1000121,2,661,549,112,0.83056,0.16944,1.658429,107,5,662,550,112,0.830816,0.169184,1.660084,107,5,1, merged,0,0,0.00159310633281
18412,1000118,1,548,486,62,0.886861,0.113139,0.886861,61,1,549,486,63,0.885246,0.114754,0.885246,62,1,1, merged,1,1,0
18413,1000005,1,158,117,41,0.740506,0.259494,0.740506,39,2,159,117,42,0.735849,0.264151,0.735849,40,2,1, merged,1,1,0.107492652415
18413,1000014,4,689,591,98,0.857765,0.142235,3.122195,89,9,691,593,98,0.858177,0.141823,3.112751,89,9,-1, merged,0,0,0.121369068552
18413,1000329,3,995,742,253,0.745729,0.254271,2.26443,234,19,998,744,254,0.745491,0.254509,2.254574,235,19,1, merged,1,1,0.139378990133
18417,1000329,2,998,744,254,0.745491,0.254509,1.745491,235,19,999,745,254,0.745746,0.254254,1.745746,235,19,1, merged,0,0,0.627457331812
18418,1000120,1,238,208,30,0.87395,0.12605,0.87395,28,2,240,210,30,0.875,0.125,0.875,28,2,1, merged,0,0,0.503347064882
18418,1000153,2,482,443,39,0.919087,0.080913,1.793037,30,9,483,444,39,0.919255,0.080745,1.794255,30,9,1, merged,0,0,1.07330977468
18426,1000132,2,117,99,18,0.846154,0.153846,1.672241,16,2,118,99,19,0.838983,0.161017,1.672316,16,3,-1, merged,1,1,0
18439,1000014,2,695,597,98,0.858993,0.141007,1.733993,89,9,696,598,98,0.859195,0.140805,1.737244,89,9,1, merged,0,0,0.0785084840114
18446,1000054,2,31,27,4,0.870968,0.129032,1.661091,2,2,32,28,4,0.875,0.125,1.661885,2,2,1, merged,0,0,3.99130680393e-08
18446,1000105,1,243,192,51,0.790123,0.209877,0.790123,48,3,244,192,52,0.786885,0.213115,0.786885,49,3,1, merged,1,1,0.00212294594038
18463,1000014,1,696,598,98,0.859195,0.140805,0.859195,89,9,697,599,98,0.859397,0.140603,0.859397,89,9,1, merged,0,0,0.0706643046498
18463,1000199,2,171,137,34,0.80117,0.19883,1.660365,32,2,172,138,34,0.802326,0.197674,1.661723,32,2,1, merged,0,0,0.000814379617242
18466,1000026,2,193,176,17,0.911917,0.088083,1.819698,15,2,195,178,17,0.912821,0.087179,1.817993,15,2,-1, merged,0,0,0.122249976485
18466,1000153,4,483,444,39,0.919255,0.080745,3.488953,30,9,484,445,39,0.919421,0.080579,3.308843,30,9,1, merged,0,0,0.275637175867
18483,1000121,4,663,551,112,0.831071,0.168929,2.587252,107,5,664,552,112,0.831325,0.168675,2.772513,107,5,1, merged,0,0,0.0015480278238
18501,1000070,3,469,430,39,0.916844,0.083156,2.214142,29,10,470,431,39,0.917021,0.082979,2.266299,29,10,-1, abandoned,0,0,0.734652215548
18501,1000327,4,383,295,88,0.770235,0.229765,2.984377,67,21,384,296,88,0.770833,0.229167,3.037132,67,21,-1, abandoned,0,0,0.553076521966
18516,1000329,1,1002,747,255,0.745509,0.254491,0.745509,235,20,1003,748,255,0.745763,0.254237,0.745763,235,20,1, merged,0,0,0.954756007792
18520,1000014,2,697,599,98,0.859397,0.140603,1.359397,89,9,698,600,98,0.859599,0.140401,1.415154,89,9,1, merged,0,0,0
18520,1000534,1,8,4,4,0.5,0.5,0.5,4,0,9,5,4,0.555556,0.444444,0.555556,4,0,1, merged,0,0,0
18529,1000014,1,698,600,98,0.859599,0.140401,0.859599,89,9,701,602,99,0.858773,0.141227,0.858773,90,9,1, merged,1,1,0.722529889679
18529,1000015,2,937,861,76,0.91889,0.08111,1.778489,68,8,938,862,76,0.918977,0.081023,1.77775,68,8,1, merged,0,0,1.1017479436
18546,1000043,2,180,147,33,0.816667,0.183333,0.816667,29,4,181,148,33,0.81768,0.18232,1.31768,29,4,1, merged,0,0,0.745674538228
18558,1000043,2,182,149,33,0.818681,0.181319,1.563779,29,4,184,150,34,0.815217,0.184783,1.557083,30,4,1, merged,1,1,0.105470824421
18577,1000004,3,902,773,129,0.856984,0.143016,2.583202,104,25,903,774,129,0.857143,0.142857,2.575848,104,25,-1, abandoned,0,0,0.00792501634087
18577,1000023,1,241,215,26,0.892116,0.107884,0.892116,23,3,242,215,27,0.88843,0.11157,0.88843,24,3,1, abandoned,1,1,0.00044003598288
18580,1000012,3,298,267,31,0.895973,0.104027,2.576587,30,1,299,267,32,0.892977,0.107023,2.558181,31,1,1, merged,1,1,0.00248493975904
18585,1000007,1,469,401,68,0.855011,0.144989,0.855011,58,10,470,402,68,0.855319,0.144681,0.855319,58,10,1, merged,0,0,0
18589,1000091,2,199,154,45,0.773869,0.226131,1.46769,41,4,201,155,46,0.771144,0.228856,1.463882,42,4,1, merged,1,1,0
18589,1000328,1,356,247,109,0.69382,0.30618,0.69382,101,8,358,248,110,0.692737,0.307263,0.692737,102,8,1, merged,1,1,0
18611,1000009,3,434,363,71,0.836406,0.163594,2.581545,63,8,435,364,71,0.836782,0.163218,2.560827,63,8,1, merged,0,0,0.00592291323972
18616,1000070,2,473,433,40,0.915433,0.084567,1.686267,30,10,474,434,40,0.915612,0.084388,1.68704,30,10,1, merged,0,0,0.243536275681
18616,1000327,1,384,296,88,0.770833,0.229167,0.770833,67,21,385,297,88,0.771429,0.228571,0.771429,67,21,-1, merged,0,0,0.183593838187
18621,1000014,2,708,608,100,0.858757,0.141243,1.671591,91,9,709,609,100,0.858956,0.141044,1.667467,91,9,1, merged,0,0,0.0316589431282
18621,1000043,1,187,152,35,0.812834,0.187166,0.812834,31,4,188,152,36,0.808511,0.191489,0.808511,32,4,1, merged,1,1,0.0410813158723
18627,1000121,2,669,557,112,0.832586,0.167414,1.578602,107,5,670,558,112,0.832836,0.167164,1.579104,107,5,1, merged,0,0,0.00822378097697
18627,1000329,1,1004,749,255,0.746016,0.253984,0.746016,235,20,1005,750,255,0.746269,0.253731,0.746269,235,20,1, merged,0,0,0.00861568724237
18629,1000329,2,1005,750,255,0.746269,0.253731,1.489803,235,20,1009,752,257,0.745292,0.254708,1.486745,237,20,-1, merged,1,0,0.0520865193254
18638,1000121,2,670,558,112,0.832836,0.167164,1.578128,107,5,671,559,112,0.833085,0.166915,1.57863,107,5,1, merged,0,0,0.0892331169021
18638,1000329,1,1009,752,257,0.745292,0.254708,0.745292,237,20,1010,753,257,0.745545,0.254455,0.745545,237,20,1, merged,0,0,0.12218343835
18640,1000327,2,385,297,88,0.771429,0.228571,1.326984,67,21,386,298,88,0.772021,0.227979,1.372021,67,21,1, merged,0,0,0.0552895856848
18656,1000015,2,946,869,77,0.918605,0.081395,0.918605,69,8,947,870,77,0.918691,0.081309,0.918691,69,8,1, merged,0,0,0.95645599354
18666,1000121,1,671,559,112,0.833085,0.166915,0.833085,107,5,672,560,112,0.833333,0.166667,0.833333,107,5,1, merged,0,0,0
18666,1000329,2,1011,754,257,0.745796,0.254204,1.578881,237,20,1012,755,257,0.746047,0.253953,1.579381,237,20,1, merged,0,0,0
18673,1000592,2,182,145,37,0.796703,0.203297,1.716703,26,11,184,147,37,0.798913,0.201087,1.724839,26,11,-1, merged,0,0,0.765263605442
18685,1000004,1,905,776,129,0.857459,0.142541,0.857459,104,25,906,777,129,0.857616,0.142384,0.857616,104,25,1, merged,0,0,0
18685,1000121,3,672,560,112,0.833333,0.166667,2.436839,107,5,673,561,112,0.833581,0.166419,2.437495,107,5,1, merged,0,0,0
18685,1000329,2,1012,755,257,0.746047,0.253953,1.603506,237,20,1013,756,257,0.746298,0.253702,1.603914,237,20,1, merged,0,0,0
18692,1000121,1,673,561,112,0.833581,0.166419,0.833581,107,5,674,562,112,0.833828,0.166172,0.833828,107,5,1, merged,0,0,0.000531321882485
18692,1000327,2,388,300,88,0.773196,0.226804,1.606777,67,21,389,301,88,0.773779,0.226221,1.607607,67,21,1, merged,0,0,0.000641339731855
18695,1000121,2,674,562,112,0.833828,0.166172,1.617981,107,5,675,563,112,0.834074,0.165926,1.61609,107,5,-1, abandoned,0,0,0
18695,1000329,3,1015,758,257,0.746798,0.253202,2.364779,237,20,1016,759,257,0.747047,0.252953,2.363138,237,20,-1, abandoned,0,0,0
18701,1000118,1,557,491,66,0.881508,0.118492,0.881508,65,1,559,493,66,0.881932,0.118068,0.881932,65,1,-1, merged,0,0,0.0512742248882
18702,1000118,1,559,493,66,0.881932,0.118068,0.881932,65,1,560,494,66,0.882143,0.117857,0.882143,65,1,1, merged,0,0,1.07197565398e-05
18760,1000121,2,678,566,112,0.834808,0.165192,1.501475,107,5,679,567,112,0.835052,0.164948,1.585052,107,5,1, merged,0,0,0.469312954686
18761,1000004,2,907,778,129,0.857773,0.142227,1.719311,104,25,908,779,129,0.85793,0.14207,1.719998,104,25,1, merged,0,0,0.0897649777989
18761,1000120,1,260,224,36,0.861538,0.138462,0.861538,34,2,261,225,36,0.862069,0.137931,0.862069,34,2,1, merged,0,0,0.105176706682
18762,1000004,1,908,779,129,0.85793,0.14207,0.85793,104,25,909,780,129,0.858086,0.141914,0.858086,104,25,1, merged,0,0,0.0980298370838
18762,1000120,2,261,225,36,0.862069,0.137931,1.719998,34,2,262,226,36,0.862595,0.137405,1.720681,34,2,1, merged,0,0,0.0699100112486
18763,1000121,1,679,567,112,0.835052,0.164948,0.835052,107,5,680,568,112,0.835294,0.164706,0.835294,107,5,1, merged,0,0,0.615747430761
18780,1000109,2,295,245,50,0.830508,0.169492,1.631713,48,2,296,246,50,0.831081,0.168919,1.633476,48,2,1, merged,0,0,1.22643114687
18788,1000130,2,157,134,23,0.853503,0.146497,1.628411,20,3,158,135,23,0.85443,0.14557,1.630166,20,3,1, merged,0,0,1.14059065934
18797,1000043,2,189,153,36,0.809524,0.190476,1.559524,32,4,190,154,36,0.810526,0.189474,1.460526,32,4,1, merged,0,0,0.302830264687
18798,1000043,2,190,154,36,0.810526,0.189474,1.586262,32,4,192,156,36,0.8125,0.1875,1.585394,32,4,-1, merged,0,0,0.0859774622098
18809,1000070,1,477,437,40,0.916143,0.083857,0.916143,30,10,478,438,40,0.916318,0.083682,0.916318,30,10,1, merged,0,0,0.575012770305
18809,1000105,2,245,193,52,0.787755,0.212245,1.703898,49,3,246,194,52,0.788618,0.211382,1.704936,49,3,1, merged,0,0,0.593890922706
18813,1000327,2,389,301,88,0.773779,0.226221,1.699705,67,21,390,302,88,0.774359,0.225641,1.70293,67,21,-1, abandoned,0,0,0
18822,1000070,1,478,438,40,0.916318,0.083682,0.916318,30,10,480,440,40,0.916667,0.083333,0.916667,30,10,-1, merged,0,0,0.009529102665
18844,1000327,1,390,302,88,0.774359,0.225641,0.774359,67,21,393,303,90,0.770992,0.229008,0.770992,69,21,1, merged,1,1,0
18850,1000121,3,680,568,112,0.835294,0.164706,2.6212,107,5,682,570,112,0.835777,0.164223,2.611572,107,5,1, merged,0,0,0.00372032655301
18850,1000124,2,237,225,12,0.949367,0.050633,1.785906,11,1,239,226,13,0.945607,0.054393,1.775795,12,1,1, merged,1,1,0.00240487065627
18850,1000166,1,104,87,17,0.836538,0.163462,0.836538,16,1,106,88,18,0.830189,0.169811,0.830189,17,1,1, merged,1,1,0.00417339416958
18851,1000004,1,914,784,130,0.857768,0.142232,0.857768,105,25,915,785,130,0.857923,0.142077,0.857923,105,25,1, merged,0,0,0.0342428666846
18851,1000014,2,711,611,100,0.859353,0.140647,1.717121,91,9,712,612,100,0.859551,0.140449,1.717474,91,9,1, merged,0,0,0.046149977599
18853,1000004,1,915,785,130,0.857923,0.142077,0.857923,105,25,916,786,130,0.858079,0.141921,0.858079,105,25,1, merged,0,0,0.000740347718118
18853,1000153,2,488,449,39,0.920082,0.079918,1.778005,30,9,490,451,39,0.920408,0.079592,1.778487,30,9,1, merged,0,0,0.000341474913297
18854,1000120,1,266,230,36,0.864662,0.135338,0.864662,34,2,267,231,36,0.865169,0.134831,0.865169,34,2,1, merged,0,0,0.495665387076
18869,1000004,2,917,787,130,0.858233,0.141767,1.599686,105,25,918,788,130,0.858388,0.141612,1.59826,105,25,-1, abandoned,0,0,0.361946401963
18870,1000043,2,192,156,36,0.8125,0.1875,1.708082,32,4,193,157,36,0.813472,0.186528,1.709114,32,4,1, merged,0,0,0.908642629905
18870,1000063,1,1743,1561,182,0.895582,0.104418,0.895582,156,26,1744,1562,182,0.895642,0.104358,0.895642,156,26,1, merged,0,0,0.260588371793
18872,1000329,2,1017,760,257,0.747296,0.252704,1.747296,237,20,1018,761,257,0.747544,0.252456,1.747544,237,20,1, merged,0,0,0.953083883211
18882,1000063,2,1744,1562,182,0.895642,0.104358,1.842207,156,26,1747,1565,182,0.895821,0.104179,1.839003,156,26,-1, merged,0,0,0.00165627887116
18885,1000124,2,239,226,13,0.945607,0.054393,1.654345,12,1,240,226,14,0.941667,0.058333,1.64359,13,1,1, abandoned,1,1,0.120350542534
18887,1000014,1,712,612,100,0.859551,0.140449,0.859551,91,9,714,613,101,0.858543,0.141457,0.858543,92,9,1, merged,1,1,0.580497352836
18888,1000063,1,1747,1565,182,0.895821,0.104179,0.895821,156,26,1748,1566,182,0.895881,0.104119,0.895881,156,26,1, merged,0,0,0.00260314278695
18889,1000063,1,1748,1566,182,0.895881,0.104119,0.895881,156,26,1749,1567,182,0.895941,0.104059,0.895941,156,26,1, merged,0,0,0.0823871213054
18892,1000004,1,918,788,130,0.858388,0.141612,0.858388,105,25,919,789,130,0.858542,0.141458,0.858542,105,25,1, merged,0,0,0.44396534126
18895,1000329,2,1018,761,257,0.747544,0.252456,1.48797,237,20,1019,762,257,0.747792,0.252208,1.488769,237,20,1, merged,0,0,0.956909068537
18906,1000004,2,919,789,130,0.858542,0.141458,1.717283,105,25,921,790,131,0.857763,0.142237,1.716702,105,26,-1, merged,1,1,0.452399682888
18906,1000014,1,715,614,101,0.858741,0.141259,0.858741,92,9,716,615,101,0.858939,0.141061,0.858939,92,9,1, merged,0,0,0.515743066457
18912,1000091,1,202,156,46,0.772277,0.227723,0.772277,42,4,204,157,47,0.769608,0.230392,0.769608,43,4,1, merged,1,1,0.214776881289
18912,1000328,2,360,250,110,0.694444,0.305556,1.466722,102,8,361,251,110,0.695291,0.304709,1.464899,102,8,1, merged,0,0,0.11222049612
18926,1000004,1,922,791,131,0.857918,0.142082,0.857918,105,26,923,792,131,0.858072,0.141928,0.858072,105,26,1, merged,0,0,0.00450314511375
18929,1000023,1,244,217,27,0.889344,0.110656,0.889344,24,3,245,218,27,0.889796,0.110204,0.889796,24,3,1, merged,0,0,0
18929,1000063,2,1749,1567,182,0.895941,0.104059,1.785285,156,26,1750,1568,182,0.896,0.104,1.785796,156,26,1, merged,0,0,0
18930,1000023,1,245,218,27,0.889796,0.110204,0.889796,24,3,246,219,27,0.890244,0.109756,0.890244,24,3,1, merged,0,0,0.0970188428882
18930,1000063,2,1750,1568,182,0.896,0.104,1.785796,156,26,1751,1569,182,0.896059,0.103941,1.786303,156,26,1, merged,0,0,0.0456542914244
18936,1000003,1,605,510,95,0.842975,0.157025,0.842975,88,7,607,511,96,0.841845,0.158155,0.841845,89,7,1, merged,1,1,0.15308266838
18936,1000011,2,339,317,22,0.935103,0.064897,1.778078,20,2,340,318,22,0.935294,0.064706,1.777139,20,2,1, merged,0,0,0.290461962139
18939,1000014,2,716,615,101,0.858939,0.141061,1.67241,92,9,717,616,101,0.859135,0.140865,1.673568,92,9,1, merged,0,0,0.497997504352
18939,1000043,1,193,157,36,0.813472,0.186528,0.813472,32,4,194,158,36,0.814433,0.185567,0.814433,32,4,1, merged,0,0,0.583800952885
18941,1000121,2,684,571,113,0.834795,0.165205,1.605788,108,5,685,572,113,0.835036,0.164964,1.60661,108,5,1, merged,0,0,0.00762930550881
18941,1000327,1,393,303,90,0.770992,0.229008,0.770992,69,21,394,304,90,0.771574,0.228426,0.771574,69,21,1, merged,0,0,0.00464756003098
18942,1000004,2,923,792,131,0.858072,0.141928,1.572357,105,26,925,794,131,0.858378,0.141622,1.525045,105,26,-1, merged,0,0,0.0251434836602
18945,1000199,2,173,139,34,0.803468,0.196532,1.605863,32,2,174,140,34,0.804598,0.195402,1.608169,32,2,1, merged,0,0,0.228862048777
18971,1000070,3,483,443,40,0.917184,0.082816,2.488931,30,10,484,444,40,0.917355,0.082645,2.491279,30,10,1, merged,0,0,0.255816899624
18971,1000091,1,204,157,47,0.769608,0.230392,0.769608,43,4,205,158,47,0.770732,0.229268,0.770732,43,4,1, merged,0,0,0.42721908939
18971,1000592,2,187,150,37,0.802139,0.197861,1.571747,26,11,188,151,37,0.803191,0.196809,1.573923,26,11,1, merged,0,0,0.266195840038
18972,1000328,2,363,252,111,0.694215,0.305785,1.497406,103,8,364,253,111,0.695055,0.304945,1.499288,103,8,1, merged,0,0,1.1576533162
18972,1000592,1,188,151,37,0.803191,0.196809,0.803191,26,11,189,152,37,0.804233,0.195767,0.804233,26,11,1, merged,0,0,0.850586309524
18976,1000199,4,175,141,34,0.805714,0.194286,2.306462,32,2,176,142,34,0.806818,0.193182,2.874973,32,2,1, merged,0,0,0
18980,1000007,2,472,404,68,0.855932,0.144068,1.69187,58,10,473,405,68,0.856237,0.143763,1.693446,58,10,-1, abandoned,0,0,0.240449255574
18984,1000007,2,473,405,68,0.856237,0.143763,1.738127,58,10,474,406,68,0.85654,0.14346,1.739353,58,10,1, merged,0,0,0
18985,1000124,2,240,226,14,0.941667,0.058333,1.655952,13,1,241,227,14,0.941909,0.058091,1.691909,13,1,1, merged,0,0,0.330785532802
18987,1000124,1,241,227,14,0.941909,0.058091,0.941909,13,1,244,229,15,0.938525,0.061475,0.938525,14,1,-1, merged,1,0,0.0292501443919
18999,1000014,1,718,617,101,0.859331,0.140669,0.859331,92,9,719,618,101,0.859527,0.140473,0.859527,92,9,1, merged,0,0,0
19000,1000004,1,929,798,131,0.858988,0.141012,0.858988,105,26,935,804,131,0.859893,0.140107,0.859893,105,26,-1, merged,0,0,0.0305232915609
19000,1000120,3,271,234,37,0.863469,0.136531,2.534957,35,2,272,235,37,0.863971,0.136029,2.557197,35,2,1, merged,0,0,0.206255082678
19008,1000091,1,205,158,47,0.770732,0.229268,0.770732,43,4,208,159,49,0.764423,0.235577,0.764423,45,4,1, merged,1,1,0.279267366853
19008,1000328,2,364,253,111,0.695055,0.304945,1.465787,103,8,367,255,112,0.694823,0.305177,1.459246,104,8,1, merged,1,1,0.568285127806
19011,1000004,2,935,804,131,0.859893,0.140107,1.631632,105,26,936,804,132,0.858974,0.141026,1.631538,105,27,-1, merged,1,1,0
19016,1000329,1,1026,767,259,0.747563,0.252437,0.747563,238,21,1027,767,260,0.746835,0.253165,0.746835,239,21,1, merged,1,1,0.0611074409971
19019,1000121,1,685,572,113,0.835036,0.164964,0.835036,108,5,686,573,113,0.835277,0.164723,0.835277,108,5,-1, abandoned,0,0,0.0626385634629
19019,1000329,2,1028,768,260,0.747082,0.252918,1.582118,239,21,1029,769,260,0.747328,0.252672,1.582604,239,21,-1, abandoned,0,0,0.0911918730265
19022,1000015,2,963,886,77,0.920042,0.079958,1.684465,69,8,964,887,77,0.920124,0.079876,1.685675,69,8,-1, abandoned,0,0,0.139254811236
19022,1000091,1,208,159,49,0.764423,0.235577,0.764423,45,4,209,160,49,0.76555,0.23445,0.76555,45,4,-1, abandoned,0,0,0.141058090266
19025,1000121,1,686,573,113,0.835277,0.164723,0.835277,108,5,688,574,114,0.834302,0.165698,0.834302,109,5,1, abandoned,1,1,0.0322421901009
19034,1000070,1,484,444,40,0.917355,0.082645,0.917355,30,10,485,444,41,0.915464,0.084536,0.915464,31,10,1, abandoned,1,1,0.300062794982
19034,1000121,2,690,575,115,0.833333,0.166667,1.750689,110,5,691,576,115,0.833575,0.166425,1.749038,110,5,-1, abandoned,0,0,0.263971318054
19038,1000121,2,691,576,115,0.833575,0.166425,1.582124,110,5,692,577,115,0.833815,0.166185,1.582607,110,5,1, merged,0,0,0.315036938454
19038,1000329,1,1034,774,260,0.748549,0.251451,0.748549,239,21,1035,775,260,0.748792,0.251208,0.748792,239,21,1, merged,0,0,0.457717509145
19046,1000004,4,936,804,132,0.858974,0.141026,2.54826,105,27,938,805,133,0.858209,0.141791,2.46469,106,27,1, merged,1,1,0.364698991299
19047,1000004,2,938,805,133,0.858209,0.141791,1.247098,106,27,943,809,134,0.8579,0.1421,1.191234,107,27,-1, merged,1,0,0.121664916124
19051,1000004,3,943,809,134,0.8579,0.1421,2.581239,107,27,944,810,134,0.858051,0.141949,2.576889,107,27,-1, merged,0,0,0.0255362169891
19051,1000063,1,1753,1571,182,0.896178,0.103822,0.896178,156,26,1754,1571,183,0.895667,0.104333,0.895667,157,26,1, merged,1,1,0.00381651017214
19052,1000004,2,944,810,134,0.858051,0.141949,1.191384,107,27,946,811,135,0.857294,0.142706,1.178722,108,27,-1, merged,1,0,0.00596633826457
19052,1000118,4,563,497,66,0.882771,0.117229,2.660362,65,1,564,498,66,0.882979,0.117021,2.642346,65,1,-1, merged,0,0,0.00141144954933
19098,1000121,3,695,580,115,0.834532,0.165468,2.331596,110,5,696,580,116,0.833333,0.166667,2.317599,111,5,1, abandoned,1,1,0
19098,1000327,2,394,304,90,0.771574,0.228426,1.497064,69,21,396,306,90,0.772727,0.227273,1.484266,69,21,-1, abandoned,0,0,0
19103,1000070,2,485,444,41,0.915464,0.084536,1.748797,31,10,486,445,41,0.915638,0.084362,1.74921,31,10,1, merged,0,0,0.0272250433396
19103,1000121,1,696,580,116,0.833333,0.166667,0.833333,111,5,697,581,116,0.833572,0.166428,0.833572,111,5,1, merged,0,0,0.0294581914141
19104,1000121,2,697,581,116,0.833572,0.166428,1.649106,111,5,698,581,117,0.832378,0.167622,1.641902,112,5,1, merged,1,1,0.311257332537
19105,1000121,2,698,581,117,0.832378,0.167622,1.641902,112,5,700,582,118,0.831429,0.168571,1.625821,113,5,1, merged,1,1,0.0163306865656
19117,1000091,1,209,160,49,0.76555,0.23445,0.76555,45,4,210,160,50,0.761905,0.238095,0.761905,46,4,1, abandoned,1,1,0.0195046280751
19117,1000121,2,700,582,118,0.831429,0.168571,1.596979,113,5,701,582,119,0.830243,0.169757,1.592147,114,5,1, abandoned,1,1,0.00765365761144
19127,1000004,2,948,813,135,0.857595,0.142405,1.595095,108,27,949,814,135,0.857745,0.142255,1.590664,108,27,-1, abandoned,0,0,0.0385332917024
19127,1000005,1,160,118,42,0.7375,0.2625,0.7375,40,2,161,118,43,0.732919,0.267081,0.732919,41,2,1, abandoned,1,1,0.00607697501688
19129,1000130,1,159,136,23,0.855346,0.144654,0.855346,20,3,161,137,24,0.850932,0.149068,0.850932,20,4,-1, merged,1,0,0.0637659826728
19130,1000130,1,161,137,24,0.850932,0.149068,0.850932,20,4,163,138,25,0.846626,0.153374,0.846626,20,5,-1, merged,1,0,0.155266240859
19133,1000026,2,197,180,17,0.913706,0.086294,1.728734,15,2,198,180,18,0.909091,0.090909,1.715909,16,2,1, merged,1,1,0.000962606004772
19137,1000105,3,251,199,52,0.792829,0.207171,2.737273,49,3,252,199,53,0.789683,0.210317,2.737051,49,4,-1, merged,1,1,0
19140,1000004,1,949,814,135,0.857745,0.142255,0.857745,108,27,953,817,136,0.857293,0.142707,0.857293,109,27,-1, merged,1,0,0.075630055311
19142,1000327,1,396,306,90,0.772727,0.227273,0.772727,69,21,397,306,91,0.770781,0.229219,0.770781,70,21,1, abandoned,1,1,0
19142,1000329,2,1035,775,260,0.748792,0.251208,1.52152,239,21,1036,775,261,0.748069,0.251931,1.51885,240,21,1, abandoned,1,1,0
19150,1000121,2,701,582,119,0.830243,0.169757,1.577591,114,5,702,583,119,0.830484,0.169516,1.578076,114,5,-1, abandoned,0,0,0
19150,1000329,1,1037,775,262,0.747348,0.252652,0.747348,241,21,1038,776,262,0.747592,0.252408,0.747592,241,21,-1, abandoned,0,0,0.445530303339
19152,1000014,1,724,623,101,0.860497,0.139503,0.860497,92,9,725,624,101,0.86069,0.13931,0.86069,92,9,1, merged,0,0,0.570293418572
19152,1000327,2,397,306,91,0.770781,0.229219,1.631278,70,21,399,308,91,0.77193,0.22807,1.632619,70,21,1, merged,0,0,0.606458252927
19162,1000199,1,181,146,35,0.80663,0.19337,0.80663,33,2,182,146,36,0.802198,0.197802,0.802198,34,2,1, merged,1,1,0.768203350333
19164,1000327,1,399,308,91,0.77193,0.22807,0.77193,70,21,400,308,92,0.77,0.23,0.77,71,21,1, merged,1,1,0.611509773663
19165,1000592,2,193,156,37,0.80829,0.19171,1.637238,26,11,194,157,37,0.809278,0.190722,1.638973,26,11,1, merged,0,0,0.520583435333
19167,1000003,2,620,521,99,0.840323,0.159677,1.697615,92,7,621,522,99,0.84058,0.15942,1.698022,92,7,1, merged,0,0,0
19167,1000004,1,953,817,136,0.857293,0.142707,0.857293,109,27,954,818,136,0.857442,0.142558,0.857442,109,27,1, merged,0,0,0
19173,1000004,1,954,818,136,0.857442,0.142558,0.857442,109,27,955,819,136,0.857592,0.142408,0.857592,109,27,-1, abandoned,0,0,0.031208551143
19174,1000014,2,725,624,101,0.86069,0.13931,1.751378,92,9,726,625,101,0.860882,0.139118,1.752011,92,9,1, merged,0,0,0.177558257345
19174,1000023,1,247,220,27,0.890688,0.109312,0.890688,24,3,248,221,27,0.891129,0.108871,0.891129,24,3,1, merged,0,0,0.686437801352
19177,1000329,2,1038,776,262,0.747592,0.252408,1.45913,241,21,1039,777,262,0.747834,0.252166,1.464816,241,21,1, merged,0,0,0.478501469148
19184,1000007,1,476,408,68,0.857143,0.142857,0.857143,58,10,477,409,68,0.857442,0.142558,0.857442,58,10,1, merged,0,0,0.55247126971
19184,1000014,2,726,625,101,0.860882,0.139118,1.718024,92,9,727,626,101,0.861073,0.138927,1.718515,92,9,1, merged,0,0,0.309683547587
19189,1000105,3,252,199,53,0.789683,0.210317,2.407826,49,4,253,200,53,0.790514,0.209486,2.322941,49,4,-1, abandoned,0,0,0
19191,1000327,4,400,308,92,0.77,0.23,3.126061,71,21,401,308,93,0.76808,0.23192,2.563318,72,21,1, merged,1,1,0.0835843560578
19192,1000014,3,728,627,101,0.861264,0.138736,2.156502,92,9,729,628,101,0.861454,0.138546,2.200343,92,9,1, merged,0,0,0
19193,1000014,1,729,628,101,0.861454,0.138546,0.861454,92,9,731,629,102,0.860465,0.139535,0.860465,93,9,1, merged,1,1,0.0831763936443
19193,1000070,2,486,445,41,0.915638,0.084362,1.777092,31,10,488,447,41,0.915984,0.084016,1.776449,31,10,-1, merged,0,0,0.105827106096
19196,1000121,1,703,584,119,0.830725,0.169275,0.830725,114,5,705,586,119,0.831206,0.168794,0.831206,114,5,-1, abandoned,0,0,0.0384723312666
19196,1000329,2,1039,777,262,0.747834,0.252166,1.57856,241,21,1040,778,262,0.748077,0.251923,1.579283,241,21,-1, abandoned,0,0,0.054561047886
19214,1000005,2,161,118,43,0.732919,0.267081,1.480996,41,2,162,119,43,0.734568,0.265432,1.482887,41,2,-1, abandoned,0,0,0.00728433331307
19214,1000329,1,1040,778,262,0.748077,0.251923,0.748077,241,21,1041,779,262,0.748319,0.251681,0.748319,241,21,-1, abandoned,0,0,0.00889332006688
19218,1000004,3,956,820,136,0.857741,0.142259,2.103569,109,27,961,824,137,0.85744,0.14256,2.052627,110,27,-1, merged,1,0,0.220529929116
19218,1000070,6,488,447,41,0.915984,0.084016,4.213997,31,10,490,448,42,0.914286,0.085714,4.026722,32,10,-1, merged,1,0,0.395436685836
19219,1000327,2,401,308,93,0.76808,0.23192,1.434746,72,21,403,310,93,0.769231,0.230769,1.435897,72,21,-1, merged,0,0,0.567405266538
19220,1000063,2,1762,1578,184,0.895573,0.104427,1.678907,158,26,1764,1579,185,0.895125,0.104875,1.680249,159,26,1, merged,1,1,0.00125078173859
19224,1000063,1,1765,1580,185,0.895184,0.104816,0.895184,159,26,1767,1581,186,0.894737,0.105263,0.894737,160,26,1, merged,1,1,0.0947605636303
19231,1000005,2,162,119,43,0.734568,0.265432,1.040123,41,2,164,121,43,0.737805,0.262195,1.035102,41,2,-1, merged,0,0,0
19246,1000153,2,493,454,39,0.920892,0.079108,1.803705,30,9,494,455,39,0.921053,0.078947,1.804774,30,9,1, merged,0,0,0.35538823432
19254,1000014,1,732,630,102,0.860656,0.139344,0.860656,93,9,733,631,102,0.860846,0.139154,0.860846,93,9,1, merged,0,0,0.30642566143
19254,1000153,2,494,455,39,0.921053,0.078947,1.781708,30,9,495,456,39,0.921212,0.078788,1.782058,30,9,1, merged,0,0,0.47047293284
19269,1000130,2,164,139,25,0.847561,0.152439,1.66879,20,5,166,140,26,0.843373,0.156627,1.661053,21,5,1, merged,1,1,0.0267293716757
19270,1000003,2,621,522,99,0.84058,0.15942,1.648489,92,7,622,523,99,0.840836,0.159164,1.650892,92,7,-1, abandoned,0,0,0.0424803342451
19273,1000327,1,403,310,93,0.769231,0.230769,0.769231,72,21,405,311,94,0.767901,0.232099,0.767901,73,21,1, merged,1,1,0
19274,1000014,1,734,632,102,0.861035,0.138965,0.861035,93,9,740,635,105,0.858108,0.141892,0.858108,96,9,-1, merged,1,0,0
19274,1000327,2,405,311,94,0.767901,0.232099,1.628937,73,21,408,314,94,0.769608,0.230392,1.627716,73,21,-1, merged,0,0,0.0716194305211
19275,1000009,2,458,385,73,0.840611,0.159389,1.590611,65,8,459,386,73,0.840959,0.159041,1.555244,65,8,1, merged,0,0,1.13460688177
19283,1000014,1,740,635,105,0.858108,0.141892,0.858108,96,9,741,636,105,0.8583,0.1417,0.8583,96,9,1, merged,0,0,0.726651437486
19283,1000327,3,409,315,94,0.770171,0.229829,2.461613,73,21,410,316,94,0.770732,0.229268,2.471137,73,21,1, merged,0,0,0.635544871795
19288,1000327,3,410,316,94,0.770732,0.229268,2.279504,73,21,411,317,94,0.77129,0.22871,2.25879,73,21,1, merged,0,0,0.284256222271
19302,1000109,1,298,248,50,0.832215,0.167785,0.832215,48,2,299,249,50,0.832776,0.167224,0.832776,48,2,1, merged,0,0,1.23151327839
19302,1000199,2,183,147,36,0.803279,0.196721,1.635493,34,2,184,148,36,0.804348,0.195652,1.637124,34,2,1, merged,0,0,1.26084645481
19316,1000121,2,713,594,119,0.8331,0.1669,1.665718,114,5,714,595,119,0.833333,0.166667,1.666667,114,5,1, merged,0,0,0
19319,1000003,2,622,523,99,0.840836,0.159164,1.650892,92,7,623,524,99,0.841091,0.158909,1.643289,92,7,-1, merged,0,0,0.0700342853684
19324,1000015,1,975,898,77,0.921026,0.078974,0.921026,69,8,977,898,79,0.91914,0.08086,0.91914,71,8,1, merged,1,1,0
19324,1000153,2,496,457,39,0.921371,0.078629,1.842397,30,9,499,459,40,0.91984,0.08016,1.83898,31,9,-1, merged,1,0,0.0649659228469
19325,1000014,3,741,636,105,0.8583,0.1417,2.610702,96,9,742,637,105,0.858491,0.141509,2.612077,96,9,1, merged,0,0,0.0135023806071
19325,1000043,2,198,161,37,0.813131,0.186869,1.752403,33,4,199,162,37,0.81407,0.18593,1.753586,33,4,1, merged,0,0,0.014550015941
19325,1000124,1,247,232,15,0.939271,0.060729,0.939271,14,1,248,233,15,0.939516,0.060484,0.939516,14,1,-1, merged,0,0,0.00374160175102
19329,1000153,2,499,459,40,0.91984,0.08016,1.91984,31,9,502,462,40,0.920319,0.079681,1.777462,31,9,-1, merged,0,0,0.357747408674
19329,1000534,6,9,5,4,0.555556,0.444444,4.593364,4,0,10,6,4,0.6,0.4,4.681416,4,0,1, merged,0,0,0.449488924535
19333,1000534,1,10,6,4,0.6,0.4,0.6,4,0,14,7,7,0.5,0.5,0.5,7,0,1, merged,1,1,0.678959180324
19334,1000534,1,14,7,7,0.5,0.5,0.5,7,0,16,7,9,0.4375,0.5625,0.4375,9,0,1, merged,1,1,0.170255133248
19345,1000108,1,12,11,1,0.916667,0.083333,0.916667,1,0,13,12,1,0.923077,0.076923,0.923077,1,0,1, merged,0,0,0.293213757396
19345,1000118,2,567,501,66,0.883598,0.116402,1.800265,65,1,568,501,67,0.882042,0.117958,1.805119,65,2,-1, merged,1,1,0.128482419894
19347,1000003,2,623,524,99,0.841091,0.158909,1.643289,92,7,626,527,99,0.841853,0.158147,1.640766,92,7,-1, merged,0,0,0.00817393533959
19365,1000043,2,199,162,37,0.81407,0.18593,1.556748,33,4,200,163,37,0.815,0.185,1.55875,33,4,1, merged,0,0,0.910694087404
19370,1000329,1,1047,782,265,0.746896,0.253104,0.746896,244,21,1052,786,266,0.747148,0.252852,0.747148,245,21,-1, merged,1,0,0
19374,1000124,2,248,233,15,0.939516,0.060484,1.769705,14,1,251,235,16,0.936255,0.063745,1.758685,15,1,-1, abandoned,1,0,0.078453048094
19374,1000166,1,106,88,18,0.830189,0.169811,0.830189,17,1,107,88,19,0.82243,0.17757,0.82243,18,1,1, abandoned,1,1,0.430309125697
19375,1000132,2,124,105,19,0.846774,0.153226,1.846774,16,3,125,106,19,0.848,0.152,1.848,16,3,1, merged,0,0,0
19378,1000014,1,744,639,105,0.858871,0.141129,0.858871,96,9,746,640,106,0.857909,0.142091,0.857909,97,9,1, merged,1,1,0.00728674340791
19378,1000023,3,248,221,27,0.891129,0.108871,2.540514,24,3,249,222,27,0.891566,0.108434,2.53771,24,3,1, merged,0,0,0.0263320984774
19378,1000105,2,253,200,53,0.790514,0.209486,1.649385,49,4,255,201,54,0.788235,0.211765,1.646144,50,4,1, merged,1,1,0.00977574790076
19379,1000063,1,1771,1585,186,0.894975,0.105025,0.894975,160,26,1772,1586,186,0.895034,0.104966,0.895034,160,26,1, merged,0,0,0.00237217226922
19384,1000014,1,746,640,106,0.857909,0.142091,0.857909,97,9,748,641,107,0.856952,0.143048,0.856952,98,9,1, merged,1,1,0.0977001393085
19384,1000105,2,255,201,54,0.788235,0.211765,1.646144,50,4,256,202,54,0.789062,0.210938,1.646014,50,4,1, merged,0,0,0.131819017185
19385,1000004,3,962,825,137,0.857588,0.142412,2.069346,110,27,963,826,137,0.857736,0.142264,2.08816,110,27,1, merged,0,0,0.0919841929784
19385,1000070,2,491,449,42,0.91446,0.08554,1.211758,32,10,492,450,42,0.914634,0.085366,1.230424,32,10,1, merged,0,0,0.149817925596
19387,1000004,2,963,826,137,0.857736,0.142264,1.173526,110,27,964,827,137,0.857884,0.142116,1.191217,110,27,1, merged,0,0,0
19402,1000063,2,1775,1589,186,0.895211,0.104789,1.76596,160,26,1776,1590,186,0.89527,0.10473,1.766311,160,26,1, merged,0,0,0.363092945463
19414,1000327,1,411,317,94,0.77129,0.22871,0.77129,73,21,412,318,94,0.771845,0.228155,0.771845,73,21,1, merged,0,0,0.57089733743
19416,1000003,2,629,530,99,0.842607,0.157393,0.842607,92,7,630,531,99,0.842857,0.157143,1.842857,92,7,1, merged,0,0,0.976623022947
19418,1000014,2,750,643,107,0.857333,0.142667,1.690667,98,9,751,644,107,0.857523,0.142477,1.688032,98,9,1, merged,0,0,0.166296230834
19419,1000004,1,964,827,137,0.857884,0.142116,0.857884,110,27,966,829,137,0.858178,0.141822,0.858178,110,27,-1, merged,0,0,0.032104729993
19420,1000004,2,966,829,137,0.858178,0.141822,1.208178,110,27,967,830,137,0.858325,0.141675,1.191658,110,27,1, merged,0,0,0
19421,1000015,2,978,899,79,0.919223,0.080777,1.544223,71,8,979,900,79,0.919305,0.080695,1.585972,71,8,1, merged,0,0,1.03759370981
19434,1000004,3,968,831,137,0.858471,0.141529,2.411412,110,27,970,833,137,0.858763,0.141237,2.364754,110,27,-1, merged,0,0,0.444523964111
19435,1000327,2,412,318,94,0.771845,0.228155,1.600416,73,21,413,319,94,0.772397,0.227603,1.60573,73,21,1, merged,0,0,0.650795477378
19437,1000004,3,970,833,137,0.858763,0.141237,2.369516,110,27,971,834,137,0.858908,0.141092,2.384246,110,27,1, merged,0,0,0.444259957885
19439,1000109,3,299,249,50,0.832776,0.167224,2.444141,48,2,300,250,50,0.833333,0.166667,2.443678,48,2,1, merged,0,0,0.171110448099
19439,1000199,1,184,148,36,0.804348,0.195652,0.804348,34,2,185,148,37,0.8,0.2,0.8,35,2,1, merged,1,1,0.175312408426
19440,1000327,2,413,319,94,0.772397,0.227603,1.439064,73,21,414,320,94,0.772947,0.227053,1.487233,73,21,1, merged,0,0,0.653421706106
19441,1000329,1,1061,791,270,0.745523,0.254477,0.745523,249,21,1063,793,270,0.746002,0.253998,0.746002,249,21,-1, merged,0,0,0.942340652029
19443,1000014,1,754,647,107,0.85809,0.14191,0.85809,98,9,757,649,108,0.857332,0.142668,0.857332,99,9,1, merged,1,1,0.280567354164
19447,1000109,1,300,250,50,0.833333,0.166667,0.833333,48,2,302,251,51,0.831126,0.168874,0.831126,49,2,1, merged,1,1,0.603658154371
19447,1000199,2,185,148,37,0.8,0.2,1.633333,35,2,187,150,37,0.802139,0.197861,1.633265,35,2,-1, merged,0,0,0.617686853429
19453,1000043,2,200,163,37,0.815,0.185,1.588494,33,4,201,164,37,0.81592,0.18408,1.588648,33,4,1, merged,0,0,0.680165663388
19453,1000327,1,415,321,94,0.773494,0.226506,0.773494,73,21,418,323,95,0.772727,0.227273,0.772727,73,22,-1, merged,1,0,0.573886122814
19457,1000105,2,256,202,54,0.789062,0.210938,1.56179,50,4,257,203,54,0.789883,0.210117,1.561312,50,4,1, merged,0,0,0.654228566075
19457,1000327,1,418,323,95,0.772727,0.227273,0.772727,73,22,420,324,96,0.771429,0.228571,0.771429,73,23,-1, merged,1,1,0.575044665646
19461,1000007,1,483,414,69,0.857143,0.142857,0.857143,59,10,487,418,69,0.858316,0.141684,0.858316,59,10,-1, merged,0,0,0.298789937853
19467,1000004,3,971,834,137,0.858908,0.141092,2.120813,110,27,975,838,137,0.859487,0.140513,2.292821,110,27,-1, merged,0,0,0.0327051861081
19470,1000327,5,420,324,96,0.771429,0.228571,3.76449,73,23,421,325,96,0.771971,0.228029,3.805188,73,23,1, merged,0,0,0.00899005355777
19495,1000132,2,127,108,19,0.850394,0.149606,1.850394,16,3,128,109,19,0.851562,0.148438,1.851562,16,3,1, merged,0,0,0
19497,1000004,3,979,841,138,0.85904,0.14096,1.746339,110,28,980,842,138,0.859184,0.140816,1.733426,110,28,1, merged,0,0,0.0329755794058
19498,1000014,2,758,650,108,0.85752,0.14248,1.647403,99,9,759,651,108,0.857708,0.142292,1.648405,99,9,1, merged,0,0,0.0163661438619
19498,1000105,1,257,203,54,0.789883,0.210117,0.789883,50,4,258,204,54,0.790698,0.209302,0.790698,50,4,1, merged,0,0,0.0264470428927
19499,1000014,2,759,651,108,0.857708,0.142292,1.648405,99,9,760,652,108,0.857895,0.142105,1.649401,99,9,1, merged,0,0,0.0395597622952
19499,1000105,1,258,204,54,0.790698,0.209302,0.790698,50,4,259,205,54,0.791506,0.208494,0.791506,50,4,1, merged,0,0,0.0535044459391
19500,1000014,2,760,652,108,0.857895,0.142105,1.649401,99,9,761,653,108,0.858081,0.141919,1.650389,99,9,1, merged,0,0,0.0162152911994
19500,1000105,1,259,205,54,0.791506,0.208494,0.791506,50,4,260,206,54,0.792308,0.207692,0.792308,50,4,1, merged,0,0,0.0236638067013
19501,1000327,2,421,325,96,0.771971,0.228029,1.448442,73,23,422,326,96,0.772512,0.227488,1.458226,73,23,1, merged,0,0,0.0851842713987
19502,1000592,2,200,163,37,0.815,0.185,1.415,26,11,201,164,37,0.81592,0.18408,1.424616,26,11,1, merged,0,0,0.359635706019
19507,1000063,2,1777,1590,187,0.894766,0.105234,1.659472,160,27,1779,1592,187,0.894885,0.105115,1.664116,160,27,-1, abandoned,0,0,0.00114232154887
19514,1000091,1,215,164,51,0.762791,0.237209,0.762791,47,4,216,165,51,0.763889,0.236111,0.763889,47,4,1, merged,0,0,0.060236205261
19514,1000592,2,202,165,37,0.816832,0.183168,1.579622,26,11,203,166,37,0.817734,0.182266,1.581623,26,11,1, merged,0,0,0.0485516702796
19515,1000121,3,716,596,120,0.832402,0.167598,2.109383,115,5,717,597,120,0.832636,0.167364,2.073377,115,5,-1, abandoned,0,0,0.0697785041422
19515,1000329,4,1063,793,270,0.746002,0.253998,2.855385,249,21,1064,794,270,0.746241,0.253759,2.819617,249,21,-1, abandoned,0,0,0.0964390898371
19519,1000327,2,422,326,96,0.772512,0.227488,1.439179,73,23,423,327,96,0.77305,0.22695,1.47305,73,23,1, merged,0,0,0.653779909522
19520,1000327,1,423,327,96,0.77305,0.22695,0.77305,73,23,424,328,96,0.773585,0.226415,0.773585,73,23,1, merged,0,0,0.0162385348544
19522,1000004,2,980,842,138,0.859184,0.140816,1.581406,110,28,981,843,138,0.859327,0.140673,1.596169,110,28,1, merged,0,0,0.0300528812505
19546,1000063,1,1780,1593,187,0.894944,0.105056,0.894944,160,27,1783,1595,188,0.89456,0.10544,0.89456,161,27,-1, merged,1,0,0.0103864205878
19565,1000118,2,570,503,67,0.882456,0.117544,1.792366,65,2,571,504,67,0.882662,0.117338,1.793376,65,2,1, merged,0,0,0.258833111438
19570,1000043,1,201,164,37,0.81592,0.18408,0.81592,33,4,202,164,38,0.811881,0.188119,0.811881,34,4,1, merged,1,1,0.0517254662781
19570,1000070,2,497,454,43,0.913481,0.086519,1.729401,32,11,499,455,44,0.911824,0.088176,1.723705,33,11,1, merged,1,1,0.0461134755439
19586,1000121,1,717,597,120,0.832636,0.167364,0.832636,115,5,719,599,120,0.833102,0.166898,0.833102,115,5,-1, abandoned,0,0,0.197387564679
19586,1000329,2,1064,794,270,0.746241,0.253759,1.578877,249,21,1065,795,270,0.746479,0.253521,1.57958,249,21,-1, abandoned,0,0,0.210887077008
19600,1000004,1,988,850,138,0.860324,0.139676,0.860324,110,28,990,851,139,0.859596,0.140404,0.859596,111,28,1, merged,1,1,0.0338824992229
19600,1000329,2,1066,796,270,0.746717,0.253283,1.607041,249,21,1068,797,271,0.746255,0.253745,1.605851,250,21,1, merged,1,1,0.0282069566595
19603,1000004,2,990,851,139,0.859596,0.140404,1.60056,111,28,992,852,140,0.858871,0.141129,1.595398,112,28,1, merged,1,1,0.0346569275002
19603,1000005,1,166,123,43,0.740964,0.259036,0.740964,41,2,167,123,44,0.736527,0.263473,0.736527,42,2,1, merged,1,1,0.004
19608,1000120,1,275,238,37,0.865455,0.134545,0.865455,35,2,276,239,37,0.865942,0.134058,0.865942,35,2,1, merged,0,0,0
19609,1000004,3,992,852,140,0.858871,0.141129,2.468615,112,28,993,853,140,0.859013,0.140987,2.469769,112,28,1, merged,0,0,0
19609,1000120,1,276,239,37,0.865942,0.134058,0.865942,35,2,277,240,37,0.866426,0.133574,0.866426,35,2,1, merged,0,0,0
19610,1000004,3,993,853,140,0.859013,0.140987,2.469769,112,28,994,854,140,0.859155,0.140845,2.470917,112,28,1, merged,0,0,0
19610,1000120,1,277,240,37,0.866426,0.133574,0.866426,35,2,278,241,37,0.866906,0.133094,0.866906,35,2,1, merged,0,0,0
19618,1000199,1,187,150,37,0.802139,0.197861,0.802139,35,2,188,151,37,0.803191,0.196809,0.803191,35,2,1, merged,0,0,0.351616525192
19632,1000004,1,999,857,142,0.857858,0.142142,0.857858,114,28,1001,858,143,0.857143,0.142857,0.857143,115,28,-1, merged,1,0,0.359521775312
19632,1000120,2,283,246,37,0.869258,0.130742,1.727116,35,2,284,247,37,0.869718,0.130282,1.726861,35,2,1, merged,0,0,0.473222530009
19634,1000003,1,638,538,100,0.84326,0.15674,0.84326,93,7,640,538,102,0.840625,0.159375,0.840625,95,7,1, abandoned,1,1,0.0829518323028
19642,1000004,1,1001,858,143,0.857143,0.142857,0.857143,115,28,1002,859,143,0.857285,0.142715,0.857285,115,28,-1, abandoned,0,0,0.472100743173
19642,1000121,2,727,607,120,0.834938,0.165062,1.692081,115,5,728,607,121,0.833791,0.166209,1.691077,116,5,1, abandoned,1,1,0.653035586529
19643,1000121,2,728,607,121,0.833791,0.166209,1.580532,116,5,729,607,122,0.832647,0.167353,1.578694,117,5,1, abandoned,1,1,0.069867312631
19643,1000329,1,1074,802,272,0.746741,0.253259,0.746741,251,21,1075,802,273,0.746047,0.253953,0.746047,252,21,1, abandoned,1,1,0.095546935062
19661,1000329,1,1083,808,275,0.746076,0.253924,0.746076,254,21,1088,812,276,0.746324,0.253676,0.746324,255,21,-1, merged,1,0,0
19668,1000329,2,1089,813,276,0.746556,0.253444,1.585266,255,21,1090,814,276,0.746789,0.253211,1.587215,255,21,1, merged,0,0,0.0650272989162
19672,1000004,1,1002,859,143,0.857285,0.142715,0.857285,115,28,1003,860,143,0.857428,0.142572,0.857428,115,28,-1, merged,0,0,0.0762513031798
19672,1000120,2,285,248,37,0.870175,0.129825,1.727461,35,2,286,249,37,0.870629,0.129371,1.728057,35,2,1, merged,0,0,0.108391881343
19673,1000091,1,216,165,51,0.763889,0.236111,0.763889,47,4,217,166,51,0.764977,0.235023,0.764977,47,4,1, merged,0,0,0.475024833262
19674,1000130,1,169,143,26,0.846154,0.153846,0.846154,21,5,171,145,26,0.847953,0.152047,0.847953,21,5,-1, merged,0,0,0.00603751186527
19676,1000327,2,425,329,96,0.774118,0.225882,1.440784,73,23,426,330,96,0.774648,0.225352,1.524648,73,23,1, merged,0,0,0
19678,1000004,1,1003,860,143,0.857428,0.142572,0.857428,115,28,1004,861,143,0.85757,0.14243,0.85757,115,28,1, merged,0,0,0.0341535356672
19678,1000043,2,203,165,38,0.812808,0.187192,1.670236,34,4,204,166,38,0.813725,0.186275,1.671295,34,4,1, merged,0,0,0.0436666666667
19681,1000004,1,1004,861,143,0.85757,0.14243,0.85757,115,28,1005,861,144,0.856716,0.143284,0.856716,115,29,-1, merged,1,1,0.00842989089458
19681,1000120,2,286,249,37,0.870629,0.129371,1.728199,35,2,287,250,37,0.87108,0.12892,1.727797,35,2,1, merged,0,0,0.104552398411
19682,1000121,2,730,608,122,0.832877,0.167123,1.368591,117,5,731,609,122,0.833105,0.166895,1.384829,117,5,1, merged,0,0,0.654346388941
19682,1000327,3,426,330,96,0.774648,0.225352,2.143239,73,23,427,331,96,0.775176,0.224824,2.160005,73,23,1, merged,0,0,0.685047046617
19685,1000327,3,428,332,96,0.775701,0.224299,1.861171,73,23,429,333,96,0.776224,0.223776,1.933367,73,23,1, merged,0,0,0.60478424015
19692,1000132,2,129,110,19,0.852713,0.147287,1.852713,16,3,131,112,19,0.854962,0.145038,1.688295,16,3,-1, merged,0,0,0
19694,1000063,1,1786,1598,188,0.894737,0.105263,0.894737,161,27,1787,1599,188,0.894796,0.105204,0.894796,161,27,-1, abandoned,0,0,0.00389838719781
19700,1000014,1,764,656,108,0.858639,0.141361,0.858639,99,9,765,657,108,0.858824,0.141176,0.858824,99,9,1, merged,0,0,0
19701,1000070,1,499,455,44,0.911824,0.088176,0.911824,33,11,500,455,45,0.91,0.09,0.91,34,11,1, abandoned,1,1,0.00936812924195
19701,1000329,2,1091,815,276,0.747021,0.252979,1.658845,255,21,1092,816,276,0.747253,0.252747,1.657253,255,21,-1, abandoned,0,0,0.0290129296752
19708,1000004,1,1005,861,144,0.856716,0.143284,0.856716,115,29,1006,862,144,0.856859,0.143141,0.856859,115,29,-1, merged,0,0,0.472450044222
19708,1000329,2,1092,816,276,0.747253,0.252747,1.603969,255,21,1093,817,276,0.747484,0.252516,1.604343,255,21,1, merged,0,0,0.952465570941
19709,1000118,2,572,505,67,0.882867,0.117133,1.728228,65,2,573,506,67,0.883072,0.116928,1.728962,65,2,1, merged,0,0,0.0499416774571
19716,1000121,2,733,611,122,0.833561,0.166439,1.766632,117,5,734,612,122,0.833787,0.166213,1.767121,117,5,1, merged,0,0,0.00310491338926
19716,1000124,1,254,237,17,0.933071,0.066929,0.933071,16,1,255,238,17,0.933333,0.066667,0.933333,16,1,1, merged,0,0,0.00106692531523
19718,1000063,1,1788,1600,188,0.894855,0.105145,0.894855,161,27,1789,1600,189,0.894354,0.105646,0.894354,162,27,1, abandoned,1,1,0.00575597265738
19718,1000121,2,734,612,122,0.833787,0.166213,1.728642,117,5,735,612,123,0.832653,0.167347,1.727007,118,5,1, abandoned,1,1,0.0095697167756
19718,1000329,3,1093,817,276,0.747484,0.252516,2.476126,255,21,1094,818,276,0.747715,0.252285,2.474722,255,21,-1, abandoned,0,0,0.0153827977316
19719,1000063,2,1789,1600,189,0.894354,0.105646,1.76431,162,27,1790,1601,189,0.894413,0.105587,1.764659,162,27,1, merged,0,0,0.375018042502
19723,1000121,2,735,612,123,0.832653,0.167347,1.580368,118,5,736,613,123,0.83288,0.16712,1.579912,118,5,1, merged,0,0,0
19723,1000329,1,1094,818,276,0.747715,0.252285,0.747715,255,21,1095,818,277,0.747032,0.252968,0.747032,256,21,1, merged,1,1,0
19745,1000026,2,200,182,18,0.91,0.09,1.742787,16,2,202,184,18,0.910891,0.089109,1.740956,16,2,-1, merged,0,0,0.650080398778
19745,1000109,1,305,254,51,0.832787,0.167213,0.832787,49,2,306,254,52,0.830065,0.169935,0.830065,50,2,1, merged,1,1,0.0474153622133
19759,1000014,1,767,659,108,0.859192,0.140808,0.859192,99,9,768,659,109,0.858073,0.141927,0.858073,100,9,1, merged,1,1,0
19759,1000328,2,371,258,113,0.695418,0.304582,1.554609,104,9,373,260,113,0.697051,0.302949,1.555124,104,9,-1, merged,0,0,0.658886430678
19765,1000121,3,739,616,123,0.833559,0.166441,2.302813,118,5,740,617,123,0.833784,0.166216,2.307638,118,5,1, merged,0,0,0.069994999093
19765,1000329,1,1095,818,277,0.747032,0.252968,0.747032,256,21,1097,819,278,0.746582,0.253418,0.746582,257,21,1, merged,1,1,0.0957804074588
19773,1000014,2,768,659,109,0.858073,0.141927,1.475094,100,9,773,662,111,0.856404,0.143596,1.436404,102,9,-1, abandoned,1,0,0.556496583044
19773,1000070,3,500,455,45,0.91,0.09,2.385094,34,11,502,455,47,0.906375,0.093625,2.342778,36,11,1, abandoned,1,1,0.839644768458
19775,1000328,1,373,260,113,0.697051,0.302949,0.697051,104,9,374,261,113,0.697861,0.302139,0.697861,104,9,-1, abandoned,0,0,0.279085147336
19775,1000329,2,1097,819,278,0.746582,0.253418,1.443633,257,21,1099,821,278,0.747043,0.252957,1.444904,257,21,-1, abandoned,0,0,0.192907673821
19776,1000070,2,502,455,47,0.906375,0.093625,1.699478,36,11,503,456,47,0.906561,0.093439,1.700454,36,11,1, merged,0,0,0.626509847275
19776,1000105,1,261,207,54,0.793103,0.206897,0.793103,50,4,262,208,54,0.793893,0.206107,0.793893,50,4,1, merged,0,0,0.510317681206
19779,1000004,1,1008,864,144,0.857143,0.142857,0.857143,115,29,1009,865,144,0.857284,0.142716,0.857284,115,29,-1, merged,0,0,0.00102890233183
19786,1000003,2,640,538,102,0.840625,0.159375,1.759735,95,7,641,539,102,0.840874,0.159126,1.75922,95,7,-1, merged,0,0,0.0658191101928
19786,1000014,3,773,662,111,0.856404,0.143596,2.616139,102,9,774,663,111,0.856589,0.143411,2.61581,102,9,1, merged,0,0,0.0613344812727
19786,1000015,1,989,909,80,0.91911,0.08089,0.91911,71,9,992,911,81,0.918347,0.081653,0.918347,72,9,-1, merged,1,0,0.0708522395994
19790,1000199,1,188,151,37,0.803191,0.196809,0.803191,35,2,190,152,38,0.8,0.2,0.8,36,2,1, merged,1,1,0.00075810195346
19791,1000199,2,190,152,38,0.8,0.2,1.60791,36,2,192,153,39,0.796875,0.203125,1.600246,37,2,1, merged,1,1,0.00122694088252
19822,1000109,2,307,255,52,0.830619,0.169381,1.627494,50,2,308,256,52,0.831169,0.168831,1.624983,50,2,1, merged,0,0,0.000409760277682
19822,1000199,1,192,153,39,0.796875,0.203125,0.796875,37,2,194,154,40,0.793814,0.206186,0.793814,38,2,1, merged,1,1,0.000388560835962
19827,1000121,2,744,620,124,0.833333,0.166667,1.583333,119,5,745,621,124,0.833557,0.166443,1.633557,119,5,1, merged,0,0,0.473440972168
19832,1000009,2,465,390,75,0.83871,0.16129,1.83871,67,8,466,391,75,0.839056,0.160944,1.748147,67,8,1, merged,0,0,0.483246737448
19844,1000070,2,503,456,47,0.906561,0.093439,1.486561,36,11,504,457,47,0.906746,0.093254,1.494981,36,11,1, merged,0,0,0.241029479371
19848,1000121,1,746,622,124,0.83378,0.16622,0.83378,119,5,747,622,125,0.832664,0.167336,0.832664,120,5,1, abandoned,1,1,0.651796269058
19848,1000329,2,1101,821,280,0.745686,0.254314,1.579466,257,23,1102,821,281,0.745009,0.254991,1.577673,258,23,1, abandoned,1,1,0.954403433541
19851,1000130,1,172,146,26,0.848837,0.151163,0.848837,21,5,174,148,26,0.850575,0.149425,0.850575,21,5,-1, merged,0,0,0.154987066805
19852,1000014,2,778,667,111,0.857326,0.142674,1.857326,102,9,780,669,111,0.857692,0.142308,1.857692,102,9,-1, merged,0,0,0.0844640817015
19855,1000070,2,504,457,47,0.906746,0.093254,1.757321,36,11,505,458,47,0.906931,0.093069,1.753522,36,11,1, merged,0,0,0.0364092032898
19855,1000130,1,174,148,26,0.850575,0.149425,0.850575,21,5,176,149,27,0.846591,0.153409,0.846591,21,6,-1, merged,1,0,0.0388984315428
19866,1000329,2,1107,825,282,0.745257,0.254743,1.47253,259,23,1108,826,282,0.745487,0.254513,1.47763,259,23,1, merged,0,0,0.480197554092
19867,1000015,2,995,914,81,0.918593,0.081407,1.695337,72,9,998,917,81,0.918838,0.081162,1.6961,72,9,-1, abandoned,0,0,0
19867,1000327,1,430,334,96,0.776744,0.223256,0.776744,73,23,431,335,96,0.777262,0.222738,0.777262,73,23,-1, abandoned,0,0,0
19878,1000063,2,1797,1608,189,0.894825,0.105175,1.829843,162,27,1798,1609,189,0.894883,0.105117,1.823199,162,27,1, merged,0,0,0.00824804458527
19893,1000063,1,1798,1609,189,0.894883,0.105117,0.894883,162,27,1799,1610,189,0.894942,0.105058,0.894942,162,27,-1, merged,0,0,0.0298231829391
19897,1000014,1,781,670,111,0.857875,0.142125,0.857875,102,9,782,671,111,0.858056,0.141944,0.858056,102,9,-1, merged,0,0,0.18937994898
19897,1000327,2,431,335,96,0.777262,0.222738,1.635137,73,23,432,336,96,0.777778,0.222222,1.635834,73,23,1, merged,0,0,0.202554969062
19898,1000091,1,217,166,51,0.764977,0.235023,0.764977,47,4,218,167,51,0.766055,0.233945,0.766055,47,4,1, merged,0,0,0.0588392285553
19898,1000121,4,747,622,125,0.832664,0.167336,3.074477,120,5,748,623,125,0.832888,0.167112,3.077358,120,5,1, merged,0,0,0.0350947250007
19898,1000328,2,375,262,113,0.698667,0.301333,1.463644,104,9,376,263,113,0.699468,0.300532,1.465523,104,9,1, merged,0,0,0.0725234318013
19906,1000003,2,648,544,104,0.839506,0.160494,1.590802,97,7,649,545,104,0.839753,0.160247,1.587176,97,7,-1, abandoned,0,0,0.0814259516487
19912,1000328,2,376,263,113,0.699468,0.300532,1.444955,104,9,377,264,113,0.700265,0.299735,1.445982,104,9,1, merged,0,0,1.14650481736
19912,1000329,1,1108,826,282,0.745487,0.254513,0.745487,259,23,1109,827,282,0.745717,0.254283,0.745717,259,23,-1, merged,0,0,0.94513658393
19913,1000328,1,377,264,113,0.700265,0.299735,0.700265,104,9,379,265,114,0.699208,0.300792,0.699208,105,9,1, merged,1,1,1.16385281385
19913,1000329,2,1109,827,282,0.745717,0.254283,1.445982,259,23,1110,828,282,0.745946,0.254054,1.445154,259,23,-1, merged,0,0,0.949959405004
19919,1000014,2,782,671,111,0.858056,0.141944,1.558056,102,9,783,672,111,0.858238,0.141762,1.565555,102,9,1, merged,0,0,0.55831740723
19925,1000003,1,651,547,104,0.840246,0.159754,0.840246,97,7,652,547,105,0.838957,0.161043,0.838957,98,7,1, merged,1,1,0.159937698848
19933,1000014,2,783,672,111,0.858238,0.141762,1.657151,102,9,784,673,111,0.858418,0.141582,1.658418,102,9,1, merged,0,0,0.0827522552468
19936,1000015,2,1000,919,81,0.919,0.081,1.805364,72,9,1001,920,81,0.919081,0.080919,1.806299,72,9,1, merged,0,0,0.551850098198
19944,1000007,2,498,425,73,0.853414,0.146586,1.692814,63,10,499,426,73,0.853707,0.146293,1.693793,63,10,1, merged,0,0,1.27292435929
19944,1000009,1,467,392,75,0.8394,0.1606,0.8394,67,8,469,394,75,0.840085,0.159915,0.840085,67,8,-1, merged,0,0,1.17629481535
19958,1000130,1,176,149,27,0.846591,0.153409,0.846591,21,6,178,150,28,0.842697,0.157303,0.842697,21,7,-1, merged,1,0,0.157633892886
19960,1000153,1,507,466,41,0.919132,0.080868,0.919132,32,9,508,467,41,0.919291,0.080709,0.919291,32,9,1, merged,0,0,0.0409205233015
19979,1000007,2,499,426,73,0.853707,0.146293,1.603707,63,10,500,427,73,0.854,0.146,1.631778,63,10,1, merged,0,0,0.39919456457
19984,1000004,3,1009,865,144,0.857284,0.142716,2.559557,115,29,1011,867,144,0.857567,0.142433,2.556133,115,29,-1, merged,0,0,0.0761194930513
19984,1000014,1,784,673,111,0.858418,0.141582,0.858418,102,9,786,674,112,0.857506,0.142494,0.857506,103,9,1, merged,1,1,0.0796855047899
19985,1000003,1,658,552,106,0.838906,0.161094,0.838906,99,7,660,554,106,0.839394,0.160606,0.839394,99,7,-1, merged,0,0,0.979624859176
19985,1000012,2,307,275,32,0.895765,0.104235,1.734671,31,1,308,276,32,0.896104,0.103896,1.735498,31,1,1, merged,0,0,0.73427986428
19992,1000328,1,380,266,114,0.7,0.3,0.7,105,9,381,267,114,0.700787,0.299213,0.700787,105,9,1, merged,0,0,0.287169578376
19992,1000329,2,1113,831,282,0.746631,0.253369,1.446631,259,23,1114,831,283,0.745961,0.254039,1.446748,259,24,-1, merged,1,1,0.194036950063
19999,1000014,2,791,679,112,0.858407,0.141593,1.602407,103,9,792,680,112,0.858586,0.141414,1.604618,103,9,1, merged,0,0,0.508658992225
20000,1000327,2,432,336,96,0.777778,0.222222,1.381551,73,23,433,337,96,0.778291,0.221709,1.378291,73,23,1, merged,0,0,0.60854556804
20001,1000329,1,1114,831,283,0.745961,0.254039,0.745961,259,24,1115,831,284,0.745291,0.254709,0.745291,259,25,-1, merged,1,1,0.078718183297
20010,1000014,2,792,680,112,0.858586,0.141414,1.745804,103,9,795,682,113,0.857862,0.142138,1.739343,104,9,1, merged,1,1,0
20011,1000109,2,309,257,52,0.831715,0.168285,1.635086,50,2,310,258,52,0.832258,0.167742,1.627838,50,2,1, merged,0,0,0.0013976544682
20012,1000109,2,310,258,52,0.832258,0.167742,1.627838,50,2,312,259,53,0.830128,0.169872,1.620451,51,2,1, merged,1,1,1.07995806743e-05
20013,1000004,1,1011,867,144,0.857567,0.142433,0.857567,115,29,1012,868,144,0.857708,0.142292,0.857708,115,29,-1, merged,0,0,0.00549486493065
20013,1000007,5,501,428,73,0.854291,0.145709,4.292832,63,10,502,428,74,0.85259,0.14741,4.275476,64,10,1, merged,1,1,0.0155272562865
20013,1000009,4,470,395,75,0.840426,0.159574,3.438541,67,8,471,395,76,0.838641,0.161359,3.422886,68,8,1, merged,1,1,0.0140049090093
20013,1000012,3,308,276,32,0.896104,0.103896,2.598115,31,1,309,276,33,0.893204,0.106796,2.584245,32,1,1, merged,1,1,0.00970958601028
20018,1000534,1,16,7,9,0.4375,0.5625,0.4375,9,0,18,8,10,0.444444,0.555556,0.444444,10,0,-1, abandoned,1,0,1.37142857143
20029,1000328,1,381,267,114,0.700787,0.299213,0.700787,105,9,382,268,114,0.701571,0.298429,0.701571,105,9,1, merged,0,0,1.08111813253
20029,1000329,2,1115,831,284,0.745291,0.254709,1.446079,259,25,1116,832,284,0.74552,0.25448,1.44709,259,25,1, merged,0,0,0.953387542931
20032,1000327,1,433,337,96,0.778291,0.221709,0.778291,73,23,434,338,96,0.778802,0.221198,0.778802,73,23,-1, merged,0,0,0.10471471342
20032,1000329,2,1116,832,284,0.74552,0.25448,1.523811,259,25,1118,834,284,0.745975,0.254025,1.524777,259,25,-1, merged,0,0,0.178961058658
20078,1000043,1,207,168,39,0.811594,0.188406,0.811594,34,5,209,169,40,0.808612,0.191388,0.808612,35,5,1, merged,1,1,0.917649975211
20079,1000327,2,434,338,96,0.778802,0.221198,1.645063,73,23,436,339,97,0.777523,0.222477,1.641571,73,24,-1, merged,1,0,0.519347798977
20080,1000327,1,436,339,97,0.777523,0.222477,0.777523,73,24,437,340,97,0.778032,0.221968,0.778032,73,24,1, merged,0,0,0
20083,1000005,2,167,123,44,0.736527,0.263473,1.50365,42,2,168,124,44,0.738095,0.261905,1.506277,42,2,1, merged,0,0,0.0740085384942
20083,1000091,1,219,168,51,0.767123,0.232877,0.767123,47,4,220,169,51,0.768182,0.231818,0.768182,47,4,1, merged,0,0,0.10124183414
20084,1000015,2,1006,923,83,0.917495,0.082505,1.669048,74,9,1007,924,83,0.917577,0.082423,1.664491,74,9,1, merged,0,0,0.0945052075199
20087,1000003,1,661,555,106,0.839637,0.160363,0.839637,99,7,664,557,107,0.838855,0.161145,0.838855,100,7,-1, merged,1,0,0.00359815774324
20087,1000023,2,249,222,27,0.891566,0.108434,1.731203,24,3,250,223,27,0.892,0.108,1.730855,24,3,1, merged,0,0,0.000418906074779
20091,1000070,6,512,465,47,0.908203,0.091797,5.061384,36,11,513,466,47,0.908382,0.091618,5.048418,36,11,1, merged,0,0,0.026751644586
20091,1000327,1,437,340,97,0.778032,0.221968,0.778032,73,24,439,341,98,0.776765,0.223235,0.776765,73,25,-1, merged,1,0,0.0210481968318
20092,1000124,2,260,243,17,0.934615,0.065385,1.577473,16,1,261,244,17,0.934866,0.065134,1.583989,16,1,1, merged,0,0,0.48229523353
20110,1000004,1,1014,870,144,0.857988,0.142012,0.857988,115,29,1015,871,144,0.858128,0.141872,0.858128,115,29,-1, abandoned,0,0,0.102544691334
20110,1000329,2,1120,836,284,0.746429,0.253571,1.604417,259,25,1121,836,285,0.745763,0.254237,1.603891,260,25,1, abandoned,1,1,0.179572635312
20128,1000026,1,210,192,18,0.914286,0.085714,0.914286,16,2,212,194,18,0.915094,0.084906,0.915094,16,2,-1, merged,0,0,0.483042040624
20129,1000070,2,514,467,47,0.90856,0.09144,0.90856,36,11,515,468,47,0.908738,0.091262,1.908738,36,11,1, merged,0,0,0
20138,1000109,2,312,259,53,0.830128,0.169872,1.620451,51,2,313,260,53,0.830671,0.169329,1.622115,51,2,1, merged,0,0,0.03946231166
20146,1000130,2,179,151,28,0.843575,0.156425,1.620848,21,7,180,152,28,0.844444,0.155556,1.622222,21,7,-1, abandoned,0,0,0.783262132604
20146,1000327,1,440,342,98,0.777273,0.222727,0.777273,73,25,441,343,98,0.777778,0.222222,0.777778,73,25,-1, abandoned,0,0,0.604439511654
20154,1000118,3,576,509,67,0.883681,0.116319,2.556388,65,2,577,509,68,0.882149,0.117851,2.550382,66,2,1, abandoned,1,1,0.0906718858941
20154,1000121,1,753,628,125,0.833997,0.166003,0.833997,120,5,754,628,126,0.832891,0.167109,0.832891,121,5,1, abandoned,1,1,0.043516189188
20155,1000121,1,754,628,126,0.832891,0.167109,0.832891,121,5,755,628,127,0.831788,0.168212,0.831788,122,5,1, merged,1,1,0.309341321157
20155,1000329,2,1126,840,286,0.746004,0.253996,1.578895,261,25,1129,842,287,0.745793,0.254207,1.577581,262,25,1, merged,1,1,0.443882420896
20156,1000121,1,755,628,127,0.831788,0.168212,0.831788,122,5,756,629,127,0.832011,0.167989,0.832011,122,5,1, merged,0,0,0.52601966265
20156,1000329,2,1129,842,287,0.745793,0.254207,1.577581,262,25,1130,843,287,0.746018,0.253982,1.578028,262,25,1, merged,0,0,0.604936256219
20163,1000015,2,1007,924,83,0.917577,0.082423,1.79993,74,9,1008,925,83,0.917659,0.082341,1.80087,74,9,1, merged,0,0,0.10969740979
20164,1000592,2,204,167,37,0.818627,0.181373,1.418627,26,11,205,168,37,0.819512,0.180488,1.426655,26,11,-1, abandoned,0,0,0
20177,1000153,2,510,469,41,0.919608,0.080392,1.586275,32,9,511,470,41,0.919765,0.080235,1.619765,32,9,1, merged,0,0,0.27676902127
20195,1000121,2,757,630,127,0.832232,0.167768,1.578923,122,5,758,631,127,0.832454,0.167546,1.579367,122,5,1, merged,0,0,0.653084592801
20195,1000329,1,1133,846,287,0.74669,0.25331,0.74669,262,25,1134,847,287,0.746914,0.253086,0.746914,262,25,1, merged,0,0,0.956067647961
20196,1000009,1,472,396,76,0.838983,0.161017,0.838983,68,8,473,396,77,0.837209,0.162791,0.837209,69,8,1, merged,1,1,0.36830332232
20198,1000005,2,168,124,44,0.738095,0.261905,1.474937,42,2,169,125,44,0.739645,0.260355,1.439645,42,2,1, merged,0,0,0
20201,1000004,1,1018,873,145,0.857564,0.142436,0.857564,116,29,1019,874,145,0.857704,0.142296,0.857704,116,29,-1, merged,0,0,0.00341607797145
20201,1000120,2,295,258,37,0.874576,0.125424,1.73214,35,2,296,259,37,0.875,0.125,1.732704,35,2,-1, merged,0,0,0.0366245513536
20203,1000121,2,758,631,127,0.832454,0.167546,1.579367,122,5,759,632,127,0.832675,0.167325,1.579811,122,5,1, merged,0,0,0
20203,1000329,1,1134,847,287,0.746914,0.253086,0.746914,262,25,1135,848,287,0.747137,0.252863,0.747137,262,25,1, merged,0,0,0
20205,1000534,2,18,8,10,0.444444,0.555556,1.044444,10,0,19,9,10,0.473684,0.526316,1.140351,10,0,1, merged,0,0,1.38348623853
20207,1000011,1,345,323,22,0.936232,0.063768,0.936232,20,2,347,324,23,0.933718,0.066282,0.933718,21,2,1, merged,1,1,0.23660425352
20207,1000120,2,298,260,38,0.872483,0.127517,1.808715,36,2,300,261,39,0.87,0.13,1.803718,37,2,1, merged,1,1,0.179903265523
20208,1000091,3,220,169,51,0.768182,0.231818,2.348652,47,4,221,170,51,0.769231,0.230769,2.353799,47,4,1, merged,0,0,0.425371460611
20208,1000329,1,1135,848,287,0.747137,0.252863,0.747137,262,25,1136,849,287,0.747359,0.252641,0.747359,262,25,1, merged,0,0,0.616924501519
20209,1000091,2,221,170,51,0.769231,0.230769,1.51659,47,4,223,172,51,0.7713,0.2287,1.518225,47,4,-1, merged,0,0,0.427133249264
20209,1000329,1,1136,849,287,0.747359,0.252641,0.747359,262,25,1138,850,288,0.746924,0.253076,0.746924,263,25,1, merged,1,1,0.606686069073
20212,1000004,1,1019,874,145,0.857704,0.142296,0.857704,116,29,1020,874,146,0.856863,0.143137,0.856863,117,29,1, merged,1,1,0.11310016349
20212,1000329,2,1138,850,288,0.746924,0.253076,1.604628,263,25,1139,851,288,0.747147,0.252853,1.604009,263,25,1, merged,0,0,0.228530754598
20219,1000070,2,515,468,47,0.908738,0.091262,1.522773,36,11,516,469,47,0.908915,0.091085,1.529604,36,11,1, merged,0,0,0.603948440526
20236,1000004,3,1020,874,146,0.856863,0.143137,1.727184,117,29,1021,875,146,0.857003,0.142997,1.768114,117,29,1, merged,0,0,0.0196174462785
20236,1000070,4,517,470,47,0.909091,0.090909,2.636275,36,11,518,471,47,0.909266,0.090734,2.67738,36,11,1, merged,0,0,0.0001402573225
20250,1000118,1,581,510,71,0.877797,0.122203,0.877797,69,2,582,511,71,0.878007,0.121993,0.878007,69,2,-1, merged,0,0,0.0651794273228
20266,1000014,3,801,687,114,0.857678,0.142322,2.4377,104,10,802,688,114,0.857855,0.142145,2.422141,104,10,-1, merged,0,0,0.25654816936
20273,1000120,2,300,261,39,0.87,0.13,1.761892,37,2,301,262,39,0.870432,0.129568,1.765169,37,2,1, merged,0,0,0.139740713039
20280,1000014,1,803,689,114,0.858032,0.141968,0.858032,104,10,804,690,114,0.858209,0.141791,0.858209,104,10,1, merged,0,0,0.00191859151724
20297,1000004,2,1021,875,146,0.857003,0.142997,1.212558,117,29,1023,877,146,0.857283,0.142717,1.205109,117,29,-1, merged,0,0,0.052854851729
20299,1000004,1,1023,877,146,0.857283,0.142717,0.857283,117,29,1026,879,147,0.856725,0.143275,0.856725,118,29,-1, merged,1,0,0
20299,1000043,2,210,170,40,0.809524,0.190476,1.666806,35,5,212,171,41,0.806604,0.193396,1.663329,36,5,1, merged,1,1,0.0267324239617
20310,1000004,2,1026,879,147,0.856725,0.143275,1.604094,118,29,1027,880,147,0.856865,0.143135,1.604454,118,29,1, merged,0,0,0.0346519472554
20310,1000329,1,1140,852,288,0.747368,0.252632,0.747368,263,25,1141,853,288,0.74759,0.25241,0.74759,263,25,1, merged,0,0,0.0303805316593
20313,1000091,1,223,172,51,0.7713,0.2287,0.7713,47,4,225,172,53,0.764444,0.235556,0.764444,47,6,-1, merged,1,1,0.211444936939
20313,1000328,2,382,268,114,0.701571,0.298429,1.472871,105,9,383,269,114,0.70235,0.29765,1.466794,105,9,1, merged,0,0,0.336050970309
20317,1000121,2,763,635,128,0.832241,0.167759,1.649701,123,5,764,636,128,0.832461,0.167539,1.651358,123,5,1, merged,0,0,0.0342358801122
20318,1000121,2,764,636,128,0.832461,0.167539,1.651358,123,5,765,637,128,0.83268,0.16732,1.652992,123,5,1, merged,0,0,0.0717196743436
20328,1000534,1,19,9,10,0.473684,0.526316,0.473684,10,0,20,9,11,0.45,0.55,0.45,11,0,1, abandoned,1,1,0.00455877364612
20334,1000003,1,668,560,108,0.838323,0.161677,0.838323,101,7,669,561,108,0.838565,0.161435,0.838565,101,7,-1, merged,0,0,0.215407668434
20336,1000091,2,225,172,53,0.764444,0.235556,1.599786,47,6,226,173,53,0.765487,0.234513,1.601487,47,6,1, merged,0,0,0.212846708185
20339,1000004,2,1027,880,147,0.856865,0.143135,1.708717,118,29,1028,881,147,0.857004,0.142996,1.714147,118,29,1, merged,0,0,0.0501248425779
20339,1000005,3,169,125,44,0.739645,0.260355,2.448361,42,2,170,126,44,0.741176,0.258824,2.455323,42,2,1, merged,0,0,0.018277079197
20339,1000121,4,765,637,128,0.83268,0.16732,3.281041,123,5,766,638,128,0.832898,0.167102,3.288221,123,5,1, merged,0,0,0.0531346296887
20352,1000121,3,766,638,128,0.832898,0.167102,2.353588,123,5,767,639,128,0.833116,0.166884,2.372699,123,5,1, merged,0,0,0
20354,1000091,3,226,173,53,0.765487,0.234513,2.300953,47,6,227,174,53,0.76652,0.23348,2.300591,47,6,1, merged,0,0,0.123114386381
20354,1000121,2,767,639,128,0.833116,0.166884,1.535466,123,5,769,641,128,0.83355,0.16645,1.534071,123,5,-1, merged,0,0,0.0702548144769
20354,1000328,1,383,269,114,0.70235,0.29765,0.70235,105,9,384,269,115,0.700521,0.299479,0.700521,106,9,1, merged,1,1,0.143055207974
20356,1000004,2,1029,882,147,0.857143,0.142857,1.412698,118,29,1032,885,147,0.857558,0.142442,1.436506,118,29,-1, merged,0,0,0.0545679935429
20357,1000328,2,384,269,115,0.700521,0.299479,0.700521,106,9,385,270,115,0.701299,0.298701,1.701299,106,9,1, merged,0,0,0
20358,1000004,2,1032,885,147,0.857558,0.142442,1.436506,118,29,1035,887,148,0.857005,0.142995,1.407005,119,29,-1, merged,1,0,0.0637999432539
20358,1000070,6,519,472,47,0.909441,0.090559,3.569706,36,11,520,473,47,0.909615,0.090385,3.755091,36,11,-1, merged,0,0,0.121294219188
20366,1000121,3,769,641,128,0.83355,0.16645,2.312627,123,5,770,642,128,0.833766,0.166234,2.314119,123,5,1, merged,0,0,0.0124694895469
20366,1000124,4,276,258,18,0.934783,0.065217,3.247409,17,1,277,259,18,0.935018,0.064982,3.249137,17,1,1, merged,0,0,0.00165994783021
20366,1000327,1,441,343,98,0.777778,0.222222,0.777778,73,25,442,344,98,0.778281,0.221719,0.778281,73,25,-1, merged,0,0,0.0147928994083
20366,1000328,2,385,270,115,0.701299,0.298701,1.479076,106,9,386,271,115,0.702073,0.297927,1.480353,106,9,1, merged,0,0,0.0115107913669
20367,1000070,4,520,473,47,0.909615,0.090385,2.928699,36,11,521,474,47,0.909789,0.090211,2.929716,36,11,1, merged,0,0,0.146238462361
20369,1000124,1,277,259,18,0.935018,0.064982,0.935018,17,1,278,260,18,0.935252,0.064748,0.935252,17,1,1, merged,0,0,0.352014044119
20373,1000014,2,806,692,114,0.858561,0.141439,1.692327,104,10,807,693,114,0.858736,0.141264,1.692933,104,10,1, merged,0,0,0
20373,1000121,1,770,642,128,0.833766,0.166234,0.833766,123,5,772,644,128,0.834197,0.165803,0.834197,123,5,-1, merged,0,0,0
20375,1000534,2,20,9,11,0.45,0.55,1.164286,11,0,22,10,12,0.454545,0.545455,1.121212,12,0,1, merged,1,1,0.228010192434
20377,1000121,2,772,644,128,0.834197,0.165803,1.581575,123,5,773,645,128,0.834411,0.165589,1.58201,123,5,1, merged,0,0,0.0106112054329
20377,1000329,1,1144,855,289,0.747378,0.252622,0.747378,264,25,1145,856,289,0.747598,0.252402,0.747598,264,25,1, merged,0,0,0.031194502355
20379,1000124,1,278,260,18,0.935252,0.064748,0.935252,17,1,280,261,19,0.932143,0.067857,0.932143,17,2,-1, merged,1,0,0.0436283660992
20379,1000166,2,113,94,19,0.831858,0.168142,1.76711,18,1,114,95,19,0.833333,0.166667,1.765476,18,1,1, merged,0,0,0.0866149589418
20380,1000014,2,807,693,114,0.858736,0.141264,1.560809,104,10,808,694,114,0.858911,0.141089,1.562519,104,10,1, merged,0,0,0.413239841938
20380,1000328,1,386,271,115,0.702073,0.297927,0.702073,106,9,388,273,115,0.703608,0.296392,0.703608,106,9,-1, merged,0,0,0.445219266715
20381,1000329,1,1145,856,289,0.747598,0.252402,0.747598,264,25,1146,857,289,0.747818,0.252182,0.747818,264,25,1, merged,0,0,0.582017137564
20385,1000014,1,808,694,114,0.858911,0.141089,0.858911,104,10,812,698,114,0.859606,0.140394,0.859606,104,10,-1, merged,0,0,0.0804007555798
20385,1000327,2,442,344,98,0.778281,0.221719,1.637191,73,25,444,345,99,0.777027,0.222973,1.636633,73,26,-1, merged,1,0,0.106972282516
20387,1000121,2,773,645,128,0.834411,0.165589,1.58223,123,5,774,646,128,0.834625,0.165375,1.582664,123,5,1, merged,0,0,0.0183753791725
20387,1000329,1,1146,857,289,0.747818,0.252182,0.747818,264,25,1147,858,289,0.748038,0.251962,0.748038,264,25,1, merged,0,0,0.015149465783
20391,1000004,1,1037,889,148,0.857281,0.142719,0.857281,119,29,1038,890,148,0.857418,0.142582,0.857418,119,29,-1, abandoned,0,0,0.447994798879
20391,1000329,2,1147,858,289,0.748038,0.251962,1.605319,264,25,1148,859,289,0.748258,0.251742,1.605676,264,25,-1, abandoned,0,0,0.908428051122
20395,1000534,1,22,10,12,0.454545,0.545455,0.454545,12,0,24,12,12,0.5,0.5,0.5,12,0,-1, merged,0,0,1.4076419214
20410,1000121,4,774,646,128,0.834625,0.165375,3.133208,123,5,776,647,129,0.833763,0.166237,3.156958,123,6,-1, merged,1,1,0.0560157506534
20410,1000329,3,1148,859,289,0.748258,0.251742,2.298583,264,25,1153,863,290,0.748482,0.251518,2.323195,265,25,-1, merged,1,0,0.0768892617491
20411,1000043,2,212,171,41,0.806604,0.193396,1.555082,36,5,213,172,41,0.807512,0.192488,1.5565,36,5,1, merged,0,0,0.915463414634
20414,1000004,2,1038,890,148,0.857418,0.142582,1.76738,119,29,1039,891,148,0.857555,0.142445,1.767689,119,29,1, merged,0,0,0.128264682003
20414,1000070,1,522,475,47,0.909962,0.090038,0.909962,36,11,523,476,47,0.910134,0.089866,0.910134,36,11,1, merged,0,0,0.249975072754
20417,1000004,2,1039,891,148,0.857555,0.142445,1.694094,119,29,1040,892,148,0.857692,0.142308,1.691558,119,29,-1, abandoned,0,0,0.00818230480997
20424,1000063,1,1803,1614,189,0.895175,0.104825,0.895175,162,27,1806,1616,190,0.894795,0.105205,0.894795,163,27,-1, merged,1,0,0.207625037431
20424,1000121,2,776,647,129,0.833763,0.166237,1.728938,123,6,777,647,130,0.83269,0.16731,1.727485,124,6,1, merged,1,1,0.16965751549
20435,1000026,1,212,194,18,0.915094,0.084906,0.915094,16,2,213,194,19,0.910798,0.089202,0.910798,17,2,1, merged,1,1,0.321227845144
20435,1000109,2,314,261,53,0.83121,0.16879,1.746305,51,2,315,262,53,0.831746,0.168254,1.742544,51,2,1, merged,0,0,0.0110461603212
20448,1000124,2,282,263,19,0.932624,0.067376,1.765957,17,2,283,264,19,0.932862,0.067138,1.767645,17,2,1, merged,0,0,0.401699399157
20448,1000166,1,114,95,19,0.833333,0.166667,0.833333,18,1,115,96,19,0.834783,0.165217,0.834783,18,1,1, merged,0,0,0.824198491278
20451,1000118,2,591,520,71,0.879865,0.120135,1.71373,69,2,593,522,71,0.88027,0.11973,1.71148,69,2,-1, merged,0,0,0.261867623336
20461,1000592,3,206,169,37,0.820388,0.179612,2.677531,26,11,207,170,37,0.821256,0.178744,2.682367,26,11,1, merged,0,0,0.325898910771
20464,1000109,3,315,262,53,0.831746,0.168254,2.418086,51,2,316,263,53,0.832278,0.167722,2.416614,51,2,1, merged,0,0,0.408603424985
20464,1000199,2,198,158,40,0.79798,0.20202,1.58634,38,2,199,159,40,0.798995,0.201005,1.584335,38,2,1, merged,0,0,0.405707676599
20476,1000004,1,1040,892,148,0.857692,0.142308,0.857692,119,29,1041,892,149,0.856868,0.143132,0.856868,120,29,1, merged,1,1,0.179496267219
20477,1000121,2,778,648,130,0.832905,0.167095,1.741996,124,6,780,650,130,0.833333,0.166667,1.708333,124,6,-1, merged,0,0,0.0842516899851
20484,1000004,3,1041,892,149,0.856868,0.143132,1.556868,120,29,1043,894,149,0.857143,0.142857,1.52381,120,29,-1, merged,0,0,0.0314616619525
20495,1000026,2,213,194,19,0.910798,0.089202,1.831032,17,2,214,195,19,0.911215,0.088785,1.831603,17,2,1, merged,0,0,0.0183356840621
20495,1000153,1,514,473,41,0.920233,0.079767,0.920233,32,9,515,474,41,0.920388,0.079612,0.920388,32,9,1, merged,0,0,0.00254631211976
20511,1000004,2,1044,895,149,0.85728,0.14272,1.65728,120,29,1046,897,149,0.857553,0.142447,1.643267,120,29,-1, merged,0,0,0.0743646544536
20523,1000166,3,116,97,19,0.836207,0.163793,2.255207,18,1,117,98,19,0.837607,0.162393,2.263053,18,1,1, merged,0,0,0.272922287347
20548,1000063,1,1806,1616,190,0.894795,0.105205,0.894795,163,27,1809,1619,190,0.89497,0.10503,0.89497,163,27,-1, merged,0,0,0.00295940008629
20555,1000063,2,1809,1619,190,0.89497,0.10503,1.825283,163,27,1810,1620,190,0.895028,0.104972,1.822363,163,27,-1, merged,0,0,0.00353175207751
20566,1000121,4,780,650,130,0.833333,0.166667,3.288616,124,6,781,651,130,0.833547,0.166453,3.273734,124,6,1, merged,0,0,0
20566,1000329,3,1154,864,290,0.7487,0.2513,2.455282,265,25,1155,865,290,0.748918,0.251082,2.440187,265,25,1, merged,0,0,0
20574,1000004,1,1046,897,149,0.857553,0.142447,0.857553,120,29,1047,898,149,0.857689,0.142311,0.857689,120,29,1, merged,0,0,0.230165808145
20574,1000121,2,781,651,130,0.833547,0.166453,1.691099,124,6,782,652,130,0.83376,0.16624,1.691448,124,6,1, merged,0,0,0.321900044114
20577,1000014,1,816,702,114,0.860294,0.139706,0.860294,104,10,817,703,114,0.860465,0.139535,0.860465,104,10,1, merged,0,0,0.242465407036
20591,1000109,2,316,263,53,0.832278,0.167722,1.619843,51,2,318,265,53,0.833333,0.166667,1.611111,51,2,-1, merged,0,0,0.0272938414481
20613,1000327,3,444,345,99,0.777027,0.222973,2.229408,73,26,445,346,99,0.777528,0.222472,2.213892,73,26,1, merged,0,0,0.11726487571
20617,1000015,2,1016,932,84,0.917323,0.082677,1.837865,75,9,1017,933,84,0.917404,0.082596,1.8381,75,9,1, merged,0,0,0.531264527807
20617,1000153,1,516,475,41,0.920543,0.079457,0.920543,32,9,517,476,41,0.920696,0.079304,0.920696,32,9,1, merged,0,0,0.554578269835
20631,1000091,2,230,177,53,0.769565,0.230435,1.456616,47,6,234,181,53,0.773504,0.226496,1.461676,47,6,-1, merged,0,0,0.0858860842994
20640,1000327,2,445,346,99,0.777528,0.222472,1.577528,73,26,446,347,99,0.778027,0.221973,1.590527,73,26,1, merged,0,0,0.119775645722
20652,1000121,1,782,652,130,0.83376,0.16624,0.83376,124,6,783,653,130,0.833972,0.166028,0.833972,124,6,1, merged,0,0,0.00138013064934
20652,1000329,2,1155,865,290,0.748918,0.251082,1.582677,265,25,1156,866,290,0.749135,0.250865,1.583107,265,25,1, merged,0,0,0.00108446721422
20663,1000014,2,820,706,114,0.860976,0.139024,1.560976,104,10,821,707,114,0.861145,0.138855,1.588418,104,10,1, merged,0,0,0.559811307294
20670,1000199,2,199,159,40,0.798995,0.201005,1.578995,38,2,201,160,41,0.79602,0.20398,1.569419,39,2,-1, merged,1,0,0.0027699567913
20674,1000004,1,1054,903,151,0.856736,0.143264,0.856736,122,29,1055,904,151,0.856872,0.143128,0.856872,122,29,1, merged,0,0,0.179596239127
20674,1000120,2,318,279,39,0.877358,0.122642,1.734095,37,2,319,280,39,0.877743,0.122257,1.734615,37,2,1, merged,0,0,0.255294717722
20677,1000199,2,201,160,41,0.79602,0.20398,1.566752,39,2,203,162,41,0.79803,0.20197,1.570976,39,2,1, merged,0,0,0.00720112201797
20678,1000026,2,215,196,19,0.911628,0.088372,1.684575,17,2,216,197,19,0.912037,0.087963,1.689288,17,2,1, merged,0,0,0.660119602361
20679,1000004,1,1055,904,151,0.856872,0.143128,0.856872,122,29,1058,905,153,0.855388,0.144612,0.855388,124,29,1, merged,1,1,0.106167921098
20679,1000329,2,1157,867,290,0.749352,0.250648,1.606224,265,25,1159,868,291,0.748921,0.251079,1.604309,266,25,1, merged,1,1,0.202705676769
20684,1000004,1,1058,905,153,0.855388,0.144612,0.855388,124,29,1059,906,153,0.855524,0.144476,0.855524,124,29,1, merged,0,0,0.179808357552
20684,1000120,2,319,280,39,0.877743,0.122257,1.73313,37,2,320,281,39,0.878125,0.121875,1.733649,37,2,1, merged,0,0,0.257461651825
20686,1000004,1,1059,906,153,0.855524,0.144476,0.855524,124,29,1060,907,153,0.85566,0.14434,0.85566,124,29,1, merged,0,0,0.360958625597
20686,1000120,2,320,281,39,0.878125,0.121875,1.733649,37,2,321,282,39,0.878505,0.121495,1.734165,37,2,1, merged,0,0,0.532024793388
20687,1000004,1,1060,907,153,0.85566,0.14434,0.85566,124,29,1061,908,153,0.855796,0.144204,0.855796,124,29,-1, abandoned,0,0,0.0198622993028
20687,1000329,2,1159,868,291,0.748921,0.251079,1.604582,266,25,1160,869,291,0.749138,0.250862,1.604934,266,25,-1, abandoned,0,0,0.00766585848104
20688,1000014,2,821,707,114,0.861145,0.138855,1.707299,104,10,823,707,116,0.859052,0.140948,1.716195,106,10,1, merged,1,1,0.103479858052
20688,1000327,6,446,347,99,0.778027,0.221973,4.767523,73,26,448,349,99,0.779018,0.220982,4.660872,73,26,-1, merged,0,0,0.0985704429699
20691,1000004,2,1062,909,153,0.855932,0.144068,1.60507,124,29,1063,910,153,0.856068,0.143932,1.605422,124,29,1, merged,0,0,0.367149027294
20691,1000329,1,1160,869,291,0.749138,0.250862,0.749138,266,25,1161,870,291,0.749354,0.250646,0.749354,266,25,1, merged,0,0,0.558074992619
20692,1000063,1,1810,1620,190,0.895028,0.104972,0.895028,163,27,1811,1621,190,0.895086,0.104914,0.895086,163,27,1, merged,0,0,0.142317233207
20692,1000091,2,234,181,53,0.773504,0.226496,1.668532,47,6,235,182,53,0.774468,0.225532,1.669554,47,6,1, merged,0,0,0.215176899544
20695,1000004,3,1064,911,153,0.856203,0.143797,2.693129,124,29,1065,912,153,0.856338,0.143662,2.694228,124,29,1, merged,0,0,0.00127270417884
20696,1000003,1,681,572,109,0.839941,0.160059,0.839941,102,7,682,573,109,0.840176,0.159824,0.840176,102,7,-1, merged,0,0,0.154337029646
20696,1000121,2,783,653,130,0.833972,0.166028,1.673913,124,6,784,654,130,0.834184,0.165816,1.67436,124,6,1, merged,0,0,0.168997684226
20697,1000120,2,321,282,39,0.878505,0.121495,1.628074,37,2,322,283,39,0.878882,0.121118,1.628667,37,2,1, merged,0,0,0.471290944123
20697,1000329,1,1162,871,291,0.74957,0.25043,0.74957,266,25,1163,872,291,0.749785,0.250215,0.749785,266,25,1, merged,0,0,0.857670202196
20702,1000070,3,526,479,47,0.910646,0.089354,2.289003,36,11,527,480,47,0.910816,0.089184,2.295048,36,11,1, merged,0,0,0.734064507583
20702,1000329,1,1163,872,291,0.749785,0.250215,0.749785,266,25,1166,875,291,0.750429,0.249571,0.750429,266,25,-1, merged,0,0,0.646233756661
20708,1000091,4,237,183,54,0.772152,0.227848,3.007987,48,6,239,184,55,0.769874,0.230126,3.001356,49,6,1, merged,1,1,0.156852873547
20708,1000121,5,784,654,130,0.834184,0.165816,3.84217,124,6,786,655,131,0.833333,0.166667,3.83469,125,6,1, merged,1,1,0.0975527434371
20708,1000328,2,389,274,115,0.70437,0.29563,1.455013,106,9,391,275,116,0.703325,0.296675,1.453325,107,9,1, merged,1,1,0.184391500491
20708,1000329,1,1167,876,291,0.750643,0.249357,0.750643,266,25,1168,876,292,0.75,0.25,0.75,267,25,1, merged,1,1,0.134839227363
20712,1000004,2,1065,912,153,0.856338,0.143662,1.376338,124,29,1066,913,153,0.856473,0.143527,1.394934,124,29,-1, merged,0,0,0.145313355231
20712,1000120,4,326,287,39,0.880368,0.119632,3.118245,37,2,327,288,39,0.880734,0.119266,3.139305,37,2,1, merged,0,0,0.160998699
20712,1000534,1,25,13,12,0.52,0.48,0.52,12,0,26,14,12,0.538462,0.461538,0.538462,12,0,-1, merged,0,0,0.455215392272
20718,1000140,2,0,0,0,0,0,0.69697,0,0,1,1,0,1,0,1.701493,0,0,1, merged,0,0,0.583333333333
20720,1000592,2,209,172,37,0.822967,0.177033,1.684078,26,11,210,172,38,0.819048,0.180952,1.665201,26,12,-1, merged,1,1,0
20730,1000014,1,823,707,116,0.859052,0.140948,0.859052,106,10,825,708,117,0.858182,0.141818,0.858182,107,10,1, merged,1,1,0.0058553738382
20730,1000121,2,786,655,131,0.833333,0.166667,1.692386,125,6,788,656,132,0.832487,0.167513,1.690669,126,6,1, merged,1,1,0.00783642195555
20736,1000004,2,1066,913,153,0.856473,0.143527,1.490276,124,29,1068,915,153,0.856742,0.143258,1.49563,124,29,-1, merged,0,0,0.01676976605
20737,1000118,2,599,528,71,0.881469,0.118531,1.712679,69,2,600,529,71,0.881667,0.118333,1.707616,69,2,-1, merged,0,0,0.0567696431966
20748,1000043,1,218,177,41,0.811927,0.188073,0.811927,36,5,219,178,41,0.812785,0.187215,0.812785,36,5,1, merged,0,0,0.608350620016
20764,1000003,2,682,573,109,0.840176,0.159824,1.757984,102,7,683,574,109,0.84041,0.15959,1.758299,102,7,1, merged,0,0,0.484329188022
20764,1000015,1,1022,938,84,0.917808,0.082192,0.917808,75,9,1023,939,84,0.917889,0.082111,0.917889,75,9,1, merged,0,0,0.477422759342
20768,1000004,2,1068,915,153,0.856742,0.143258,1.737476,124,29,1069,916,153,0.856876,0.143124,1.737973,124,29,-1, merged,0,0,0.00800491589463
20768,1000014,4,826,709,117,0.858354,0.141646,3.134291,107,10,829,712,117,0.858866,0.141134,3.132554,107,10,-1, merged,0,0,0
20768,1000120,1,327,288,39,0.880734,0.119266,0.880734,37,2,328,289,39,0.881098,0.118902,0.881098,37,2,-1, merged,0,0,0.00887549281613
20768,1000534,3,26,14,12,0.538462,0.461538,2.275937,12,0,28,15,13,0.535714,0.464286,2.273687,13,0,-1, merged,1,0,0
20778,1000004,3,1069,916,153,0.856876,0.143124,2.581793,124,29,1072,919,153,0.857276,0.142724,2.580513,124,29,-1, merged,0,0,0.0225016553383
20778,1000023,1,251,224,27,0.89243,0.10757,0.89243,24,3,252,225,27,0.892857,0.107143,0.892857,24,3,-1, merged,0,0,0.00511158930888
20778,1000121,2,788,656,132,0.832487,0.167513,1.724918,126,6,790,656,134,0.83038,0.16962,1.723237,128,6,1, merged,1,1,0.0251151708195
20781,1000023,2,252,225,27,0.892857,0.107143,1.723237,24,3,254,226,28,0.889764,0.110236,1.719309,25,3,1, merged,1,1,0.00536201623935
20781,1000063,3,1811,1621,190,0.895086,0.104914,2.618322,163,27,1812,1622,190,0.895143,0.104857,2.614453,163,27,-1, merged,0,0,0.0133864665461
20781,1000121,1,790,656,134,0.83038,0.16962,0.83038,128,6,792,657,135,0.829545,0.170455,0.829545,129,6,1, merged,1,1,0.0265571246554
20782,1000004,2,1072,919,153,0.857276,0.142724,1.39216,124,29,1073,920,153,0.857409,0.142591,1.402864,124,29,1, merged,0,0,0.0334995969367
20785,1000004,3,1073,920,153,0.857409,0.142591,2.437168,124,29,1074,921,153,0.857542,0.142458,2.43773,124,29,1, merged,0,0,0
20785,1000121,2,792,657,135,0.829545,0.170455,1.579759,129,6,793,658,135,0.82976,0.17024,1.580188,129,6,1, merged,0,0,0.00124107973937
20785,1000329,1,1169,877,292,0.750214,0.249786,0.750214,267,25,1170,878,292,0.750427,0.249573,0.750427,267,25,1, merged,0,0,0.000882028665932
20787,1000004,1,1074,921,153,0.857542,0.142458,0.857542,124,29,1075,922,153,0.857674,0.142326,0.857674,124,29,1, merged,0,0,0.0362198377915
20787,1000043,2,227,186,41,0.819383,0.180617,1.676925,36,5,228,187,41,0.820175,0.179825,1.67785,36,5,1, merged,0,0,0.0459770114943
20792,1000063,2,1812,1622,190,0.895143,0.104857,1.84138,163,27,1813,1623,190,0.895201,0.104799,1.831372,163,27,-1, abandoned,0,0,0.00641907490444
20810,1000014,2,829,712,117,0.858866,0.141134,1.858866,107,10,831,714,117,0.859206,0.140794,1.716349,107,10,-1, merged,0,0,0.524616980304
20814,1000091,1,242,185,57,0.764463,0.235537,0.764463,51,6,243,186,57,0.765432,0.234568,0.765432,51,6,1, merged,0,0,0.118734892142
20814,1000328,2,391,275,116,0.703325,0.296675,1.467788,107,9,392,276,116,0.704082,0.295918,1.469514,107,9,1, merged,0,0,0.145995548368
20826,1000007,1,505,431,74,0.853465,0.146535,0.853465,64,10,507,432,75,0.852071,0.147929,0.852071,65,10,-1, merged,1,0,0.0496653702601
20826,1000011,2,347,324,23,0.933718,0.066282,1.787183,21,2,348,324,24,0.931034,0.068966,1.783105,22,2,1, merged,1,1,0.0536995908697
20835,1000327,1,448,349,99,0.779018,0.220982,0.779018,73,26,449,350,99,0.77951,0.22049,0.77951,73,26,1, merged,0,0,0.595924441205
20851,1000328,2,392,276,116,0.704082,0.295918,1.454509,107,9,393,276,117,0.70229,0.29771,1.451437,107,10,-1, merged,1,1,0.114623278879
20851,1000329,1,1170,878,292,0.750427,0.249573,0.750427,267,25,1172,878,294,0.749147,0.250853,0.749147,267,27,-1, merged,1,1,0.0909018843911
20852,1000327,1,449,350,99,0.77951,0.22049,0.77951,73,26,451,350,101,0.776053,0.223947,0.776053,75,26,1, merged,1,1,0.0653504076641
20852,1000329,5,1172,878,294,0.749147,0.250853,3.41521,267,27,1173,879,294,0.749361,0.250639,3.387412,267,27,1, merged,0,0,0.122282106445
20863,1000328,1,393,276,117,0.70229,0.29771,0.70229,107,10,395,277,118,0.701266,0.298734,0.701266,108,10,1, merged,1,1,0
20866,1000004,1,1075,922,153,0.857674,0.142326,0.857674,124,29,1076,923,153,0.857807,0.142193,0.857807,124,29,1, merged,0,0,0.204683106091
20866,1000592,3,210,172,38,0.819048,0.180952,2.533865,26,12,211,173,38,0.819905,0.180095,2.538177,26,12,1, merged,0,0,0.371895076718
20867,1000004,2,1076,923,153,0.857807,0.142193,1.635584,124,29,1077,924,153,0.857939,0.142061,1.621097,124,29,1, merged,0,0,0.20482216353
20867,1000592,4,211,173,38,0.819905,0.180095,3.315955,26,12,212,174,38,0.820755,0.179245,3.305488,26,12,1, merged,0,0,0.373535230137
20868,1000004,1,1077,924,153,0.857939,0.142061,0.857939,124,29,1078,925,153,0.858071,0.141929,0.858071,124,29,1, merged,0,0,0.205027274053
20868,1000592,3,212,174,38,0.820755,0.179245,2.441851,26,12,213,175,38,0.821596,0.178404,2.448898,26,12,1, merged,0,0,0.376118235659
20869,1000329,1,1175,880,295,0.748936,0.251064,0.748936,267,28,1176,881,295,0.74915,0.25085,0.74915,267,28,-1, merged,0,0,0.918465643367
20871,1000327,3,451,350,101,0.776053,0.223947,2.284426,75,26,452,351,101,0.776549,0.223451,2.295465,75,26,1, merged,0,0,0
20895,1000004,2,1079,926,153,0.858202,0.141798,1.753461,124,29,1080,927,153,0.858333,0.141667,1.75365,124,29,-1, abandoned,0,0,0.0273017551051
20895,1000063,1,1814,1624,190,0.895259,0.104741,0.895259,163,27,1815,1625,190,0.895317,0.104683,0.895317,163,27,-1, abandoned,0,0,0.00468069560134
20925,1000091,1,243,186,57,0.765432,0.234568,0.765432,51,6,244,187,57,0.766393,0.233607,0.766393,51,6,-1, merged,0,0,0.432964736059
20927,1000004,1,1080,927,153,0.858333,0.141667,0.858333,124,29,1082,929,153,0.858595,0.141405,0.858595,124,29,-1, merged,0,0,0.0128099913903
20927,1000121,3,796,661,135,0.830402,0.169598,2.438098,129,6,797,662,135,0.830615,0.169385,2.43815,129,6,1, merged,0,0,0
20927,1000329,2,1177,882,295,0.749363,0.250637,1.607696,267,28,1179,883,296,0.74894,0.25106,1.607535,267,29,-1, merged,1,0,0
20931,1000063,2,1818,1628,190,0.89549,0.10451,1.83166,163,27,1820,1630,190,0.895604,0.104396,1.82192,163,27,-1, merged,0,0,0.000690332823597
20932,1000004,1,1082,929,153,0.858595,0.141405,0.858595,124,29,1083,930,153,0.858726,0.141274,0.858726,124,29,1, merged,0,0,0.0021370152188
20932,1000120,2,332,293,39,0.88253,0.11747,1.741125,37,2,333,294,39,0.882883,0.117117,1.741609,37,2,1, merged,0,0,0.035438330934
20934,1000121,3,797,662,135,0.830615,0.169385,2.414606,129,6,798,663,135,0.830827,0.169173,2.41608,129,6,1, merged,0,0,0.515366421532
20934,1000329,1,1179,883,296,0.74894,0.25106,0.74894,267,29,1181,884,297,0.748518,0.251482,0.748518,267,30,-1, merged,1,1,0.609350479512
20941,1000070,2,527,480,47,0.910816,0.089184,1.687365,36,11,528,481,47,0.910985,0.089015,1.688027,36,11,1, merged,0,0,0.803912888112
20941,1000327,1,452,351,101,0.776549,0.223451,0.776549,75,26,453,352,101,0.777042,0.222958,0.777042,75,26,1, merged,0,0,0.669456574478
20943,1000004,1,1085,932,153,0.858986,0.141014,0.858986,124,29,1086,933,153,0.859116,0.140884,0.859116,124,29,1, merged,0,0,0.000339468919734
20943,1000120,2,333,294,39,0.882883,0.117117,1.741869,37,2,334,295,39,0.883234,0.116766,1.74235,37,2,1, merged,0,0,0.00696594427245
20946,1000012,1,318,283,35,0.889937,0.110063,0.889937,34,1,319,284,35,0.890282,0.109718,0.890282,34,1,1, merged,0,0,0.0146875981201
20946,1000026,2,219,200,19,0.913242,0.086758,1.803179,17,2,220,201,19,0.913636,0.086364,1.803918,17,2,1, merged,0,0,0.0395944602224
20954,1000004,2,1087,934,153,0.859246,0.140754,1.424463,124,29,1088,935,153,0.859375,0.140625,1.433843,124,29,1, merged,0,0,0.0240014434367
20954,1000120,3,335,296,39,0.883582,0.116418,2.308045,37,2,336,297,39,0.883929,0.116071,2.317772,37,2,1, merged,0,0,0.112079426365
20959,1000004,3,1088,935,153,0.859375,0.140625,2.518916,124,29,1090,937,153,0.859633,0.140367,2.512036,124,29,-1, abandoned,0,0,0.463524257123
20959,1000592,1,213,175,38,0.821596,0.178404,0.821596,26,12,214,175,39,0.817757,0.182243,0.817757,27,12,1, abandoned,1,1,0.865355343001
20976,1000091,1,244,187,57,0.766393,0.233607,0.766393,51,6,245,187,58,0.763265,0.236735,0.763265,52,6,1, abandoned,1,1,0
20980,1000003,2,688,579,109,0.84157,0.15843,1.644679,102,7,689,579,110,0.840348,0.159652,1.639317,103,7,1, abandoned,1,1,0
20991,1000004,1,1090,937,153,0.859633,0.140367,0.859633,124,29,1091,938,153,0.859762,0.140238,0.859762,124,29,1, merged,0,0,0.0131212643369
20991,1000120,2,336,297,39,0.883929,0.116071,1.743562,37,2,337,298,39,0.884273,0.115727,1.744035,37,2,1, merged,0,0,0.203425487388
21005,1000329,2,1181,884,297,0.748518,0.251482,1.479287,267,30,1182,885,297,0.748731,0.251269,1.470953,267,30,1, merged,0,0,0.232512779123
21006,1000329,2,1182,885,297,0.748731,0.251269,1.566488,267,30,1183,886,297,0.748943,0.251057,1.567548,267,30,1, merged,0,0,0.910676439451
21006,1000592,1,214,175,39,0.817757,0.182243,0.817757,27,12,215,176,39,0.818605,0.181395,0.818605,27,12,1, merged,0,0,0.839411162314
21009,1000592,1,215,176,39,0.818605,0.181395,0.818605,27,12,216,177,39,0.819444,0.180556,0.819444,27,12,1, merged,0,0,0
21011,1000329,2,1183,886,297,0.748943,0.251057,1.568388,267,30,1184,887,297,0.749155,0.250845,1.565669,267,30,-1, merged,0,0,0.0733907611958
21011,1000592,1,216,177,39,0.819444,0.180556,0.819444,27,12,218,178,40,0.816514,0.183486,0.816514,28,12,1, merged,1,1,0.0704936750555
21013,1000014,2,836,719,117,0.860048,0.139952,1.772033,107,10,837,720,117,0.860215,0.139785,1.772365,107,10,-1, abandoned,0,0,0.132094128333
21013,1000070,1,534,487,47,0.911985,0.088015,0.911985,36,11,535,488,47,0.91215,0.08785,0.91215,36,11,-1, abandoned,0,0,0.182366602341
21016,1000328,3,396,278,118,0.70202,0.29798,2.202655,108,10,397,279,118,0.702771,0.297229,2.203475,108,10,1, merged,0,0,0.98959245258
21016,1000329,1,1184,887,297,0.749155,0.250845,0.749155,267,30,1186,888,298,0.748735,0.251265,0.748735,268,30,1, merged,1,1,0.85112292231
21028,1000004,1,1094,941,153,0.860146,0.139854,0.860146,124,29,1095,941,154,0.859361,0.140639,0.859361,125,29,1, merged,1,1,0
21039,1000004,2,1096,942,154,0.859489,0.140511,1.609489,125,29,1097,943,154,0.859617,0.140383,1.605886,125,29,-1, merged,0,0,0
21039,1000091,3,245,187,58,0.763265,0.236735,2.372754,52,6,246,187,59,0.760163,0.239837,2.366048,53,6,1, merged,1,1,0
21040,1000004,1,1097,943,154,0.859617,0.140383,0.859617,125,29,1098,944,154,0.859745,0.140255,0.859745,125,29,-1, merged,0,0,0
21040,1000329,2,1188,890,298,0.749158,0.250842,1.608775,268,30,1190,892,298,0.74958,0.25042,1.609325,268,30,-1, merged,0,0,0
21041,1000004,1,1098,944,154,0.859745,0.140255,0.859745,125,29,1099,945,154,0.859873,0.140127,0.859873,125,29,-1, merged,0,0,0
21041,1000329,2,1190,892,298,0.74958,0.25042,1.609325,268,30,1191,893,298,0.74979,0.25021,1.609663,268,30,-1, merged,0,0,0
21042,1000329,1,1191,893,298,0.74979,0.25021,0.74979,268,30,1192,894,298,0.75,0.25,0.75,268,30,-1, merged,0,0,0
21043,1000327,1,455,354,101,0.778022,0.221978,0.778022,75,26,456,355,101,0.778509,0.221491,0.778509,75,26,1, merged,0,0,0
21046,1000121,4,802,667,135,0.831671,0.168329,3.109803,129,6,803,668,135,0.83188,0.16812,3.115308,129,6,1, merged,0,0,0
21046,1000329,3,1192,894,298,0.75,0.25,2.278132,268,30,1193,895,298,0.75021,0.24979,2.283427,268,30,-1, merged,0,0,0
21047,1000121,2,803,668,135,0.83188,0.16812,1.580082,129,6,805,669,136,0.831056,0.168944,1.573913,130,6,1, merged,1,1,0
21056,1000121,2,811,673,138,0.82984,0.17016,1.580049,132,6,812,674,138,0.830049,0.169951,1.579631,132,6,1, merged,0,0,0
21056,1000329,1,1193,895,298,0.75021,0.24979,0.75021,268,30,1194,895,299,0.749581,0.250419,0.749581,269,30,1, merged,1,1,0
21068,1000121,2,829,684,145,0.82509,0.17491,1.567948,139,6,831,685,146,0.824308,0.175692,1.551581,140,6,1, merged,1,1,0
21071,1000327,3,456,355,101,0.778509,0.221491,2.275295,75,26,459,358,101,0.779956,0.220044,2.265257,75,26,-1, merged,0,0,0.153026370432
21074,1000121,2,831,685,146,0.824308,0.175692,1.527079,140,6,832,686,146,0.824519,0.175481,1.528037,140,6,1, merged,0,0,0.567238419846
21074,1000328,1,397,279,118,0.702771,0.297229,0.702771,108,10,398,280,118,0.703518,0.296482,0.703518,108,10,1, merged,0,0,0.602783576896
21081,1000327,2,461,360,101,0.780911,0.219089,1.537009,75,26,462,361,101,0.781385,0.218615,1.54329,75,26,1, merged,0,0,0.298242260401
21082,1000070,2,542,493,49,0.909594,0.090406,1.66398,38,11,543,494,49,0.909761,0.090239,1.664624,38,11,1, merged,0,0,0
21085,1000004,1,1101,947,154,0.860127,0.139873,0.860127,125,29,1104,948,156,0.858696,0.141304,0.858696,127,29,1, abandoned,1,1,0
21087,1000328,2,398,280,118,0.703518,0.296482,1.43079,108,10,399,281,118,0.704261,0.295739,1.435295,108,10,-1, abandoned,0,0,0
21126,1000004,1,1105,948,157,0.857919,0.142081,0.857919,128,29,1106,949,157,0.858047,0.141953,0.858047,128,29,1, merged,0,0,0
21126,1000121,2,832,686,146,0.824519,0.175481,1.682438,140,6,833,687,146,0.82473,0.17527,1.682777,140,6,1, merged,0,0,0
21128,1000070,1,543,494,49,0.909761,0.090239,0.909761,38,11,545,495,50,0.908257,0.091743,0.908257,39,11,1, merged,1,1,0.0812685833707
21128,1000329,2,1194,895,299,0.749581,0.250419,1.659342,269,30,1196,897,299,0.75,0.25,1.658257,269,30,-1, merged,0,0,0.0679033862562
21132,1000004,1,1106,949,157,0.858047,0.141953,0.858047,128,29,1108,950,158,0.857401,0.142599,0.857401,129,29,1, merged,1,1,0.198553188042
21132,1000070,2,545,495,50,0.908257,0.091743,1.766304,39,11,547,496,51,0.906764,0.093236,1.764165,40,11,1, merged,1,1,0.366433868658
21133,1000004,1,1108,950,158,0.857401,0.142599,0.857401,129,29,1110,951,159,0.856757,0.143243,0.856757,130,29,1, merged,1,1,0.402480225928
21133,1000070,2,547,496,51,0.906764,0.093236,1.764165,40,11,549,497,52,0.905282,0.094718,1.762039,41,11,1, merged,1,1,0.72947845805
21138,1000070,2,552,500,52,0.905797,0.094203,1.655797,41,11,553,500,53,0.904159,0.095841,1.654368,41,12,-1, merged,1,1,0.745247855906
21138,1000329,1,1196,897,299,0.75,0.25,0.75,269,30,1197,898,299,0.750209,0.249791,0.750209,269,30,-1, merged,0,0,0.62361614439
21142,1000070,2,553,500,53,0.904159,0.095841,1.744923,41,12,554,501,53,0.904332,0.095668,1.747099,41,12,1, merged,0,0,0.746137132449
21160,1000109,2,320,267,53,0.834375,0.165625,1.611626,51,2,321,268,53,0.834891,0.165109,1.613193,51,2,1, merged,0,0,0.00341710105555
21166,1000070,1,554,501,53,0.904332,0.095668,0.904332,41,12,555,501,54,0.902703,0.097297,0.902703,42,12,1, abandoned,1,1,0.0930100174842
21166,1000329,2,1197,898,299,0.750209,0.249791,1.654541,269,30,1198,899,299,0.750417,0.249583,1.65312,269,30,-1, abandoned,0,0,0.057945440182
21170,1000070,1,556,502,54,0.902878,0.097122,0.902878,42,12,557,503,54,0.903052,0.096948,0.903052,42,12,1, merged,0,0,0.758520449858
21178,1000327,2,462,361,101,0.781385,0.218615,1.54329,75,26,463,362,101,0.781857,0.218143,1.549299,75,26,1, merged,0,0,0.303317625747
21188,1000329,1,1198,899,299,0.750417,0.249583,0.750417,269,30,1199,900,299,0.750626,0.249374,0.750626,269,30,1, merged,0,0,0
21193,1000004,2,1110,951,159,0.856757,0.143243,1.607382,130,29,1111,951,160,0.855986,0.144014,1.606819,131,29,1, abandoned,1,1,0
21193,1000328,3,400,282,118,0.705,0.295,2.312382,108,10,403,284,119,0.704715,0.295285,2.311534,109,10,-1, abandoned,1,0,0
21193,1000329,1,1199,900,299,0.750626,0.249374,0.750626,269,30,1200,901,299,0.750833,0.249167,0.750833,269,30,-1, abandoned,0,0,0
21196,1000329,2,1200,901,299,0.750833,0.249167,1.588043,269,30,1201,902,299,0.751041,0.248959,1.59195,269,30,1, merged,0,0,0.91650341678
21199,1000004,1,1113,953,160,0.856244,0.143756,0.856244,131,29,1114,953,161,0.855476,0.144524,0.855476,131,30,-1, merged,1,1,0
21199,1000329,2,1201,902,299,0.751041,0.248959,1.607285,269,30,1202,902,300,0.750416,0.249584,1.605892,269,31,-1, merged,1,1,0
21201,1000004,1,1114,953,161,0.855476,0.144524,0.855476,131,30,1117,954,163,0.854073,0.145927,0.854073,133,30,-1, abandoned,1,0,0
21204,1000121,1,836,690,146,0.825359,0.174641,0.825359,140,6,838,691,147,0.824582,0.175418,0.824582,141,6,1, merged,1,1,0.0113542526837
21204,1000329,2,1202,902,300,0.750416,0.249584,1.575775,269,31,1204,904,300,0.750831,0.249169,1.575413,269,31,-1, merged,0,0,0.0328588626868
21207,1000003,2,689,579,110,0.840348,0.159652,1.560348,103,7,690,579,111,0.83913,0.16087,1.553416,104,7,1, merged,1,1,0.149984993649
21215,1000063,2,1820,1630,190,0.895604,0.104396,1.77786,163,27,1823,1633,190,0.895776,0.104224,1.776571,163,27,-1, merged,0,0,0.127056781291
21215,1000118,1,603,532,71,0.882255,0.117745,0.882255,69,2,604,532,72,0.880795,0.119205,0.880795,70,2,1, merged,1,1,0.169310383011
21217,1000327,2,463,362,101,0.781857,0.218143,1.476773,75,26,464,363,101,0.782328,0.217672,1.482328,75,26,-1, abandoned,0,0,0.0570095430989
21224,1000091,2,246,187,59,0.760163,0.239837,1.584745,53,6,247,188,59,0.761134,0.238866,1.584733,53,6,-1, abandoned,0,0,0
21224,1000121,1,838,691,147,0.824582,0.175418,0.824582,141,6,839,691,148,0.8236,0.1764,0.8236,142,6,1, abandoned,1,1,0
21229,1000121,3,839,691,148,0.8236,0.1764,2.39283,142,6,840,692,148,0.82381,0.17619,2.442857,142,6,1, merged,0,0,0.458803060909
21230,1000014,1,840,723,117,0.860714,0.139286,0.860714,107,10,841,724,117,0.86088,0.13912,0.86088,107,10,1, merged,0,0,0.0464502723696
21230,1000043,2,235,194,41,0.825532,0.174468,1.686246,36,5,236,195,41,0.826271,0.173729,1.687151,36,5,1, merged,0,0,0.0392401865923
21250,1000063,2,1823,1633,190,0.895776,0.104224,1.626811,163,27,1824,1634,190,0.895833,0.104167,1.621861,163,27,-1, abandoned,0,0,0.0944799010523
21251,1000329,1,1204,904,300,0.750831,0.249169,0.750831,269,31,1206,906,300,0.751244,0.248756,0.751244,269,31,1, merged,0,0,0.840169724601
21252,1000329,1,1206,906,300,0.751244,0.248756,0.751244,269,31,1208,907,301,0.750828,0.249172,0.750828,270,31,1, merged,1,1,0.203642436615
21253,1000003,2,690,579,111,0.83913,0.16087,1.590374,104,7,692,581,111,0.839595,0.160405,1.58712,104,7,-1, merged,0,0,0.0531173107245
21255,1000009,2,474,397,77,0.837553,0.162447,1.755506,69,8,475,398,77,0.837895,0.162105,1.755928,69,8,1, merged,0,0,0
21255,1000015,1,1036,951,85,0.917954,0.082046,0.917954,76,9,1037,952,85,0.918033,0.081967,0.918033,76,9,1, merged,0,0,0
21267,1000327,4,465,364,101,0.782796,0.217204,2.771031,75,26,466,365,101,0.783262,0.216738,2.887035,75,26,1, merged,0,0,0.608836930456
21276,1000327,3,466,365,101,0.783262,0.216738,2.175704,75,26,468,366,102,0.782051,0.217949,2.121182,76,26,1, merged,1,1,0.0599164539057
21283,1000070,2,562,506,56,0.900356,0.099644,1.650563,44,12,564,507,57,0.898936,0.101064,1.64873,45,12,1, merged,1,1,0.0622657341655
21283,1000329,1,1209,907,302,0.750207,0.249793,0.750207,270,32,1211,908,303,0.749794,0.250206,0.749794,271,32,-1, merged,1,0,0.0388102572239
21289,1000121,2,843,695,148,0.824437,0.175563,1.565816,142,6,844,696,148,0.824645,0.175355,1.570407,142,6,-1, abandoned,0,0,0
21292,1000005,2,171,127,44,0.74269,0.25731,1.397452,42,2,172,128,44,0.744186,0.255814,1.40301,42,2,-1, abandoned,0,0,0.124257657219
21306,1000329,1,1212,909,303,0.75,0.25,0.75,271,32,1213,910,303,0.750206,0.249794,0.750206,271,32,1, merged,0,0,0
21309,1000121,3,844,696,148,0.824645,0.175355,2.278554,142,6,845,697,148,0.824852,0.175148,2.279697,142,6,1, merged,0,0,0.211603081231
21309,1000328,1,405,285,120,0.703704,0.296296,0.703704,110,10,406,286,120,0.704433,0.295567,0.704433,110,10,1, merged,0,0,0.389404306526
21309,1000329,2,1213,910,303,0.750206,0.249794,1.45391,271,32,1214,911,303,0.750412,0.249588,1.454845,271,32,1, merged,0,0,0.304677170676
21310,1000070,2,564,507,57,0.898936,0.101064,1.649348,45,12,565,508,57,0.899115,0.100885,1.648909,45,12,-1, abandoned,0,0,0.580898283035
21310,1000329,1,1214,911,303,0.750412,0.249588,0.750412,271,32,1215,911,304,0.749794,0.250206,0.749794,272,32,1, abandoned,1,1,0.925434936682
21312,1000004,2,1124,959,165,0.853203,0.146797,1.602997,135,30,1127,962,165,0.853594,0.146406,1.603594,135,30,-1, merged,0,0,0.149206469427
21312,1000329,1,1215,911,304,0.749794,0.250206,0.749794,272,32,1216,912,304,0.75,0.25,0.75,272,32,-1, merged,0,0,0.285643017261
21313,1000004,3,1127,962,165,0.853594,0.146406,2.424221,135,30,1129,964,165,0.853853,0.146147,2.421023,135,30,-1, abandoned,0,0,0.451821681053
21313,1000328,4,406,286,120,0.704433,0.295567,3.128655,110,10,407,287,120,0.70516,0.29484,3.126182,110,10,-1, abandoned,0,0,1.03597426531
21313,1000329,1,1216,912,304,0.75,0.25,0.75,272,32,1217,913,304,0.750205,0.249795,0.750205,272,32,-1, abandoned,0,0,0.876525769856
21313,1000592,2,223,183,40,0.820628,0.179372,1.570628,28,12,224,183,41,0.816964,0.183036,1.56717,29,12,1, abandoned,1,1,0.779595387215
21317,1000327,4,468,366,102,0.782051,0.217949,2.954246,76,26,470,367,103,0.780851,0.219149,2.923975,77,26,1, merged,1,1,0
21318,1000014,2,847,730,117,0.861865,0.138135,1.686717,107,10,848,731,117,0.862028,0.137972,1.687294,107,10,1, merged,0,0,0.0293507415863
21318,1000121,1,845,697,148,0.824852,0.175148,0.824852,142,6,847,699,148,0.825266,0.174734,0.825266,142,6,1, merged,0,0,0.0389701719027
21323,1000004,6,1130,965,165,0.853982,0.146018,4.965359,135,30,1131,966,165,0.854111,0.145889,4.953279,135,30,-1, merged,0,0,0.0315164084759
21323,1000063,3,1824,1634,190,0.895833,0.104167,2.535701,163,27,1825,1635,190,0.89589,0.10411,2.524462,163,27,-1, merged,0,0,0.053920546091
21323,1000121,5,847,699,148,0.825266,0.174734,4.111377,142,6,850,701,149,0.824706,0.175294,4.099168,143,6,-1, merged,1,0,0.0418476364805
21323,1000124,2,291,272,19,0.934708,0.065292,1.639868,17,2,294,273,21,0.928571,0.071429,1.628571,19,2,-1, merged,1,0,0.0117870511169
21323,1000328,1,407,287,120,0.70516,0.29484,0.70516,110,10,410,287,123,0.7,0.3,0.7,113,10,1, merged,1,1,0.0750641724547
21323,1000329,4,1218,914,304,0.750411,0.249589,3.286111,272,32,1220,915,305,0.75,0.25,3.274462,273,32,-1, merged,1,0,0.0564893356682
21325,1000004,1,1131,966,165,0.854111,0.145889,0.854111,135,30,1136,970,166,0.853873,0.146127,0.853873,136,30,-1, merged,1,0,0.0675909836982
21325,1000043,4,237,196,41,0.827004,0.172996,3.305717,36,5,238,197,41,0.827731,0.172269,3.291142,36,5,1, merged,0,0,0.12225514197
21325,1000327,2,470,367,103,0.780851,0.219149,1.634962,77,26,471,368,103,0.781316,0.218684,1.63519,77,26,-1, merged,0,0,0.100766199257
21326,1000004,3,1136,970,166,0.853873,0.146127,2.462921,136,30,1137,971,166,0.854002,0.145998,2.462829,136,30,1, merged,0,0,0.45553640708
21326,1000043,2,238,197,41,0.827731,0.172269,1.609047,36,5,240,199,41,0.829167,0.170833,1.608828,36,5,1, merged,0,0,0.61441043619
21326,1000327,1,471,368,103,0.781316,0.218684,0.781316,77,26,472,368,104,0.779661,0.220339,0.779661,78,26,1, merged,1,1,0.681173153998
21328,1000043,2,240,199,41,0.829167,0.170833,1.72846,36,5,242,200,42,0.826446,0.173554,1.722756,37,5,1, merged,1,1,0.576885014138
21328,1000070,1,566,509,57,0.899293,0.100707,0.899293,45,12,569,510,59,0.896309,0.103691,0.896309,47,12,-1, merged,1,0,0.60417710944
21335,1000121,3,850,701,149,0.824706,0.175294,2.393983,143,6,851,702,149,0.824912,0.175088,2.389774,143,6,1, merged,0,0,0.089422861351
21335,1000329,1,1220,915,305,0.75,0.25,0.75,273,32,1221,915,306,0.749386,0.250614,0.749386,274,32,1, merged,1,1,0.106605230225
21336,1000329,2,1221,915,306,0.749386,0.250614,1.475413,274,32,1222,916,306,0.749591,0.250409,1.477482,274,32,-1, abandoned,0,0,0.0270059664098
21340,1000063,1,1825,1635,190,0.89589,0.10411,0.89589,163,27,1826,1635,191,0.8954,0.1046,0.8954,164,27,1, merged,1,1,0
21340,1000329,2,1222,916,306,0.749591,0.250409,1.645481,274,32,1224,917,307,0.749183,0.250817,1.644583,275,32,1, merged,1,1,0
21344,1000121,3,851,702,149,0.824912,0.175088,2.353961,143,6,853,703,150,0.82415,0.17585,2.349973,144,6,1, merged,1,1,0.321532498608
21344,1000327,2,472,368,104,0.779661,0.220339,1.529049,78,26,475,369,106,0.776842,0.223158,1.525823,80,26,1, merged,1,1,0.347072671694
21344,1000329,1,1225,918,307,0.749388,0.250612,0.749388,275,32,1227,919,308,0.748981,0.251019,0.748981,276,32,-1, merged,1,0,0.459425741531
21345,1000121,2,853,703,150,0.82415,0.17585,1.573131,144,6,854,703,151,0.823185,0.176815,1.572371,145,6,1, abandoned,1,1,0.191301550285
21345,1000327,3,475,369,106,0.776842,0.223158,2.349973,80,26,476,369,107,0.77521,0.22479,2.347581,81,26,1, abandoned,1,1,0.201979166549
21345,1000329,1,1227,919,308,0.748981,0.251019,0.748981,276,32,1228,920,308,0.749186,0.250814,0.749186,276,32,-1, abandoned,0,0,0.203409432609
21346,1000121,2,854,703,151,0.823185,0.176815,1.751999,145,6,855,703,152,0.822222,0.177778,1.744781,146,6,1, abandoned,1,1,0
21346,1000124,1,295,274,21,0.928814,0.071186,0.928814,19,2,297,274,23,0.922559,0.077441,0.922559,21,2,1, abandoned,1,1,0
21347,1000004,4,1137,971,166,0.854002,0.145998,3.343521,136,30,1138,971,167,0.853251,0.146749,3.339773,137,30,1, merged,1,1,0.0189190231359
21347,1000015,2,1038,953,85,0.918112,0.081888,1.667297,76,9,1039,953,86,0.917228,0.082772,1.666009,77,9,1, merged,1,1,0
21347,1000121,3,855,703,152,0.822222,0.177778,2.48952,146,6,858,704,154,0.820513,0.179487,2.486521,148,6,1, merged,1,1,0.0181905455916
21347,1000327,5,476,369,107,0.77521,0.22479,4.118731,81,26,477,369,108,0.773585,0.226415,4.113358,82,26,1, merged,1,1,0.0177416909733
21347,1000329,1,1228,920,308,0.749186,0.250814,0.749186,276,32,1230,921,309,0.74878,0.25122,0.74878,277,32,-1, merged,1,0,0.0423508334834
21351,1000026,2,220,201,19,0.913636,0.086364,1.834333,17,2,221,202,19,0.914027,0.085973,1.834877,17,2,1, merged,0,0,0.470852324521
21351,1000153,1,517,476,41,0.920696,0.079304,0.920696,32,9,518,477,41,0.920849,0.079151,0.920849,32,9,1, merged,0,0,1.10978994944
21353,1000004,1,1138,971,167,0.853251,0.146749,0.853251,137,30,1141,974,167,0.853637,0.146363,0.853637,137,30,-1, merged,0,0,0.451605430968
21362,1000328,1,410,287,123,0.7,0.3,0.7,113,10,411,288,123,0.70073,0.29927,0.70073,113,10,-1, abandoned,0,0,0.0325118008808
21375,1000118,3,606,534,72,0.881188,0.118812,2.420296,70,2,607,535,72,0.881384,0.118616,2.415857,70,2,1, merged,0,0,0.0266917285381
21377,1000329,2,1230,921,309,0.74878,0.25122,1.407604,277,32,1231,922,309,0.748985,0.251015,1.411775,277,32,-1, abandoned,0,0,0.0329662719025
21388,1000009,1,476,399,77,0.838235,0.161765,0.838235,69,8,477,400,77,0.838574,0.161426,0.838574,69,8,1, merged,0,0,0
21390,1000003,1,696,585,111,0.840517,0.159483,0.840517,104,7,699,588,111,0.841202,0.158798,0.841202,104,7,-1, merged,0,0,0.228005125497
21390,1000015,2,1039,953,86,0.917228,0.082772,1.757745,77,9,1040,954,86,0.917308,0.082692,1.758509,77,9,1, merged,0,0,0.258443894835
21391,1000054,1,45,40,5,0.888889,0.111111,0.888889,3,2,46,41,5,0.891304,0.108696,0.891304,3,2,1, merged,0,0,0.0502217544026
21393,1000014,1,850,732,118,0.861176,0.138824,0.861176,108,10,851,733,118,0.86134,0.13866,0.86134,108,10,-1, merged,0,0,0.177064512159
21393,1000327,2,477,369,108,0.773585,0.226415,1.634761,82,26,481,373,108,0.775468,0.224532,1.636807,82,26,-1, merged,0,0,0.192527377458
21407,1000199,1,204,163,41,0.79902,0.20098,0.79902,39,2,205,164,41,0.8,0.2,0.8,39,2,1, merged,0,0,0.243948692679
21412,1000124,2,297,274,23,0.922559,0.077441,1.577731,21,2,298,275,23,0.922819,0.077181,1.589485,21,2,1, merged,0,0,0.663188809027
21420,1000124,2,298,275,23,0.922819,0.077181,1.698287,21,2,300,277,23,0.923333,0.076667,1.69766,21,2,-1, merged,0,0,0.316544693909
21420,1000327,1,481,373,108,0.775468,0.224532,0.775468,82,26,483,374,109,0.774327,0.225673,0.774327,83,26,1, merged,1,1,0.701253709699
21421,1000199,1,205,164,41,0.8,0.2,0.8,39,2,207,166,41,0.801932,0.198068,0.801932,39,2,-1, merged,0,0,0.0225016977485
21424,1000327,2,483,374,109,0.774327,0.225673,1.374327,83,26,484,375,109,0.774793,0.225207,1.399793,83,26,1, merged,0,0,0.0604770690397
21430,1000004,2,1146,978,168,0.853403,0.146597,1.602388,137,31,1147,979,168,0.853531,0.146469,1.602719,137,31,1, merged,0,0,0.0337468240921
21430,1000329,1,1231,922,309,0.748985,0.251015,0.748985,277,32,1232,923,309,0.749188,0.250812,0.749188,277,32,1, merged,0,0,0.0171028037383
21431,1000124,2,300,277,23,0.923333,0.076667,1.59,21,2,302,278,24,0.92053,0.07947,1.576268,22,2,1, merged,1,1,0.0489288425486
21433,1000120,1,338,299,39,0.884615,0.115385,0.884615,37,2,340,300,40,0.882353,0.117647,0.882353,38,2,1, merged,1,1,0.00783035414078
21434,1000120,1,340,300,40,0.882353,0.117647,0.882353,38,2,341,300,41,0.879765,0.120235,0.879765,39,2,1, merged,1,1,0.0239869763685
21435,1000120,1,341,300,41,0.879765,0.120235,0.879765,39,2,342,300,42,0.877193,0.122807,0.877193,40,2,1, merged,1,1,0
21436,1000004,2,1147,979,168,0.853531,0.146469,1.730724,137,31,1148,980,168,0.853659,0.146341,1.728294,137,31,1, merged,0,0,0.0822524490826
21436,1000120,1,342,300,42,0.877193,0.122807,0.877193,40,2,343,300,43,0.874636,0.125364,0.874636,41,2,1, merged,1,1,0.0885073453451
21437,1000004,2,1148,980,168,0.853659,0.146341,1.728294,137,31,1149,981,168,0.853786,0.146214,1.725879,137,31,1, merged,0,0,0.0432808536039
21437,1000120,1,343,300,43,0.874636,0.125364,0.874636,41,2,344,300,44,0.872093,0.127907,0.872093,42,2,1, merged,1,1,0.125659382065
21438,1000004,1,1149,981,168,0.853786,0.146214,0.853786,137,31,1150,981,169,0.853043,0.146957,0.853043,138,31,1, merged,1,1,0.0229816019951
21438,1000120,2,344,300,44,0.872093,0.127907,1.725879,42,2,345,300,45,0.869565,0.130435,1.722609,43,2,1, merged,1,1,0.0261385972871
21439,1000120,1,345,300,45,0.869565,0.130435,0.869565,43,2,347,300,47,0.864553,0.135447,0.864553,45,2,1, merged,1,1,0.0575241470523
21442,1000120,1,352,300,52,0.852273,0.147727,0.852273,50,2,355,300,55,0.84507,0.15493,0.84507,53,2,1, merged,1,1,0.183019167637
21443,1000120,1,355,300,55,0.84507,0.15493,0.84507,53,2,358,300,58,0.837989,0.162011,0.837989,56,2,1, merged,1,1,0.185846560847
21444,1000120,1,358,300,58,0.837989,0.162011,0.837989,56,2,361,300,61,0.831025,0.168975,0.831025,59,2,1, merged,1,1,0.0629016379369
21446,1000014,2,851,733,118,0.86134,0.13866,1.712168,108,10,852,734,118,0.861502,0.138498,1.713151,108,10,1, merged,0,0,0.105917327145
21451,1000199,2,207,166,41,0.801932,0.198068,1.581275,39,2,211,169,42,0.800948,0.199052,1.575141,40,2,1, merged,1,1,0.0406220620495
21452,1000070,1,569,510,59,0.896309,0.103691,0.896309,47,12,570,510,60,0.894737,0.105263,0.894737,48,12,1, abandoned,1,1,0.245204455002
21458,1000153,2,518,477,41,0.920849,0.079151,1.620849,32,9,519,478,41,0.921002,0.078998,1.557366,32,9,-1, abandoned,0,0,0.554597789544
21459,1000070,3,570,510,60,0.894737,0.105263,2.264418,48,12,571,511,60,0.894921,0.105079,2.29198,48,12,1, merged,0,0,0.728617610837
21459,1000327,4,484,375,109,0.774793,0.225207,3.039211,83,26,485,376,109,0.775258,0.224742,3.067238,83,26,1, merged,0,0,0.609569854665
21462,1000004,2,1151,982,169,0.853171,0.146829,1.603171,138,31,1153,984,169,0.853426,0.146574,1.593426,138,31,-1, merged,0,0,0.224386687871
21463,1000004,2,1153,984,169,0.853426,0.146574,1.19958,138,31,1155,986,169,0.85368,0.14632,1.21217,138,31,-1, merged,0,0,0.0397469296613
21472,1000004,1,1157,988,169,0.853933,0.146067,0.853933,138,31,1159,990,169,0.854185,0.145815,0.854185,138,31,-1, merged,0,0,0.0263748879817
21472,1000121,4,864,709,155,0.820602,0.179398,3.263126,149,6,865,710,155,0.820809,0.179191,3.264873,149,6,1, merged,0,0,0.0273124192259
21472,1000327,3,485,376,109,0.775258,0.224742,2.442524,83,26,486,377,109,0.77572,0.22428,2.444064,83,26,1, merged,0,0,0.0206583357163
21472,1000592,2,225,183,42,0.813333,0.186667,1.667266,29,13,226,184,42,0.814159,0.185841,1.668344,29,13,1, merged,0,0,0.0180396153687
21475,1000043,2,246,204,42,0.829268,0.170732,1.643428,37,5,247,205,42,0.82996,0.17004,1.644937,37,5,1, merged,0,0,0.0257402138699
21475,1000592,1,226,184,42,0.814159,0.185841,0.814159,29,13,227,185,42,0.814978,0.185022,0.814978,29,13,1, merged,0,0,0.0435682721246
21480,1000592,2,228,186,42,0.815789,0.184211,1.622241,29,13,229,187,42,0.816594,0.183406,1.629094,29,13,1, merged,0,0,0.391255793314
21482,1000592,2,229,187,42,0.816594,0.183406,1.629094,29,13,230,188,42,0.817391,0.182609,1.635573,29,13,1, merged,0,0,0.0998980632008
21483,1000004,2,1161,992,169,0.854436,0.145564,1.721102,138,31,1162,993,169,0.854561,0.145439,1.725529,138,31,1, merged,0,0,0.226399891598
21483,1000592,3,230,188,42,0.817391,0.182609,2.538494,29,13,231,189,42,0.818182,0.181818,2.543711,29,13,1, merged,0,0,0.392941776534
21492,1000118,2,607,535,72,0.881384,0.118616,1.481384,70,2,608,536,72,0.881579,0.118421,1.496964,70,2,1, merged,0,0,0.251356976062
21496,1000004,2,1162,993,169,0.854561,0.145439,1.725529,138,31,1163,994,169,0.854686,0.145314,1.729686,138,31,1, merged,0,0,0.0227600753692
21496,1000592,3,231,189,42,0.818182,0.181818,2.543711,29,13,232,190,42,0.818966,0.181034,2.548652,29,13,1, merged,0,0,0.0503189957505
21517,1000153,2,519,478,41,0.921002,0.078998,1.456716,32,9,520,479,41,0.921154,0.078846,1.472878,32,9,1, merged,0,0,1.08133950918
21517,1000534,1,28,15,13,0.535714,0.464286,0.535714,13,0,29,16,13,0.551724,0.448276,0.551724,13,0,1, merged,0,0,1.36393442623
21518,1000091,3,247,188,59,0.761134,0.238866,2.29834,53,6,248,189,59,0.762097,0.237903,2.298186,53,6,-1, merged,0,0,0.512734060549
21518,1000328,4,411,288,123,0.70073,0.29927,2.99907,113,10,413,289,124,0.699758,0.300242,2.997944,114,10,1, merged,1,1,0.972884584342
21518,1000329,1,1232,923,309,0.749188,0.250812,0.749188,277,32,1233,924,309,0.749392,0.250608,0.749392,277,32,-1, merged,0,0,0.840859304095
21522,1000124,2,302,278,24,0.92053,0.07947,1.565691,22,2,303,279,24,0.920792,0.079208,1.571586,22,2,1, merged,0,0,0.494574117543
21523,1000124,2,303,279,24,0.920792,0.079208,1.571586,22,2,304,280,24,0.921053,0.078947,1.577303,22,2,1, merged,0,0,0.239802658893
21532,1000014,2,856,737,119,0.860981,0.139019,1.791751,109,10,861,741,120,0.860627,0.139373,1.77792,110,10,1, merged,1,1,0.0337441687667
21538,1000004,2,1163,994,169,0.854686,0.145314,1.638126,138,31,1165,996,169,0.854936,0.145064,1.639746,138,31,-1, merged,0,0,0.00951782832155
21539,1000091,2,248,189,59,0.762097,0.237903,1.546907,53,6,249,190,59,0.763052,0.236948,1.545661,53,6,-1, merged,0,0,0.258016363498
21541,1000091,1,249,190,59,0.763052,0.236948,0.763052,53,6,250,191,59,0.764,0.236,0.764,53,6,-1, merged,0,0,0.0482032126108
21543,1000023,2,255,227,28,0.890196,0.109804,1.785596,25,3,256,228,28,0.890625,0.109375,1.786139,25,3,1, merged,0,0,0.000243409159981
21543,1000063,1,1826,1635,191,0.8954,0.1046,0.8954,164,27,1828,1637,191,0.895514,0.104486,0.895514,164,27,-1, merged,0,0,0.00039352083503
21546,1000007,1,514,438,76,0.85214,0.14786,0.85214,66,10,515,438,77,0.850485,0.149515,0.850485,67,10,1, merged,1,1,0.644933075965
21546,1000014,3,863,743,120,0.86095,0.13905,2.462482,110,10,864,744,120,0.861111,0.138889,2.459775,110,10,1, merged,0,0,0.35351999593
21546,1000329,2,1233,924,309,0.749392,0.250608,1.601532,277,32,1235,924,311,0.748178,0.251822,1.598664,279,32,1, merged,1,1,0.280314068689
21554,1000054,2,46,41,5,0.891304,0.108696,1.772883,3,2,47,42,5,0.893617,0.106383,1.77539,3,2,1, merged,0,0,0.259231209895
21554,1000118,1,608,536,72,0.881579,0.118421,0.881579,70,2,609,537,72,0.881773,0.118227,0.881773,70,2,1, merged,0,0,0.125635164215
21557,1000109,2,322,269,53,0.835404,0.164596,1.636352,51,2,323,270,53,0.835913,0.164087,1.6378,51,2,1, merged,0,0,0.117050884451
21557,1000199,1,211,169,42,0.800948,0.199052,0.800948,40,2,212,170,42,0.801887,0.198113,0.801887,40,2,-1, merged,0,0,0.120400771646
21572,1000023,2,256,228,28,0.890625,0.109375,1.638803,25,3,257,229,28,0.891051,0.108949,1.638827,25,3,1, merged,0,0,0.134308789885
21572,1000329,1,1235,924,311,0.748178,0.251822,0.748178,279,32,1237,925,312,0.747777,0.252223,0.747777,280,32,1, merged,1,1,0.0387242851359
21573,1000063,4,1828,1637,191,0.895514,0.104486,3.197847,164,27,1830,1639,191,0.895628,0.104372,3.172959,164,27,-1, merged,0,0,1.18423895941e-11
21573,1000121,3,867,712,155,0.821223,0.178777,2.302333,149,6,868,712,156,0.820276,0.179724,2.277331,150,6,1, merged,1,1,0.000204530346656
21573,1000329,2,1237,925,312,0.747777,0.252223,1.48111,280,32,1239,926,313,0.747377,0.252623,1.457054,281,32,-1, merged,1,0,0.000409962074202
21576,1000014,2,864,744,120,0.861111,0.138889,1.724747,110,10,865,745,120,0.861272,0.138728,1.727938,110,10,1, merged,0,0,0.651275845521
21579,1000592,2,232,190,42,0.818966,0.181034,1.528643,29,13,233,191,42,0.819742,0.180258,1.534028,29,13,1, merged,0,0,0.0945862806688
21588,1000004,1,1174,1004,170,0.855196,0.144804,0.855196,139,31,1177,1005,172,0.853866,0.146134,0.853866,141,31,1, merged,1,1,0.464048915285
21597,1000004,1,1180,1007,173,0.85339,0.14661,0.85339,142,31,1181,1008,173,0.853514,0.146486,0.853514,142,31,-1, abandoned,0,0,0
21597,1000329,2,1239,926,313,0.747377,0.252623,1.600767,281,32,1240,927,313,0.747581,0.252419,1.601095,281,32,-1, abandoned,0,0,0
21598,1000121,4,869,713,156,0.820483,0.179517,3.220662,150,6,871,713,158,0.818599,0.181401,3.200619,152,6,1, merged,1,1,0.644797601613
21598,1000327,2,486,377,109,0.77572,0.22428,1.617304,83,26,488,378,110,0.77459,0.22541,1.607923,84,26,1, merged,1,1,0.696999382005
21602,1000121,1,871,713,158,0.818599,0.181401,0.818599,152,6,874,715,159,0.818078,0.181922,0.818078,153,6,-1, merged,1,0,0.0711257833241
21602,1000329,3,1242,929,313,0.747987,0.252013,2.354741,281,32,1243,930,313,0.74819,0.25181,2.354904,281,32,1, merged,0,0,0.0768453939112
21605,1000327,3,488,378,110,0.77459,0.22541,2.297808,84,26,489,379,110,0.775051,0.224949,2.295753,84,26,-1, abandoned,0,0,0.285610267837
21607,1000014,2,865,745,120,0.861272,0.138728,1.861272,110,10,870,748,122,0.85977,0.14023,1.776437,112,10,-1, merged,1,0,0
21607,1000121,4,874,715,159,0.818078,0.181922,3.497531,153,6,875,716,159,0.818286,0.181714,3.428056,153,6,-1, merged,0,0,0
21614,1000004,2,1182,1009,173,0.853638,0.146362,1.60203,142,31,1184,1011,173,0.853885,0.146115,1.601676,142,31,-1, merged,0,0,0.0408163265306
21614,1000329,1,1244,931,313,0.748392,0.251608,0.748392,281,32,1245,931,314,0.747791,0.252209,0.747791,282,32,1, merged,1,1,0.0354030501089
21617,1000004,2,1184,1011,173,0.853885,0.146115,1.601676,142,31,1185,1012,173,0.854008,0.145992,1.601199,142,31,1, merged,0,0,0.0411101216978
21617,1000329,1,1245,931,314,0.747791,0.252209,0.747791,282,32,1246,931,315,0.747191,0.252809,0.747191,283,32,1, merged,1,1,0.036212647199
21620,1000118,2,609,537,72,0.881773,0.118227,1.774081,70,2,610,538,72,0.881967,0.118033,1.775097,70,2,1, merged,0,0,0.0712674588748
21640,1000121,1,876,717,159,0.818493,0.181507,0.818493,153,6,877,718,159,0.8187,0.1813,0.8187,153,6,1, merged,0,0,0.0203002356036
21641,1000014,2,871,749,122,0.859931,0.140069,1.750982,112,10,872,750,122,0.860092,0.139908,1.751565,112,10,1, merged,0,0,0.0299707237207
21641,1000023,1,257,229,28,0.891051,0.108949,0.891051,25,3,258,230,28,0.891473,0.108527,0.891473,25,3,1, merged,0,0,0.0108748960506
21643,1000004,1,1185,1012,173,0.854008,0.145992,0.854008,142,31,1189,1015,174,0.853659,0.146341,0.853659,143,31,-1, merged,1,0,0.0208898148797
21651,1000070,2,574,514,60,0.89547,0.10453,1.646428,48,12,575,515,60,0.895652,0.104348,1.647086,48,12,1, merged,0,0,0.855139924778
21655,1000329,2,1248,932,316,0.746795,0.253205,1.544775,284,32,1251,933,318,0.745803,0.254197,1.539773,286,32,1, merged,1,1,0.0887256570817
21660,1000014,2,872,750,122,0.860092,0.139908,1.678792,112,10,873,751,122,0.860252,0.139748,1.67802,112,10,-1, abandoned,0,0,0.0305445743692
21660,1000121,1,877,718,159,0.8187,0.1813,0.8187,153,6,878,718,160,0.817768,0.182232,0.817768,154,6,1, abandoned,1,1,0.0552072714917
21668,1000327,3,489,379,110,0.775051,0.224949,1.515051,84,26,490,380,110,0.77551,0.22449,1.853942,84,26,1, merged,0,0,0.101817243864
21669,1000327,2,490,380,110,0.77551,0.22449,0.77551,84,26,492,382,110,0.776423,0.223577,1.276423,84,26,-1, merged,0,0,0.610477855478
21675,1000329,2,1251,933,318,0.745803,0.254197,1.497237,286,32,1252,934,318,0.746006,0.253994,1.497915,286,32,1, merged,0,0,0.858375500584
21683,1000327,4,492,382,110,0.776423,0.223577,2.470239,84,26,494,383,111,0.775304,0.224696,2.437079,85,26,1, merged,1,1,0.0616315378612
21693,1000014,1,874,752,122,0.860412,0.139588,0.860412,112,10,883,755,128,0.85504,0.14496,0.85504,118,10,1, merged,1,1,0.0734924361537
21693,1000043,3,249,207,42,0.831325,0.168675,2.509505,37,5,252,208,44,0.825397,0.174603,2.497482,39,5,1, merged,1,1,0.0964855644267
21693,1000070,4,576,516,60,0.895833,0.104167,3.405338,48,12,577,517,60,0.896014,0.103986,3.393496,48,12,1, merged,0,0,0.0924775720387
21693,1000121,2,878,718,160,0.817768,0.182232,1.67818,154,6,880,719,161,0.817045,0.182955,1.672085,155,6,1, merged,1,1,0.0762814960149
21706,1000329,2,1253,935,318,0.746209,0.253791,1.520403,286,32,1254,936,318,0.746411,0.253589,1.521411,286,32,1, merged,0,0,0.908748766241
21719,1000026,1,221,202,19,0.914027,0.085973,0.914027,17,2,222,202,20,0.90991,0.09009,0.90991,18,2,1, merged,1,1,0.334098700539
21719,1000199,2,215,173,42,0.804651,0.195349,1.718678,40,2,217,175,42,0.806452,0.193548,1.716362,40,2,-1, merged,0,0,0.00584084484173
21733,1000327,2,494,383,111,0.775304,0.224696,1.58991,85,26,496,384,112,0.774194,0.225806,1.589836,85,27,-1, merged,1,1,0.683772038944
21736,1000004,3,1196,1021,175,0.853679,0.146321,2.464607,144,31,1197,1022,175,0.853801,0.146199,2.465222,144,31,1, merged,0,0,0.0539407710289
21736,1000329,1,1254,936,318,0.746411,0.253589,0.746411,286,32,1255,937,318,0.746614,0.253386,0.746614,286,32,-1, merged,0,0,0.0754227088308
21740,1000109,2,325,271,54,0.833846,0.166154,1.610102,52,2,326,272,54,0.834356,0.165644,1.611629,52,2,1, merged,0,0,0.0107226557184
21749,1000004,1,1198,1023,175,0.853923,0.146077,0.853923,144,31,1199,1024,175,0.854045,0.145955,0.854045,144,31,-1, merged,0,0,0.0146876542384
21749,1000070,3,578,518,60,0.896194,0.103806,2.398469,48,12,579,519,60,0.896373,0.103627,2.402592,48,12,1, merged,0,0,0.000978047435296
21751,1000121,2,880,719,161,0.817045,0.182955,1.535795,155,6,881,720,161,0.817253,0.182747,1.54033,155,6,1, merged,0,0,0.0900757634509
21753,1000329,2,1255,937,318,0.746614,0.253386,1.46969,286,32,1257,938,319,0.746221,0.253779,1.462639,287,32,1, merged,1,1,0.00162866449511
21754,1000014,3,883,755,128,0.85504,0.14496,2.317679,118,10,884,756,128,0.855204,0.144796,2.300239,118,10,1, merged,0,0,0
21754,1000329,1,1257,938,319,0.746221,0.253779,0.746221,287,32,1259,938,321,0.745036,0.254964,0.745036,289,32,1, merged,1,1,0.000814290784627
21757,1000121,2,881,720,161,0.817253,0.182747,1.517253,155,6,882,721,161,0.81746,0.18254,1.521686,155,6,1, merged,0,0,0.0902289791358
21761,1000118,2,610,538,72,0.881967,0.118033,1.563785,70,2,611,539,72,0.88216,0.11784,1.567554,70,2,1, merged,0,0,0.0187497371343
21770,1000121,2,882,721,161,0.81746,0.18254,1.484127,155,6,883,722,161,0.817667,0.182333,1.567667,155,6,1, merged,0,0,0.00528347896769
21777,1000003,1,712,601,111,0.844101,0.155899,0.844101,104,7,713,602,111,0.84432,0.15568,0.84432,104,7,-1, abandoned,0,0,0.228271090519
21777,1000009,2,482,404,78,0.838174,0.161826,1.682275,70,8,483,405,78,0.838509,0.161491,1.682829,70,8,-1, abandoned,0,0,0.296429250271
21781,1000014,2,886,758,128,0.85553,0.14447,1.607424,118,10,888,759,129,0.85473,0.14527,1.60756,119,10,1, merged,1,1,0.118120679533
21781,1000043,4,252,208,44,0.825397,0.174603,3.329194,39,5,253,208,45,0.822134,0.177866,3.326246,39,6,-1, merged,1,1,0.155341642248
21781,1000070,3,579,519,60,0.896373,0.103627,2.503797,48,12,580,520,60,0.896552,0.103448,2.504112,48,12,1, merged,0,0,0.149357037521
21789,1000003,2,713,602,111,0.84432,0.15568,1.761541,104,7,714,603,111,0.844538,0.155462,1.761838,104,7,1, merged,0,0,0.9261733911
21789,1000015,1,1051,964,87,0.917222,0.082778,0.917222,78,9,1052,965,87,0.9173,0.0827,0.9173,78,9,1, merged,0,0,1.03400652334
21795,1000003,2,714,603,111,0.844538,0.155462,1.761917,104,7,716,604,112,0.843575,0.156425,1.760084,105,7,1, merged,1,1,0.927005504422
21795,1000015,1,1053,966,87,0.917379,0.082621,0.917379,78,9,1054,966,88,0.916509,0.083491,0.916509,79,9,1, merged,1,1,1.03428632956
21798,1000003,2,716,604,112,0.843575,0.156425,1.760084,105,7,717,605,112,0.843794,0.156206,1.76046,105,7,-1, merged,0,0,0.981325794188
21798,1000015,1,1054,966,88,0.916509,0.083491,0.916509,79,9,1056,968,88,0.916667,0.083333,0.916667,79,9,-1, merged,0,0,0.957385874246
21801,1000327,3,496,384,112,0.774194,0.225806,2.367322,85,27,497,385,112,0.774648,0.225352,2.369449,85,27,1, merged,0,0,0.685866454953
21805,1000014,1,888,759,129,0.85473,0.14527,0.85473,119,10,889,760,129,0.854893,0.145107,0.854893,119,10,1, merged,0,0,0.245165648032
21806,1000327,3,497,385,112,0.774648,0.225352,1.835254,85,27,498,386,112,0.7751,0.2249,1.935815,85,27,1, merged,0,0,0.0622666296283
21809,1000121,2,883,722,161,0.817667,0.182333,1.612133,155,6,884,723,161,0.817873,0.182127,1.613149,155,6,1, merged,0,0,0.603580257664
21812,1000004,2,1199,1024,175,0.854045,0.145955,1.730757,144,31,1200,1025,175,0.854167,0.145833,1.732545,144,31,1, merged,0,0,0.0385402154112
21817,1000015,2,1056,968,88,0.916667,0.083333,1.85,79,9,1057,969,88,0.916746,0.083254,1.850569,79,9,1, merged,0,0,0.00179432705558
21818,1000014,1,890,761,129,0.855056,0.144944,0.855056,119,10,892,762,130,0.85426,0.14574,0.85426,120,10,1, merged,1,1,0
21818,1000121,2,884,723,161,0.817873,0.182127,1.672929,155,6,885,724,161,0.818079,0.181921,1.672339,155,6,1, merged,0,0,0.000812512695511
21826,1000007,1,522,445,77,0.85249,0.14751,0.85249,67,10,523,445,78,0.85086,0.14914,0.85086,68,10,1, merged,1,1,0.321472087264
21826,1000009,2,484,406,78,0.838843,0.161157,1.691333,70,8,485,407,78,0.839175,0.160825,1.690036,70,8,1, merged,0,0,0.302718288978
21830,1000327,3,498,386,112,0.7751,0.2249,1.940514,85,27,499,387,112,0.775551,0.224449,2.01693,85,27,1, merged,0,0,0.10463053714
21844,1000009,1,485,407,78,0.839175,0.160825,0.839175,70,8,486,408,78,0.839506,0.160494,0.839506,70,8,-1, merged,0,0,0.249016118871
21844,1000011,2,352,328,24,0.931818,0.068182,1.770993,22,2,355,331,24,0.932394,0.067606,1.771901,22,2,-1, merged,0,0,0.267311155342
21845,1000009,1,486,408,78,0.839506,0.160494,0.839506,70,8,488,410,78,0.840164,0.159836,0.840164,70,8,-1, merged,0,0,0.49899480304
21845,1000011,2,355,331,24,0.932394,0.067606,1.771901,22,2,356,331,25,0.929775,0.070225,1.769939,23,2,1, merged,1,1,0.535983323601
21846,1000009,1,488,410,78,0.840164,0.159836,0.840164,70,8,490,412,78,0.840816,0.159184,0.840816,70,8,-1, merged,0,0,0.0472674524958
21846,1000011,2,356,331,25,0.929775,0.070225,1.769939,23,2,357,332,25,0.929972,0.070028,1.770788,23,2,-1, merged,0,0,0.0516218504043
21849,1000329,1,1259,938,321,0.745036,0.254964,0.745036,289,32,1262,939,323,0.744057,0.255943,0.744057,291,32,1, merged,1,1,0
21858,1000004,2,1200,1025,175,0.854167,0.145833,1.354167,144,31,1201,1026,175,0.854288,0.145712,1.409844,144,31,1, merged,0,0,0.449428529097
21859,1000003,1,726,613,113,0.844353,0.155647,0.844353,106,7,727,614,113,0.844567,0.155433,0.844567,106,7,1, merged,0,0,0.533420910806
21864,1000329,3,1262,939,323,0.744057,0.255943,2.428606,291,32,1263,939,324,0.743468,0.256532,2.429208,292,32,1, abandoned,1,1,0
21864,1000592,2,233,191,42,0.819742,0.180258,1.684549,29,13,237,195,42,0.822785,0.177215,1.68574,29,13,-1, abandoned,0,0,0
21869,1000121,3,887,726,161,0.818489,0.181511,2.504229,155,6,889,727,162,0.817773,0.182227,2.498803,156,6,1, merged,1,1,0.0569731171894
21869,1000592,2,237,195,42,0.822785,0.177215,1.68574,29,13,238,195,43,0.819328,0.180672,1.68103,30,13,1, merged,1,1,0.0488017954287
21870,1000592,2,238,195,43,0.819328,0.180672,1.68103,30,13,240,196,44,0.816667,0.183333,1.676836,31,13,1, merged,1,1,0
21871,1000592,2,240,196,44,0.816667,0.183333,1.676836,31,13,243,196,47,0.806584,0.193416,1.665234,34,13,1, merged,1,1,0.571747149564
21872,1000329,3,1263,939,324,0.743468,0.256532,2.408702,292,32,1264,940,324,0.743671,0.256329,2.404895,292,32,-1, merged,0,0,0
21872,1000592,2,243,196,47,0.806584,0.193416,1.665234,34,13,245,197,48,0.804082,0.195918,1.661224,35,13,1, merged,1,1,0
21878,1000327,3,499,387,112,0.775551,0.224449,2.183597,85,27,500,388,112,0.776,0.224,2.210211,85,27,1, merged,0,0,0.209434794279
21879,1000327,3,500,388,112,0.776,0.224,2.210211,85,27,501,389,112,0.776447,0.223553,2.230545,85,27,1, merged,0,0,0.126131879273
21881,1000327,1,501,389,112,0.776447,0.223553,0.776447,85,27,503,390,113,0.775348,0.224652,0.775348,86,27,1, merged,1,1,0.0793485809006
21882,1000327,1,503,390,113,0.775348,0.224652,0.775348,86,27,506,391,115,0.772727,0.227273,0.772727,88,27,1, merged,1,1,0.127491019749
21883,1000004,1,1201,1026,175,0.854288,0.145712,0.854288,144,31,1202,1027,175,0.854409,0.145591,0.854409,144,31,1, merged,0,0,0.00288287955108
21885,1000592,2,245,197,48,0.804082,0.195918,1.579882,35,13,246,198,48,0.804878,0.195122,1.581474,35,13,1, merged,0,0,0.522416666667
21887,1000011,2,357,332,25,0.929972,0.070028,1.768682,23,2,358,333,25,0.930168,0.069832,1.769911,23,2,1, merged,0,0,1.6961163227
21889,1000004,2,1202,1027,175,0.854409,0.145591,1.676399,144,31,1203,1028,175,0.85453,0.14547,1.677447,144,31,1, merged,0,0,0.201287801851
21892,1000004,2,1203,1028,175,0.85453,0.14547,1.737647,144,31,1204,1029,175,0.854651,0.145349,1.739267,144,31,1, merged,0,0,0.154719327939
21893,1000120,2,363,302,61,0.831956,0.168044,1.716571,59,2,364,303,61,0.832418,0.167582,1.705835,59,2,1, merged,0,0,0.27078854283
21897,1000004,1,1204,1029,175,0.854651,0.145349,0.854651,144,31,1205,1030,175,0.854772,0.145228,0.854772,144,31,-1, abandoned,0,0,0.0356254626203
21906,1000121,1,889,727,162,0.817773,0.182227,0.817773,156,6,890,728,162,0.817978,0.182022,0.817978,156,6,1, merged,0,0,0.000811688311688
21906,1000329,2,1264,940,324,0.743671,0.256329,1.561444,292,32,1265,941,324,0.743874,0.256126,1.561851,292,32,1, merged,0,0,0.00324477793551
21916,1000014,2,894,764,130,0.854586,0.145414,1.771253,120,10,896,766,130,0.854911,0.145089,1.777988,120,10,-1, merged,0,0,0.563509271879
21920,1000120,2,365,304,61,0.832877,0.167123,1.753929,59,2,366,305,61,0.833333,0.166667,1.754645,59,2,1, merged,0,0,0.07699409671
21920,1000124,1,304,280,24,0.921053,0.078947,0.921053,22,2,305,281,24,0.921311,0.078689,0.921311,22,2,1, merged,0,0,0.134978329064
21928,1000121,3,891,729,162,0.818182,0.181818,2.391211,156,6,892,730,162,0.818386,0.181614,2.390642,156,6,1, merged,0,0,0.0136262449814
21935,1000004,1,1205,1030,175,0.854772,0.145228,0.854772,144,31,1208,1031,177,0.853477,0.146523,0.853477,146,31,1, merged,1,1,0.016836905108
21935,1000043,2,253,208,45,0.822134,0.177866,1.676906,39,6,254,209,45,0.822835,0.177165,1.676311,39,6,1, merged,0,0,0.0305885551697
21936,1000329,3,1265,941,324,0.743874,0.256126,1.396047,292,32,1266,941,325,0.743286,0.256714,2.392222,292,33,-1, merged,1,1,0
21947,1000014,2,896,766,130,0.854911,0.145089,1.677745,120,10,897,767,130,0.855072,0.144928,1.678602,120,10,1, merged,0,0,0.586458849436
21947,1000043,1,254,209,45,0.822835,0.177165,0.822835,39,6,255,210,45,0.823529,0.176471,0.823529,39,6,1, merged,0,0,0.770620358235
21947,1000070,3,581,521,60,0.89673,0.10327,2.574475,48,12,582,522,60,0.896907,0.103093,2.575509,48,12,1, merged,0,0,0.739148690099
21948,1000014,2,897,767,130,0.855072,0.144928,1.678602,120,10,903,770,133,0.852713,0.147287,1.673026,123,10,1, merged,1,1,0.124235864197
21948,1000043,1,255,210,45,0.823529,0.176471,0.823529,39,6,256,210,46,0.820312,0.179688,0.820312,40,6,1, merged,1,1,0.145680049044
21963,1000014,2,903,770,133,0.852713,0.147287,1.71938,123,10,904,771,133,0.852876,0.147124,1.722441,123,10,1, merged,0,0,0.170077015644
21967,1000329,1,1266,941,325,0.743286,0.256714,0.743286,292,33,1267,942,325,0.743489,0.256511,0.743489,292,33,1, merged,0,0,0.613298195824
21973,1000124,2,305,281,24,0.921311,0.078689,1.699089,22,2,306,282,24,0.921569,0.078431,1.658411,22,2,1, merged,0,0,0.496352385337
21975,1000014,1,904,771,133,0.852876,0.147124,0.852876,123,10,906,772,134,0.852097,0.147903,0.852097,124,10,1, merged,1,1,0.107733986989
21982,1000014,1,906,772,134,0.852097,0.147903,0.852097,124,10,907,773,134,0.85226,0.14774,0.85226,124,10,1, merged,0,0,0.647790783942
21982,1000132,2,144,125,19,0.868056,0.131944,1.720153,16,3,145,126,19,0.868966,0.131034,1.721226,16,3,1, merged,0,0,0.655158004701
21984,1000091,4,251,192,59,0.76494,0.23506,3.0275,53,6,253,193,60,0.762846,0.237154,3.026533,53,7,-1, merged,1,1,0.516200206044
21984,1000121,3,892,730,162,0.818386,0.181614,2.26256,156,6,893,731,162,0.818589,0.181411,2.263687,156,6,1, merged,0,0,0.611016024126
21984,1000328,2,414,290,124,0.700483,0.299517,1.444174,114,10,415,291,124,0.701205,0.298795,1.445098,114,10,1, merged,0,0,1.00541227985
21984,1000329,1,1268,943,325,0.743691,0.256309,0.743691,292,33,1269,944,325,0.743893,0.256107,0.743893,292,33,1, merged,0,0,0.861618398035
21994,1000329,1,1269,944,325,0.743893,0.256107,0.743893,292,33,1272,947,325,0.744497,0.255503,0.744497,292,33,-1, merged,0,0,0.203713377449
22032,1000004,2,1211,1034,177,0.85384,0.14616,1.555332,146,31,1213,1036,177,0.854081,0.145919,1.545257,146,31,-1, merged,0,0,0.0418541743514
22032,1000329,4,1272,947,325,0.744497,0.255503,2.948765,292,33,1273,948,325,0.744698,0.255302,2.946205,292,33,1, merged,0,0,0.0368346488565
22033,1000327,2,509,394,115,0.774067,0.225933,1.508442,88,27,510,395,115,0.77451,0.22549,1.512971,88,27,1, merged,0,0,0.0642503733598
22034,1000329,1,1273,948,325,0.744698,0.255302,0.744698,292,33,1274,949,325,0.744898,0.255102,0.744898,292,33,1, merged,0,0,0
22040,1000329,2,1274,949,325,0.744898,0.255102,1.567479,292,33,1275,950,325,0.745098,0.254902,1.571414,292,33,1, merged,0,0,0.319029119149
22043,1000014,1,908,774,134,0.852423,0.147577,0.852423,124,10,912,774,138,0.848684,0.151316,0.848684,128,10,1, merged,1,1,0
22043,1000043,3,260,213,47,0.819231,0.180769,1.671654,41,6,261,214,47,0.819923,0.180077,1.811465,41,6,1, merged,0,0,0.183237521689
22045,1000329,2,1275,950,325,0.745098,0.254902,1.478431,292,33,1276,951,325,0.745298,0.254702,1.495298,292,33,1, merged,0,0,0.609122168285
22046,1000004,1,1213,1036,177,0.854081,0.145919,0.854081,146,31,1214,1037,177,0.854201,0.145799,0.854201,146,31,1, merged,0,0,0.0333652994984
22046,1000070,2,583,523,60,0.897084,0.102916,1.751165,48,12,584,524,60,0.89726,0.10274,1.751461,48,12,1, merged,0,0,0.00291556728232
22050,1000043,2,262,215,47,0.820611,0.179389,0.963468,41,6,264,217,47,0.82197,0.17803,0.94697,41,6,-1, merged,0,0,0.0489070458404
22056,1000004,1,1214,1037,177,0.854201,0.145799,0.854201,146,31,1215,1038,177,0.854321,0.145679,0.854321,146,31,1, merged,0,0,0.370664250062
22056,1000043,2,264,217,47,0.82197,0.17803,1.676171,41,6,265,218,47,0.822642,0.177358,1.676962,41,6,1, merged,0,0,0.704652213189
22060,1000091,1,253,193,60,0.762846,0.237154,0.762846,53,7,257,195,62,0.758755,0.241245,0.758755,55,7,1, merged,1,1,0.26256970205
22060,1000329,3,1277,952,325,0.745497,0.254503,2.282824,292,33,1278,953,325,0.745696,0.254304,2.276641,292,33,1, merged,0,0,0.463666546182
22069,1000120,1,373,312,61,0.836461,0.163539,0.836461,59,2,375,313,62,0.834667,0.165333,0.834667,60,2,1, merged,1,1,0.0358223197749
22073,1000026,1,222,202,20,0.90991,0.09009,0.90991,18,2,223,203,20,0.910314,0.089686,0.910314,18,2,1, merged,0,0,0.383887118798
22073,1000153,2,523,481,42,0.919694,0.080306,1.829604,32,10,524,482,42,0.919847,0.080153,1.830161,32,10,1, merged,0,0,0.943331091137
22075,1000329,4,1284,957,327,0.745327,0.254673,3.059909,294,33,1285,957,328,0.744747,0.255253,3.047521,295,33,1, merged,1,1,0.104828652187
22075,1000592,3,246,198,48,0.804878,0.195122,2.314582,35,13,248,199,49,0.802419,0.197581,2.302774,36,13,1, merged,1,1,0.116849737841
22076,1000327,1,511,396,115,0.774951,0.225049,0.774951,88,27,513,397,116,0.773879,0.226121,0.773879,89,27,1, merged,1,1,0.0430693501548
22081,1000118,2,614,542,72,0.882736,0.117264,1.567519,70,2,615,543,72,0.882927,0.117073,1.571099,70,2,1, merged,0,0,0.0243449733788
22090,1000118,2,616,544,72,0.883117,0.116883,1.777056,70,2,617,545,72,0.883306,0.116694,1.778043,70,2,1, merged,0,0,0.134097756637
22106,1000004,2,1216,1039,177,0.854441,0.145559,1.409996,146,31,1217,1040,177,0.85456,0.14544,1.45456,146,31,1, merged,0,0,0.450076335074
22110,1000327,3,513,397,116,0.773879,0.226121,2.198122,89,27,514,398,116,0.774319,0.225681,2.219971,89,27,1, merged,0,0,0.107784837994
22111,1000327,3,514,398,116,0.774319,0.225681,2.219971,89,27,515,399,116,0.774757,0.225243,2.236714,89,27,1, merged,0,0,0.0814875204783
22112,1000327,3,515,399,116,0.774757,0.225243,2.236714,89,27,516,400,116,0.775194,0.224806,2.252337,89,27,1, merged,0,0,0.130788588714
22114,1000327,2,516,400,116,0.775194,0.224806,1.50722,89,27,517,401,116,0.775629,0.224371,1.511112,89,27,1, merged,0,0,0.0675838711969
22115,1000327,1,517,401,116,0.775629,0.224371,0.775629,89,27,519,403,116,0.776493,0.223507,0.776493,89,27,1, merged,0,0,0.6538206167
22116,1000121,1,895,733,162,0.818994,0.181006,0.818994,156,6,898,736,162,0.819599,0.180401,0.819599,156,6,-1, merged,0,0,0.057456339053
22118,1000120,2,376,314,62,0.835106,0.164894,1.386831,60,2,377,315,62,0.835544,0.164456,1.416189,60,2,1, merged,0,0,0.0607869674185
22118,1000534,1,29,16,13,0.551724,0.448276,0.551724,13,0,31,18,13,0.580645,0.419355,0.580645,13,0,-1, merged,0,0,0.044776119403
22120,1000014,1,912,774,138,0.848684,0.151316,0.848684,128,10,913,775,138,0.84885,0.15115,0.84885,128,10,1, merged,0,0,0.527012875008
22120,1000329,2,1285,957,328,0.744747,0.255253,1.593431,295,33,1286,958,328,0.744946,0.255054,1.593796,295,33,1, merged,0,0,0.921595613741
22121,1000132,2,146,127,19,0.869863,0.130137,1.658409,16,3,147,128,19,0.870748,0.129252,1.659759,16,3,1, merged,0,0,1.35489014277
22130,1000329,3,1286,958,328,0.744946,0.255054,2.075715,295,33,1288,960,328,0.745342,0.254658,2.098986,295,33,1, merged,0,0,0.0218519264331
22131,1000327,3,519,403,116,0.776493,0.223507,2.277797,89,27,520,404,116,0.776923,0.223077,2.280348,89,27,1, merged,0,0,0.163426109804
22134,1000109,1,326,272,54,0.834356,0.165644,0.834356,52,2,327,273,54,0.834862,0.165138,0.834862,52,2,1, merged,0,0,0.119687908532
22134,1000199,2,219,177,42,0.808219,0.191781,1.642575,40,2,220,178,42,0.809091,0.190909,1.643953,40,2,1, merged,0,0,0.122734038911
22140,1000070,1,585,525,60,0.897436,0.102564,0.897436,48,12,587,526,61,0.896082,0.103918,0.896082,49,12,1, merged,1,1,0.246528609869
22143,1000327,2,520,404,116,0.776923,0.223077,1.526923,89,27,521,405,116,0.777351,0.222649,1.535972,89,27,1, merged,0,0,0.658159254268
22144,1000327,3,521,405,116,0.777351,0.222649,2.289397,89,27,522,406,116,0.777778,0.222222,2.301201,89,27,1, merged,0,0,0.328081088031
22148,1000327,3,522,406,116,0.777778,0.222222,2.301201,89,27,523,407,116,0.778203,0.221797,2.312396,89,27,1, merged,0,0,0.328398779643
22150,1000011,2,359,334,25,0.930362,0.069638,1.765906,23,2,360,335,25,0.930556,0.069444,1.766534,23,2,1, merged,0,0,1.28736901198
22150,1000120,1,377,315,62,0.835544,0.164456,0.835544,60,2,378,316,62,0.835979,0.164021,0.835979,60,2,-1, merged,0,0,0.506100981767
22151,1000327,1,523,407,116,0.778203,0.221797,0.778203,89,27,525,407,118,0.775238,0.224762,0.775238,91,27,1, merged,1,1,0
22151,1000328,2,415,291,124,0.701205,0.298795,1.479407,114,10,416,291,125,0.699519,0.300481,1.474757,115,10,1, merged,1,1,0
22151,1000329,4,1288,960,328,0.745342,0.254658,3.080095,295,33,1290,962,328,0.745736,0.254264,3.07405,295,33,-1, merged,0,0,0
22154,1000109,2,327,273,54,0.834862,0.165138,1.643953,52,2,328,273,55,0.832317,0.167683,1.643976,53,2,1, merged,1,1,0.0123542372207
22154,1000199,1,220,178,42,0.809091,0.190909,0.809091,40,2,223,181,42,0.811659,0.188341,0.811659,40,2,-1, merged,0,0,0.0121573337211
22155,1000121,3,898,736,162,0.819599,0.180401,2.367755,156,6,899,737,162,0.8198,0.1802,2.369143,156,6,1, merged,0,0,0.0122074563607
22155,1000329,2,1290,962,328,0.745736,0.254264,1.548156,295,33,1292,964,328,0.74613,0.25387,1.549343,295,33,-1, merged,0,0,0.0113578867621
22155,1000592,1,248,199,49,0.802419,0.197581,0.802419,36,13,249,200,49,0.803213,0.196787,0.803213,36,13,-1, merged,0,0,0.0102804514034
22156,1000043,2,265,218,47,0.822642,0.177358,1.822642,41,6,266,219,47,0.823308,0.176692,1.823308,41,6,1, merged,0,0,0.370389634985
22166,1000014,1,914,776,138,0.849015,0.150985,0.849015,128,10,916,778,138,0.849345,0.150655,0.849345,128,10,-1, merged,0,0,0.0466316115896
22166,1000153,2,524,482,42,0.919847,0.080153,1.768863,32,10,525,483,42,0.92,0.08,1.769345,32,10,1, merged,0,0,0.0718540560383
22167,1000091,2,257,195,62,0.758755,0.241245,1.529104,55,7,258,196,62,0.75969,0.24031,1.528476,55,7,1, merged,0,0,0.265065511214
22167,1000329,3,1295,967,328,0.746718,0.253282,2.275822,295,33,1296,968,328,0.746914,0.253086,2.27539,295,33,1, merged,0,0,0.465968471543
22183,1000592,2,249,200,49,0.803213,0.196787,1.678213,36,13,251,201,50,0.800797,0.199203,1.660797,37,13,1, merged,1,1,0.368953506721
22210,1000120,1,379,317,62,0.836412,0.163588,0.836412,60,2,381,319,62,0.83727,0.16273,0.83727,60,2,-1, merged,0,0,0.166921233902
22218,1000124,2,312,288,24,0.923077,0.076923,1.63141,22,2,313,289,24,0.923323,0.076677,1.635651,22,2,1, merged,0,0,0
22219,1000070,2,587,526,61,0.896082,0.103918,1.545566,49,12,588,527,61,0.896259,0.103741,1.552824,49,12,1, merged,0,0,0.859957391511
22222,1000043,2,266,219,47,0.823308,0.176692,1.57704,41,6,267,220,47,0.82397,0.17603,1.578617,41,6,-1, merged,0,0,0
22225,1000007,3,535,455,80,0.850467,0.149533,2.658506,68,12,538,457,81,0.849442,0.150558,2.653842,69,12,-1, merged,1,0,0.143516732834
22225,1000012,2,319,284,35,0.890282,0.109718,1.808039,34,1,320,284,36,0.8875,0.1125,1.8044,35,1,1, merged,1,1,0.0862879902583
22225,1000015,1,1070,982,88,0.917757,0.082243,0.917757,79,9,1071,982,89,0.9169,0.0831,0.9169,80,9,1, merged,1,1,0
22227,1000026,2,223,203,20,0.910314,0.089686,1.490959,18,2,224,204,20,0.910714,0.089286,1.504464,18,2,1, merged,0,0,0
22227,1000534,1,31,18,13,0.580645,0.419355,0.580645,13,0,32,19,13,0.59375,0.40625,0.59375,13,0,-1, merged,0,0,0
22228,1000070,3,588,527,61,0.896259,0.103741,1.911315,49,12,589,528,61,0.896435,0.103565,1.926805,49,12,1, merged,0,0,0.183683916598
22234,1000070,2,589,528,61,0.896435,0.103565,1.266805,49,12,590,529,61,0.89661,0.10339,1.289467,49,12,1, merged,0,0,0.18433001315
22241,1000327,4,526,408,118,0.775665,0.224335,2.924465,91,27,527,409,118,0.776091,0.223909,2.851952,91,27,-1, merged,0,0,0.132710682689
22244,1000014,2,916,778,138,0.849345,0.150655,1.724345,128,10,917,779,138,0.849509,0.150491,1.731862,128,10,1, merged,0,0,0.512874514613
22258,1000132,2,149,130,19,0.872483,0.127517,1.791002,16,3,150,131,19,0.873333,0.126667,1.785098,16,3,1, merged,0,0,0.836084183673
22284,1000327,3,527,409,118,0.776091,0.223909,2.142325,91,27,528,410,118,0.776515,0.223485,2.18211,91,27,1, merged,0,0,0.13292607851
22285,1000003,2,737,624,113,0.846676,0.153324,1.643705,106,7,739,626,113,0.847091,0.152909,1.640194,106,7,-1, merged,0,0,0.314699036402
22306,1000005,2,175,131,44,0.748571,0.251429,1.508261,42,2,176,131,45,0.744318,0.255682,1.504936,42,3,-1, merged,1,1,0.219057735489
22306,1000091,1,258,196,62,0.75969,0.24031,0.75969,55,7,259,197,62,0.760618,0.239382,0.760618,55,7,1, merged,0,0,0.219076259897
22307,1000015,2,1071,982,89,0.9169,0.0831,1.492658,80,9,1072,983,89,0.916978,0.083022,1.505213,80,9,1, merged,0,0,0
22307,1000534,1,33,19,14,0.575758,0.424242,0.575758,14,0,34,20,14,0.588235,0.411765,0.588235,14,0,1, merged,0,0,0
22315,1000011,1,362,337,25,0.930939,0.069061,0.930939,23,2,363,338,25,0.931129,0.068871,0.931129,23,2,1, merged,0,0,0.230203027724
22315,1000014,3,920,782,138,0.85,0.15,2.636495,128,10,921,783,138,0.850163,0.149837,2.638435,128,10,1, merged,0,0,0.164818646512
22319,1000012,2,320,284,36,0.8875,0.1125,1.72477,35,1,321,285,36,0.88785,0.11215,1.721184,35,1,1, merged,0,0,0.763801728058
22319,1000120,1,381,319,62,0.83727,0.16273,0.83727,60,2,384,320,64,0.833333,0.166667,0.833333,60,4,-1, merged,1,0,0.518732782369
22323,1000327,3,528,410,118,0.776515,0.223485,2.18211,91,27,529,411,118,0.776938,0.223062,2.206104,91,27,1, merged,0,0,0.669527445772
22337,1000327,1,529,411,118,0.776938,0.223062,0.776938,91,27,530,412,118,0.777358,0.222642,0.777358,91,27,1, merged,0,0,0.200369825992
22338,1000070,2,592,531,61,0.896959,0.103041,1.021959,49,12,593,532,61,0.897133,0.102867,1.008244,49,12,1, merged,0,0,0
22344,1000120,1,385,321,64,0.833766,0.166234,0.833766,60,4,389,324,65,0.832905,0.167095,0.832905,61,4,-1, merged,1,0,0.522024623803
22344,1000534,2,34,20,14,0.588235,0.411765,1.422002,14,0,35,21,14,0.6,0.4,1.432905,14,0,-1, merged,0,0,1.24405204461
22348,1000011,1,366,341,25,0.931694,0.068306,0.931694,23,2,367,342,25,0.93188,0.06812,0.93188,23,2,1, merged,0,0,0.637179962894
22351,1000120,1,389,324,65,0.832905,0.167095,0.832905,61,4,390,324,66,0.830769,0.169231,0.830769,62,4,1, merged,1,1,0.0296195033037
22353,1000120,1,390,324,66,0.830769,0.169231,0.830769,62,4,391,325,66,0.831202,0.168798,0.831202,62,4,1, merged,0,0,0.178766455388
22354,1000120,1,391,325,66,0.831202,0.168798,0.831202,62,4,392,325,67,0.829082,0.170918,0.829082,63,4,1, merged,1,1,0.1813730267
22355,1000004,1,1220,1043,177,0.854918,0.145082,0.854918,146,31,1222,1044,178,0.854337,0.145663,0.854337,147,31,1, merged,1,1,0.0339539109519
22355,1000120,2,392,325,67,0.829082,0.170918,1.684,63,4,393,326,67,0.829517,0.170483,1.683854,63,4,1, merged,0,0,0.183976044405
22356,1000120,1,393,326,67,0.829517,0.170483,0.829517,63,4,394,326,68,0.827411,0.172589,0.827411,64,4,1, merged,1,1,0.186575515765
22357,1000120,1,394,326,68,0.827411,0.172589,0.827411,64,4,395,326,69,0.825316,0.174684,0.825316,65,4,1, merged,1,1,0.189171448021
22367,1000120,1,411,335,76,0.815085,0.184915,0.815085,72,4,412,335,77,0.813107,0.186893,0.813107,73,4,1, merged,1,1,0.0144781144781
22371,1000004,2,1222,1044,178,0.854337,0.145663,1.664433,147,31,1223,1045,178,0.854456,0.145544,1.665008,147,31,1, merged,0,0,0.000195755717364
22371,1000120,1,416,337,79,0.810096,0.189904,0.810096,75,4,417,338,79,0.810552,0.189448,0.810552,75,4,1, merged,0,0,3.89623063059e-07
22372,1000004,2,1223,1045,178,0.854456,0.145544,1.665008,147,31,1224,1046,178,0.854575,0.145425,1.663644,147,31,1, merged,0,0,0.0463521828304
22372,1000120,1,417,338,79,0.810552,0.189448,0.810552,75,4,419,339,80,0.809069,0.190931,0.809069,76,4,1, merged,1,1,0.138669301713
22385,1000004,1,1228,1050,178,0.855049,0.144951,0.855049,147,31,1230,1051,179,0.854472,0.145528,0.854472,147,32,-1, merged,1,0,0
22385,1000120,2,427,339,88,0.793911,0.206089,1.64896,84,4,428,340,88,0.794393,0.205607,1.648864,84,4,1, merged,0,0,0
22405,1000329,2,1306,977,329,0.748086,0.251914,1.748086,296,33,1307,977,330,0.747513,0.252487,1.41418,297,33,1, abandoned,1,1,0.122564959137
22408,1000063,1,1836,1643,193,0.89488,0.10512,0.89488,165,28,1838,1645,193,0.894995,0.105005,0.894995,165,28,-1, merged,0,0,0
22409,1000121,2,900,738,162,0.82,0.18,1.62315,156,6,901,739,162,0.8202,0.1798,1.6202,156,6,-1, abandoned,0,0,0.125873499541
22409,1000592,1,254,204,50,0.80315,0.19685,0.80315,37,13,255,204,51,0.8,0.2,0.8,38,13,1, abandoned,1,1,0.100737718676
22422,1000327,2,530,412,118,0.777358,0.222642,1.524872,91,27,531,413,118,0.777778,0.222222,1.525484,91,27,1, merged,0,0,0.697399437545
22422,1000329,1,1307,977,330,0.747513,0.252487,0.747513,297,33,1308,978,330,0.747706,0.252294,0.747706,297,33,1, merged,0,0,0.925721386965
22424,1000070,2,593,532,61,0.897133,0.102867,1.720322,49,12,594,533,61,0.897306,0.102694,1.721006,49,12,1, merged,0,0,0.742796731562
22454,1000003,2,739,626,113,0.847091,0.152909,1.847091,106,7,740,627,113,0.847297,0.152703,1.847297,106,7,1, merged,0,0,0.081189497938
22455,1000003,2,740,627,113,0.847297,0.152703,1.847297,106,7,741,628,113,0.847503,0.152497,1.847503,106,7,1, merged,0,0,0.272053150857
22456,1000003,2,741,628,113,0.847503,0.152497,1.847503,106,7,743,630,113,0.847914,0.152086,1.705057,106,7,-1, merged,0,0,0.204462587609
22457,1000327,3,531,413,118,0.777778,0.222222,2.206944,91,27,532,414,118,0.778195,0.221805,2.235935,91,27,1, merged,0,0,0.134311839368
22458,1000009,1,492,414,78,0.841463,0.158537,0.841463,70,8,493,414,79,0.839757,0.160243,0.839757,71,8,1, merged,1,1,0.608406131133
22459,1000327,2,532,414,118,0.778195,0.221805,1.543628,91,27,533,415,118,0.778612,0.221388,1.546904,91,27,1, merged,0,0,0.672257174393
22461,1000011,1,368,343,25,0.932065,0.067935,0.932065,23,2,369,343,26,0.929539,0.070461,0.929539,24,2,1, merged,1,1,0.718469803631
22463,1000011,1,369,343,26,0.929539,0.070461,0.929539,24,2,370,344,26,0.92973,0.07027,0.92973,24,2,1, merged,0,0,0.719037037037
22481,1000328,2,417,292,125,0.70024,0.29976,1.447946,115,10,418,292,126,0.698565,0.301435,1.445893,116,10,1, merged,1,1,0.987873828777
22481,1000329,1,1308,978,330,0.747706,0.252294,0.747706,297,33,1310,979,331,0.747328,0.252672,0.747328,298,33,1, merged,1,1,0.854603956525
22483,1000014,2,925,787,138,0.850811,0.149189,1.69172,128,10,926,788,138,0.850972,0.149028,1.695416,128,10,1, merged,0,0,0.531585882544
22484,1000327,3,533,415,118,0.778612,0.221388,2.445239,91,27,535,416,119,0.77757,0.22243,2.43663,92,27,-1, merged,1,0,0.121848171412
22491,1000004,4,1242,1063,179,0.855878,0.144122,3.200053,147,32,1245,1065,180,0.855422,0.144578,3.185384,148,32,1, merged,1,1,0.0425181198943
22491,1000121,5,901,739,162,0.8202,0.1798,4.020253,156,6,902,739,163,0.81929,0.18071,4.004675,157,6,1, merged,1,1,0.0118101439561
22491,1000329,2,1310,979,331,0.747328,0.252672,1.574061,298,33,1313,979,334,0.745621,0.254379,1.564248,301,33,1, merged,1,1,0.0374310480693
22492,1000329,2,1313,979,334,0.745621,0.254379,1.564248,301,33,1314,980,334,0.745814,0.254186,1.565327,301,33,1, merged,0,0,0.466794162626
22493,1000329,2,1314,980,334,0.745814,0.254186,1.565327,301,33,1315,981,334,0.746008,0.253992,1.566396,301,33,1, merged,0,0,0.233601316666
22494,1000329,2,1315,981,334,0.746008,0.253992,1.566396,301,33,1316,982,334,0.746201,0.253799,1.567457,301,33,1, merged,0,0,0.233946227324
22495,1000329,2,1316,982,334,0.746201,0.253799,1.567457,301,33,1317,983,334,0.746393,0.253607,1.568509,301,33,1, merged,0,0,0.469463956701
22496,1000329,2,1317,983,334,0.746393,0.253607,1.568509,301,33,1318,984,334,0.746586,0.253414,1.569552,301,33,1, merged,0,0,0.469893567146
22497,1000329,2,1318,984,334,0.746586,0.253414,1.569552,301,33,1320,986,334,0.74697,0.25303,1.566017,301,33,-1, merged,0,0,0.234548490837
22499,1000199,2,226,183,43,0.809735,0.190265,1.588015,41,2,227,184,43,0.810573,0.189427,1.589852,41,2,1, merged,0,0,0.242220190714
22511,1000070,3,594,533,61,0.897306,0.102694,2.398855,49,12,595,534,61,0.897479,0.102521,2.399668,49,12,1, merged,0,0,0.249119333994
22511,1000329,2,1320,986,334,0.74697,0.25303,1.501548,301,33,1321,987,334,0.747161,0.252839,1.502189,301,33,1, merged,0,0,0.208529617036
22512,1000004,2,1245,1065,180,0.855422,0.144578,1.651245,148,32,1246,1066,180,0.855538,0.144462,1.647686,148,32,1, merged,0,0,0
22512,1000120,1,431,343,88,0.795824,0.204176,0.795824,84,4,433,343,90,0.792148,0.207852,0.792148,84,6,-1, merged,1,1,0
22519,1000004,2,1246,1066,180,0.855538,0.144462,1.621919,148,32,1247,1067,180,0.855654,0.144346,1.622699,148,32,1, merged,0,0,0.47895010497
22521,1000329,1,1323,989,334,0.747543,0.252457,0.747543,301,33,1324,990,334,0.747734,0.252266,0.747734,301,33,1, merged,0,0,0.0825990108352
22526,1000004,2,1247,1067,180,0.855654,0.144346,1.241618,148,32,1249,1069,180,0.855885,0.144115,1.228766,148,32,-1, merged,0,0,0.0427996703989
22526,1000329,4,1326,992,334,0.748115,0.251885,2.649733,301,33,1327,993,334,0.748304,0.251696,2.640437,301,33,-1, merged,0,0,0.0379276637341
22537,1000118,2,620,548,72,0.883871,0.116129,1.563483,70,2,621,549,72,0.884058,0.115942,1.560248,70,2,1, merged,0,0,0.142595111305
22544,1000091,3,262,199,63,0.759542,0.240458,2.306665,55,8,265,201,64,0.758491,0.241509,2.304573,56,8,-1, merged,1,0,0.30988506667
22544,1000592,2,256,205,51,0.800781,0.199219,1.547123,38,13,257,206,51,0.801556,0.198444,1.546082,38,13,-1, merged,0,0,0.425179912773
22556,1000003,3,747,633,114,0.84739,0.15261,2.530823,107,7,752,635,117,0.844415,0.155585,2.416845,110,7,1, merged,1,1,0.10669666854
22556,1000329,4,1329,995,334,0.748683,0.251317,3.279507,301,33,1333,999,334,0.749437,0.250563,3.166282,301,33,-1, merged,0,0,0.131793357937
22565,1000592,2,257,206,51,0.801556,0.198444,1.611313,38,13,259,208,51,0.803089,0.196911,1.613768,38,13,-1, abandoned,0,0,0.746567212063
22568,1000011,3,370,344,26,0.92973,0.07027,2.605093,24,2,372,346,26,0.930108,0.069892,2.608304,24,2,-1, merged,0,0,0.387604314005
22568,1000329,2,1333,999,334,0.749437,0.250563,1.675363,301,33,1334,1000,334,0.749625,0.250375,1.678197,301,33,-1, merged,0,0,0
22569,1000011,2,372,346,26,0.930108,0.069892,1.709387,24,2,373,346,27,0.927614,0.072386,1.707883,24,3,-1, merged,1,1,0.258319103927
22573,1000011,1,373,346,27,0.927614,0.072386,0.927614,24,3,374,347,27,0.927807,0.072193,0.927807,24,3,1, merged,0,0,0.782212781677
22582,1000014,3,931,793,138,0.851772,0.148228,2.445842,128,10,932,794,138,0.851931,0.148069,2.44957,128,10,1, merged,0,0,0.511833286132
22582,1000329,1,1334,1000,334,0.749625,0.250375,0.749625,301,33,1335,1001,334,0.749813,0.250187,0.749813,301,33,-1, merged,0,0,0.639662559013
22583,1000014,1,932,794,138,0.851931,0.148069,0.851931,128,10,933,795,138,0.85209,0.14791,0.85209,128,10,-1, merged,0,0,0.0017803327613
22585,1000043,2,267,220,47,0.82397,0.17603,1.02397,41,6,268,221,47,0.824627,0.175373,1.097354,41,6,1, merged,0,0,0.928275551553
22589,1000070,2,595,534,61,0.897479,0.102521,1.647479,49,12,596,535,61,0.897651,0.102349,1.564318,49,12,1, merged,0,0,0.743347759579
22593,1000004,3,1249,1069,180,0.855885,0.144115,2.5068,148,32,1250,1070,180,0.856,0.144,2.51091,148,32,1, merged,0,0,0.0111416731292
22593,1000592,2,259,208,51,0.803089,0.196911,1.650915,38,13,260,209,51,0.803846,0.196154,1.65491,38,13,1, merged,0,0,0.0105001607026
22594,1000014,1,934,796,138,0.852248,0.147752,0.852248,128,10,935,796,139,0.851337,0.148663,0.851337,129,10,1, abandoned,1,1,0
22594,1000329,2,1335,1001,334,0.749813,0.250187,1.602061,301,33,1336,1002,334,0.75,0.25,1.601337,301,33,-1, abandoned,0,0,0
22602,1000004,1,1250,1070,180,0.856,0.144,0.856,148,32,1251,1071,180,0.856115,0.143885,0.856115,148,32,-1, merged,0,0,0.000498327508825
22607,1000004,2,1253,1072,181,0.855547,0.144453,1.648173,148,33,1254,1073,181,0.855662,0.144338,1.648765,148,33,1, merged,0,0,0
22607,1000120,1,434,344,90,0.792627,0.207373,0.792627,84,6,435,345,90,0.793103,0.206897,0.793103,84,6,1, merged,0,0,0
22609,1000153,2,528,486,42,0.920455,0.079545,1.698232,32,10,529,487,42,0.920605,0.079395,1.720605,32,10,1, merged,0,0,1.07636581576
22618,1000004,3,1257,1076,181,0.856006,0.143994,1.937748,148,33,1259,1078,181,0.856235,0.143765,1.922902,148,33,-1, merged,0,0,0.0429344151454
22619,1000091,2,265,201,64,0.758491,0.241509,1.508678,56,8,266,202,64,0.759398,0.240602,1.509772,56,8,1, merged,0,0,0.537210641592
22619,1000329,1,1337,1003,334,0.750187,0.249813,0.750187,301,33,1338,1004,334,0.750374,0.249626,0.750374,301,33,1, merged,0,0,0.934961437999
22621,1000091,2,266,202,64,0.759398,0.240602,1.509959,56,8,267,203,64,0.7603,0.2397,1.511046,56,8,1, merged,0,0,0.538633876689
22621,1000329,1,1339,1005,334,0.75056,0.24944,0.75056,301,33,1340,1006,334,0.750746,0.249254,0.750746,301,33,1, merged,0,0,0.935505869339
22628,1000121,4,903,739,164,0.818383,0.181617,2.602649,158,6,904,740,164,0.818584,0.181416,2.648406,158,6,1, merged,0,0,0.00634466179547
22628,1000329,3,1341,1007,334,0.750932,0.249068,1.784265,301,33,1342,1008,334,0.751118,0.248882,1.829821,301,33,1, merged,0,0,0.00901203331699
22634,1000070,2,599,538,61,0.898164,0.101836,1.56153,49,12,600,539,61,0.898333,0.101667,1.565,49,12,1, merged,0,0,0.189592156292
22635,1000327,1,535,416,119,0.77757,0.22243,0.77757,92,27,536,417,119,0.777985,0.222015,0.777985,92,27,1, merged,0,0,0.697331571382
22635,1000329,2,1342,1008,334,0.751118,0.248882,1.528688,301,33,1343,1009,334,0.751303,0.248697,1.529288,301,33,1, merged,0,0,0.93019924917
22636,1000063,2,1838,1645,193,0.894995,0.105005,1.598698,165,28,1839,1646,193,0.895052,0.104948,1.602369,165,28,1, merged,0,0,4.37339034939e-05
22637,1000063,2,1839,1646,193,0.895052,0.104948,1.602369,165,28,1840,1647,193,0.895109,0.104891,1.59749,165,28,1, merged,0,0,8.26076815425e-05
22638,1000063,2,1840,1647,193,0.895109,0.104891,1.59749,165,28,1842,1649,193,0.895223,0.104777,1.588404,165,28,-1, merged,0,0,0.000121480704005
22646,1000011,1,377,350,27,0.928382,0.071618,0.928382,24,3,378,350,28,0.925926,0.074074,0.925926,25,3,1, merged,1,1,0.391302600906
22653,1000043,3,268,221,47,0.824627,0.175373,1.995687,41,6,269,222,47,0.825279,0.174721,2.029981,41,6,1, merged,0,0,0.587758775878
22653,1000070,2,600,539,61,0.898333,0.101667,1.171061,49,12,602,540,62,0.89701,0.10299,1.204702,50,12,1, merged,1,1,0.570166431907
22655,1000121,1,904,740,164,0.818584,0.181416,0.818584,158,6,905,741,164,0.818785,0.181215,0.818785,158,6,1, merged,0,0,0.00356234096692
22655,1000329,2,1343,1009,334,0.751303,0.248697,1.569887,301,33,1344,1010,334,0.751488,0.248512,1.570273,301,33,1, merged,0,0,0.00594869811807
22661,1000063,2,1842,1649,193,0.895223,0.104777,1.750295,165,28,1844,1650,194,0.894794,0.105206,1.750166,165,29,-1, merged,1,1,0.376786457759
22662,1000063,3,1844,1650,194,0.894794,0.105206,1.587976,165,29,1846,1651,195,0.894366,0.105634,1.568279,166,29,1, merged,1,1,0.000160349854227
22663,1000063,2,1846,1651,195,0.894366,0.105634,1.568279,166,29,1849,1654,195,0.894538,0.105462,1.547169,166,29,-1, merged,0,0,0.000199220610101
22667,1000054,2,48,43,5,0.895833,0.104167,1.6966,3,2,49,44,5,0.897959,0.102041,1.695669,3,2,1, merged,0,0,0.0993503796103
22671,1000124,2,318,294,24,0.924528,0.075472,1.676201,22,2,319,294,25,0.92163,0.07837,1.672187,23,2,1, merged,1,1,0.320541544636
22671,1000329,1,1345,1011,334,0.751673,0.248327,0.751673,301,33,1347,1011,336,0.750557,0.249443,0.750557,303,33,1, merged,1,1,0.91056698106
22672,1000043,4,269,222,47,0.825279,0.174721,2.802874,41,6,270,223,47,0.825926,0.174074,2.449735,41,6,1, merged,0,0,0.468458514216
22679,1000121,4,905,741,164,0.818785,0.181215,2.732557,158,6,906,742,164,0.818985,0.181015,2.770391,158,6,1, merged,0,0,0.576768506277
22680,1000063,2,1849,1654,195,0.894538,0.105462,1.547169,166,29,1852,1655,197,0.893629,0.106371,1.532804,168,29,1, merged,1,1,0.000238085983052
22681,1000063,2,1852,1655,197,0.893629,0.106371,1.532804,168,29,1855,1657,198,0.893261,0.106739,1.525915,169,29,-1, merged,1,0,0.000276954472572
22683,1000004,1,1260,1079,181,0.856349,0.143651,0.856349,148,33,1263,1082,181,0.85669,0.14331,0.85669,148,33,-1, merged,0,0,0.0438188006952
22684,1000592,2,260,209,51,0.803846,0.196154,1.473571,38,13,261,210,51,0.804598,0.195402,1.477325,38,13,1, merged,0,0,0
22687,1000070,2,607,543,64,0.894563,0.105437,1.675385,52,12,609,544,65,0.893268,0.106732,1.663538,53,12,1, merged,1,1,0.0518264248705
22689,1000070,2,611,546,65,0.893617,0.106383,1.663887,53,12,612,547,65,0.893791,0.106209,1.653791,53,12,1, merged,0,0,0.0525495750708
22695,1000070,3,612,547,65,0.893791,0.106209,2.610986,53,12,613,548,65,0.893964,0.106036,2.613065,53,12,1, merged,0,0,0.841693625469
22695,1000105,2,269,213,56,0.791822,0.208178,1.717195,50,6,271,215,56,0.793358,0.206642,1.719101,50,6,1, merged,0,0,0.710039660938
22696,1000004,3,1263,1082,181,0.85669,0.14331,1.890073,148,33,1265,1084,181,0.856917,0.143083,1.906456,148,33,-1, merged,0,0,0.0090511030686
22710,1000023,1,259,231,28,0.891892,0.108108,0.891892,25,3,260,232,28,0.892308,0.107692,0.892308,25,3,1, merged,0,0,0.000429046444278
22710,1000063,2,1855,1657,198,0.893261,0.106739,1.785153,169,29,1856,1658,198,0.893319,0.106681,1.785627,169,29,1, merged,0,0,0.00132151741294
22717,1000004,2,1265,1084,181,0.856917,0.143083,1.634902,148,33,1266,1085,181,0.85703,0.14297,1.633982,148,33,1, merged,0,0,0.108667381996
22717,1000327,1,536,417,119,0.777985,0.222015,0.777985,92,27,538,418,120,0.776952,0.223048,0.776952,93,27,1, merged,1,1,0.10433717522
22719,1000004,1,1266,1085,181,0.85703,0.14297,0.85703,148,33,1268,1087,181,0.857256,0.142744,0.857256,148,33,-1, merged,0,0,0.477764164458
22719,1000121,2,906,742,164,0.818985,0.181015,1.676015,158,6,908,744,164,0.819383,0.180617,1.676639,158,6,-1, merged,0,0,0.696856986987
22719,1000329,3,1348,1011,337,0.75,0.25,2.426015,303,34,1349,1012,337,0.750185,0.249815,2.426824,303,34,-1, merged,0,0,0.931401232695
22721,1000121,2,908,744,164,0.819383,0.180617,1.595309,158,6,909,745,164,0.819582,0.180418,1.595922,158,6,-1, merged,0,0,0
22721,1000327,1,540,419,121,0.775926,0.224074,0.775926,94,27,541,420,121,0.77634,0.22366,0.77634,94,27,-1, merged,0,0,0
22726,1000004,1,1268,1087,181,0.857256,0.142744,0.857256,148,33,1269,1088,181,0.857368,0.142632,0.857368,148,33,1, merged,0,0,0.0143942437614
22726,1000121,2,910,746,164,0.81978,0.18022,1.677036,158,6,911,747,164,0.819978,0.180022,1.677346,158,6,1, merged,0,0,0.0101165034224
22727,1000004,2,1269,1088,181,0.857368,0.142632,1.677346,148,33,1270,1089,181,0.85748,0.14252,1.677656,148,33,1, merged,0,0,0.23881776867
22727,1000121,1,911,747,164,0.819978,0.180022,0.819978,158,6,912,748,164,0.820175,0.179825,0.820175,158,6,1, merged,0,0,0.348682623592
22735,1000327,3,541,420,121,0.77634,0.22366,1.90134,94,27,542,421,121,0.776753,0.223247,1.926564,94,27,1, merged,0,0,0.0970055398673
22750,1000121,1,914,750,164,0.820569,0.179431,0.820569,158,6,915,751,164,0.820765,0.179235,0.820765,158,6,1, merged,0,0,0.26368892053
22751,1000121,1,915,751,164,0.820765,0.179235,0.820765,158,6,916,752,164,0.820961,0.179039,0.820961,158,6,1, merged,0,0,0.527847416819
22752,1000121,1,916,752,164,0.820961,0.179039,0.820961,158,6,917,753,164,0.821156,0.178844,0.821156,158,6,1, merged,0,0,0.264018252428
22753,1000121,1,917,753,164,0.821156,0.178844,0.821156,158,6,918,754,164,0.821351,0.178649,0.821351,158,6,1, merged,0,0,0.264265476333
22754,1000121,1,918,754,164,0.821351,0.178649,0.821351,158,6,919,755,164,0.821545,0.178455,0.821545,158,6,1, merged,0,0,0.176283427251
22755,1000121,1,919,755,164,0.821545,0.178455,0.821545,158,6,921,756,165,0.820847,0.179153,0.820847,159,6,1, merged,1,1,0.106456762803
22756,1000121,1,921,756,165,0.820847,0.179153,0.820847,159,6,922,757,165,0.821041,0.178959,0.821041,159,6,1, merged,0,0,0.264917668079
22757,1000121,1,922,757,165,0.821041,0.178959,0.821041,159,6,923,758,165,0.821235,0.178765,0.821235,159,6,1, merged,0,0,0.26474843777
22764,1000043,2,270,223,47,0.825926,0.174074,1.580024,41,6,273,225,48,0.824176,0.175824,1.578688,42,6,1, merged,1,1,0.0532417077592
22767,1000004,2,1273,1092,181,0.857816,0.142184,0.857816,148,33,1274,1093,181,0.857928,0.142072,0.857928,148,33,-1, abandoned,0,0,0.0459644174441
22771,1000009,2,496,417,79,0.840726,0.159274,1.5384,71,8,497,418,79,0.841046,0.158954,1.507713,71,8,1, merged,0,0,0.0519363708208
22782,1000120,1,436,346,90,0.793578,0.206422,0.793578,84,6,437,346,91,0.791762,0.208238,0.791762,85,6,1, merged,1,1,0.168697101821
22783,1000120,1,437,346,91,0.791762,0.208238,0.791762,85,6,438,346,92,0.789954,0.210046,0.789954,86,6,1, merged,1,1,0.170988550923
22785,1000120,2,440,347,93,0.788636,0.211364,1.602646,87,6,441,347,94,0.786848,0.213152,1.598896,88,6,1, merged,1,1,0.065408929056
22786,1000063,2,1857,1659,198,0.893376,0.106624,1.705425,169,29,1861,1659,202,0.891456,0.108544,1.701552,173,29,1, merged,1,1,0.00598780483856
22800,1000121,1,928,762,166,0.821121,0.178879,0.821121,160,6,929,763,166,0.821313,0.178687,0.821313,160,6,1, merged,0,0,0.530784155342
22802,1000091,2,267,203,64,0.7603,0.2397,1.438871,56,8,268,204,64,0.761194,0.238806,1.43376,56,8,1, merged,0,0,0.149449166258
22804,1000070,3,614,549,65,0.894137,0.105863,1.937671,53,12,615,550,65,0.894309,0.105691,1.938753,53,12,1, merged,0,0,0.249285458842
22807,1000004,2,1275,1094,181,0.858039,0.141961,1.64585,148,33,1276,1095,181,0.85815,0.14185,1.644667,148,33,1, merged,0,0,0.0490065746695
22807,1000120,1,443,349,94,0.78781,0.21219,0.78781,88,6,445,350,95,0.786517,0.213483,0.786517,89,6,1, merged,1,1,0.136883802817
22808,1000004,2,1276,1095,181,0.85815,0.14185,1.644667,148,33,1277,1096,181,0.858262,0.141738,1.645257,148,33,1, merged,0,0,0.0472691807542
22808,1000120,1,445,350,95,0.786517,0.213483,0.786517,89,6,446,351,95,0.786996,0.213004,0.786996,89,6,1, merged,0,0,0.130938416422
22809,1000004,2,1277,1096,181,0.858262,0.141738,1.645257,148,33,1278,1097,181,0.858372,0.141628,1.644087,148,33,1, merged,0,0,0.0481506898794
22809,1000120,1,446,351,95,0.786996,0.213004,0.786996,89,6,448,352,96,0.785714,0.214286,0.785714,90,6,1, merged,1,1,0.138042203986
22810,1000004,2,1278,1097,181,0.858372,0.141628,1.644087,148,33,1279,1098,181,0.858483,0.141517,1.642928,148,33,1, merged,0,0,0.0484361456227
22810,1000120,1,448,352,96,0.785714,0.214286,0.785714,90,6,450,353,97,0.784444,0.215556,0.784444,91,6,1, merged,1,1,0.140304628002
22811,1000004,2,1279,1098,181,0.858483,0.141517,1.642928,148,33,1280,1099,181,0.858594,0.141406,1.643516,148,33,1, merged,0,0,0.137034038524
22811,1000120,1,450,353,97,0.784444,0.215556,0.784444,91,6,451,354,97,0.784922,0.215078,0.784922,91,6,1, merged,0,0,0.153251815837
22832,1000004,2,1280,1099,181,0.858594,0.141406,1.775957,148,33,1282,1101,181,0.858814,0.141186,1.775404,148,33,-1, merged,0,0,0.0550003602565
22832,1000015,1,1077,988,89,0.917363,0.082637,0.917363,80,9,1079,989,90,0.916589,0.083411,0.916589,81,9,-1, merged,1,0,0
22844,1000327,2,542,421,121,0.776753,0.223247,1.721197,94,27,543,422,121,0.777164,0.222836,1.727164,94,27,1, merged,0,0,0.589263738595
22850,1000003,1,760,643,117,0.846053,0.153947,0.846053,110,7,761,644,117,0.846255,0.153745,0.846255,110,7,-1, merged,0,0,0.186657602477
22850,1000015,2,1080,990,90,0.916667,0.083333,1.762719,81,9,1081,991,90,0.916744,0.083256,1.762999,81,9,1, merged,0,0,0.207184494287
22854,1000043,1,273,225,48,0.824176,0.175824,0.824176,42,6,274,226,48,0.824818,0.175182,0.824818,42,6,1, merged,0,0,0.622005224927
22854,1000329,4,1351,1014,337,0.750555,0.249445,3.009103,303,34,1352,1015,337,0.75074,0.24926,2.980282,303,34,1, merged,0,0,0.886900130883
22856,1000004,1,1285,1103,182,0.858366,0.141634,0.858366,149,33,1286,1104,182,0.858476,0.141524,0.858476,149,33,1, merged,0,0,0.398779684735
22857,1000014,2,941,802,139,0.852285,0.147715,1.488648,129,10,942,802,140,0.85138,0.14862,1.518047,129,11,-1, merged,1,1,0.623378325077
22864,1000004,1,1286,1104,182,0.858476,0.141524,0.858476,149,33,1287,1105,182,0.858586,0.141414,0.858586,149,33,1, merged,0,0,0.0724046674276
22864,1000121,2,934,766,168,0.820128,0.179872,1.678604,162,6,935,767,168,0.820321,0.179679,1.678907,162,6,1, merged,0,0,0.100106570948
22869,1000327,1,543,422,121,0.777164,0.222836,0.777164,94,27,544,423,121,0.777574,0.222426,0.777574,94,27,1, merged,0,0,0.698314878683
22869,1000329,2,1352,1015,337,0.75074,0.24926,1.527904,303,34,1353,1016,337,0.750924,0.249076,1.528497,303,34,1, merged,0,0,0.931653482141
22870,1000327,1,544,423,121,0.777574,0.222426,0.777574,94,27,545,424,121,0.777982,0.222018,0.777982,94,27,1, merged,0,0,0.207616930545
22870,1000329,2,1353,1016,337,0.750924,0.249076,1.528497,303,34,1354,1017,337,0.751108,0.248892,1.529089,303,34,1, merged,0,0,0.400405699359
22871,1000328,2,420,294,126,0.7,0.3,1.332653,116,10,421,294,127,0.698337,0.301663,1.334701,116,11,-1, merged,1,1,1.08488441673
22871,1000329,3,1354,1017,337,0.751108,0.248892,2.083761,303,34,1355,1018,337,0.751292,0.248708,2.085992,303,34,1, merged,0,0,0.933192438706
22873,1000004,1,1287,1105,182,0.858586,0.141414,0.858586,149,33,1288,1106,182,0.858696,0.141304,0.858696,149,33,-1, abandoned,0,0,0.479482898511
22876,1000003,1,761,644,117,0.846255,0.153745,0.846255,110,7,763,646,117,0.846658,0.153342,0.846658,110,7,-1, merged,0,0,0.205147178831
22881,1000004,2,1288,1106,182,0.858696,0.141304,1.557033,149,33,1289,1107,182,0.858805,0.141195,1.555488,149,33,1, merged,0,0,0.0265195519255
22881,1000328,1,421,294,127,0.698337,0.301663,0.698337,116,11,422,294,128,0.696682,0.303318,0.696682,117,11,1, merged,1,1,0.0620718387428
22887,1000003,1,763,646,117,0.846658,0.153342,0.846658,110,7,764,646,118,0.84555,0.15445,0.84555,111,7,1, merged,1,1,0.582594103711
22893,1000121,1,937,769,168,0.820704,0.179296,0.820704,162,6,938,770,168,0.820896,0.179104,0.820896,162,6,1, merged,0,0,0.150662682378
22894,1000007,1,541,459,82,0.848429,0.151571,0.848429,70,12,542,460,82,0.848708,0.151292,0.848708,70,12,1, merged,0,0,0.602079510627
22905,1000004,2,1289,1107,182,0.858805,0.141195,1.495169,149,33,1290,1108,182,0.858915,0.141085,1.474299,149,33,1, merged,0,0,0.0767192648202
22906,1000004,2,1290,1108,182,0.858915,0.141085,1.643056,149,33,1291,1109,182,0.859024,0.140976,1.643639,149,33,1, merged,0,0,0.0230175935527
22906,1000120,1,454,356,98,0.784141,0.215859,0.784141,92,6,455,357,98,0.784615,0.215385,0.784615,92,6,1, merged,0,0,0.0648869368054
22908,1000004,2,1291,1109,182,0.859024,0.140976,1.644112,149,33,1292,1110,182,0.859133,0.140867,1.644691,149,33,1, merged,0,0,0.0056041147379
22908,1000120,1,456,358,98,0.785088,0.214912,0.785088,92,6,457,359,98,0.785558,0.214442,0.785558,92,6,1, merged,0,0,0.0159399397288
22909,1000004,2,1292,1110,182,0.859133,0.140867,1.644691,149,33,1293,1111,182,0.859242,0.140758,1.645268,149,33,1, merged,0,0,0.0254312724907
22909,1000120,1,457,359,98,0.785558,0.214442,0.785558,92,6,458,360,98,0.786026,0.213974,0.786026,92,6,1, merged,0,0,0.0739096277699
22911,1000004,2,1293,1111,182,0.859242,0.140758,1.645734,149,33,1294,1112,182,0.859351,0.140649,1.646307,149,33,1, merged,0,0,0.0155486929043
22911,1000120,1,459,361,98,0.786492,0.213508,0.786492,92,6,460,362,98,0.786957,0.213043,0.786957,92,6,1, merged,0,0,0.0326333711691
22929,1000003,4,764,646,118,0.84555,0.15445,3.296774,111,7,765,647,118,0.845752,0.154248,3.25863,111,7,-1, abandoned,0,0,0.0850304402196
22929,1000026,2,226,206,20,0.911504,0.088496,1.701224,18,2,228,207,21,0.907895,0.092105,1.698592,19,2,-1, abandoned,1,0,0.0419859075079
22930,1000592,4,263,212,51,0.806084,0.193916,2.516871,38,13,265,214,51,0.807547,0.192453,2.461715,38,13,-1, merged,0,0,0.0415219404886
22945,1000004,2,1294,1112,182,0.859351,0.140649,1.499351,149,33,1296,1114,182,0.859568,0.140432,1.503132,149,33,-1, merged,0,0,0.384980278359
22947,1000121,2,948,780,168,0.822785,0.177215,1.574808,162,6,949,781,168,0.822972,0.177028,1.575177,162,6,1, merged,0,0,0
22947,1000329,1,1359,1022,337,0.752024,0.247976,0.752024,303,34,1360,1023,337,0.752206,0.247794,0.752206,303,34,1, merged,0,0,0
22951,1000327,1,545,424,121,0.777982,0.222018,0.777982,94,27,546,425,121,0.778388,0.221612,0.778388,94,27,1, merged,0,0,0
22958,1000327,2,546,425,121,0.778388,0.221612,1.570055,94,27,547,425,122,0.776965,0.223035,1.546196,94,28,-1, merged,1,1,0.331538853097
22959,1000004,2,1296,1114,182,0.859568,0.140432,1.646987,149,33,1297,1115,182,0.859676,0.140324,1.647555,149,33,1, merged,0,0,0.0486650398335
22959,1000120,1,461,363,98,0.787419,0.212581,0.787419,92,6,462,364,98,0.787879,0.212121,0.787879,92,6,1, merged,0,0,0.138243626062
22961,1000121,3,950,782,168,0.823158,0.176842,2.592389,162,6,951,782,169,0.822292,0.177708,2.572292,162,7,-1, merged,1,1,0
22963,1000091,1,269,205,64,0.762082,0.237918,0.762082,56,8,270,205,65,0.759259,0.240741,0.759259,57,8,1, abandoned,1,1,0.236908282429
22963,1000105,2,272,216,56,0.794118,0.205882,1.556199,50,6,273,216,57,0.791209,0.208791,1.550468,51,6,1, abandoned,1,1,0.356448866956
23005,1000105,1,277,220,57,0.794224,0.205776,0.794224,51,6,279,222,57,0.795699,0.204301,0.795699,51,6,1, merged,0,0,0.161691345849
23014,1000014,1,947,807,140,0.852165,0.147835,0.852165,129,11,949,807,142,0.850369,0.149631,0.850369,131,11,1, merged,1,1,0.0842142225891
23014,1000105,2,279,222,57,0.795699,0.204301,1.647864,51,6,282,223,59,0.79078,0.20922,1.641149,53,6,1, merged,1,1,0.0900643925848
23020,1000004,1,1297,1115,182,0.859676,0.140324,0.859676,149,33,1298,1116,182,0.859784,0.140216,0.859784,149,33,-1, merged,0,0,0.0160690000716
23020,1000121,3,952,783,169,0.822479,0.177521,2.604515,162,7,953,784,169,0.822665,0.177335,2.60505,162,7,1, merged,0,0,0.00295663600526
23020,1000124,2,322,297,25,0.92236,0.07764,1.782036,23,2,323,298,25,0.922601,0.077399,1.782385,23,2,1, merged,0,0,0
23045,1000327,4,548,426,122,0.777372,0.222628,2.684287,94,28,549,427,122,0.777778,0.222222,2.705383,94,28,1, merged,0,0,0.0085517313967
23054,1000012,1,326,290,36,0.889571,0.110429,0.889571,35,1,327,291,36,0.889908,0.110092,0.889908,35,1,1, merged,0,0,0.0633616994102
23054,1000026,2,228,207,21,0.907895,0.092105,1.797465,19,2,229,208,21,0.908297,0.091703,1.798205,19,2,1, merged,0,0,0.166092623652
23084,1000329,1,1365,1028,337,0.753114,0.246886,0.753114,303,34,1366,1028,338,0.752562,0.247438,0.752562,303,35,-1, merged,1,1,0.634971396036
23100,1000011,1,382,354,28,0.926702,0.073298,0.926702,25,3,383,355,28,0.926893,0.073107,0.926893,25,3,1, merged,0,0,0.388248606579
23101,1000004,2,1298,1116,182,0.859784,0.140216,1.637562,149,33,1299,1117,182,0.859892,0.140108,1.633443,149,33,1, merged,0,0,0.00705275616337
23101,1000327,1,549,427,122,0.777778,0.222222,0.777778,94,28,552,427,125,0.773551,0.226449,0.773551,97,28,1, merged,1,1,0.00633585648166
23106,1000004,2,1299,1117,182,0.859892,0.140108,1.652265,149,33,1300,1118,182,0.86,0.14,1.652812,149,33,1, merged,0,0,0.0497434618399
23106,1000120,1,472,374,98,0.792373,0.207627,0.792373,92,6,473,375,98,0.792812,0.207188,0.792812,92,6,1, merged,0,0,0.143473570658
23110,1000124,2,324,299,25,0.92284,0.07716,1.67284,23,2,325,300,25,0.923077,0.076923,1.684982,23,2,1, merged,0,0,0.107944358605
23136,1000070,2,629,564,65,0.896661,0.103339,1.719513,53,12,630,565,65,0.896825,0.103175,1.719862,53,12,1, merged,0,0,0.150729170278
23136,1000121,1,954,785,169,0.822851,0.177149,0.822851,162,7,955,786,169,0.823037,0.176963,0.823037,162,7,1, merged,0,0,0.115449580556
23145,1000327,3,552,427,125,0.773551,0.226449,1.976087,97,28,553,428,125,0.77396,0.22604,1.9831,97,28,1, merged,0,0,0.0972880924581
23155,1000003,1,768,650,118,0.846354,0.153646,0.846354,111,7,769,651,118,0.846554,0.153446,0.846554,111,7,-1, merged,0,0,0.0755713953809
23158,1000124,2,325,300,25,0.923077,0.076923,1.783371,23,2,326,301,25,0.923313,0.076687,1.784627,23,2,1, merged,0,0,0.0867750897796
23158,1000166,1,136,117,19,0.860294,0.139706,0.860294,18,1,137,118,19,0.861314,0.138686,0.861314,18,1,1, merged,0,0,0.185458355252
23167,1000004,2,1300,1118,182,0.86,0.14,1.693333,149,33,1301,1119,182,0.860108,0.139892,1.696842,149,33,1, merged,0,0,0.0177522167789
23171,1000015,2,1082,992,90,0.916821,0.083179,1.809226,81,9,1083,993,90,0.916898,0.083102,1.809979,81,9,1, merged,0,0,0.113684245328
23176,1000003,2,771,653,118,0.846952,0.153048,1.639745,111,7,773,655,118,0.847348,0.152652,1.637527,111,7,-1, merged,0,0,0.165407837065
23199,1000327,2,553,428,125,0.77396,0.22604,1.44896,97,28,554,429,125,0.774368,0.225632,1.457295,97,28,1, merged,0,0,0.173101347855
23210,1000130,2,191,160,31,0.837696,0.162304,1.65078,23,8,192,161,31,0.838542,0.161458,1.652495,23,8,-1, merged,0,0,1.09522058824
23220,1000109,3,329,274,55,0.832827,0.167173,2.439319,53,2,331,275,56,0.830816,0.169184,2.430331,54,2,1, merged,1,1,0.0606313540007
23223,1000007,1,543,461,82,0.848987,0.151013,0.848987,70,12,544,462,82,0.849265,0.150735,0.849265,70,12,1, merged,0,0,0.0392123583223
23223,1000015,2,1090,1000,90,0.917431,0.082569,1.766418,81,9,1091,1001,90,0.917507,0.082493,1.766772,81,9,1, merged,0,0,0.0923432718992
23226,1000070,2,632,566,66,0.89557,0.10443,1.77057,54,12,633,567,66,0.895735,0.104265,1.784623,54,12,1, merged,0,0,0.420498864942
23228,1000070,2,633,567,66,0.895735,0.104265,1.784623,54,12,634,568,66,0.895899,0.104101,1.795899,54,12,1, merged,0,0,0.279190416172
23231,1000329,1,1368,1030,338,0.752924,0.247076,0.752924,303,35,1369,1031,338,0.753104,0.246896,0.753104,303,35,1, merged,0,0,0.934051734496
23232,1000004,1,1301,1119,182,0.860108,0.139892,0.860108,149,33,1302,1120,182,0.860215,0.139785,0.860215,149,33,1, merged,0,0,0.216942330906
23232,1000329,2,1369,1031,338,0.753104,0.246896,1.613212,303,35,1370,1032,338,0.753285,0.246715,1.6135,303,35,1, merged,0,0,0.399102356174
23234,1000328,1,425,297,128,0.698824,0.301176,0.698824,117,11,426,297,129,0.697183,0.302817,0.697183,117,12,-1, merged,1,1,0.993430190912
23236,1000070,1,634,568,66,0.895899,0.104101,0.895899,54,12,635,569,66,0.896063,0.103937,0.896063,54,12,1, merged,0,0,0.586987322893
23236,1000105,2,282,223,59,0.79078,0.20922,1.686679,53,6,283,224,59,0.791519,0.208481,1.687582,53,6,1, merged,0,0,0.60760197306
23241,1000121,3,957,788,169,0.823406,0.176594,2.376304,162,7,958,789,169,0.823591,0.176409,2.384132,162,7,1, merged,0,0,0.131552967523
23253,1000014,4,954,812,142,0.851153,0.148847,3.344191,131,11,955,813,142,0.851309,0.148691,3.345554,131,11,1, merged,0,0,0.566378235418
23253,1000121,2,958,789,169,0.823591,0.176409,1.739084,162,7,959,790,169,0.823775,0.176225,1.739859,162,7,1, merged,0,0,0.618636776269
23253,1000132,5,153,134,19,0.875817,0.124183,4.220008,16,3,154,135,19,0.876623,0.123377,4.222177,16,3,1, merged,0,0,1.07426562892
23257,1000121,2,959,790,169,0.823775,0.176225,1.70839,162,7,960,791,169,0.823958,0.176042,1.712847,162,7,1, merged,0,0,0
23260,1000121,2,960,791,169,0.823958,0.176042,1.712847,162,7,961,791,170,0.823101,0.176899,1.68517,163,7,1, merged,1,1,0
23263,1000327,2,554,429,125,0.774368,0.225632,1.417933,97,28,555,430,125,0.774775,0.225225,1.421834,97,28,1, merged,0,0,0.159098026934
23272,1000124,2,330,303,27,0.918182,0.081818,1.565241,25,2,331,304,27,0.918429,0.081571,1.572275,25,2,1, merged,0,0,0.307893797483
23273,1000121,3,967,791,176,0.817994,0.182006,2.324878,169,7,968,792,176,0.818182,0.181818,2.317436,169,7,1, merged,0,0,0.106455675021
23273,1000328,1,426,297,129,0.697183,0.302817,0.697183,117,12,427,297,130,0.69555,0.30445,0.69555,118,12,1, merged,1,1,0.108831958832
23273,1000592,2,268,217,51,0.809701,0.190299,1.506885,38,13,270,217,53,0.803704,0.196296,1.499254,38,15,-1, merged,1,1,0.0897622471024
23274,1000124,2,331,304,27,0.918429,0.081571,1.572275,25,2,332,305,27,0.918675,0.081325,1.566294,25,2,1, merged,0,0,0.307545275381
23275,1000328,1,427,297,130,0.69555,0.30445,0.69555,118,12,429,298,131,0.694639,0.305361,0.694639,119,12,1, merged,1,1,0.0253454264298
23275,1000329,2,1371,1033,338,0.753465,0.246535,1.449015,303,35,1373,1035,338,0.753824,0.246176,1.448462,303,35,-1, merged,0,0,0.0232534325288
23284,1000121,2,968,792,176,0.818182,0.181818,1.512821,169,7,969,793,176,0.818369,0.181631,1.514425,169,7,1, merged,0,0,0.438699133392
23284,1000328,1,429,298,131,0.694639,0.305361,0.694639,119,12,431,300,131,0.696056,0.303944,0.696056,119,12,-1, merged,0,0,0.449578742709
23289,1000124,1,332,305,27,0.918675,0.081325,0.918675,25,2,333,306,27,0.918919,0.081081,0.918919,25,2,1, merged,0,0,0.137520964195
23290,1000004,2,1303,1121,182,0.860322,0.139678,1.757519,149,33,1304,1122,182,0.860429,0.139571,1.757786,149,33,1, merged,0,0,0.410400672476
23290,1000070,1,642,576,66,0.897196,0.102804,0.897196,54,12,643,577,66,0.897356,0.102644,0.897356,54,12,1, merged,0,0,0.853670219627
23302,1000014,2,955,813,142,0.851309,0.148691,1.778845,131,11,957,815,142,0.85162,0.14838,1.780191,131,11,-1, merged,0,0,0
23302,1000043,3,276,228,48,0.826087,0.173913,2.604932,42,6,277,228,49,0.823105,0.176895,2.603296,43,6,1, merged,1,1,0.37602818461
23304,1000070,2,644,578,66,0.897516,0.102484,1.279868,54,12,645,579,66,0.897674,0.102326,1.288979,54,12,1, merged,0,0,0.0285327706762
23307,1000121,1,970,794,176,0.818557,0.181443,0.818557,169,7,973,797,176,0.819116,0.180884,0.819116,169,7,-1, merged,0,0,0.698981139975
23314,1000004,1,1307,1125,182,0.86075,0.13925,0.86075,149,33,1308,1126,182,0.860856,0.139144,0.860856,149,33,1, merged,0,0,0
23314,1000120,2,474,376,98,0.793249,0.206751,1.653999,92,6,475,377,98,0.793684,0.206316,1.65454,92,6,1, merged,0,0,0
23321,1000004,1,1309,1127,182,0.860963,0.139037,0.860963,149,33,1310,1128,182,0.861069,0.138931,0.861069,149,33,1, merged,0,0,0
23321,1000120,2,475,377,98,0.793684,0.206316,1.654647,92,6,476,378,98,0.794118,0.205882,1.655186,92,6,1, merged,0,0,0
23335,1000014,1,957,815,142,0.85162,0.14838,0.85162,131,11,958,816,142,0.851775,0.148225,0.851775,131,11,1, merged,0,0,0.0766305987342
23335,1000015,2,1099,1008,91,0.917197,0.082803,1.768817,81,10,1100,1009,91,0.917273,0.082727,1.769047,81,10,1, merged,0,0,0.119932992975
23336,1000004,2,1310,1128,182,0.861069,0.138931,1.252373,149,33,1311,1129,182,0.861175,0.138825,1.261175,149,33,1, merged,0,0,0.373097745074
23344,1000329,1,1373,1035,338,0.753824,0.246176,0.753824,303,35,1374,1036,338,0.754003,0.245997,0.754003,303,35,1, merged,0,0,0.304439047597
23361,1000070,1,645,579,66,0.897674,0.102326,0.897674,54,12,646,580,66,0.897833,0.102167,0.897833,54,12,1, merged,0,0,0.849952276193
23366,1000120,1,476,378,98,0.794118,0.205882,0.794118,92,6,477,379,98,0.794549,0.205451,0.794549,92,6,1, merged,0,0,0.00811122967948
23367,1000014,2,958,816,142,0.851775,0.148225,1.688509,131,11,959,817,142,0.851929,0.148071,1.691929,131,11,1, merged,0,0,0
23378,1000091,1,273,208,65,0.761905,0.238095,0.761905,57,8,274,209,65,0.762774,0.237226,0.762774,57,8,1, merged,0,0,0
23384,1000329,1,1374,1036,338,0.754003,0.245997,0.754003,303,35,1375,1037,338,0.754182,0.245818,0.754182,303,35,1, merged,0,0,0
23397,1000004,1,1313,1130,183,0.860625,0.139375,0.860625,149,34,1314,1131,183,0.860731,0.139269,0.860731,149,34,1, merged,0,0,0.457674722219
23403,1000009,2,503,423,80,0.840954,0.159046,1.340954,72,8,504,424,80,0.84127,0.15873,1.507937,72,8,1, merged,0,0,1.21913761249
23412,1000120,2,479,381,98,0.795407,0.204593,1.366836,92,6,480,382,98,0.795833,0.204167,1.329167,92,6,1, merged,0,0,0.143602783726
23414,1000004,2,1314,1131,183,0.860731,0.139269,1.656988,149,34,1315,1132,183,0.860837,0.139163,1.657517,149,34,1, merged,0,0,0.00530495523243
23414,1000120,1,481,383,98,0.796258,0.203742,0.796258,92,6,482,384,98,0.79668,0.20332,0.79668,92,6,1, merged,0,0,0.0192607900863
23419,1000120,2,483,385,98,0.797101,0.202899,1.397101,92,6,484,386,98,0.797521,0.202479,1.408632,92,6,-1, abandoned,0,0,0.0505696058328
23419,1000534,1,35,21,14,0.6,0.4,0.6,14,0,36,22,14,0.611111,0.388889,0.611111,14,0,-1, abandoned,0,0,0.0611313868613
23429,1000327,4,556,431,125,0.77518,0.22482,2.935977,97,28,557,432,125,0.775583,0.224417,2.930901,97,28,-1, merged,0,0,0.664343677546
23429,1000328,5,431,300,131,0.696056,0.303944,3.632033,119,12,432,301,131,0.696759,0.303241,3.627661,119,12,1, merged,0,0,0.986985459129
23429,1000329,2,1375,1037,338,0.754182,0.245818,1.405125,303,35,1376,1038,338,0.75436,0.24564,1.39922,303,35,-1, merged,0,0,0.856004424844
23440,1000063,2,1870,1668,202,0.891979,0.108021,1.749991,173,29,1872,1670,202,0.892094,0.107906,1.74866,173,29,-1, merged,0,0,0
23443,1000004,3,1320,1137,183,0.861364,0.138636,2.580996,149,34,1321,1138,183,0.861469,0.138531,2.58388,149,34,-1, merged,0,0,0.000552790803906
23443,1000014,4,959,817,142,0.851929,0.148071,3.432925,131,11,964,822,142,0.852697,0.147303,3.436577,131,11,-1, merged,0,0,0.000646995760572
23443,1000043,8,278,229,49,0.823741,0.176259,6.530277,43,6,279,230,49,0.824373,0.175627,6.537513,43,6,1, merged,0,0,0.000609648457725
23443,1000070,9,649,583,66,0.898305,0.101695,7.428582,54,12,650,584,66,0.898462,0.101538,7.435974,54,12,1, merged,0,0,0.000603283123954
23443,1000105,2,286,227,59,0.793706,0.206294,1.719632,53,6,288,229,59,0.795139,0.204861,1.722412,53,6,-1, merged,0,0,0.000795632992133
23443,1000121,5,976,800,176,0.819672,0.180328,4.252597,169,7,978,802,176,0.820041,0.179959,4.256618,169,7,-1, merged,0,0,0.000797070611232
23444,1000070,1,650,584,66,0.898462,0.101538,0.898462,54,12,651,585,66,0.898618,0.101382,0.898618,54,12,1, merged,0,0,0.0267919174181
23444,1000105,2,288,229,59,0.795139,0.204861,1.6936,53,6,289,230,59,0.795848,0.204152,1.694465,53,6,1, merged,0,0,0.0437069390613
23445,1000014,2,964,822,142,0.852697,0.147303,1.743108,131,11,965,823,142,0.85285,0.14715,1.743635,131,11,1, merged,0,0,0.494800540269
23469,1000105,1,289,230,59,0.795848,0.204152,0.795848,53,6,290,231,59,0.796552,0.203448,0.796552,53,6,1, merged,0,0,0.0585090244233
23469,1000118,2,624,551,73,0.883013,0.116987,1.678861,70,3,625,552,73,0.8832,0.1168,1.679752,70,3,1, merged,0,0,0.106802671624
23469,1000140,3,1,1,0,1,0,2.678861,0,0,2,2,0,1,0,2.679752,0,0,1, merged,0,0,0.0871785807292
23480,1000063,2,1873,1671,202,0.892152,0.107848,1.738305,173,29,1874,1672,202,0.892209,0.107791,1.741266,173,29,1, merged,0,0,0
23481,1000120,2,484,386,98,0.797521,0.202479,1.646577,92,6,485,387,98,0.797938,0.202062,1.634302,92,6,1, merged,0,0,0
23496,1000005,2,176,131,45,0.744318,0.255682,1.59732,42,3,178,132,46,0.741573,0.258427,1.594727,42,4,-1, merged,1,1,0.0204956925437
23496,1000014,1,966,824,142,0.853002,0.146998,0.853002,131,11,967,825,142,0.853154,0.146846,0.853154,131,11,1, merged,0,0,0.0298902385152
23497,1000014,1,967,825,142,0.853154,0.146846,0.853154,131,11,969,826,143,0.852425,0.147575,0.852425,131,12,-1, merged,1,0,0.0986657905258
23504,1000004,2,1326,1143,183,0.861991,0.138009,1.7542,149,34,1329,1146,183,0.862302,0.137698,1.754569,149,34,-1, merged,0,0,0.00226256152331
23504,1000063,1,1874,1672,202,0.892209,0.107791,0.892209,173,29,1875,1673,202,0.892267,0.107733,0.892267,173,29,-1, merged,0,0,0.0026676031452
23510,1000070,2,654,588,66,0.899083,0.100917,1.543942,54,12,655,589,66,0.899237,0.100763,1.547385,54,12,1, merged,0,0,0.254383698381
23510,1000327,3,557,432,125,0.775583,0.224417,2.319526,97,28,558,433,125,0.775986,0.224014,2.32337,97,28,1, merged,0,0,0.196924642748
23517,1000120,2,485,387,98,0.797938,0.202062,1.464605,92,6,486,388,98,0.798354,0.201646,1.490662,92,6,1, merged,0,0,0.0524452003023
23529,1000014,1,969,826,143,0.852425,0.147575,0.852425,131,12,971,828,143,0.852729,0.147271,0.852729,131,12,-1, merged,0,0,0.622863653152
23529,1000534,2,36,22,14,0.611111,0.388889,1.463536,14,0,37,23,14,0.621622,0.378378,1.474351,14,0,1, merged,0,0,1.02254545455
23537,1000003,2,782,664,118,0.849105,0.150895,1.643865,111,7,783,665,118,0.849298,0.150702,1.64495,111,7,1, merged,0,0,0.4157434219
23538,1000121,4,979,803,176,0.820225,0.179775,3.477654,169,7,980,804,176,0.820408,0.179592,3.511457,169,7,1, merged,0,0,0.00288027529455
23540,1000015,1,1106,1015,91,0.917722,0.082278,0.917722,81,10,1107,1015,92,0.916893,0.083107,0.916893,81,11,-1, merged,1,1,0.0307751746192
23547,1000153,1,531,489,42,0.920904,0.079096,0.920904,32,10,532,490,42,0.921053,0.078947,0.921053,32,10,1, merged,0,0,0.0345230798018
23550,1000121,1,980,804,176,0.820408,0.179592,0.820408,169,7,984,805,179,0.818089,0.181911,0.818089,172,7,1, merged,1,1,0
23552,1000054,2,51,46,5,0.901961,0.098039,1.694553,3,2,53,47,6,0.886792,0.113208,1.677234,4,2,1, merged,1,1,0.0259488074538
23564,1000014,2,972,829,143,0.852881,0.147119,1.607241,131,12,973,830,143,0.853032,0.146968,1.607571,131,12,1, merged,0,0,0.175585769959
23564,1000329,1,1376,1038,338,0.75436,0.24564,0.75436,303,35,1377,1039,338,0.754539,0.245461,0.754539,303,35,1, merged,0,0,0.306980788236
23567,1000070,2,655,589,66,0.899237,0.100763,1.649237,54,12,656,590,66,0.89939,0.10061,1.621612,54,12,1, merged,0,0,0.106799581743
23574,1000004,2,1329,1146,183,0.862302,0.137698,1.695636,149,34,1330,1147,183,0.862406,0.137594,1.612406,149,34,1, merged,0,0,0.00932183044406
23581,1000328,3,432,301,131,0.696759,0.303241,1.500463,119,12,433,301,132,0.69515,0.30485,1.750297,120,12,1, merged,1,1,0.663688172043
23581,1000592,2,270,217,53,0.803704,0.196296,0.803704,38,15,272,219,53,0.805147,0.194853,1.055147,38,15,-1, merged,0,0,0.74759293114
23588,1000091,2,274,209,65,0.762774,0.237226,1.54987,57,8,275,210,65,0.763636,0.236364,1.551418,57,8,1, merged,0,0,0.436192343604
23591,1000327,3,558,433,125,0.775986,0.224014,2.208912,97,28,559,434,125,0.776386,0.223614,2.231568,97,28,1, merged,0,0,0.692336866168
23593,1000004,1,1335,1152,183,0.862921,0.137079,0.862921,149,34,1336,1153,183,0.863024,0.136976,0.863024,149,34,1, merged,0,0,0.380997407275
23593,1000329,2,1377,1039,338,0.754539,0.245461,1.61746,303,35,1378,1040,338,0.754717,0.245283,1.617741,303,35,1, merged,0,0,0.591983831947
23594,1000004,1,1336,1153,183,0.863024,0.136976,0.863024,149,34,1337,1154,183,0.863126,0.136874,0.863126,149,34,-1, abandoned,0,0,0.482153549467
23599,1000329,1,1378,1040,338,0.754717,0.245283,0.754717,303,35,1380,1042,338,0.755072,0.244928,0.755072,303,35,1, merged,0,0,0.203821020923
23610,1000063,2,1877,1675,202,0.892381,0.107619,1.822761,173,29,1878,1676,202,0.892439,0.107561,1.823038,173,29,1, merged,0,0,0.00414340347964
23612,1000063,2,1878,1676,202,0.892439,0.107561,1.823038,173,29,1879,1677,202,0.892496,0.107504,1.823314,173,29,1, merged,0,0,0.00416105307744
23619,1000118,1,627,554,73,0.883573,0.116427,0.883573,70,3,628,555,73,0.883758,0.116242,0.883758,70,3,1, merged,0,0,0.0357274702219
23631,1000004,3,1337,1154,183,0.863126,0.136874,2.478799,149,34,1338,1154,184,0.862481,0.137519,2.428205,150,34,1, merged,1,1,0.0984361433445
23631,1000327,2,559,434,125,0.776386,0.223614,1.615672,97,28,561,435,126,0.775401,0.224599,1.565724,98,28,1, merged,1,1,0.174602048294
23633,1000329,2,1380,1042,338,0.755072,0.244928,1.588406,303,35,1381,1043,338,0.75525,0.24475,1.589275,303,35,1, merged,0,0,0.0508658481342
23635,1000120,1,486,388,98,0.798354,0.201646,0.798354,92,6,487,389,98,0.798768,0.201232,0.798768,92,6,-1, merged,0,0,0.0385116221605
23635,1000534,2,37,23,14,0.621622,0.378378,1.419976,14,0,38,24,14,0.631579,0.368421,1.430347,14,0,1, merged,0,0,0.0126956948721
23640,1000199,2,232,189,43,0.814655,0.185345,1.593416,41,2,233,190,43,0.815451,0.184549,1.591766,41,2,1, merged,0,0,0.0293659448512
23641,1000199,2,233,190,43,0.815451,0.184549,1.715451,41,2,234,191,43,0.816239,0.183761,1.718678,41,2,1, merged,0,0,0.24465027444
23642,1000199,2,234,191,43,0.816239,0.183761,1.718678,41,2,236,193,43,0.817797,0.182203,1.724773,41,2,-1, merged,0,0,0.0306209202518
23644,1000007,3,549,467,82,0.850638,0.149362,2.607808,70,12,550,468,82,0.850909,0.149091,2.60385,70,12,1, merged,0,0,0.652144269743
23644,1000026,2,236,215,21,0.911017,0.088983,1.757171,19,2,238,217,21,0.911765,0.088235,1.752941,19,2,-1, merged,0,0,0.234153696595
23652,1000014,2,975,831,144,0.852308,0.147692,1.657455,132,12,976,832,144,0.852459,0.147541,1.65832,132,12,1, merged,0,0,0.580058120681
23652,1000592,1,272,219,53,0.805147,0.194853,0.805147,38,15,273,220,53,0.805861,0.194139,0.805861,38,15,1, merged,0,0,0.626718135029
23653,1000153,2,533,491,42,0.921201,0.078799,1.815611,32,10,534,492,42,0.921348,0.078652,1.81641,32,10,1, merged,0,0,1.11512975389
23663,1000004,2,1338,1154,184,0.862481,0.137519,1.775525,150,34,1339,1155,184,0.862584,0.137416,1.77687,150,34,-1, abandoned,0,0,0.0289944791344
23670,1000091,2,275,210,65,0.763636,0.236364,1.58015,57,8,276,211,65,0.764493,0.235507,1.578129,57,8,1, merged,0,0,0.627372085643
23671,1000004,3,1339,1155,184,0.862584,0.137416,2.428308,150,34,1341,1157,184,0.862789,0.137211,2.43224,150,34,1, merged,0,0,0.0418712964884
23671,1000327,2,561,435,126,0.775401,0.224599,1.565724,98,28,562,436,126,0.775801,0.224199,1.569452,98,28,1, merged,0,0,0.0140874249016
23677,1000592,2,273,220,53,0.805861,0.194139,1.680861,38,15,274,221,53,0.806569,0.193431,1.685357,38,15,1, merged,0,0,0.209695263975
23678,1000592,2,274,221,53,0.806569,0.193431,1.685357,38,15,275,222,53,0.807273,0.192727,1.692987,38,15,1, merged,0,0,0.196926308985
23681,1000329,2,1381,1043,338,0.75525,0.24475,1.590641,303,35,1382,1044,338,0.755427,0.244573,1.592162,303,35,1, merged,0,0,0.0264324608751
23686,1000329,2,1386,1048,338,0.756133,0.243867,1.592867,303,35,1387,1049,338,0.756309,0.243691,1.593707,303,35,1, merged,0,0,0.00154763210435
23687,1000329,2,1387,1049,338,0.756309,0.243691,1.593707,303,35,1388,1050,338,0.756484,0.243516,1.594541,303,35,1, merged,0,0,0
23691,1000329,1,1392,1054,338,0.757184,0.242816,0.757184,303,35,1393,1055,338,0.757358,0.242642,0.757358,303,35,1, merged,0,0,0
23697,1000329,2,1393,1055,338,0.757358,0.242642,1.593358,303,35,1394,1056,338,0.757532,0.242468,1.590866,303,35,1, merged,0,0,0
23703,1000026,1,238,217,21,0.911765,0.088235,0.911765,19,2,240,218,22,0.908333,0.091667,0.908333,20,2,1, merged,1,1,0.0346038172732
23706,1000327,2,562,436,126,0.775801,0.224199,1.569452,98,28,563,437,126,0.776199,0.223801,1.573074,98,28,1, merged,0,0,0.138847823135
23709,1000329,2,1397,1059,338,0.758053,0.241947,1.571689,303,35,1398,1060,338,0.758226,0.241774,1.568181,303,35,-1, merged,0,0,0.299638420031
23717,1000121,2,986,807,179,0.818458,0.181542,1.193458,172,7,987,808,179,0.818642,0.181358,1.171584,172,7,1, merged,0,0,0.0757106905141
23717,1000327,3,563,437,126,0.776199,0.223801,1.969657,98,28,564,437,127,0.774823,0.225177,1.946406,98,29,-1, merged,1,1,0.050268065231
23718,1000023,1,263,235,28,0.893536,0.106464,0.893536,25,3,264,235,29,0.890152,0.109848,0.890152,26,3,1, abandoned,1,1,0.00982811365449
23718,1000063,4,1883,1681,202,0.892724,0.107276,3.490157,173,29,1884,1682,202,0.892781,0.107219,3.438162,173,29,-1, abandoned,0,0,0.00629255985838
23719,1000003,2,783,665,118,0.849298,0.150702,1.645908,111,7,786,667,119,0.848601,0.151399,1.641849,112,7,-1, merged,1,0,0.073679074372
23726,1000004,1,1342,1158,184,0.862891,0.137109,0.862891,150,34,1344,1160,184,0.863095,0.136905,0.863095,150,34,-1, merged,0,0,0.0993272894754
23726,1000014,2,979,835,144,0.852911,0.147089,1.715802,132,12,980,836,144,0.853061,0.146939,1.716156,132,12,1, merged,0,0,0.165426809067
23728,1000004,3,1344,1160,184,0.863095,0.136905,2.547364,150,34,1348,1164,184,0.863501,0.136499,2.481291,150,34,-1, merged,0,0,0.0040529291926
23728,1000023,1,264,235,29,0.890152,0.109848,0.890152,26,3,268,238,30,0.88806,0.11194,0.88806,27,3,-1, merged,1,0,0.0191211051281
23728,1000063,4,1885,1683,202,0.892838,0.107162,3.440203,173,29,1886,1684,202,0.892895,0.107105,3.374186,173,29,-1, merged,0,0,0.00932470291432
23728,1000592,5,276,223,53,0.807971,0.192029,4.248174,38,15,278,224,54,0.805755,0.194245,4.179941,38,16,-1, merged,1,1,0.00574798846994
23732,1000004,1,1348,1164,184,0.863501,0.136499,0.863501,150,34,1350,1166,184,0.863704,0.136296,0.863704,150,34,-1, merged,0,0,0.160192653065
23732,1000329,2,1398,1060,338,0.758226,0.241774,1.621728,303,35,1400,1062,338,0.758571,0.241429,1.622275,303,35,-1, merged,0,0,0.303726017218
23734,1000592,1,278,224,54,0.805755,0.194245,0.805755,38,16,279,225,54,0.806452,0.193548,0.806452,38,16,1, merged,0,0,0.30337439854
23739,1000015,4,1113,1021,92,0.917341,0.082659,3.505356,81,11,1115,1022,93,0.916592,0.083408,3.088087,82,11,1, merged,1,1,0
23739,1000153,3,534,492,42,0.921348,0.078652,2.588015,32,10,535,493,42,0.921495,0.078505,2.171495,32,10,-1, merged,0,0,0
23748,1000004,2,1350,1166,184,0.863704,0.136296,1.73037,150,34,1351,1167,184,0.863805,0.136195,1.738805,150,34,1, merged,0,0,0.183695547183
23764,1000328,2,433,301,132,0.69515,0.30485,1.485626,120,12,434,302,132,0.695853,0.304147,1.486992,120,12,1, merged,0,0,1.16409100665
23765,1000328,2,434,302,132,0.695853,0.304147,1.486992,120,12,435,303,132,0.696552,0.303448,1.48835,120,12,1, merged,0,0,1.16591591592
23767,1000328,3,435,303,132,0.696552,0.303448,2.31154,120,12,436,304,132,0.697248,0.302752,2.313881,120,12,1, merged,0,0,0.568301351309
23772,1000118,2,628,555,73,0.883758,0.116242,1.707287,70,3,629,556,73,0.883943,0.116057,1.707965,70,3,1, merged,0,0,0.151164726625
23781,1000014,3,981,837,144,0.853211,0.146789,2.150086,132,12,982,838,144,0.85336,0.14664,2.320027,132,12,1, merged,0,0,0
23783,1000534,1,38,24,14,0.631579,0.368421,0.631579,14,0,41,25,16,0.609756,0.390244,0.609756,16,0,1, merged,1,1,0.0457142857143
23784,1000534,1,41,25,16,0.609756,0.390244,0.609756,16,0,42,26,16,0.619048,0.380952,0.619048,16,0,-1, merged,0,0,0
23790,1000091,2,276,211,65,0.764493,0.235507,1.557596,57,8,277,212,65,0.765343,0.234657,1.559093,57,8,1, merged,0,0,0.244183042855
23791,1000091,3,277,212,65,0.765343,0.234657,1.927514,57,8,278,213,65,0.766187,0.233813,1.893913,57,8,1, merged,0,0,0.359913961674
23793,1000063,2,1889,1687,202,0.893065,0.106935,1.824742,173,29,1890,1688,202,0.893122,0.106878,1.82501,173,29,1, merged,0,0,0.000782563947227
23801,1000012,1,336,299,37,0.889881,0.110119,0.889881,36,1,337,299,38,0.88724,0.11276,0.88724,37,1,1, merged,1,1,0.128030358863
23801,1000015,2,1115,1022,93,0.916592,0.083408,1.806473,82,11,1116,1023,93,0.916667,0.083333,1.803907,82,11,1, merged,0,0,0.17335482701
23802,1000012,1,337,299,38,0.88724,0.11276,0.88724,37,1,338,299,39,0.884615,0.115385,0.884615,38,1,1, merged,1,1,0.0855799526601
23802,1000015,2,1116,1023,93,0.916667,0.083333,1.803907,82,11,1117,1024,93,0.916741,0.083259,1.801357,82,11,1, merged,0,0,0.115593032819
23803,1000012,1,338,299,39,0.884615,0.115385,0.884615,38,1,339,299,40,0.882006,0.117994,0.882006,39,1,1, merged,1,1,0.00147266825011
23803,1000015,2,1117,1024,93,0.916741,0.083259,1.801357,82,11,1118,1025,93,0.916816,0.083184,1.798822,82,11,1, merged,0,0,0.00625462144427
23804,1000012,1,339,299,40,0.882006,0.117994,0.882006,39,1,340,299,41,0.879412,0.120588,0.879412,40,1,1, merged,1,1,0.498636763412
23804,1000015,2,1118,1025,93,0.916816,0.083184,1.798822,82,11,1120,1026,94,0.916071,0.083929,1.795483,83,11,1, merged,1,1,0.628402223834
23806,1000012,1,341,299,42,0.876833,0.123167,0.876833,41,1,342,299,43,0.874269,0.125731,0.874269,42,1,1, merged,1,1,0.247835184157
23806,1000015,2,1120,1026,94,0.916071,0.083929,1.792904,83,11,1121,1027,94,0.916146,0.083854,1.790415,83,11,1, merged,0,0,0.313899240846
23807,1000012,1,342,299,43,0.874269,0.125731,0.874269,42,1,343,299,44,0.87172,0.12828,0.87172,43,1,1, merged,1,1,0.248990171425
23807,1000015,2,1121,1027,94,0.916146,0.083854,1.790415,83,11,1122,1028,94,0.916221,0.083779,1.787941,83,11,1, merged,0,0,0.314075267455
23808,1000012,1,343,299,44,0.87172,0.12828,0.87172,43,1,344,299,45,0.869186,0.130814,0.869186,44,1,1, merged,1,1,0.00764591657696
23808,1000015,2,1122,1028,94,0.916221,0.083779,1.787941,83,11,1123,1029,94,0.916296,0.083704,1.785482,83,11,1, merged,0,0,0.0252839624982
23810,1000012,2,346,300,46,0.867052,0.132948,1.602684,45,1,347,300,47,0.864553,0.135447,1.595982,46,1,1, merged,1,1,0.00291494491212
23810,1000015,3,1123,1029,94,0.916296,0.083704,2.51898,83,11,1128,1031,97,0.914007,0.085993,2.509989,86,11,1, merged,1,1,0.00848502152339
23827,1000007,3,550,468,82,0.850909,0.149091,2.391452,70,12,551,469,82,0.85118,0.14882,2.400728,70,12,1, merged,0,0,0.434296698291
23827,1000153,2,535,493,42,0.921495,0.078505,1.540543,32,10,536,494,42,0.921642,0.078358,1.549549,32,10,1, merged,0,0,0.36842695392
23827,1000534,1,42,26,16,0.619048,0.380952,0.619048,16,0,43,27,16,0.627907,0.372093,0.627907,16,0,1, merged,0,0,0.411342042069
23830,1000007,2,552,470,82,0.851449,0.148551,1.479356,70,12,553,471,82,0.851718,0.148282,1.488082,70,12,1, merged,0,0,0.650546158519
23830,1000153,3,536,494,42,0.921642,0.078358,2.400998,32,10,537,495,42,0.921788,0.078212,2.409869,32,10,1, merged,0,0,0.552525537008
23830,1000534,1,43,27,16,0.627907,0.372093,0.627907,16,0,44,28,16,0.636364,0.363636,0.636364,16,0,1, merged,0,0,0.625835802668
23832,1000329,1,1403,1064,339,0.758375,0.241625,0.758375,304,35,1404,1064,340,0.757835,0.242165,0.757835,305,35,1, abandoned,1,1,0.549693948933
23835,1000121,3,988,809,179,0.818826,0.181174,2.383112,172,7,990,810,180,0.818182,0.181818,2.379748,173,7,1, merged,1,1,0.526185644277
23835,1000329,2,1404,1064,340,0.757835,0.242165,1.564286,305,35,1405,1064,341,0.757295,0.242705,1.561566,306,35,1, merged,1,1,0.567394977568
23835,1000592,1,279,225,54,0.806452,0.193548,0.806452,38,16,281,226,55,0.80427,0.19573,0.80427,39,16,1, merged,1,1,0.522686393966
23843,1000004,1,1352,1168,184,0.863905,0.136095,0.863905,150,34,1353,1169,184,0.864006,0.135994,0.864006,150,34,1, merged,0,0,0
23847,1000329,2,1405,1064,341,0.757295,0.242705,1.588004,306,35,1406,1065,341,0.757468,0.242532,1.588841,306,35,1, merged,0,0,0.113312493765
23849,1000329,2,1407,1066,341,0.75764,0.24236,1.589013,306,35,1408,1067,341,0.757812,0.242188,1.589844,306,35,1, merged,0,0,0.0141150209424
23856,1000091,2,278,213,65,0.766187,0.233813,1.662529,57,8,279,214,65,0.767025,0.232975,1.663682,57,8,-1, merged,0,0,0.079760391434
23859,1000014,2,982,838,144,0.85336,0.14664,1.65336,132,12,985,840,145,0.852792,0.147208,1.661615,133,12,-1, merged,1,0,0.0276058716883
23860,1000120,2,489,391,98,0.799591,0.200409,1.608415,92,6,490,392,98,0.8,0.2,1.611594,92,6,1, merged,0,0,0.483072993058
23861,1000327,4,564,437,127,0.774823,0.225177,2.971126,98,29,565,438,127,0.775221,0.224779,2.939444,98,29,-1, abandoned,0,0,0.610821638851
23861,1000592,5,281,226,55,0.80427,0.19573,3.775397,39,16,282,227,55,0.804965,0.195035,3.744409,39,16,-1, abandoned,0,0,0.638
23863,1000120,2,490,392,98,0.8,0.2,1.6,92,6,491,392,99,0.798371,0.201629,1.601188,92,7,-1, merged,1,1,0
23878,1000004,1,1354,1170,184,0.864106,0.135894,0.864106,150,34,1355,1170,185,0.863469,0.136531,0.863469,151,34,1, merged,1,1,0.184133455426
23878,1000120,2,494,395,99,0.799595,0.200405,1.663701,92,7,495,396,99,0.8,0.2,1.663469,92,7,1, merged,0,0,0.277302060644
23890,1000011,1,388,360,28,0.927835,0.072165,0.927835,25,3,389,361,28,0.928021,0.071979,0.928021,25,3,1, merged,0,0,0.259109474081
23907,1000121,2,990,810,180,0.818182,0.181818,1.57668,173,7,991,811,180,0.818365,0.181635,1.576327,173,7,1, merged,0,0,0.123712780375
23907,1000329,1,1412,1071,341,0.758499,0.241501,0.758499,306,35,1413,1071,342,0.757962,0.242038,0.757962,307,35,1, merged,1,1,0.130302955066
23910,1000026,2,240,218,22,0.908333,0.091667,1.771643,20,2,241,219,22,0.908714,0.091286,1.772999,20,2,1, merged,0,0,0.280725623583
23910,1000166,1,139,120,19,0.863309,0.136691,0.863309,18,1,140,121,19,0.864286,0.135714,0.864286,18,1,1, merged,0,0,0.959200107009
23911,1000592,2,285,230,55,0.807018,0.192982,0.807018,39,16,286,230,56,0.804196,0.195804,1.804196,40,16,1, abandoned,1,1,0.359460235429
23916,1000004,2,1356,1171,185,0.863569,0.136431,1.56151,151,34,1357,1172,185,0.86367,0.13633,1.5623,151,34,1, merged,0,0,0.150706619418
23916,1000328,1,437,305,132,0.697941,0.302059,0.697941,120,12,438,306,132,0.69863,0.30137,0.69863,120,12,1, merged,0,0,0.330478223371
23917,1000328,2,438,306,132,0.69863,0.30137,1.456763,120,12,440,307,133,0.697727,0.302273,1.455324,121,12,1, merged,1,1,0.51822367085
23917,1000329,1,1414,1072,342,0.758133,0.241867,0.758133,307,35,1415,1072,343,0.757597,0.242403,0.757597,308,35,1, merged,1,1,0.431882328371
23921,1000328,1,444,310,134,0.698198,0.301802,0.698198,122,12,446,311,135,0.697309,0.302691,0.697309,123,12,1, merged,1,1,0.522213287448
23927,1000004,1,1357,1172,185,0.86367,0.13633,0.86367,151,34,1358,1172,186,0.863034,0.136966,0.863034,152,34,1, merged,1,1,0.240789367001
23927,1000070,3,659,592,67,0.898331,0.101669,2.524713,55,12,660,593,67,0.898485,0.101515,2.524632,55,12,1, merged,0,0,0.294207381868
23962,1000121,2,991,811,180,0.818365,0.181635,1.575962,173,7,992,812,180,0.818548,0.181452,1.576317,173,7,1, merged,0,0,0
23962,1000329,1,1415,1072,343,0.757597,0.242403,0.757597,308,35,1416,1073,343,0.757768,0.242232,0.757768,308,35,1, merged,0,0,0
23963,1000014,1,988,843,145,0.853239,0.146761,0.853239,133,12,989,844,145,0.853387,0.146613,0.853387,133,12,1, merged,0,0,0.66738407829
23963,1000132,2,155,136,19,0.877419,0.122581,1.730658,16,3,156,137,19,0.878205,0.121795,1.731592,16,3,1, merged,0,0,0.662887112887
23971,1000592,2,292,236,56,0.808219,0.191781,1.537949,40,16,293,237,56,0.808874,0.191126,1.545716,40,16,1, merged,0,0,0.216824658858
23980,1000153,1,538,496,42,0.921933,0.078067,0.921933,32,10,539,497,42,0.922078,0.077922,0.922078,32,10,1, merged,0,0,1.07578451257
23983,1000009,1,512,432,80,0.84375,0.15625,0.84375,72,8,513,433,80,0.844055,0.155945,0.844055,72,8,1, merged,0,0,1.11517953652
23983,1000153,2,539,497,42,0.922078,0.077922,1.765828,32,10,540,498,42,0.922222,0.077778,1.766277,32,10,1, merged,0,0,1.07622088096
24055,1000004,1,1360,1174,186,0.863235,0.136765,0.863235,152,34,1361,1174,187,0.862601,0.137399,0.862601,152,35,-1, merged,1,1,0.458601492506
24055,1000121,2,992,812,180,0.818548,0.181452,1.681784,173,7,993,813,180,0.818731,0.181269,1.681332,173,7,1, merged,0,0,0.665613756138
24056,1000199,4,237,194,43,0.818565,0.181435,3.2324,41,2,238,194,44,0.815126,0.184874,3.22849,42,2,1, merged,1,1,0
24056,1000329,2,1416,1073,343,0.757768,0.242232,1.586562,308,35,1419,1076,343,0.75828,0.24172,1.584535,308,35,-1, merged,0,0,0
24057,1000329,1,1419,1076,343,0.75828,0.24172,0.75828,308,35,1420,1077,343,0.758451,0.241549,0.758451,308,35,1, merged,0,0,0.0011767754816
24062,1000329,3,1420,1077,343,0.758451,0.241549,2.125786,308,35,1422,1079,343,0.75879,0.24121,2.110007,308,35,-1, merged,0,0,0.275484531733
24067,1000329,2,1422,1079,343,0.75879,0.24121,1.504245,308,35,1423,1080,343,0.75896,0.24104,1.505948,308,35,1, merged,0,0,0.315358938365
24069,1000003,1,787,668,119,0.848793,0.151207,0.848793,112,7,788,669,119,0.848985,0.151015,0.848985,112,7,1, merged,0,0,0.551373329052
24069,1000091,2,279,214,65,0.767025,0.232975,1.615818,57,8,280,215,65,0.767857,0.232143,1.616842,57,8,1, merged,0,0,0.525945323527
24074,1000023,1,269,239,30,0.888476,0.111524,0.888476,27,3,270,240,30,0.888889,0.111111,0.888889,27,3,1, merged,0,0,0.0852643078799
24074,1000063,3,1895,1693,202,0.893404,0.106596,2.545393,173,29,1896,1694,202,0.89346,0.10654,2.546261,173,29,1, merged,0,0,0.0412735693528
24076,1000004,1,1362,1175,187,0.862702,0.137298,0.862702,152,35,1363,1176,187,0.862803,0.137197,0.862803,152,35,1, merged,0,0,0.0518312375455
24076,1000121,3,993,813,180,0.818731,0.181269,2.407239,173,7,994,814,180,0.818913,0.181087,2.411875,173,7,1, merged,0,0,0.0109014109823
24078,1000121,4,994,814,180,0.818913,0.181087,3.077218,173,7,997,816,181,0.818455,0.181545,3.030878,174,7,-1, merged,1,0,0.3468427632
24078,1000592,1,293,237,56,0.808874,0.191126,0.808874,40,16,294,238,56,0.809524,0.190476,0.809524,40,16,-1, merged,0,0,0.354031830055
24080,1000063,1,1896,1694,202,0.89346,0.10654,0.89346,173,29,1897,1695,202,0.893516,0.106484,0.893516,173,29,1, merged,0,0,0.283584973367
24081,1000121,2,997,816,181,0.818455,0.181545,1.545728,174,7,998,817,181,0.818637,0.181363,1.568637,174,7,1, merged,0,0,0.588968574851
24083,1000121,3,998,817,181,0.818637,0.181363,2.23519,174,7,999,818,181,0.818819,0.181181,2.229328,174,7,1, merged,0,0,0.0511933307179
24085,1000023,1,270,240,30,0.888889,0.111111,0.888889,27,3,271,241,30,0.889299,0.110701,0.889299,27,3,1, merged,0,0,0.679744999435
24091,1000592,2,295,239,56,0.810169,0.189831,1.566267,40,16,296,240,56,0.810811,0.189189,1.572716,40,16,1, merged,0,0,0.268284543326
24093,1000091,2,283,217,66,0.766784,0.233216,1.463889,57,9,285,219,66,0.768421,0.231579,1.466869,57,9,-1, merged,0,0,0.246599218004
24093,1000328,1,449,313,136,0.697105,0.302895,0.697105,124,12,451,315,136,0.698448,0.301552,0.698448,124,12,-1, merged,0,0,0.277370391516
24094,1000009,2,513,433,80,0.844055,0.155945,1.480418,72,8,515,434,81,0.842718,0.157282,1.488552,73,8,1, merged,1,1,0.11541188365
24094,1000153,3,540,498,42,0.922222,0.077778,2.40264,32,10,542,499,43,0.920664,0.079336,2.409216,33,10,1, merged,1,1,0.107660337927
24094,1000534,1,44,28,16,0.636364,0.363636,0.636364,16,0,48,31,17,0.645833,0.354167,0.645833,17,0,-1, merged,1,0,0.128489407021
24095,1000327,4,565,438,127,0.775221,0.224779,2.769572,98,29,566,439,127,0.775618,0.224382,2.794185,98,29,1, merged,0,0,0.348476701516
24099,1000004,2,1364,1177,187,0.862903,0.137097,1.673714,152,35,1365,1178,187,0.863004,0.136996,1.674451,152,35,1, merged,0,0,0.0403929576797
24099,1000014,3,991,846,145,0.853683,0.146317,2.527397,133,12,992,847,145,0.853831,0.146169,2.528282,133,12,1, merged,0,0,0.0551203221797
24099,1000592,1,296,240,56,0.810811,0.189189,0.810811,40,16,297,241,56,0.811448,0.188552,0.811448,40,16,1, merged,0,0,0.0546762743501
24101,1000592,2,297,241,56,0.811448,0.188552,1.573353,40,16,298,242,56,0.812081,0.187919,1.579522,40,16,1, merged,0,0,0.239783918434
24116,1000327,2,566,439,127,0.775618,0.224382,1.505777,98,29,567,440,127,0.776014,0.223986,1.510389,98,29,1, merged,0,0,0.0777794959518
24117,1000329,1,1427,1084,343,0.759636,0.240364,0.759636,308,35,1428,1084,344,0.759104,0.240896,0.759104,309,35,1, abandoned,1,1,0.112459829028
24119,1000003,2,788,669,119,0.848985,0.151015,1.737874,112,7,789,670,119,0.849176,0.150824,1.749176,112,7,1, merged,0,0,0.00483415254917
24128,1000329,1,1429,1085,344,0.759272,0.240728,0.759272,309,35,1431,1086,345,0.75891,0.24109,0.75891,310,35,-1, abandoned,1,0,0
24137,1000012,3,347,300,47,0.864553,0.135447,2.517008,46,1,348,301,47,0.864943,0.135057,2.532819,46,1,1, merged,0,0,0.00538608194739
24139,1000004,2,1366,1179,187,0.863104,0.136896,1.622014,152,35,1367,1180,187,0.863204,0.136796,1.62245,152,35,1, merged,0,0,0.179716013561
24139,1000329,1,1431,1086,345,0.75891,0.24109,0.75891,310,35,1433,1088,345,0.759246,0.240754,0.759246,310,35,1, merged,0,0,0.273675429322
24145,1000328,1,451,315,136,0.698448,0.301552,0.698448,124,12,452,316,136,0.699115,0.300885,0.699115,124,12,1, merged,0,0,1.1242663259
24145,1000329,2,1433,1088,345,0.759246,0.240754,1.457694,310,35,1434,1089,345,0.759414,0.240586,1.458529,310,35,1, merged,0,0,0.891794556738
24149,1000328,1,452,316,136,0.699115,0.300885,0.699115,124,12,454,317,137,0.698238,0.301762,0.698238,125,12,1, merged,1,1,0.0340920774926
24164,1000004,1,1367,1180,187,0.863204,0.136796,0.863204,152,35,1368,1181,187,0.863304,0.136696,0.863304,152,35,-1, merged,0,0,0.385669445151
24164,1000120,2,499,400,99,0.801603,0.198397,1.664807,92,7,501,402,99,0.802395,0.197605,1.665699,92,7,-1, merged,0,0,0.479202795546
24165,1000004,1,1368,1181,187,0.863304,0.136696,0.863304,152,35,1369,1182,187,0.863404,0.136596,0.863404,152,35,1, merged,0,0,0.0367595699514
24165,1000327,3,567,440,127,0.776014,0.223986,2.303184,98,29,568,441,127,0.776408,0.223592,2.306479,98,29,1, merged,0,0,0.00982813625605
24169,1000120,1,501,402,99,0.802395,0.197605,0.802395,92,7,502,403,99,0.802789,0.197211,0.802789,92,7,1, merged,0,0,0
24174,1000070,1,660,593,67,0.898485,0.101515,0.898485,55,12,661,593,68,0.897126,0.102874,0.897126,56,12,1, abandoned,1,1,0.162081260308
24175,1000070,1,661,593,68,0.897126,0.102874,0.897126,56,12,662,593,69,0.89577,0.10423,0.89577,57,12,1, merged,1,1,0.660775247807
24184,1000534,1,48,31,17,0.645833,0.354167,0.645833,17,0,49,32,17,0.653061,0.346939,0.653061,17,0,1, merged,0,0,0.647047070027
24207,1000329,3,1435,1090,345,0.759582,0.240418,2.196934,310,35,1436,1091,345,0.759749,0.240251,2.21589,310,35,1, merged,0,0,0.83842801567
24209,1000121,2,1003,820,183,0.817547,0.182453,1.489961,176,7,1004,821,183,0.817729,0.182271,1.492943,176,7,1, merged,0,0,0.215566426607
24211,1000012,1,348,301,47,0.864943,0.135057,0.864943,46,1,349,301,48,0.862464,0.137536,0.862464,47,1,1, merged,1,1,0.00119940749799
24211,1000120,2,502,403,99,0.802789,0.197211,1.667731,92,7,503,404,99,0.803181,0.196819,1.665645,92,7,1, merged,0,0,0.0127241156125
24214,1000121,2,1004,821,183,0.817729,0.182271,1.492943,176,7,1005,822,183,0.81791,0.18209,1.495877,176,7,1, merged,0,0,0.00378323966616
24221,1000327,2,568,441,127,0.776408,0.223592,1.443075,98,29,569,442,127,0.776801,0.223199,1.450271,98,29,1, merged,0,0,0.69253600823
24224,1000003,2,790,671,119,0.849367,0.150633,1.749367,112,7,791,672,119,0.849558,0.150442,1.758648,112,7,1, merged,0,0,0.278957268663
24227,1000121,2,1005,822,183,0.81791,0.18209,1.495877,176,7,1006,823,183,0.818091,0.181909,1.501425,176,7,1, merged,0,0,0.528974012789
24228,1000063,1,1908,1705,203,0.893606,0.106394,0.893606,174,29,1909,1706,203,0.893662,0.106338,0.893662,174,29,1, merged,0,0,0.334354298716
24232,1000109,2,331,275,56,0.830816,0.169184,1.605707,54,2,332,276,56,0.831325,0.168675,1.607187,54,2,1, merged,0,0,0.0346201306072
24234,1000004,2,1369,1182,187,0.863404,0.136596,1.623626,152,35,1371,1184,187,0.863603,0.136397,1.623797,152,35,-1, merged,0,0,0.00420987780593
24234,1000329,1,1443,1097,346,0.760222,0.239778,0.760222,311,35,1447,1100,347,0.760194,0.239806,0.760194,312,35,-1, merged,1,0,0.000892477681611
24249,1000120,2,503,404,99,0.803181,0.196819,1.456242,92,7,504,405,99,0.803571,0.196429,1.470238,92,7,1, merged,0,0,0.0198117880139
24249,1000534,1,49,32,17,0.653061,0.346939,0.653061,17,0,51,34,17,0.666667,0.333333,0.666667,17,0,-1, merged,0,0,0.0133779264214
24278,1000004,1,1372,1185,187,0.863703,0.136297,0.863703,152,35,1373,1186,187,0.863802,0.136198,0.863802,152,35,-1, merged,0,0,0.0509122926608
24279,1000328,1,455,318,137,0.698901,0.301099,0.698901,125,12,457,320,137,0.700219,0.299781,0.700219,125,12,-1, merged,0,0,0.178306784087
24280,1000328,1,457,320,137,0.700219,0.299781,0.700219,125,12,459,321,138,0.699346,0.300654,0.699346,126,12,1, merged,1,1,0.281940943144
24280,1000329,3,1447,1100,347,0.760194,0.239806,2.223835,312,35,1448,1100,348,0.759669,0.240331,2.221557,313,35,1, merged,1,1,0.222997418307
24281,1000328,1,459,321,138,0.699346,0.300654,0.699346,126,12,462,322,140,0.69697,0.30303,0.69697,128,12,1, merged,1,1,0.179174714978
24281,1000329,3,1448,1100,348,0.759669,0.240331,2.221557,313,35,1449,1100,349,0.759144,0.240856,2.216513,314,35,1, merged,1,1,0.12605629106
24282,1000091,5,287,221,66,0.770035,0.229965,3.80464,57,9,288,222,66,0.770833,0.229167,3.807042,57,9,1, merged,0,0,0.0681736843767
24282,1000121,4,1006,823,183,0.818091,0.181909,3.034605,176,7,1007,824,183,0.818272,0.181728,3.036209,176,7,1, merged,0,0,0.042198504456
24282,1000328,1,462,322,140,0.69697,0.30303,0.69697,128,12,465,325,140,0.698925,0.301075,0.698925,128,12,-1, merged,0,0,0.0807185408023
24282,1000329,3,1449,1100,349,0.759144,0.240856,2.216513,314,35,1451,1102,349,0.759476,0.240524,2.217937,314,35,-1, merged,0,0,0.0546966867021
24283,1000328,1,465,325,140,0.698925,0.301075,0.698925,128,12,466,326,140,0.699571,0.300429,0.699571,128,12,1, merged,0,0,0.282512389021
24283,1000329,2,1451,1102,349,0.759476,0.240524,1.458401,314,35,1452,1103,349,0.759642,0.240358,1.459213,314,35,1, merged,0,0,0.287769676493
24284,1000328,1,466,326,140,0.699571,0.300429,0.699571,128,12,467,327,140,0.700214,0.299786,0.700214,128,12,1, merged,0,0,0.481581376524
24284,1000329,2,1452,1103,349,0.759642,0.240358,1.459213,314,35,1453,1104,349,0.759807,0.240193,1.460021,314,35,1, merged,0,0,0.433496719054
24285,1000328,1,467,327,140,0.700214,0.299786,0.700214,128,12,469,327,142,0.697228,0.302772,0.697228,128,14,-1, merged,1,1,0.291376132486
24285,1000329,2,1453,1104,349,0.759807,0.240193,1.460021,314,35,1454,1105,349,0.759972,0.240028,1.457201,314,35,1, merged,0,0,0.297719501671
24286,1000328,1,469,327,142,0.697228,0.302772,0.697228,128,14,471,327,144,0.694268,0.305732,0.694268,130,14,1, merged,1,1,0.142753293957
24286,1000329,2,1454,1105,349,0.759972,0.240028,1.457201,314,35,1457,1106,351,0.759094,0.240906,1.453362,316,35,1, merged,1,1,0.147671466656
24287,1000329,1,1457,1106,351,0.759094,0.240906,0.759094,316,35,1458,1107,351,0.759259,0.240741,0.759259,316,35,1, merged,0,0,0.118037079269
24294,1000023,1,275,244,31,0.887273,0.112727,0.887273,28,3,277,245,32,0.884477,0.115523,0.884477,29,3,1, merged,1,1,0.000605434666477
24294,1000592,2,299,243,56,0.812709,0.187291,1.699982,40,16,300,244,56,0.813333,0.186667,1.69781,40,16,-1, merged,0,0,0.00257441673371
24296,1000120,2,504,405,99,0.803571,0.196429,1.470238,92,7,505,406,99,0.80396,0.19604,1.464338,92,7,-1, abandoned,0,0,0.149620427881
24296,1000534,1,51,34,17,0.666667,0.333333,0.666667,17,0,53,35,18,0.660377,0.339623,0.660377,18,0,-1, abandoned,1,0,0.0733333333333
24300,1000014,2,998,853,145,0.854709,0.145291,1.748538,133,12,999,854,145,0.854855,0.145145,1.748739,133,12,1, merged,0,0,0.489363871435
24300,1000063,1,1912,1709,203,0.893828,0.106172,0.893828,174,29,1913,1710,203,0.893884,0.106116,0.893884,174,29,1, merged,0,0,0.26733810304
24303,1000004,1,1373,1186,187,0.863802,0.136198,0.863802,152,35,1374,1187,187,0.863901,0.136099,0.863901,152,35,1, merged,0,0,0.00875817884406
24303,1000014,3,999,854,145,0.854855,0.145145,2.603133,133,12,1000,855,145,0.855,0.145,2.603793,133,12,1, merged,0,0,0.00909208150632
24303,1000023,2,277,245,32,0.884477,0.115523,1.748278,29,3,278,246,32,0.884892,0.115108,1.748793,29,3,1, merged,0,0,0.000106833802215
24304,1000121,2,1007,824,183,0.818272,0.181728,1.577696,176,7,1008,825,183,0.818452,0.181548,1.578041,176,7,1, merged,0,0,0.694175998511
24304,1000329,1,1459,1108,351,0.759424,0.240576,0.759424,316,35,1460,1109,351,0.759589,0.240411,0.759589,316,35,-1, merged,0,0,0.908427113812
24306,1000063,2,1913,1710,203,0.893884,0.106116,1.827419,174,29,1914,1711,203,0.893939,0.106061,1.827674,174,29,1, merged,0,0,0.00423365501714
24313,1000003,1,791,672,119,0.849558,0.150442,0.849558,112,7,793,674,119,0.849937,0.150063,0.849937,112,7,-1, merged,0,0,0.0306195361091
24314,1000063,3,1914,1711,203,0.893939,0.106061,2.761008,174,29,1916,1712,204,0.893528,0.106472,2.749194,174,30,-1, merged,1,0,0.00694587842006
24319,1000130,2,196,165,31,0.841837,0.158163,1.619615,23,8,197,166,31,0.84264,0.15736,1.601676,23,8,1, merged,0,0,0.0696435385439
24329,1000329,2,1460,1109,351,0.759589,0.240411,1.433058,316,35,1461,1110,351,0.759754,0.240246,1.439754,316,35,1, merged,0,0,0.839222958944
24335,1000004,2,1374,1187,187,0.863901,0.136099,1.524278,152,35,1375,1188,187,0.864,0.136,1.530667,152,35,1, merged,0,0,0.0135400135656
24335,1000120,3,505,406,99,0.80396,0.19604,2.328239,92,7,506,407,99,0.804348,0.195652,2.335014,92,7,1, merged,0,0,0.151187607573
24335,1000534,1,53,35,18,0.660377,0.339623,0.660377,18,0,54,36,18,0.666667,0.333333,0.666667,18,0,1, merged,0,0,0.0863787375415
24339,1000004,2,1375,1188,187,0.864,0.136,1.719015,152,35,1377,1189,188,0.863471,0.136529,1.716937,153,35,-1, merged,1,0,0.0339775700384
24339,1000014,1,1007,861,146,0.855015,0.144985,0.855015,134,12,1010,862,148,0.853465,0.146535,0.853465,136,12,1, merged,1,1,0.0552541065946
24340,1000004,1,1377,1189,188,0.863471,0.136529,0.863471,153,35,1379,1191,188,0.863669,0.136331,0.863669,153,35,-1, merged,0,0,0.378824486832
24340,1000014,2,1010,862,148,0.853465,0.146535,1.716937,136,12,1012,863,149,0.852767,0.147233,1.716436,137,12,1, merged,1,1,0.626845391113
24342,1000043,3,282,233,49,0.826241,0.173759,2.26911,43,6,284,234,50,0.823944,0.176056,2.26125,44,6,1, merged,1,1,0.00514668937383
24345,1000063,2,1916,1712,204,0.893528,0.106472,1.771079,174,30,1917,1713,204,0.893584,0.106416,1.773584,174,30,1, merged,0,0,0.338746561434
24346,1000063,2,1917,1713,204,0.893584,0.106416,1.773584,174,30,1918,1714,204,0.893639,0.106361,1.775992,174,30,1, merged,0,0,0.338847260277
24347,1000003,2,793,674,119,0.849937,0.150063,1.68327,112,7,794,675,119,0.850126,0.149874,1.69628,112,7,1, merged,0,0,0.963351943755
24348,1000003,2,794,675,119,0.850126,0.149874,1.69628,112,7,797,678,119,0.85069,0.14931,1.65069,112,7,-1, merged,0,0,0.0960656015613
24350,1000153,2,543,500,43,0.92081,0.07919,1.856525,33,10,544,501,43,0.920956,0.079044,1.850034,33,10,1, merged,0,0,0.53551680834
24352,1000121,1,1008,825,183,0.818452,0.181548,0.818452,176,7,1009,826,183,0.818632,0.181368,0.818632,176,7,1, merged,0,0,0.522692466711
24364,1000327,4,569,442,127,0.776801,0.223199,3.001943,98,29,570,443,127,0.777193,0.222807,3.003785,98,29,1, merged,0,0,0.348273619555
24364,1000328,3,472,328,144,0.694915,0.305085,2.225141,130,14,473,329,144,0.69556,0.30444,2.226592,130,14,1, merged,0,0,0.536790034709
24364,1000329,1,1462,1111,351,0.759918,0.240082,0.759918,316,35,1463,1112,351,0.760082,0.239918,0.760082,316,35,1, merged,0,0,0.457353554379
24375,1000109,3,332,276,56,0.831325,0.168675,2.224915,54,2,333,277,56,0.831832,0.168168,2.234919,54,2,1, merged,0,0,0.245861643875
24375,1000199,1,240,196,44,0.816667,0.183333,0.816667,42,2,242,198,44,0.818182,0.181818,0.818182,42,2,-1, merged,0,0,0.254437782547
24376,1000004,1,1380,1191,189,0.863043,0.136957,0.863043,153,36,1382,1192,190,0.862518,0.137482,0.862518,154,36,-1, merged,1,0,0.101773831608
24376,1000014,2,1015,866,149,0.853202,0.146798,1.716245,137,12,1016,867,149,0.853346,0.146654,1.715865,137,12,1, merged,0,0,0.141639477182
24377,1000124,2,341,314,27,0.920821,0.079179,1.682726,25,2,342,315,27,0.921053,0.078947,1.648325,25,2,1, merged,0,0,0.0640597107495
24379,1000003,3,797,678,119,0.85069,0.14931,2.39859,112,7,798,679,119,0.850877,0.149123,2.392689,112,7,1, merged,0,0,0.0746536238904
24386,1000199,1,242,198,44,0.818182,0.181818,0.818182,42,2,244,200,44,0.819672,0.180328,0.819672,42,2,-1, merged,0,0,0.0848942629149
24396,1000109,3,333,277,56,0.831832,0.168168,2.244097,54,2,334,278,56,0.832335,0.167665,2.260616,54,2,1, merged,0,0,0.0412103014676
24396,1000199,2,244,200,44,0.819672,0.180328,1.412265,42,2,246,202,44,0.821138,0.178862,1.428281,42,2,-1, merged,0,0,0.0426520165016
24405,1000091,2,288,222,66,0.770833,0.229167,1.530915,57,9,289,223,66,0.771626,0.228374,1.531872,57,9,1, merged,0,0,0.641026275739
24405,1000329,1,1463,1112,351,0.760082,0.239918,0.760082,316,35,1464,1113,351,0.760246,0.239754,0.760246,316,35,1, merged,0,0,0.901874747766
24414,1000091,2,289,223,66,0.771626,0.228374,1.590259,57,9,290,224,66,0.772414,0.227586,1.591226,57,9,1, merged,0,0,0.159032213994
24414,1000121,1,1009,826,183,0.818632,0.181368,0.818632,176,7,1010,827,183,0.818812,0.181188,0.818812,176,7,1, merged,0,0,0.0725237506221
24415,1000199,2,246,202,44,0.821138,0.178862,1.621138,42,2,249,204,45,0.819277,0.180723,1.485944,43,2,1, merged,1,1,0.0643640461302
24417,1000015,2,1141,1042,99,0.913234,0.086766,1.646567,88,11,1142,1043,99,0.91331,0.08669,1.66331,88,11,1, merged,0,0,0.0262242599298
24418,1000004,1,1383,1193,190,0.862617,0.137383,0.862617,154,36,1384,1194,190,0.862717,0.137283,0.862717,154,36,1, merged,0,0,0.181145194912
24422,1000004,1,1386,1196,190,0.862915,0.137085,0.862915,154,36,1388,1198,190,0.863112,0.136888,0.863112,154,36,-1, merged,0,0,0
24423,1000005,2,178,132,46,0.741573,0.258427,1.637657,42,4,179,133,46,0.743017,0.256983,1.63641,42,4,1, merged,0,0,0.213879679601
24423,1000070,1,664,595,69,0.896084,0.103916,0.896084,57,12,666,595,71,0.893393,0.106607,0.893393,59,12,1, merged,1,1,0.396475812638
24426,1000121,4,1010,827,183,0.818812,0.181188,3.032735,176,7,1011,828,183,0.818991,0.181009,3.034112,176,7,1, merged,0,0,0.0739934302419
24426,1000328,1,473,329,144,0.69556,0.30444,0.69556,130,14,474,330,144,0.696203,0.303797,0.696203,130,14,1, merged,0,0,0.14128803614
24426,1000329,3,1464,1113,351,0.760246,0.239754,2.213923,316,35,1465,1114,351,0.76041,0.23959,2.215121,316,35,1, merged,0,0,0.0958924371349
24427,1000121,2,1011,828,183,0.818991,0.181009,1.579401,176,7,1012,829,183,0.81917,0.18083,1.579061,176,7,1, merged,0,0,0.00163685152057
24427,1000329,1,1465,1114,351,0.76041,0.23959,0.76041,316,35,1466,1114,352,0.759891,0.240109,0.759891,316,36,-1, merged,1,1,0.000420450723175
24428,1000004,1,1388,1198,190,0.863112,0.136888,0.863112,154,36,1389,1199,190,0.863211,0.136789,0.863211,154,36,1, merged,0,0,0.00820506820312
24447,1000043,1,284,234,50,0.823944,0.176056,0.823944,44,6,285,235,50,0.824561,0.175439,0.824561,44,6,1, merged,0,0,0.204855735398
24448,1000015,2,1143,1044,99,0.913386,0.086614,1.663386,88,11,1144,1045,99,0.913462,0.086538,1.678167,88,11,1, merged,0,0,0.0112492100274
24449,1000009,1,518,437,81,0.843629,0.156371,0.843629,73,8,519,438,81,0.843931,0.156069,0.843931,73,8,1, merged,0,0,0.605884951062
24449,1000014,2,1020,871,149,0.853922,0.146078,1.697551,137,12,1021,872,149,0.854065,0.145935,1.697995,137,12,1, merged,0,0,0.509127849114
24456,1000329,1,1468,1115,353,0.759537,0.240463,0.759537,317,36,1470,1116,354,0.759184,0.240816,0.759184,317,37,-1, merged,1,1,0.637430972389
24457,1000329,1,1470,1116,354,0.759184,0.240816,0.759184,317,37,1472,1117,355,0.758832,0.241168,0.758832,318,37,1, merged,1,1,0
24470,1000004,1,1389,1199,190,0.863211,0.136789,0.863211,154,36,1390,1200,190,0.863309,0.136691,0.863309,154,36,1, merged,0,0,0.391076204724
24470,1000120,2,510,411,99,0.805882,0.194118,1.669093,92,7,511,412,99,0.806262,0.193738,1.669572,92,7,1, merged,0,0,0.526793062904
24473,1000043,3,285,235,50,0.824561,0.175439,2.263789,44,6,287,236,51,0.8223,0.1777,2.249533,45,6,1, merged,1,1,0.393188670474
24476,1000023,2,279,247,32,0.885305,0.114695,1.747441,29,3,280,248,32,0.885714,0.114286,1.748117,29,3,1, merged,0,0,0.68999064748
24493,1000014,3,1022,873,149,0.854207,0.145793,2.453039,137,12,1024,875,149,0.854492,0.145508,2.427623,137,12,-1, merged,0,0,0.26800381281
24493,1000120,4,512,413,99,0.806641,0.193359,3.25968,92,7,513,414,99,0.807018,0.192982,3.234641,92,7,1, merged,0,0,0.221536963733
24493,1000329,1,1472,1117,355,0.758832,0.241168,0.758832,318,37,1473,1117,356,0.758316,0.241684,0.758316,319,37,1, merged,1,1,0.447513725581
24500,1000009,2,522,441,81,0.844828,0.155172,1.821572,73,8,523,442,81,0.845124,0.154876,1.822397,73,8,1, merged,0,0,1.02301587302
24516,1000011,1,397,369,28,0.929471,0.070529,0.929471,25,3,398,370,28,0.929648,0.070352,0.929648,25,3,1, merged,0,0,0.356392690705
24516,1000120,2,513,414,99,0.807018,0.192982,1.736489,92,7,514,415,99,0.807393,0.192607,1.737041,92,7,1, merged,0,0,0.272324827345
24519,1000109,2,334,278,56,0.832335,0.167665,1.610113,54,2,335,279,56,0.832836,0.167164,1.611559,54,2,1, merged,0,0,0.084886380573
24521,1000109,3,335,279,56,0.832836,0.167164,2.417115,54,2,336,280,56,0.833333,0.166667,2.421214,54,2,1, merged,0,0,0.126153833925
24526,1000023,4,280,248,32,0.885714,0.114286,3.625686,29,3,281,249,32,0.886121,0.113879,3.618094,29,3,1, merged,0,0,0.00236401789324
24526,1000063,3,1921,1716,205,0.893285,0.106715,2.739972,175,30,1923,1717,206,0.892876,0.107124,2.731973,175,31,-1, merged,1,0,0.00148556845589
24529,1000063,2,1923,1717,206,0.892876,0.107124,1.821447,175,31,1924,1718,206,0.892931,0.107069,1.821715,175,31,1, merged,0,0,0.00791125269087
24532,1000023,3,281,249,32,0.886121,0.113879,2.721881,29,3,282,250,32,0.886525,0.113475,2.723446,29,3,1, merged,0,0,0.00897646414888
24551,1000329,1,1480,1124,356,0.759459,0.240541,0.759459,319,37,1481,1124,357,0.758947,0.241053,0.758947,320,37,1, merged,1,1,0.0638166921977
24570,1000121,2,1014,831,183,0.819527,0.180473,1.629481,176,7,1016,833,183,0.819882,0.180118,1.626188,176,7,-1, merged,0,0,0.626709180632
24580,1000014,1,1025,876,149,0.854634,0.145366,0.854634,137,12,1026,877,149,0.854776,0.145224,0.854776,137,12,1, merged,0,0,0.0575036653481
24580,1000043,2,287,236,51,0.8223,0.1777,1.676934,45,6,288,237,51,0.822917,0.177083,1.677692,45,6,1, merged,0,0,0.0749346236672
24586,1000328,1,476,332,144,0.697479,0.302521,0.697479,130,14,479,334,145,0.697286,0.302714,0.697286,131,14,-1, merged,1,0,0.282378369377
24599,1000014,2,1026,877,149,0.854776,0.145224,1.737129,137,12,1027,878,149,0.854917,0.145083,1.739533,137,12,1, merged,0,0,0.571014163241
24602,1000124,2,349,322,27,0.922636,0.077364,1.717689,25,2,350,323,27,0.922857,0.077143,1.718632,25,2,1, merged,0,0,0.0511015338199
24611,1000005,3,180,133,47,0.738889,0.261111,2.238388,42,5,181,134,47,0.740331,0.259669,2.24583,42,5,1, merged,0,0,0
24620,1000015,2,1149,1049,100,0.912968,0.087032,1.579634,89,11,1150,1050,100,0.913043,0.086957,1.585771,89,11,1, merged,0,0,1.11370521001
24620,1000534,1,54,36,18,0.666667,0.333333,0.666667,18,0,55,37,18,0.672727,0.327273,0.672727,18,0,1, merged,0,0,1.19253968254
24622,1000007,2,567,484,83,0.853616,0.146384,1.743859,71,12,568,485,83,0.853873,0.146127,1.744782,71,12,1, merged,0,0,1.22274767088
24626,1000007,2,570,486,84,0.852632,0.147368,1.765675,72,12,572,488,84,0.853147,0.146853,1.765397,72,12,1, merged,0,0,0.216537576984
24626,1000015,1,1150,1050,100,0.913043,0.086957,0.913043,89,11,1151,1050,101,0.91225,0.08775,0.91225,90,11,1, merged,1,1,0.176833646212
24627,1000121,3,1016,833,183,0.819882,0.180118,2.261486,176,7,1017,834,183,0.820059,0.179941,2.266678,176,7,1, merged,0,0,0.108094228476
24627,1000329,2,1484,1127,357,0.759434,0.240566,1.441605,320,37,1485,1128,357,0.759596,0.240404,1.446619,320,37,-1, merged,0,0,0.0932048987253
24646,1000063,1,1924,1718,206,0.892931,0.107069,0.892931,175,31,1925,1719,206,0.892987,0.107013,0.892987,175,31,-1, merged,0,0,0.0459598923966
24646,1000124,2,351,324,27,0.923077,0.076923,1.816008,25,2,352,325,27,0.923295,0.076705,1.816282,25,2,1, merged,0,0,0.047993853485
24649,1000023,2,283,251,32,0.886926,0.113074,1.81675,29,3,284,252,32,0.887324,0.112676,1.817353,29,3,1, merged,0,0,0.000628158395235
24651,1000023,2,284,252,32,0.887324,0.112676,1.817353,29,3,285,253,32,0.887719,0.112281,1.817952,29,3,1, merged,0,0,0.000991082718807
24652,1000023,2,285,253,32,0.887719,0.112281,1.817952,29,3,286,254,32,0.888112,0.111888,1.818547,29,3,1, merged,0,0,0.000124244208943
24654,1000023,1,286,254,32,0.888112,0.111888,0.888112,29,3,287,255,32,0.888502,0.111498,0.888502,29,3,1, merged,0,0,0.00927917899938
24666,1000109,2,336,280,56,0.833333,0.166667,1.612994,54,2,337,281,56,0.833828,0.166172,1.614419,54,2,1, merged,0,0,0.126678112723
24676,1000063,1,1926,1720,206,0.893043,0.106957,0.893043,175,31,1927,1721,206,0.893098,0.106902,0.893098,175,31,1, merged,0,0,0.0423003068838
24676,1000328,2,479,334,145,0.697286,0.302714,1.590329,131,14,480,335,145,0.697917,0.302083,1.591015,131,14,1, merged,0,0,0.0268668863493
24680,1000063,2,1927,1721,206,0.893098,0.106902,1.777713,175,31,1928,1722,206,0.893154,0.106846,1.779946,175,31,1, merged,0,0,0.325527966794
24689,1000026,1,251,229,22,0.912351,0.087649,0.912351,20,2,252,230,22,0.912698,0.087302,0.912698,20,2,1, merged,0,0,0.561492103076
24689,1000124,2,356,329,27,0.924157,0.075843,1.836508,25,2,357,330,27,0.92437,0.07563,1.837068,25,2,1, merged,0,0,0.203829208849
24693,1000007,2,573,489,84,0.853403,0.146597,1.783403,72,12,574,490,84,0.853659,0.146341,1.783833,72,12,1, merged,0,0,0.16088100569
24693,1000009,3,524,443,81,0.84542,0.15458,2.628823,73,8,525,444,81,0.845714,0.154286,2.629547,73,8,1, merged,0,0,0.145074974614
24693,1000011,1,400,372,28,0.93,0.07,0.93,25,3,401,373,28,0.930175,0.069825,0.930175,25,3,1, merged,0,0,0.152783150145
24694,1000011,1,401,373,28,0.930175,0.069825,0.930175,25,3,402,374,28,0.930348,0.069652,0.930348,25,3,1, merged,0,0,0.360955439464
24694,1000120,2,516,417,99,0.80814,0.19186,1.738314,92,7,517,418,99,0.808511,0.191489,1.738859,92,7,1, merged,0,0,0.272002036641
24699,1000015,2,1151,1050,101,0.91225,0.08775,1.732563,90,11,1152,1050,102,0.911458,0.088542,1.731146,90,12,-1, merged,1,1,0
24699,1000121,1,1024,840,184,0.820312,0.179688,0.820312,176,8,1026,841,185,0.819688,0.180312,0.819688,176,9,-1, merged,1,1,0
24709,1000014,2,1029,880,149,0.855199,0.144801,1.188533,137,12,1030,881,149,0.85534,0.14466,1.218976,137,12,1, merged,0,0,0.672688433989
24710,1000109,3,337,281,56,0.833828,0.166172,2.435136,54,2,338,282,56,0.83432,0.16568,2.434014,54,2,1, merged,0,0,0.127071150125
24710,1000199,2,251,206,45,0.820717,0.179283,1.601308,43,2,253,207,46,0.818182,0.181818,1.599694,43,3,-1, merged,1,1,0.130867087293
24717,1000063,2,1928,1722,206,0.893154,0.106846,1.660595,175,31,1930,1723,207,0.892746,0.107254,1.648302,176,31,1, merged,1,1,0.338532753481
24725,1000592,2,300,244,56,0.813333,0.186667,1.568889,40,16,301,245,56,0.813953,0.186047,1.574823,40,16,1, merged,0,0,0.275286172161
24726,1000592,2,301,245,56,0.813953,0.186047,1.574823,40,16,302,246,56,0.81457,0.18543,1.580527,40,16,1, merged,0,0,0.278268328949
24733,1000009,1,525,444,81,0.845714,0.154286,0.845714,73,8,527,445,82,0.844402,0.155598,0.844402,74,8,1, abandoned,1,1,0.612263916836
24733,1000011,2,402,374,28,0.930348,0.069652,1.776063,25,3,405,375,30,0.925926,0.074074,1.770328,27,3,-1, abandoned,1,0,0.644026245301
24734,1000592,2,302,246,56,0.81457,0.18543,1.580527,40,16,303,247,56,0.815182,0.184818,1.595182,40,16,1, merged,0,0,0.11796
24737,1000592,3,303,247,56,0.815182,0.184818,2.433019,40,16,304,248,56,0.815789,0.184211,2.442208,40,16,1, merged,0,0,0.0688202403848
24738,1000199,2,256,210,46,0.820312,0.179688,1.601825,43,3,258,212,46,0.821705,0.178295,1.600872,43,3,-1, merged,0,0,0.269002889114
24741,1000592,2,304,248,56,0.815789,0.184211,1.600103,40,16,305,249,56,0.816393,0.183607,1.604855,40,16,1, merged,0,0,0.122509960159
24742,1000592,2,305,249,56,0.816393,0.183607,1.604855,40,16,306,250,56,0.816993,0.183007,1.609446,40,16,1, merged,0,0,0.125597133758
24743,1000592,2,306,250,56,0.816993,0.183007,1.609446,40,16,307,251,56,0.81759,0.18241,1.613886,40,16,1, merged,0,0,0.128679395386
24755,1000091,1,296,228,68,0.77027,0.22973,0.77027,58,10,297,229,68,0.771044,0.228956,0.771044,58,10,-1, merged,0,0,0.0879878890535
24755,1000329,2,1488,1131,357,0.760081,0.239919,1.530351,320,37,1491,1133,358,0.759893,0.240107,1.530936,321,37,-1, merged,1,0,0.0753867091678
24772,1000014,2,1035,886,149,0.856039,0.143961,1.757773,137,12,1038,889,149,0.856455,0.143545,1.75559,137,12,-1, merged,0,0,0.497691674535
24776,1000014,2,1040,891,149,0.856731,0.143269,1.273397,137,12,1041,892,149,0.856868,0.143132,1.281526,137,12,1, merged,0,0,0.428746899014
24785,1000043,2,288,237,51,0.822917,0.177083,1.509484,45,6,289,238,51,0.823529,0.176471,1.512418,45,6,-1, abandoned,0,0,0.189288373628
24790,1000043,2,289,238,51,0.823529,0.176471,1.616633,45,6,290,239,51,0.824138,0.175862,1.624138,45,6,1, merged,0,0,0.295739489489
24791,1000004,2,1395,1205,190,0.863799,0.136201,1.717458,154,36,1396,1206,190,0.863897,0.136103,1.71781,154,36,1, merged,0,0,0.223348387042
24791,1000007,1,574,490,84,0.853659,0.146341,0.853659,72,12,575,491,84,0.853913,0.146087,0.853913,72,12,1, merged,0,0,0.651572146977
24793,1000014,1,1041,892,149,0.856868,0.143132,0.856868,137,12,1042,892,150,0.856046,0.143954,0.856046,138,12,1, merged,1,1,0
24799,1000592,2,307,251,56,0.81759,0.18241,1.613886,40,16,308,252,56,0.818182,0.181818,1.618182,40,16,1, merged,0,0,0.131756756757
24800,1000004,1,1399,1209,190,0.864189,0.135811,0.864189,154,36,1400,1210,190,0.864286,0.135714,0.864286,154,36,1, merged,0,0,0.00241198119319
24800,1000014,2,1043,893,150,0.856184,0.143816,1.720373,138,12,1044,894,150,0.856322,0.143678,1.720608,138,12,1, merged,0,0,0
24800,1000121,3,1031,845,186,0.819593,0.180407,2.539965,177,9,1032,846,186,0.819767,0.180233,2.540375,177,9,1, merged,0,0,0.0024924735492
24810,1000124,2,358,331,27,0.924581,0.075419,1.6806,25,2,359,332,27,0.924791,0.075209,1.681201,25,2,1, merged,0,0,0.165209453967
24816,1000023,1,287,255,32,0.888502,0.111498,0.888502,29,3,289,256,33,0.885813,0.114187,0.885813,30,3,1, merged,1,1,0.0239631850459
24823,1000328,2,482,337,145,0.69917,0.30083,1.495577,131,14,483,338,145,0.699793,0.300207,1.496808,131,14,1, merged,0,0,0.231579090364
24827,1000124,1,359,332,27,0.924791,0.075209,0.924791,25,2,360,333,27,0.925,0.075,0.925,25,2,1, merged,0,0,0.449878991475
24827,1000166,2,143,123,20,0.86014,0.13986,1.784931,19,1,144,124,20,0.861111,0.138889,1.786111,19,1,1, merged,0,0,0.960618045668
24832,1000091,2,297,229,68,0.771044,0.228956,1.531579,58,10,298,229,69,0.768456,0.231544,1.529152,58,11,-1, merged,1,1,0.146951199427
24832,1000329,1,1495,1137,358,0.760535,0.239465,0.760535,321,37,1496,1138,358,0.760695,0.239305,0.760695,321,37,1, merged,0,0,0.13063982923
24845,1000007,1,575,491,84,0.853913,0.146087,0.853913,72,12,577,492,85,0.852686,0.147314,0.852686,73,12,1, merged,1,1,0.0132646267733
24845,1000014,3,1047,897,150,0.856734,0.143266,2.530414,138,12,1049,898,151,0.856053,0.143947,2.527714,139,12,1, merged,1,1,0.0101210182061
24845,1000121,2,1032,846,186,0.819767,0.180233,1.67368,177,9,1033,846,187,0.818974,0.181026,1.67166,178,9,1, merged,1,1,0.0104772019287
24845,1000329,4,1498,1140,358,0.761015,0.238985,3.291429,321,37,1500,1141,359,0.760667,0.239333,3.28838,322,37,1, merged,1,1,0.0111368373607
24846,1000091,2,298,229,69,0.768456,0.231544,1.529123,58,11,299,230,69,0.769231,0.230769,1.530057,58,11,1, merged,0,0,0.64475139123
24846,1000329,1,1500,1141,359,0.760667,0.239333,0.760667,322,37,1501,1142,359,0.760826,0.239174,0.760826,322,37,1, merged,0,0,0.897752754864
24847,1000070,2,667,596,71,0.893553,0.106447,1.654379,59,12,668,597,71,0.893713,0.106287,1.654698,59,12,1, merged,0,0,0.301251799541
24847,1000329,1,1501,1142,359,0.760826,0.239174,0.760826,322,37,1502,1143,359,0.760985,0.239015,0.760985,322,37,1, merged,0,0,0.275862134521
24850,1000014,1,1050,899,151,0.85619,0.14381,0.85619,139,12,1051,900,151,0.856327,0.143673,0.856327,139,12,1, merged,0,0,0.513928228266
24850,1000329,2,1502,1143,359,0.760985,0.239015,1.617176,322,37,1503,1144,359,0.761144,0.238856,1.617472,322,37,1, merged,0,0,0.825626891736
24853,1000121,2,1033,846,187,0.818974,0.181026,1.580277,178,9,1034,846,188,0.818182,0.181818,1.579138,179,9,1, merged,1,1,0.138247146546
24853,1000329,1,1504,1145,359,0.761303,0.238697,0.761303,322,37,1506,1146,360,0.760956,0.239044,0.760956,323,37,-1, merged,1,0,0.150373679988
24856,1000014,2,1051,900,151,0.856327,0.143673,1.617283,139,12,1052,901,151,0.856464,0.143536,1.617579,139,12,1, merged,0,0,0.513707184628
24856,1000121,4,1034,846,188,0.818182,0.181818,3.191876,179,9,1035,847,188,0.818357,0.181643,3.192736,179,9,1, merged,0,0,0.651916510602
24856,1000329,1,1506,1146,360,0.760956,0.239044,0.760956,323,37,1507,1147,360,0.761115,0.238885,0.761115,323,37,1, merged,0,0,0.826043966044
24870,1000004,1,1404,1214,190,0.864672,0.135328,0.864672,154,36,1405,1215,190,0.864769,0.135231,0.864769,154,36,1, merged,0,0,0.330822836003
24870,1000026,2,256,234,22,0.914062,0.085938,1.778735,20,2,257,235,22,0.914397,0.085603,1.779166,20,2,1, merged,0,0,0.951158460902
24872,1000014,1,1052,901,151,0.856464,0.143536,0.856464,139,12,1059,907,152,0.856468,0.143532,0.856468,140,12,-1, merged,1,0,0.0335842641515
24872,1000043,2,290,239,51,0.824138,0.175862,1.680602,45,6,291,240,51,0.824742,0.175258,1.681211,45,6,1, merged,0,0,0.043705643913
24889,1000023,3,289,256,33,0.885813,0.114187,2.185813,30,3,290,257,33,0.886207,0.113793,2.057635,30,3,1, merged,0,0,0.0709106151812
24892,1000007,2,582,496,86,0.852234,0.147766,0.852234,73,13,583,497,86,0.852487,0.147513,1.852487,73,13,1, merged,0,0,1.20788927054
24899,1000070,1,672,601,71,0.894345,0.105655,0.894345,59,12,673,601,72,0.893016,0.106984,0.893016,59,13,-1, merged,1,1,0.151903918726
24899,1000105,2,295,236,59,0.8,0.2,1.694345,53,6,296,236,60,0.797297,0.202703,1.690314,53,7,-1, merged,1,1,0
24900,1000124,2,361,334,27,0.925208,0.074792,1.791874,25,2,362,335,27,0.925414,0.074586,1.800414,25,2,1, merged,0,0,0.339211309524
24905,1000121,2,1037,849,188,0.818708,0.181292,1.643269,179,9,1038,850,188,0.818882,0.181118,1.637848,179,9,1, merged,0,0,0.0393255181202
24910,1000121,3,1038,850,188,0.818882,0.181118,2.408966,179,9,1039,851,188,0.819057,0.180943,2.417029,179,9,1, merged,0,0,0.0266420263473
24910,1000327,1,571,444,127,0.777583,0.222417,0.777583,98,29,572,445,127,0.777972,0.222028,0.777972,98,29,-1, merged,0,0,0.0289578841674
24922,1000023,2,290,257,33,0.886207,0.113793,1.818025,30,3,291,258,33,0.886598,0.113402,1.818609,30,3,1, merged,0,0,0.000743257591845
24926,1000328,2,483,338,145,0.699793,0.300207,1.631804,131,14,484,339,145,0.700413,0.299587,1.632617,131,14,1, merged,0,0,0.258479766895
24937,1000054,3,63,57,6,0.904762,0.095238,2.375498,4,2,64,58,6,0.90625,0.09375,2.369468,4,2,-1, merged,0,0,1.16037466037
24951,1000329,2,1511,1151,360,0.761747,0.238253,1.517338,323,37,1514,1153,361,0.761559,0.238441,1.518316,324,37,1, merged,1,1,0.847451499118
24953,1000327,2,572,445,127,0.777972,0.222028,1.534729,98,29,573,446,127,0.77836,0.22164,1.536271,98,29,-1, merged,0,0,0.667154714908
24955,1000121,2,1039,851,188,0.819057,0.180943,1.580616,179,9,1040,852,188,0.819231,0.180769,1.581104,179,9,1, merged,0,0,0
24955,1000329,1,1514,1153,361,0.761559,0.238441,0.761559,324,37,1516,1155,361,0.761873,0.238127,0.761873,324,37,-1, merged,0,0,0
24977,1000091,1,299,230,69,0.769231,0.230769,0.769231,58,11,300,231,69,0.77,0.23,0.77,58,11,1, merged,0,0,0.0187531730277
24977,1000121,2,1040,852,188,0.819231,0.180769,1.588462,179,9,1041,853,188,0.819404,0.180596,1.589404,179,9,1, merged,0,0,0.00740562558897
24978,1000023,1,291,258,33,0.886598,0.113402,0.886598,30,3,292,259,33,0.886986,0.113014,0.886986,30,3,1, merged,0,0,0.017807051576
24986,1000329,2,1519,1157,362,0.761685,0.238315,1.459527,325,37,1520,1158,362,0.761842,0.238158,1.461842,325,37,-1, abandoned,0,0,0.453519000914
24987,1000014,1,1060,908,152,0.856604,0.143396,0.856604,140,12,1061,909,152,0.856739,0.143261,0.856739,140,12,1, merged,0,0,0.188751202651
24987,1000070,2,675,603,72,0.893333,0.106667,1.749937,59,13,676,604,72,0.893491,0.106509,1.75023,59,13,1, merged,0,0,0.226568884997
24991,1000327,4,573,446,127,0.77836,0.22164,2.595213,98,29,575,447,128,0.777391,0.222609,2.560591,99,29,1, merged,1,1,0.235193017276
24992,1000004,1,1411,1221,190,0.865344,0.134656,0.865344,154,36,1412,1222,190,0.865439,0.134561,0.865439,154,36,1, merged,0,0,0.0247095371753
24993,1000121,2,1041,853,188,0.819404,0.180596,1.581247,179,9,1042,853,189,0.818618,0.181382,1.579959,180,9,1, abandoned,1,1,0.0586873093882
24993,1000329,1,1520,1158,362,0.761842,0.238158,0.761842,325,37,1521,1158,363,0.761341,0.238659,0.761341,326,37,1, abandoned,1,1,0.0767304300031
24994,1000121,2,1042,853,189,0.818618,0.181382,1.576912,180,9,1043,854,189,0.818792,0.181208,1.577467,180,9,1, merged,0,0,0
24999,1000070,2,677,605,72,0.893648,0.106352,1.71244,59,13,678,606,72,0.893805,0.106195,1.712161,59,13,1, merged,0,0,0.595833072835
24999,1000121,1,1043,854,189,0.818792,0.181208,0.818792,180,9,1046,856,190,0.818356,0.181644,0.818356,181,9,1, merged,1,1,0.53248390513
25006,1000329,2,1525,1162,363,0.761967,0.238033,1.520642,326,37,1526,1163,363,0.762123,0.237877,1.521178,326,37,1, merged,0,0,0.83359693508
25014,1000124,1,362,335,27,0.925414,0.074586,0.925414,25,2,363,336,27,0.92562,0.07438,0.92562,25,2,1, merged,0,0,0
25014,1000153,2,552,508,44,0.92029,0.07971,1.845704,34,10,553,509,44,0.920434,0.079566,1.846054,34,10,1, merged,0,0,0.085372283818
25015,1000014,2,1061,909,152,0.856739,0.143261,1.743531,140,12,1062,910,152,0.856874,0.143126,1.745763,140,12,1, merged,0,0,0.571224939296
25016,1000091,1,300,231,69,0.77,0.23,0.77,58,11,301,232,69,0.770764,0.229236,0.770764,58,11,1, merged,0,0,0.558194549584
25018,1000015,2,1159,1057,102,0.911993,0.088007,1.832427,90,12,1160,1058,102,0.912069,0.087931,1.830988,90,12,1, merged,0,0,0
25018,1000153,1,553,509,44,0.920434,0.079566,0.920434,34,10,555,510,45,0.918919,0.081081,0.918919,35,10,1, merged,1,1,0
25020,1000070,2,678,606,72,0.893805,0.106195,1.538967,59,13,679,607,72,0.893962,0.106038,1.550212,59,13,1, merged,0,0,0.0807436313278
25024,1000327,2,576,448,128,0.777778,0.222222,1.540057,99,29,578,449,129,0.776817,0.223183,1.538753,99,30,-1, merged,1,0,0.594070609535
25024,1000329,1,1527,1164,363,0.762279,0.237721,0.762279,326,37,1529,1165,364,0.761936,0.238064,0.761936,327,37,1, merged,1,1,0.63734554255
25026,1000329,1,1530,1165,365,0.761438,0.238562,0.761438,328,37,1533,1167,366,0.761252,0.238748,0.761252,329,37,-1, merged,1,0,0.638318561426
25027,1000329,1,1533,1167,366,0.761252,0.238748,0.761252,329,37,1535,1169,366,0.761564,0.238436,0.761564,329,37,-1, merged,0,0,0.318604190937
25040,1000121,2,1046,856,190,0.818356,0.181644,1.318356,181,9,1047,857,190,0.818529,0.181471,1.318529,181,9,1, merged,0,0,0.699067505657
25042,1000121,2,1047,857,190,0.818529,0.181471,1.744353,181,9,1048,858,190,0.818702,0.181298,1.74473,181,9,1, merged,0,0,0.139873974858
25042,1000124,1,364,337,27,0.925824,0.074176,0.925824,25,2,365,338,27,0.926027,0.073973,0.926027,25,2,1, merged,0,0,0.080812007226
25050,1000004,2,1412,1222,190,0.865439,0.134561,1.567567,154,36,1413,1223,190,0.865534,0.134466,1.56976,154,36,1, merged,0,0,0.376086977517
25068,1000199,2,258,212,46,0.821705,0.178295,1.600872,43,3,260,214,46,0.823077,0.176923,1.599011,43,3,-1, merged,0,0,0.00185401890302
25070,1000091,2,303,232,71,0.765677,0.234323,1.584379,60,11,304,233,71,0.766447,0.233553,1.585322,60,11,1, merged,0,0,0.0143871191123
25070,1000121,1,1048,858,190,0.818702,0.181298,0.818702,181,9,1049,859,190,0.818875,0.181125,0.818875,181,9,1, merged,0,0,0.00993715321802
25072,1000121,1,1051,861,190,0.81922,0.18078,0.81922,181,9,1052,862,190,0.819392,0.180608,0.819392,181,9,1, merged,0,0,0.0110019584541
25073,1000328,1,485,340,145,0.701031,0.298969,0.701031,131,14,486,341,145,0.701646,0.298354,0.701646,131,14,1, merged,0,0,0.00789692823008
25073,1000329,2,1543,1175,368,0.761504,0.238496,1.462534,331,37,1544,1176,368,0.761658,0.238342,1.463304,331,37,1, merged,0,0,0.0069577307839
25075,1000070,2,679,607,72,0.893962,0.106038,1.773709,59,13,680,608,72,0.894118,0.105882,1.774621,59,13,1, merged,0,0,0.12567608964
25075,1000132,1,158,139,19,0.879747,0.120253,0.879747,16,3,159,140,19,0.880503,0.119497,0.880503,16,3,1, merged,0,0,0.161135464008
25080,1000121,2,1053,863,190,0.819563,0.180437,1.7143,181,9,1054,864,190,0.819734,0.180266,1.719734,181,9,1, merged,0,0,0.545911759448
25087,1000329,1,1546,1178,368,0.761966,0.238034,0.761966,331,37,1548,1179,369,0.761628,0.238372,0.761628,332,37,1, merged,1,1,0.277366427816
25087,1000592,3,308,252,56,0.818182,0.181818,2.106464,40,16,309,253,56,0.81877,0.18123,2.130398,40,16,1, merged,0,0,0.220792097903
25092,1000592,3,309,253,56,0.81877,0.18123,2.460875,40,16,310,254,56,0.819355,0.180645,2.443439,40,16,1, merged,0,0,0.716009267631
25114,1000063,1,1934,1727,207,0.892968,0.107032,0.892968,176,31,1935,1728,207,0.893023,0.106977,0.893023,176,31,1, merged,0,0,0.000720577870685
25116,1000327,2,578,449,129,0.776817,0.223183,1.363024,99,30,580,450,130,0.775862,0.224138,1.352133,100,30,1, merged,1,1,0.0875039232672
25118,1000023,1,296,261,35,0.881757,0.118243,0.881757,32,3,297,262,35,0.882155,0.117845,0.882155,32,3,1, merged,0,0,0.00742486539403
25121,1000014,2,1063,911,152,0.857008,0.142992,1.745897,140,12,1064,912,152,0.857143,0.142857,1.748052,140,12,1, merged,0,0,0.676745013611
25124,1000329,1,1552,1181,371,0.760954,0.239046,0.760954,334,37,1553,1182,371,0.761108,0.238892,0.761108,334,37,-1, abandoned,0,0,0.0340973413851
25136,1000153,1,555,510,45,0.918919,0.081081,0.918919,35,10,556,511,45,0.919065,0.080935,0.919065,35,10,1, merged,0,0,0.357341388115
25150,1000121,1,1056,866,190,0.820076,0.179924,0.820076,181,9,1057,867,190,0.820246,0.179754,0.820246,181,9,1, merged,0,0,0.00518337834306
25152,1000153,1,558,513,45,0.919355,0.080645,0.919355,35,10,559,514,45,0.919499,0.080501,0.919499,35,10,1, merged,0,0,1.07114152911
25158,1000329,3,1557,1186,371,0.761721,0.238279,1.92072,334,37,1558,1187,371,0.761874,0.238126,1.958749,334,37,1, merged,0,0,0.00173454147158
25159,1000329,3,1558,1187,371,0.761874,0.238126,1.958749,334,37,1559,1188,371,0.762027,0.237973,1.992366,334,37,1, merged,0,0,0.0329885971891
25160,1000070,2,680,608,72,0.894118,0.105882,1.656145,59,13,681,609,72,0.894273,0.105727,1.656453,59,13,1, merged,0,0,0.767917649249
25160,1000329,1,1559,1188,371,0.762027,0.237973,0.762027,334,37,1560,1189,371,0.762179,0.237821,0.762179,334,37,1, merged,0,0,0.635199915155
25162,1000043,4,294,242,52,0.823129,0.176871,2.816022,46,6,295,243,52,0.823729,0.176271,2.846558,46,6,1, merged,0,0,0.00227708749277
25162,1000329,3,1560,1189,371,0.762179,0.237821,1.992892,334,37,1561,1190,371,0.762332,0.237668,2.02283,334,37,1, merged,0,0,0.00142253620648
25163,1000014,2,1064,912,152,0.857143,0.142857,1.680872,140,12,1066,914,152,0.857411,0.142589,1.678357,140,12,-1, merged,0,0,0.19375885852
25163,1000043,1,295,243,52,0.823729,0.176271,0.823729,46,6,296,243,53,0.820946,0.179054,0.820946,47,6,1, merged,1,1,0.262143981678
25163,1000121,3,1058,868,190,0.820416,0.179584,2.501288,181,9,1059,869,190,0.820585,0.179415,2.498942,181,9,1, merged,0,0,0.209656634617
25167,1000014,2,1066,914,152,0.857411,0.142589,1.507046,140,12,1067,915,152,0.857545,0.142455,1.509718,140,12,1, merged,0,0,0.547702324644
25180,1000121,2,1059,869,190,0.820585,0.179415,1.582917,181,9,1060,870,190,0.820755,0.179245,1.583239,181,9,1, merged,0,0,0.010627522649
25180,1000329,1,1561,1190,371,0.762332,0.237668,0.762332,334,37,1562,1191,371,0.762484,0.237516,0.762484,334,37,1, merged,0,0,0.0133381058186
25181,1000026,1,257,235,22,0.914397,0.085603,0.914397,20,2,258,236,22,0.914729,0.085271,0.914729,20,2,1, merged,0,0,0.687434518886
25181,1000199,2,260,214,46,0.823077,0.176923,1.737474,43,3,261,215,46,0.823755,0.176245,1.738483,43,3,1, merged,0,0,0.0128514364726
25182,1000199,2,261,215,46,0.823755,0.176245,1.599688,43,3,263,217,46,0.825095,0.174905,1.602873,43,3,-1, merged,0,0,0.273334064809
25200,1000124,2,369,342,27,0.926829,0.073171,1.750359,25,2,371,344,27,0.927224,0.072776,1.734916,25,2,-1, merged,0,0,0.0630350773848
25205,1000003,1,801,682,119,0.851436,0.148564,0.851436,112,7,804,684,120,0.850746,0.149254,0.850746,113,7,1, merged,1,1,0.0838901453114
25220,1000592,1,312,255,57,0.817308,0.182692,0.817308,40,17,313,256,57,0.817891,0.182109,0.817891,40,17,1, merged,0,0,0.141422414323
25239,1000007,1,592,506,86,0.85473,0.14527,0.85473,73,13,593,507,86,0.854975,0.145025,0.854975,73,13,1, merged,0,0,1.22707431457
25239,1000015,2,1166,1064,102,0.912521,0.087479,1.767251,90,12,1167,1065,102,0.912596,0.087404,1.767571,90,12,1, merged,0,0,1.11694490818
25240,1000121,1,1061,871,190,0.820924,0.179076,0.820924,181,9,1062,872,190,0.821092,0.178908,0.821092,181,9,1, merged,0,0,0
25240,1000327,2,581,451,130,0.776248,0.223752,1.597172,100,30,582,452,130,0.776632,0.223368,1.597725,100,30,1, merged,0,0,0
25244,1000091,2,304,233,71,0.766447,0.233553,1.468093,60,11,306,235,71,0.767974,0.232026,1.470233,60,11,1, merged,0,0,0
25244,1000328,1,486,341,145,0.701646,0.298354,0.701646,131,14,487,342,145,0.702259,0.297741,0.702259,131,14,1, merged,0,0,0
25245,1000070,2,681,609,72,0.894273,0.105727,1.644273,59,13,682,610,72,0.894428,0.105572,1.654428,59,13,1, merged,0,0,0.508779761905
25251,1000015,1,1167,1065,102,0.912596,0.087404,0.912596,90,12,1168,1065,103,0.911815,0.088185,0.911815,91,12,1, merged,1,1,0
25251,1000153,2,560,515,45,0.919643,0.080357,1.832239,35,10,563,518,45,0.920071,0.079929,1.831886,35,10,-1, merged,0,0,1.07240467006
25262,1000004,2,1418,1228,190,0.866008,0.133992,1.786221,154,36,1419,1229,190,0.866103,0.133897,1.786457,154,36,1, merged,0,0,0.0209540847325
25262,1000153,1,564,519,45,0.920213,0.079787,0.920213,35,10,565,520,45,0.920354,0.079646,0.920354,35,10,1, merged,0,0,0.0847085149778
25268,1000023,1,298,263,35,0.88255,0.11745,0.88255,32,3,299,264,35,0.882943,0.117057,0.882943,32,3,1, merged,0,0,0.000563797173967
25268,1000063,2,1936,1729,207,0.893079,0.106921,1.775629,176,31,1937,1730,207,0.893134,0.106866,1.776077,176,31,1, merged,0,0,0.00134766997488
25271,1000105,3,297,237,60,0.79798,0.20202,1.945908,53,7,299,238,61,0.795987,0.204013,1.94315,54,7,1, merged,1,1,0.61866685017
25298,1000014,1,1073,921,152,0.858341,0.141659,0.858341,140,12,1074,921,153,0.857542,0.142458,0.857542,141,12,1, abandoned,1,1,0.499588940702
25306,1000054,2,64,58,6,0.90625,0.09375,1.572917,4,2,65,59,6,0.907692,0.092308,1.607692,4,2,1, merged,0,0,0.59158718251
25309,1000004,2,1421,1231,190,0.866291,0.133709,1.67736,154,36,1422,1232,190,0.866385,0.133615,1.677814,154,36,1, merged,0,0,0.0248670749504
25309,1000120,1,524,425,99,0.811069,0.188931,0.811069,92,7,525,426,99,0.811429,0.188571,0.811429,92,7,1, merged,0,0,0.0653738273247
25311,1000327,2,582,452,130,0.776632,0.223368,1.478891,100,30,583,453,130,0.777015,0.222985,1.479884,100,30,1, merged,0,0,0.66719742954
25311,1000328,1,487,342,145,0.702259,0.297741,0.702259,131,14,488,343,145,0.702869,0.297131,0.702869,131,14,1, merged,0,0,0.96944051548
25315,1000153,2,565,520,45,0.920354,0.079646,0.920354,35,10,566,521,45,0.920495,0.079505,1.920495,35,10,1, merged,0,0,1.07357178269
25317,1000014,3,1074,921,153,0.857542,0.142458,2.512994,141,12,1078,922,156,0.855288,0.144712,2.511418,144,12,1, merged,1,1,0.0406779474175
25317,1000070,2,683,611,72,0.894583,0.105417,1.655452,59,13,685,613,72,0.894891,0.105109,1.656131,59,13,-1, merged,0,0,0.0492432366735
25317,1000105,7,299,238,61,0.795987,0.204013,5.450906,54,7,300,238,62,0.793333,0.206667,5.306027,55,7,1, merged,1,1,0.0322183733292
25317,1000121,6,1064,874,190,0.821429,0.178571,4.65492,181,9,1068,876,192,0.820225,0.179775,4.512694,183,9,-1, merged,1,0,0.0301542980816
25318,1000130,2,203,172,31,0.847291,0.152709,1.65551,23,8,204,173,31,0.848039,0.151961,1.645337,23,8,-1, abandoned,0,0,0.368018645469
25321,1000014,2,1078,922,156,0.855288,0.144712,1.652585,144,12,1079,923,156,0.855422,0.144578,1.655422,144,12,1, merged,0,0,0.548933673048
25322,1000199,1,265,219,46,0.826415,0.173585,0.826415,43,3,267,221,46,0.827715,0.172285,0.827715,43,3,-1, merged,0,0,0.044768897875
25323,1000109,2,339,283,56,0.834808,0.165192,1.662524,54,2,340,284,56,0.835294,0.164706,1.66122,54,2,1, merged,0,0,0.267405301417
25323,1000199,1,267,221,46,0.827715,0.172285,0.827715,43,3,270,223,47,0.825926,0.174074,0.825926,44,3,-1, merged,1,0,0.275556626576
25332,1000014,1,1079,923,156,0.855422,0.144578,0.855422,144,12,1080,923,157,0.85463,0.14537,0.85463,145,12,1, abandoned,1,1,0
25339,1000070,2,685,613,72,0.894891,0.105109,1.549567,59,13,686,614,72,0.895044,0.104956,1.552187,59,13,1, merged,0,0,0.74525146271
25339,1000121,3,1068,876,192,0.820225,0.179775,2.369791,183,9,1069,877,192,0.820393,0.179607,2.372579,183,9,1, merged,0,0,0.621557564641
25344,1000070,2,686,614,72,0.895044,0.104956,1.552187,59,13,687,615,72,0.895197,0.104803,1.554771,59,13,1, merged,0,0,0.86870939222
25351,1000070,1,687,615,72,0.895197,0.104803,0.895197,59,13,689,615,74,0.892598,0.107402,0.892598,59,15,-1, merged,1,1,0.0136898748893
25355,1000070,1,689,615,74,0.892598,0.107402,0.892598,59,15,690,616,74,0.892754,0.107246,0.892754,59,15,-1, abandoned,0,0,0.745759104848
25369,1000070,3,690,616,74,0.892754,0.107246,2.404618,59,15,691,617,74,0.892909,0.107091,2.412207,59,15,1, merged,0,0,0.766854312785
25371,1000043,4,297,244,53,0.821549,0.178451,3.135469,47,6,298,244,54,0.818792,0.181208,3.123773,47,7,-1, merged,1,1,0.864214448852
25371,1000130,3,204,173,31,0.848039,0.151961,2.31392,23,8,205,173,32,0.843902,0.156098,2.304981,23,9,-1, merged,1,1,0
25373,1000592,3,313,256,57,0.817891,0.182109,2.052157,40,17,314,257,57,0.818471,0.181529,2.027263,40,17,-1, abandoned,0,0,0.056121294412
25382,1000329,1,1571,1199,372,0.763208,0.236792,0.763208,334,38,1573,1201,372,0.763509,0.236491,0.763509,334,38,-1, merged,0,0,0.103911499249
25382,1000592,2,314,257,57,0.818471,0.181529,1.581679,40,17,315,258,57,0.819048,0.180952,1.582557,40,17,1, merged,0,0,0.0871916132446
25383,1000592,2,315,258,57,0.819048,0.180952,1.622619,40,17,316,259,57,0.81962,0.18038,1.626638,40,17,1, merged,0,0,0.0925444967498
25388,1000014,1,1084,927,157,0.855166,0.144834,0.855166,145,12,1085,928,157,0.8553,0.1447,0.8553,145,12,1, merged,0,0,0.0708187027072
25388,1000153,2,571,526,45,0.921191,0.078809,1.776357,35,10,572,527,45,0.921329,0.078671,1.776628,35,10,1, merged,0,0,0.111083143235
25406,1000118,2,640,567,73,0.885938,0.114062,1.649447,70,3,641,568,73,0.886115,0.113885,1.649775,70,3,1, merged,0,0,0.229014793562
25406,1000329,1,1573,1201,372,0.763509,0.236491,0.763509,334,38,1574,1202,372,0.763659,0.236341,0.763659,334,38,1, merged,0,0,0.44875181272
25408,1000004,2,1422,1232,190,0.866385,0.133615,1.630045,154,36,1423,1233,190,0.866479,0.133521,1.630439,154,36,-1, merged,0,0,0.0968677971524
25408,1000329,1,1574,1202,372,0.763659,0.236341,0.763659,334,38,1576,1204,372,0.763959,0.236041,0.763959,334,38,-1, merged,0,0,0.178299020904
25412,1000014,2,1085,928,157,0.8553,0.1447,1.674091,145,12,1087,929,158,0.854646,0.145354,1.670699,146,12,1, merged,1,1,0.292951336042
25412,1000043,1,298,244,54,0.818792,0.181208,0.818792,47,7,299,244,55,0.816054,0.183946,0.816054,48,7,1, merged,1,1,0.39589388719
25412,1000110,3,6,6,0,1,0,2.674091,0,0,8,8,0,1,0,2.670699,0,0,-1, merged,0,0,0.33709375
25416,1000005,1,181,134,47,0.740331,0.259669,0.740331,42,5,182,135,47,0.741758,0.258242,0.741758,42,5,1, merged,0,0,0
25416,1000091,2,307,236,71,0.76873,0.23127,1.509061,60,11,308,237,71,0.769481,0.230519,1.511239,60,11,1, merged,0,0,0
25432,1000153,2,574,528,46,0.919861,0.080139,1.719861,35,11,575,529,46,0.92,0.08,1.753333,35,11,1, merged,0,0,0.539898251965
25437,1000003,1,814,694,120,0.85258,0.14742,0.85258,113,7,818,698,120,0.853301,0.146699,0.853301,113,7,-1, merged,0,0,1.05496538332
25448,1000003,1,818,698,120,0.853301,0.146699,0.853301,113,7,822,700,122,0.851582,0.148418,0.851582,115,7,-1, abandoned,1,0,0.0312493930451
25452,1000121,3,1071,879,192,0.820728,0.179272,2.45706,183,9,1072,880,192,0.820896,0.179104,2.453861,183,9,1, merged,0,0,0.0889798433672
25455,1000011,1,417,387,30,0.928058,0.071942,0.928058,27,3,418,388,30,0.92823,0.07177,0.92823,27,3,1, merged,0,0,0.00316326684546
25455,1000120,2,526,427,99,0.811787,0.188213,1.739845,92,7,527,428,99,0.812144,0.187856,1.740374,92,7,1, merged,0,0,0.023045367295
25456,1000011,1,418,388,30,0.92823,0.07177,0.92823,27,3,419,389,30,0.928401,0.071599,0.928401,27,3,1, merged,0,0,0.726011846002
25456,1000120,2,527,428,99,0.812144,0.187856,1.740374,92,7,528,429,99,0.8125,0.1875,1.740901,92,7,1, merged,0,0,0.56828030303
25459,1000054,3,65,59,6,0.907692,0.092308,2.635548,4,2,66,60,6,0.909091,0.090909,2.635188,4,2,1, merged,0,0,0.0015662484331
25459,1000124,1,381,353,28,0.926509,0.073491,0.926509,26,2,382,353,29,0.924084,0.075916,0.924084,27,2,1, merged,1,1,0.000956948083286
25465,1000004,2,1423,1233,190,0.866479,0.133521,1.687375,154,36,1426,1236,190,0.86676,0.13324,1.686295,154,36,-1, merged,0,0,0
25465,1000121,1,1072,880,192,0.820896,0.179104,0.820896,183,9,1075,881,194,0.819535,0.180465,0.819535,185,9,1, merged,1,1,0
25465,1000124,3,383,354,29,0.924282,0.075718,2.611657,27,2,384,355,29,0.924479,0.075521,2.610774,27,2,1, merged,0,0,0
25466,1000004,1,1426,1236,190,0.86676,0.13324,0.86676,154,36,1427,1236,191,0.866153,0.133847,0.866153,155,36,1, merged,1,1,0
25468,1000199,2,270,223,47,0.825926,0.174074,1.719543,44,3,271,224,47,0.826568,0.173432,1.722402,44,3,1, merged,0,0,0.0902644115163
25470,1000054,3,66,60,6,0.909091,0.090909,2.635583,4,2,68,61,7,0.897059,0.102941,2.619137,5,2,1, merged,1,1,0.00123113756266
25470,1000124,1,384,355,29,0.924479,0.075521,0.924479,27,2,385,355,30,0.922078,0.077922,0.922078,28,2,1, merged,1,1,0.000755716475119
25476,1000015,2,1172,1068,104,0.911263,0.088737,1.577929,92,12,1173,1069,104,0.911338,0.088662,1.578005,92,12,1, merged,0,0,0.039266324417
25476,1000534,1,57,38,19,0.666667,0.333333,0.666667,19,0,60,40,20,0.666667,0.333333,0.666667,20,0,1, merged,1,1,0.0115644273319
25477,1000023,1,304,269,35,0.884868,0.115132,0.884868,32,3,305,270,35,0.885246,0.114754,0.885246,32,3,1, merged,0,0,0.000281630641414
25477,1000063,2,1937,1730,207,0.893134,0.106866,1.778002,176,31,1938,1731,207,0.893189,0.106811,1.778435,176,31,1, merged,0,0,0.000128991572551
25478,1000023,1,305,270,35,0.885246,0.114754,0.885246,32,3,306,270,36,0.882353,0.117647,0.882353,33,3,1, merged,1,1,0.000422431090928
25478,1000063,2,1938,1731,207,0.893189,0.106811,1.778435,176,31,1940,1733,207,0.893299,0.106701,1.775652,176,31,-1, merged,0,0,0.000167209700074
25483,1000004,2,1427,1236,191,0.866153,0.133847,1.721372,155,36,1428,1237,191,0.866246,0.133754,1.721709,155,36,1, merged,0,0,0.440148829593
25483,1000007,1,594,508,86,0.855219,0.144781,0.855219,73,13,595,509,86,0.855462,0.144538,0.855462,73,13,1, merged,0,0,1.23562063533
25489,1000015,2,1174,1070,104,0.911414,0.088586,1.482843,92,12,1175,1071,104,0.911489,0.088511,1.502398,92,12,1, merged,0,0,0
25489,1000121,4,1075,881,194,0.819535,0.180465,3.005854,185,9,1076,882,194,0.819703,0.180297,3.026183,185,9,1, merged,0,0,0
25489,1000328,3,489,344,145,0.703476,0.296524,2.186319,131,14,490,345,145,0.704082,0.295918,2.20648,131,14,1, merged,0,0,0
25490,1000121,3,1076,882,194,0.819703,0.180297,2.114693,185,9,1077,883,194,0.81987,0.18013,2.13325,185,9,1, merged,0,0,0.174330094998
25490,1000328,2,490,345,145,0.704082,0.295918,1.294991,131,14,491,346,145,0.704684,0.295316,1.31338,131,14,1, merged,0,0,0.261777221501
25506,1000121,2,1077,883,194,0.81987,0.18013,1.612531,185,9,1078,884,194,0.820037,0.179963,1.613077,185,9,1, merged,0,0,0.0984062627915
25519,1000132,2,161,142,19,0.881988,0.118012,1.6032,16,3,162,143,19,0.882716,0.117284,1.605608,16,3,1, merged,0,0,1.35247813411
25522,1000121,2,1078,884,194,0.820037,0.179963,1.614955,185,9,1079,884,195,0.819277,0.180723,1.612755,186,9,1, merged,1,1,0
25522,1000329,3,1578,1206,372,0.764259,0.235741,2.379214,334,38,1580,1207,373,0.763924,0.236076,2.376679,334,39,-1, merged,1,0,0.331385767376
25523,1000118,1,642,569,73,0.886293,0.113707,0.886293,70,3,643,569,74,0.884914,0.115086,0.884914,71,3,1, merged,1,1,0.253012298084
25525,1000121,1,1079,884,195,0.819277,0.180723,0.819277,186,9,1081,886,195,0.819611,0.180389,0.819611,186,9,-1, merged,0,0,0.097759967976
25525,1000329,2,1580,1207,373,0.763924,0.236076,1.583201,334,39,1582,1209,373,0.764223,0.235777,1.583834,334,39,-1, merged,0,0,0.125604579441
25529,1000023,1,306,270,36,0.882353,0.117647,0.882353,33,3,307,271,36,0.882736,0.117264,0.882736,33,3,1, merged,0,0,0.000479920017771
25529,1000063,3,1940,1733,207,0.893299,0.106701,2.710078,176,31,1941,1734,207,0.893354,0.106646,2.710695,176,31,1, merged,0,0,0.00115795595725
25534,1000014,1,1092,934,158,0.855311,0.144689,0.855311,146,12,1094,935,159,0.854662,0.145338,0.854662,147,12,1, merged,1,1,0.597242151415
25534,1000070,3,692,618,74,0.893064,0.106936,2.410444,59,15,693,619,74,0.893218,0.106782,2.412263,59,15,1, merged,0,0,0.745872028279
25536,1000091,3,308,237,71,0.769481,0.230519,2.332127,60,11,309,237,72,0.76699,0.23301,2.332707,60,12,-1, merged,1,1,0.497716211157
25538,1000026,2,258,236,22,0.914729,0.085271,1.77584,20,2,259,237,22,0.915058,0.084942,1.776809,20,2,1, merged,0,0,0.110976744184
25546,1000005,1,182,135,47,0.741758,0.258242,0.741758,42,5,183,135,48,0.737705,0.262295,0.737705,43,5,1, merged,1,1,0.0516865688888
25546,1000105,3,303,241,62,0.79538,0.20462,2.237138,55,7,305,242,63,0.793443,0.206557,2.146532,56,7,1, merged,1,1,0.0463726140916
25546,1000118,4,643,569,74,0.884914,0.115086,3.122052,71,3,644,570,74,0.885093,0.114907,3.031625,71,3,1, merged,0,0,0.0841408536365
25552,1000015,1,1175,1071,104,0.911489,0.088511,0.911489,92,12,1176,1071,105,0.910714,0.089286,0.910714,93,12,1, abandoned,1,1,0
25552,1000534,2,60,40,20,0.666667,0.333333,1.578156,20,0,61,41,20,0.672131,0.327869,1.582845,20,0,-1, abandoned,0,0,0
25570,1000023,1,307,271,36,0.882736,0.117264,0.882736,33,3,309,271,38,0.877023,0.122977,0.877023,35,3,1, merged,1,1,0.000449905255865
25582,1000121,2,1082,887,195,0.819778,0.180222,1.740087,186,9,1083,888,195,0.819945,0.180055,1.738103,186,9,1, merged,0,0,0.00372646511415
25582,1000124,1,389,358,31,0.920308,0.079692,0.920308,29,2,391,359,32,0.918159,0.081841,0.918159,29,3,-1, merged,1,0,0.00528539836288
25591,1000091,2,309,237,72,0.76699,0.23301,1.472275,60,12,311,238,73,0.765273,0.234727,1.471156,60,13,-1, merged,1,1,0.0363597814664
25591,1000328,1,492,347,145,0.705285,0.294715,0.705285,131,14,493,348,145,0.705882,0.294118,0.705882,131,14,1, merged,0,0,0.0553586771385
25599,1000023,2,309,271,38,0.877023,0.122977,1.806847,35,3,310,272,38,0.877419,0.122581,1.807854,35,3,1, merged,0,0,0.000879229091932
25602,1000004,2,1430,1239,191,0.866434,0.133566,1.721361,155,36,1433,1242,191,0.866713,0.133287,1.720083,155,36,-1, merged,0,0,0.0556087722507
25602,1000014,1,1096,937,159,0.854927,0.145073,0.854927,147,12,1098,937,161,0.85337,0.14663,0.85337,149,12,1, merged,1,1,0
25606,1000003,2,822,700,122,0.851582,0.148418,1.643087,115,7,824,702,122,0.851942,0.148058,1.641214,115,7,-1, merged,0,0,0.147494382737
25607,1000003,2,824,702,122,0.851942,0.148058,1.641214,115,7,825,703,122,0.852121,0.147879,1.642198,115,7,1, merged,0,0,0.841181191763
25617,1000004,2,1433,1242,191,0.866713,0.133287,1.720083,155,36,1434,1243,191,0.866806,0.133194,1.720443,155,36,1, merged,0,0,0.126605301592
25617,1000014,1,1098,937,161,0.85337,0.14663,0.85337,149,12,1100,939,161,0.853636,0.146364,0.853636,149,12,-1, merged,0,0,0.175365767302
25642,1000014,1,1100,939,161,0.853636,0.146364,0.853636,149,12,1102,941,161,0.853902,0.146098,0.853902,149,12,1, merged,0,0,0.540475605619
25643,1000003,2,825,703,122,0.852121,0.147879,1.706023,115,7,828,705,123,0.851449,0.148551,1.704843,116,7,-1, merged,1,0,0.565569462596
25643,1000014,1,1102,941,161,0.853902,0.146098,0.853902,149,12,1105,943,162,0.853394,0.146606,0.853394,150,12,-1, merged,1,0,0.518012257095
25643,1000329,3,1586,1213,373,0.764817,0.235183,2.47084,334,39,1588,1215,373,0.765113,0.234887,2.469956,334,39,-1, merged,0,0,0.837514144331
25647,1000091,2,312,239,73,0.766026,0.233974,1.564842,60,13,313,240,73,0.766773,0.233227,1.566183,60,13,1, merged,0,0,0.661470516569
25649,1000043,1,303,248,55,0.818482,0.181518,0.818482,48,7,304,249,55,0.819079,0.180921,0.819079,48,7,1, merged,0,0,0.00239205836622
25649,1000110,2,9,9,0,1,0,1.818482,0,0,10,10,0,1,0,1.819079,0,0,1, merged,0,0,0.0625
25650,1000043,1,304,249,55,0.819079,0.180921,0.819079,48,7,305,250,55,0.819672,0.180328,0.819672,48,7,1, merged,0,0,0.00292922046868
25650,1000110,2,10,10,0,1,0,1.819079,0,0,11,11,0,1,0,1.819672,0,0,1, merged,0,0,0.0773195876289
25651,1000043,1,305,250,55,0.819672,0.180328,0.819672,48,7,306,251,55,0.820261,0.179739,0.820261,48,7,1, merged,0,0,0.00346599737062
25651,1000110,2,11,11,0,1,0,1.819672,0,0,12,12,0,1,0,1.820261,0,0,1, merged,0,0,0.0918367346939
25654,1000023,2,311,273,38,0.877814,0.122186,1.642927,35,3,312,274,38,0.878205,0.121795,1.643466,35,3,1, merged,0,0,0.000298874824191
25654,1000329,1,1588,1215,373,0.765113,0.234887,0.765113,334,39,1589,1216,373,0.765261,0.234739,0.765261,334,39,1, merged,0,0,0.0031914893617
25657,1000121,2,1085,890,195,0.820276,0.179724,1.570276,186,9,1086,891,195,0.820442,0.179558,1.589673,186,9,1, merged,0,0,0.13421098887
25663,1000023,3,312,274,38,0.878205,0.121795,2.724318,35,3,313,275,38,0.878594,0.121406,2.725318,35,3,1, merged,0,0,0.000166967223081
25690,1000005,2,184,136,48,0.73913,0.26087,0.73913,43,5,185,137,48,0.740541,0.259459,1.740541,43,5,1, merged,0,0,0
25695,1000005,1,185,137,48,0.740541,0.259459,0.740541,43,5,186,138,48,0.741935,0.258065,0.741935,43,5,1, merged,0,0,0
25714,1000014,2,1105,943,162,0.853394,0.146606,1.769201,150,12,1106,944,162,0.853526,0.146474,1.769622,150,12,1, merged,0,0,0.158028683283
25714,1000153,1,582,533,49,0.915808,0.084192,0.915808,38,11,584,535,49,0.916096,0.083904,0.916096,38,11,1, merged,0,0,0.235265992257
25715,1000014,1,1106,944,162,0.853526,0.146474,0.853526,150,12,1107,945,162,0.853659,0.146341,0.853659,150,12,1, merged,0,0,0.728040380672
25715,1000153,2,584,535,49,0.916096,0.083904,1.769622,38,11,585,536,49,0.916239,0.083761,1.769898,38,11,1, merged,0,0,1.10494402539
25720,1000014,1,1107,945,162,0.853659,0.146341,0.853659,150,12,1108,946,162,0.853791,0.146209,0.853791,150,12,1, merged,0,0,0.0443258185513
25720,1000121,2,1089,894,195,0.820937,0.179063,1.674595,186,9,1090,895,195,0.821101,0.178899,1.674892,186,9,1, merged,0,0,0.0453375888917
25721,1000014,1,1108,946,162,0.853791,0.146209,0.853791,150,12,1109,947,162,0.853922,0.146078,0.853922,150,12,1, merged,0,0,0.0481988848193
25721,1000121,2,1090,895,195,0.821101,0.178899,1.674892,186,9,1091,896,195,0.821265,0.178735,1.675187,186,9,1, merged,0,0,0.0492093716957
25726,1000003,2,830,707,123,0.851807,0.148193,1.762824,116,7,831,708,123,0.851986,0.148014,1.763078,116,7,1, merged,0,0,0.604328725398
25726,1000015,1,1180,1075,105,0.911017,0.088983,0.911017,93,12,1181,1076,105,0.911092,0.088908,0.911092,93,12,1, merged,0,0,0.620387939086
25739,1000124,2,392,360,32,0.918367,0.081633,1.776475,29,3,393,361,32,0.918575,0.081425,1.777635,29,3,1, merged,0,0,0.239363423038
25739,1000166,1,148,127,21,0.858108,0.141892,0.858108,20,1,149,128,21,0.85906,0.14094,0.85906,20,1,1, merged,0,0,0.507596757067
25743,1000132,2,164,145,19,0.884146,0.115854,1.804146,16,3,165,146,19,0.884848,0.115152,1.805378,16,3,1, merged,0,0,1.39734648068
25760,1000121,2,1091,896,195,0.821265,0.178735,0.821265,186,9,1092,897,195,0.821429,0.178571,1.821429,186,9,1, merged,0,0,0.557461883609
25761,1000014,1,1110,948,162,0.854054,0.145946,0.854054,150,12,1113,949,164,0.85265,0.14735,0.85265,152,12,-1, merged,1,0,0.26396484101
25761,1000109,2,341,285,56,0.835777,0.164223,1.689831,54,2,342,286,56,0.836257,0.163743,1.688908,54,2,-1, merged,0,0,0.0655894445861
25761,1000153,4,586,537,49,0.916382,0.083618,3.606213,38,11,588,538,50,0.914966,0.085034,3.103874,39,11,-1, merged,1,0,0.29729542684
25780,1000004,1,1435,1244,191,0.866899,0.133101,0.866899,155,36,1436,1245,191,0.866992,0.133008,0.866992,155,36,-1, merged,0,0,0.020765797397
25788,1000004,3,1436,1245,191,0.866992,0.133008,2.435179,155,36,1439,1247,192,0.866574,0.133426,2.436806,155,37,-1, merged,1,0,0.0323956903061
25788,1000328,4,493,348,145,0.705882,0.294118,3.141062,131,14,495,350,145,0.707071,0.292929,3.143877,131,14,-1, merged,0,0,0.0534758174782
25788,1000329,1,1591,1218,373,0.765556,0.234444,0.765556,334,39,1596,1221,375,0.765038,0.234962,0.765038,336,39,-1, merged,1,0,0.0493927791597
25790,1000004,3,1439,1247,192,0.866574,0.133426,2.5246,155,37,1440,1248,192,0.866667,0.133333,2.522314,155,37,1, merged,0,0,0.0558964772669
25790,1000014,2,1116,952,164,0.853047,0.146953,1.658026,152,12,1117,953,164,0.853178,0.146822,1.655647,152,12,1, merged,0,0,0.0273042599177
25792,1000063,1,1942,1735,207,0.893409,0.106591,0.893409,176,31,1944,1735,209,0.89249,0.10751,0.89249,178,31,1, merged,1,1,0.335219201758
25802,1000023,1,314,276,38,0.878981,0.121019,0.878981,35,3,315,277,38,0.879365,0.120635,0.879365,35,3,1, merged,0,0,0.00204169055957
25803,1000023,1,315,277,38,0.879365,0.120635,0.879365,35,3,316,278,38,0.879747,0.120253,0.879747,35,3,1, merged,0,0,0.000440730650366
25804,1000121,2,1092,897,195,0.821429,0.178571,1.740824,186,9,1093,898,195,0.821592,0.178408,1.74119,186,9,1, merged,0,0,0
25804,1000124,1,397,365,32,0.919395,0.080605,0.919395,29,3,398,366,32,0.919598,0.080402,0.919598,29,3,1, merged,0,0,0
25813,1000110,1,12,12,0,1,0,1,0,0,13,13,0,1,0,1,0,0,1, merged,0,0,0.182343744487
25813,1000140,2,2,2,0,1,0,2,0,0,3,3,0,1,0,2,0,0,1, merged,0,0,0.169354161418
25821,1000121,1,1094,899,195,0.821755,0.178245,0.821755,186,9,1095,900,195,0.821918,0.178082,0.821918,186,9,1, merged,0,0,0.145862437515
25821,1000329,2,1597,1222,375,0.765185,0.234815,1.58694,336,39,1598,1223,375,0.765332,0.234668,1.587249,336,39,1, merged,0,0,0.187256884298
25822,1000091,1,316,242,74,0.765823,0.234177,0.765823,61,13,317,243,74,0.766562,0.233438,0.766562,61,13,1, merged,0,0,0.0789325041723
25828,1000118,2,648,574,74,0.885802,0.114198,1.649161,71,3,649,575,74,0.885978,0.114022,1.650237,71,3,1, merged,0,0,0.149583687827
25845,1000014,1,1120,956,164,0.853571,0.146429,0.853571,152,12,1121,957,164,0.853702,0.146298,0.853702,152,12,1, merged,0,0,0.570544697918
25845,1000120,2,535,436,99,0.814953,0.185047,1.668525,92,7,536,437,99,0.815299,0.184701,1.669001,92,7,1, merged,0,0,0.427144982993
25848,1000124,2,401,369,32,0.9202,0.0798,1.633533,29,3,403,371,32,0.920596,0.079404,1.631122,29,3,-1, merged,0,0,0.00448086333861
25862,1000014,2,1121,957,164,0.853702,0.146298,1.744611,152,12,1122,958,164,0.853832,0.146168,1.748569,152,12,1, merged,0,0,0.0660181529135
25864,1000124,2,415,383,32,0.922892,0.077108,1.729909,29,3,418,386,32,0.923445,0.076555,1.706778,29,3,-1, merged,0,0,0.246895550164
25866,1000592,2,317,260,57,0.820189,0.179811,1.603523,40,17,318,261,57,0.820755,0.179245,1.60764,40,17,1, merged,0,0,0.128097014925
25867,1000592,2,318,261,57,0.820755,0.179245,1.60764,40,17,319,262,57,0.821317,0.178683,1.611639,40,17,1, merged,0,0,0.130984340045
25891,1000014,1,1122,958,164,0.853832,0.146168,0.853832,152,12,1123,959,164,0.853963,0.146037,0.853963,152,12,1, merged,0,0,0.000488707972334
25891,1000121,3,1095,900,195,0.821918,0.178082,2.41325,186,9,1096,901,195,0.82208,0.17792,2.416784,186,9,1, merged,0,0,0.00170671509776
25895,1000120,2,536,437,99,0.815299,0.184701,1.593076,92,7,537,438,99,0.815642,0.184358,1.595234,92,7,1, merged,0,0,0
25895,1000199,3,271,224,47,0.826568,0.173432,2.419645,44,3,272,225,47,0.827206,0.172794,2.42244,44,3,1, merged,0,0,0
25896,1000070,2,705,631,74,0.895035,0.104965,1.62603,59,15,706,632,74,0.895184,0.104816,1.627742,59,15,1, merged,0,0,0.247210370206
25899,1000329,2,1598,1223,375,0.765332,0.234668,1.60317,336,39,1601,1225,376,0.765147,0.234853,1.603531,337,39,1, merged,1,1,0
25901,1000070,1,706,632,74,0.895184,0.104816,0.895184,59,15,708,633,75,0.894068,0.105932,0.894068,60,15,1, abandoned,1,1,0.59872600826
25901,1000105,3,306,243,63,0.794118,0.205882,2.115968,56,7,308,245,63,0.795455,0.204545,2.123733,56,7,-1, abandoned,0,0,0.622595915143
25903,1000592,2,319,262,57,0.821317,0.178683,1.611639,40,17,320,263,57,0.821875,0.178125,1.60649,40,17,1, merged,0,0,0.133668154762
25917,1000121,2,1096,901,195,0.82208,0.17792,1.679223,186,9,1098,902,196,0.821494,0.178506,1.548766,187,9,-1, abandoned,1,0,0.00203221827763
25925,1000043,4,308,253,55,0.821429,0.178571,2.465331,48,7,309,254,55,0.822006,0.177994,2.467552,48,7,-1, abandoned,0,0,0.00140484590621
25925,1000130,1,205,173,32,0.843902,0.156098,0.843902,23,9,206,174,32,0.84466,0.15534,0.84466,23,9,-1, abandoned,0,0,0.00226813636434
25935,1000124,2,420,388,32,0.92381,0.07619,1.770868,29,3,421,389,32,0.92399,0.07601,1.771647,29,3,1, merged,0,0,0.371958734594
25938,1000124,2,421,389,32,0.92399,0.07601,1.772828,29,3,422,390,32,0.924171,0.075829,1.773591,29,3,1, merged,0,0,0.189809544096
25948,1000063,2,1947,1738,209,0.892655,0.107345,1.828312,178,31,1948,1739,209,0.89271,0.10729,1.828539,178,31,1, merged,0,0,0.00432377134241
25953,1000023,2,316,278,38,0.879747,0.120253,1.793622,35,3,317,279,38,0.880126,0.119874,1.794412,35,3,1, merged,0,0,0.0105115127565
25959,1000063,1,1952,1743,209,0.89293,0.10707,0.89293,178,31,1953,1744,209,0.892985,0.107015,0.892985,178,31,1, merged,0,0,0.00251414204903
25974,1000004,2,1441,1248,193,0.866065,0.133935,1.688072,155,38,1442,1249,193,0.866158,0.133842,1.688739,155,38,1, merged,0,0,0.0045855144945
25974,1000043,1,309,254,55,0.822006,0.177994,0.822006,48,7,310,255,55,0.822581,0.177419,0.822581,48,7,1, merged,0,0,0.00510152496663
25978,1000015,3,1184,1079,105,0.911318,0.088682,2.74163,93,12,1185,1080,105,0.911392,0.088608,2.740483,93,12,1, merged,0,0,0.0322199312715
25978,1000026,2,259,237,22,0.915058,0.084942,1.830312,20,2,260,238,22,0.915385,0.084615,1.82909,20,2,1, merged,0,0,0.676038228823
25978,1000153,1,590,540,50,0.915254,0.084746,0.915254,39,11,591,540,51,0.913706,0.086294,0.913706,40,11,1, merged,1,1,0.0393848211301
25983,1000199,1,272,225,47,0.827206,0.172794,0.827206,44,3,275,228,47,0.829091,0.170909,0.829091,44,3,-1, merged,0,0,0.0169097754681
25992,1000043,1,310,255,55,0.822581,0.177419,0.822581,48,7,311,256,55,0.823151,0.176849,0.823151,48,7,1, merged,0,0,0.608626019469
25992,1000328,2,495,350,145,0.707071,0.292929,1.529651,131,14,496,351,145,0.707661,0.292339,1.530812,131,14,1, merged,0,0,0.975035434539
25992,1000329,3,1601,1225,376,0.765147,0.234853,2.294798,337,39,1602,1226,376,0.765293,0.234707,2.296106,337,39,1, merged,0,0,0.835999619238
25993,1000004,2,1442,1249,193,0.866158,0.133842,1.689309,155,38,1444,1251,193,0.866343,0.133657,1.686856,155,38,-1, merged,0,0,0.000271356181482
25993,1000043,1,311,256,55,0.823151,0.176849,0.823151,48,7,312,256,56,0.820513,0.179487,0.820513,49,7,1, merged,1,1,0
26007,1000199,1,276,229,47,0.82971,0.17029,0.82971,44,3,277,230,47,0.830325,0.169675,0.830325,44,3,-1, abandoned,0,0,0.0921057638008
26008,1000121,3,1099,903,196,0.821656,0.178344,2.297476,187,9,1100,903,197,0.820909,0.179091,2.30045,188,9,1, merged,1,1,0.00215649707734
26008,1000329,2,1602,1226,376,0.765293,0.234707,1.47582,337,39,1606,1229,377,0.765255,0.234745,1.479541,338,39,-1, merged,1,0,0.0014478900285
26013,1000004,2,1444,1251,193,0.866343,0.133657,1.671538,155,38,1449,1256,193,0.866805,0.133195,1.664273,155,38,-1, merged,0,0,0.00694388498778
26014,1000014,1,1126,961,165,0.853464,0.146536,0.853464,153,12,1128,962,166,0.852837,0.147163,0.852837,154,12,1, merged,1,1,0.292864223596
26014,1000070,5,711,635,76,0.893108,0.106892,3.674174,61,15,712,636,76,0.893258,0.106742,3.635966,61,15,1, merged,0,0,0.432105961165
26028,1000003,1,849,723,126,0.85159,0.14841,0.85159,119,7,850,723,127,0.850588,0.149412,0.850588,120,7,1, merged,1,1,0.0313493716783
26030,1000007,1,607,518,89,0.853377,0.146623,0.853377,76,13,608,519,89,0.853618,0.146382,0.853618,76,13,1, merged,0,0,1.31184080432
26030,1000153,2,593,542,51,0.913997,0.086003,1.767374,40,11,595,543,52,0.912605,0.087395,1.766223,40,12,1, merged,1,0,1.12069677871
26041,1000121,1,1101,904,197,0.821072,0.178928,0.821072,188,9,1102,905,197,0.821234,0.178766,0.821234,188,9,1, merged,0,0,0
26042,1000004,4,1449,1256,193,0.866805,0.133195,2.593573,155,38,1450,1257,193,0.866897,0.133103,2.525353,155,38,-1, merged,0,0,0.0331898277934
26047,1000329,2,1614,1233,381,0.763941,0.236059,1.495369,342,39,1615,1233,382,0.763467,0.236533,1.488187,343,39,1, merged,1,1,0.0322114185989
26051,1000014,2,1128,962,166,0.852837,0.147163,1.524968,154,12,1129,963,166,0.852967,0.147033,1.530387,154,12,-1, abandoned,0,0,0.616765800971
26051,1000534,1,61,41,20,0.672131,0.327869,0.672131,20,0,62,42,20,0.677419,0.322581,0.677419,20,0,-1, abandoned,0,0,0.942613636364
26055,1000004,5,1450,1257,193,0.866897,0.133103,4.128455,155,38,1451,1258,193,0.866988,0.133012,4.136258,155,38,1, merged,0,0,0.00813575296985
26055,1000014,1,1129,963,166,0.852967,0.147033,0.852967,154,12,1132,964,168,0.85159,0.14841,0.85159,156,12,1, merged,1,1,0.00419117180101
26055,1000120,2,541,442,99,0.817006,0.182994,1.669973,92,7,543,444,99,0.81768,0.18232,1.66927,92,7,-1, merged,0,0,0.00831390381343
26056,1000014,3,1132,964,168,0.85159,0.14841,2.04856,156,12,1133,965,168,0.851721,0.148279,2.232673,156,12,1, merged,0,0,0
26059,1000070,1,714,638,76,0.893557,0.106443,0.893557,61,15,715,639,76,0.893706,0.106294,0.893706,61,15,1, merged,0,0,0.815906273621
26061,1000592,2,320,263,57,0.821875,0.178125,1.60649,40,17,321,264,57,0.82243,0.17757,1.613475,40,17,1, merged,0,0,0.136441307578
26066,1000592,2,322,264,58,0.819876,0.180124,1.610921,40,18,323,265,58,0.820433,0.179567,1.614551,40,18,1, merged,0,0,0.139612256401
26071,1000118,1,654,580,74,0.88685,0.11315,0.88685,71,3,655,581,74,0.887023,0.112977,0.887023,71,3,1, merged,0,0,0.220362289932
26071,1000121,2,1102,905,197,0.821234,0.178766,1.708084,188,9,1103,906,197,0.821396,0.178604,1.708419,188,9,1, merged,0,0,0.651533990667
26088,1000121,4,1103,906,197,0.821396,0.178604,3.014274,188,9,1104,907,197,0.821558,0.178442,2.97209,188,9,1, merged,0,0,0.0259364433774
26090,1000054,1,69,62,7,0.898551,0.101449,0.898551,5,2,70,63,7,0.9,0.1,0.9,5,2,1, merged,0,0,0.976892862919
26097,1000109,3,342,286,56,0.836257,0.163743,2.4774,54,2,343,286,57,0.833819,0.166181,2.49368,54,3,-1, merged,1,1,0.24518259271
26097,1000199,4,278,231,47,0.830935,0.169065,3.308335,44,3,279,231,48,0.827957,0.172043,3.321637,44,4,-1, merged,1,1,0.252892531956
26105,1000023,1,317,279,38,0.880126,0.119874,0.880126,35,3,318,280,38,0.880503,0.119497,0.880503,35,3,1, merged,0,0,0.0043782662734
26106,1000328,2,496,351,145,0.707661,0.292339,1.471567,131,14,497,352,145,0.708249,0.291751,1.472301,131,14,1, merged,0,0,0.478410074584
26106,1000329,1,1618,1236,382,0.763906,0.236094,0.763906,343,39,1619,1237,382,0.764052,0.235948,0.764052,343,39,1, merged,0,0,0.413904103822
26114,1000592,2,323,265,58,0.820433,0.179567,1.640946,40,18,324,266,58,0.820988,0.179012,1.645988,40,18,1, merged,0,0,0.20762013715
26115,1000592,2,324,266,58,0.820988,0.179012,1.645988,40,18,325,267,58,0.821538,0.178462,1.650807,40,18,1, merged,0,0,0.530892504931
26121,1000015,2,1187,1082,105,0.911542,0.088458,1.640355,93,12,1188,1082,106,0.910774,0.089226,1.635494,94,12,1, merged,1,1,0.372270465671
26121,1000026,3,260,238,22,0.915385,0.084615,2.55574,20,2,261,239,22,0.915709,0.084291,2.551202,20,2,1, merged,0,0,0.150203889581
26128,1000328,1,498,353,145,0.708835,0.291165,0.708835,131,14,500,355,145,0.71,0.29,0.71,131,14,-1, merged,0,0,0.215324544568
26129,1000328,1,500,355,145,0.71,0.29,0.71,131,14,501,356,145,0.710579,0.289421,0.710579,131,14,-1, abandoned,0,0,0.546795566121
26130,1000121,2,1104,907,197,0.821558,0.178442,1.488885,188,9,1105,907,198,0.820814,0.179186,1.486822,189,9,1, abandoned,1,1,0
26141,1000007,2,612,522,90,0.852941,0.147059,1.530361,77,13,613,523,90,0.853181,0.146819,1.535721,77,13,1, merged,0,0,0.436445492656
26141,1000534,1,62,42,20,0.677419,0.322581,0.677419,20,0,63,43,20,0.68254,0.31746,0.68254,20,0,1, merged,0,0,0.408593550665
26142,1000014,2,1134,966,168,0.851852,0.148148,1.746589,156,12,1135,967,168,0.851982,0.148018,1.748534,156,12,1, merged,0,0,0.678718358509
26159,1000003,2,856,728,128,0.850467,0.149533,1.761466,121,7,859,730,129,0.849825,0.150175,1.76006,122,7,-1, merged,1,0,0.212617395011
26159,1000015,1,1191,1085,106,0.910999,0.089001,0.910999,94,12,1192,1085,107,0.910235,0.089765,0.910235,95,12,1, merged,1,1,0.222905311715
26165,1000014,2,1135,967,168,0.851982,0.148018,1.748534,156,12,1136,968,168,0.852113,0.147887,1.737359,156,12,1, merged,0,0,0.130928959826
26179,1000329,1,1623,1241,382,0.764633,0.235367,0.764633,343,39,1624,1242,382,0.764778,0.235222,0.764778,343,39,-1, merged,0,0,0.0885317323983
26180,1000105,2,310,247,63,0.796774,0.203226,1.617751,56,7,311,248,63,0.797428,0.202572,1.618727,56,7,1, merged,0,0,0.00606897912005
26180,1000121,1,1106,908,198,0.820976,0.179024,0.820976,189,9,1108,910,198,0.8213,0.1787,0.8213,189,9,-1, merged,0,0,0.00576369058252
26184,1000003,1,862,732,130,0.849188,0.150812,0.849188,122,8,864,734,130,0.849537,0.150463,0.849537,122,8,-1, merged,0,0,0.168828046314
26190,1000121,1,1108,910,198,0.8213,0.1787,0.8213,189,9,1109,911,198,0.821461,0.178539,0.821461,189,9,1, merged,0,0,0.0745272483743
26191,1000121,2,1109,911,198,0.821461,0.178539,1.586346,189,9,1110,912,198,0.821622,0.178378,1.586866,189,9,1, merged,0,0,0.031979199634
26192,1000121,2,1110,912,198,0.821622,0.178378,1.586866,189,9,1112,912,200,0.820144,0.179856,1.584223,191,9,1, merged,1,1,0.0448569946488
26205,1000023,3,318,280,38,0.880503,0.119497,2.73379,35,3,319,281,38,0.880878,0.119122,2.734717,35,3,1, merged,0,0,0.000255091385124
26223,1000070,2,716,640,76,0.893855,0.106145,1.750998,61,15,717,641,76,0.894003,0.105997,1.727336,61,15,1, merged,0,0,0.64244083679
26225,1000070,2,719,642,77,0.892907,0.107093,1.690334,62,15,720,643,77,0.893056,0.106944,1.691132,62,15,1, merged,0,0,0.10653653589
26225,1000105,1,311,248,63,0.797428,0.202572,0.797428,56,7,312,249,63,0.798077,0.201923,0.798077,56,7,1, merged,0,0,0.0883885834366
26228,1000004,1,1451,1258,193,0.866988,0.133012,0.866988,155,38,1452,1258,194,0.866391,0.133609,0.866391,155,39,-1, merged,1,1,0.00465338959585
26234,1000121,2,1112,912,200,0.820144,0.179856,1.584922,191,9,1113,913,200,0.820305,0.179695,1.585373,191,9,1, merged,0,0,0.650559556429
26234,1000329,1,1624,1242,382,0.764778,0.235222,0.764778,343,39,1626,1244,382,0.765068,0.234932,0.765068,343,39,1, merged,0,0,0.815716740791
26241,1000007,1,616,525,91,0.852273,0.147727,0.852273,77,14,617,526,91,0.852512,0.147488,0.852512,77,14,1, merged,0,0,0.0302028161736
26241,1000026,2,262,240,22,0.916031,0.083969,1.768303,20,2,263,241,22,0.91635,0.08365,1.768862,20,2,1, merged,0,0,0.676426611797
26248,1000009,2,561,476,85,0.848485,0.151515,1.52036,77,8,563,478,85,0.849023,0.150977,1.525946,77,8,1, merged,0,0,0.48510775177
26248,1000534,1,64,43,21,0.671875,0.328125,0.671875,20,1,65,44,21,0.676923,0.323077,0.676923,20,1,1, merged,0,0,0.528472180292
26252,1000329,1,1626,1244,382,0.765068,0.234932,0.765068,343,39,1627,1245,382,0.765212,0.234788,0.765212,343,39,1, merged,0,0,0
26257,1000329,2,1627,1245,382,0.765212,0.234788,1.479498,343,39,1628,1246,382,0.765356,0.234644,1.320912,343,39,1, merged,0,0,0.851683869705
26266,1000091,2,318,244,74,0.767296,0.232704,1.587762,61,13,319,245,74,0.768025,0.231975,1.588814,61,13,1, merged,0,0,0.0120722916339
26266,1000121,1,1114,914,200,0.820467,0.179533,0.820467,191,9,1116,916,200,0.820789,0.179211,0.820789,191,9,-1, merged,0,0,0.00742952836331
26268,1000199,2,279,231,48,0.827957,0.172043,1.610566,44,4,280,232,48,0.828571,0.171429,1.612036,44,4,1, merged,0,0,0.0452276720308
26274,1000120,2,549,450,99,0.819672,0.180328,1.596688,92,7,550,451,99,0.82,0.18,1.597778,92,7,1, merged,0,0,0.425498826291
26274,1000327,1,583,453,130,0.777015,0.222985,0.777015,100,30,585,455,130,0.777778,0.222222,0.777778,100,30,-1, merged,0,0,0.575480429561
26274,1000329,3,1628,1246,382,0.765356,0.234644,2.362044,343,39,1629,1247,382,0.7655,0.2345,2.363278,343,39,1, merged,0,0,0.605176414
26276,1000004,1,1455,1261,194,0.866667,0.133333,0.866667,155,39,1459,1265,194,0.867032,0.132968,0.867032,155,39,-1, merged,0,0,0.0431926133085
26277,1000004,1,1459,1265,194,0.867032,0.132968,0.867032,155,39,1461,1267,194,0.867214,0.132786,0.867214,155,39,-1, merged,0,0,0.198155281881
26285,1000004,2,1461,1267,194,0.867214,0.132786,1.60091,155,39,1462,1268,194,0.867305,0.132695,1.60244,155,39,1, merged,0,0,0.0341189002064
26298,1000004,2,1462,1268,194,0.867305,0.132695,1.672802,155,39,1463,1269,194,0.867396,0.132604,1.673303,155,39,1, merged,0,0,0.0771628233461
26305,1000004,1,1465,1271,194,0.867577,0.132423,0.867577,155,39,1467,1273,194,0.867757,0.132243,0.867757,155,39,-1, merged,0,0,0.408663554601
26305,1000120,2,550,451,99,0.82,0.18,1.687577,92,7,551,452,99,0.820327,0.179673,1.688084,92,7,-1, merged,0,0,0.442308256343
26316,1000121,1,1116,916,200,0.820789,0.179211,0.820789,191,9,1117,917,200,0.820949,0.179051,0.820949,191,9,1, merged,0,0,0.263245948109
26325,1000329,1,1632,1250,382,0.765931,0.234069,0.765931,343,39,1633,1250,383,0.765462,0.234538,0.765462,344,39,1, abandoned,1,1,0.169595037519
26331,1000004,1,1467,1273,194,0.867757,0.132243,0.867757,155,39,1468,1274,194,0.867847,0.132153,0.867847,155,39,1, merged,0,0,0.207873614488
26336,1000003,2,868,736,132,0.847926,0.152074,1.700299,122,10,869,737,132,0.848101,0.151899,1.700603,122,10,1, merged,0,0,0.307137523552
26336,1000014,1,1138,970,168,0.852373,0.147627,0.852373,156,12,1139,971,168,0.852502,0.147498,0.852502,156,12,1, merged,0,0,0.256171748968
26341,1000199,1,282,234,48,0.829787,0.170213,0.829787,44,4,283,235,48,0.830389,0.169611,0.830389,44,4,1, merged,0,0,0.139666063124
26344,1000014,1,1139,971,168,0.852502,0.147498,0.852502,156,12,1140,972,168,0.852632,0.147368,0.852632,156,12,1, merged,0,0,0.306895074945
26350,1000015,2,1202,1095,107,0.910982,0.089018,1.662178,95,12,1203,1096,107,0.911056,0.088944,1.663437,95,12,1, merged,0,0,1.11924972618
26351,1000004,1,1468,1274,194,0.867847,0.132153,0.867847,155,39,1470,1276,194,0.868027,0.131973,0.868027,155,39,-1, merged,0,0,0.0434271519507
26351,1000070,2,720,643,77,0.893056,0.106944,1.760903,62,15,721,644,77,0.893204,0.106796,1.761231,62,15,1, merged,0,0,0.0117687781239
26353,1000007,1,618,527,91,0.852751,0.147249,0.852751,77,14,619,528,91,0.852989,0.147011,0.852989,77,14,1, merged,0,0,0.0304415182029
26360,1000153,2,602,550,52,0.913621,0.086379,1.678327,40,12,603,551,52,0.913765,0.086235,1.691542,40,12,1, merged,0,0,1.07896828046
26363,1000329,1,1634,1251,383,0.765606,0.234394,0.765606,344,39,1636,1253,383,0.765892,0.234108,0.765892,344,39,-1, merged,0,0,0.897149681716
26369,1000043,2,313,257,56,0.821086,0.178914,1.665746,49,7,314,258,56,0.821656,0.178344,1.667067,49,7,-1, abandoned,0,0,0.776958525346
26369,1000130,1,206,174,32,0.84466,0.15534,0.84466,23,9,207,175,32,0.845411,0.154589,0.845411,23,9,-1, abandoned,0,0,0.876840934191
26370,1000043,2,314,258,56,0.821656,0.178344,1.667067,49,7,315,259,56,0.822222,0.177778,1.663568,49,7,1, merged,0,0,0.788561627052
26370,1000130,1,207,175,32,0.845411,0.154589,0.845411,23,9,208,175,33,0.841346,0.158654,0.841346,24,9,1, merged,1,1,0.906736293699
26378,1000105,3,313,250,63,0.798722,0.201278,2.3358,56,7,314,251,63,0.799363,0.200637,2.343902,56,7,1, merged,0,0,0.122113429204
26378,1000121,2,1117,917,200,0.820949,0.179051,1.537078,191,9,1119,919,200,0.821269,0.178731,1.544539,191,9,-1, merged,0,0,0.117598740193
26386,1000009,2,565,479,86,0.847788,0.152212,1.524711,78,8,566,480,86,0.848057,0.151943,1.519698,78,8,1, merged,0,0,0.243742676272
26386,1000534,1,65,44,21,0.676923,0.323077,0.676923,20,1,67,45,22,0.671642,0.328358,0.671642,21,1,1, merged,1,1,0.266985644912
26401,1000070,2,723,646,77,0.893499,0.106501,1.657578,62,15,724,646,78,0.892265,0.107735,1.655183,63,15,1, merged,1,1,0.154347217042
26402,1000014,1,1140,972,168,0.852632,0.147368,0.852632,156,12,1141,973,168,0.852761,0.147239,0.852761,156,12,1, merged,0,0,0.275490805015
26402,1000132,2,167,148,19,0.886228,0.113772,1.738859,16,3,168,149,19,0.886905,0.113095,1.739665,16,3,1, merged,0,0,0.670454606786
26416,1000327,1,585,455,130,0.777778,0.222222,0.777778,100,30,587,457,130,0.778535,0.221465,0.778535,100,30,-1, merged,0,0,0.683770593545
26419,1000009,1,567,481,86,0.848325,0.151675,0.848325,78,8,568,482,86,0.848592,0.151408,0.848592,78,8,1, merged,0,0,0.975966642439
26419,1000014,2,1142,974,168,0.85289,0.14711,1.701214,156,12,1143,975,168,0.853018,0.146982,1.70161,156,12,1, merged,0,0,0.610840798742
26424,1000070,1,728,649,79,0.891484,0.108516,0.891484,64,15,729,650,79,0.891632,0.108368,0.891632,64,15,1, merged,0,0,0.0725395611396
26424,1000121,2,1121,921,200,0.821588,0.178412,1.713071,191,9,1122,922,200,0.821747,0.178253,1.713379,191,9,1, merged,0,0,0.0442085860662
26428,1000121,1,1122,922,200,0.821747,0.178253,0.821747,191,9,1123,923,200,0.821906,0.178094,0.821906,191,9,1, merged,0,0,0.230365929239
26429,1000070,2,730,651,79,0.891781,0.108219,1.670316,64,15,731,651,80,0.890561,0.109439,1.667772,64,16,-1, merged,1,1,0.0474525577558
26429,1000327,1,587,457,130,0.778535,0.221465,0.778535,100,30,588,457,131,0.777211,0.222789,0.777211,100,31,-1, merged,1,1,0.0408498667456
26441,1000023,1,323,283,40,0.876161,0.123839,0.876161,37,3,324,284,40,0.876543,0.123457,0.876543,37,3,1, merged,0,0,0.000698250881542
26451,1000121,3,1123,923,200,0.821906,0.178094,2.283061,191,9,1124,924,200,0.822064,0.177936,2.284382,191,9,1, merged,0,0,0.125206249512
26451,1000328,1,502,357,145,0.711155,0.288845,0.711155,131,14,503,358,145,0.71173,0.28827,0.71173,131,14,1, merged,0,0,0.143912586971
26453,1000070,3,731,651,80,0.890561,0.109439,2.295958,64,16,732,652,80,0.89071,0.10929,2.312933,64,16,1, merged,0,0,0.171720989946
26453,1000121,2,1124,924,200,0.822064,0.177936,1.405397,191,9,1125,925,200,0.822222,0.177778,1.422222,191,9,1, merged,0,0,0.126208198405
26456,1000121,1,1125,925,200,0.822222,0.177778,0.822222,191,9,1126,926,200,0.82238,0.17762,0.82238,191,9,1, merged,0,0,0.635775328165
26457,1000121,1,1126,926,200,0.82238,0.17762,0.82238,191,9,1127,927,200,0.822538,0.177462,0.822538,191,9,1, merged,0,0,0.343791167797
26470,1000121,2,1128,927,201,0.821809,0.178191,1.421809,192,9,1129,927,202,0.821081,0.178919,1.413673,193,9,1, abandoned,1,1,0.105397510274
26475,1000070,2,735,655,80,0.891156,0.108844,1.324891,64,16,736,656,80,0.891304,0.108696,1.331781,64,16,1, merged,0,0,0.781727916336
26476,1000043,1,315,259,56,0.822222,0.177778,0.822222,49,7,316,259,57,0.81962,0.18038,0.81962,49,8,-1, merged,1,1,0.582605820106
26514,1000009,2,570,484,86,0.849123,0.150877,1.520765,78,8,571,484,87,0.847636,0.152364,1.514302,79,8,1, merged,1,1,0.976964601965
26514,1000014,3,1143,975,168,0.853018,0.146982,2.373783,156,12,1144,976,168,0.853147,0.146853,2.367449,156,12,1, merged,0,0,0.61162925862
26514,1000534,1,67,45,22,0.671642,0.328358,0.671642,21,1,69,46,23,0.666667,0.333333,0.666667,22,1,1, merged,1,1,1.08395721925
26517,1000014,1,1144,976,168,0.853147,0.146853,0.853147,156,12,1146,977,169,0.852531,0.147469,0.852531,157,12,1, merged,1,1,0.596001264828
26517,1000070,2,737,657,80,0.891452,0.108548,1.744599,64,16,738,658,80,0.891599,0.108401,1.744129,64,16,1, merged,0,0,0.742095922558
26519,1000014,2,1146,977,169,0.852531,0.147469,1.651397,157,12,1147,978,169,0.852659,0.147341,1.652094,157,12,1, merged,0,0,0.24855668401
26523,1000054,2,71,64,7,0.901408,0.098592,1.667729,5,2,72,64,8,0.888889,0.111111,1.655495,6,2,1, merged,1,1,0.517200825151
26523,1000329,1,1639,1256,383,0.766321,0.233679,0.766321,344,39,1641,1258,383,0.766606,0.233394,0.766606,344,39,-1, merged,0,0,0.862643783264
26528,1000014,1,1148,979,169,0.852787,0.147213,0.852787,157,12,1150,981,169,0.853043,0.146957,0.853043,157,12,-1, merged,0,0,0.0901341074683
26540,1000004,2,1475,1281,194,0.868475,0.131525,1.63508,155,39,1476,1282,194,0.868564,0.131436,1.634703,155,39,1, merged,0,0,0.0436323366556
26540,1000329,1,1641,1258,383,0.766606,0.233394,0.766606,344,39,1642,1258,384,0.766139,0.233861,0.766139,344,40,-1, merged,1,1,0.0329789328608
26541,1000592,2,325,267,58,0.821538,0.178462,1.615656,40,18,326,268,58,0.822086,0.177914,1.619187,40,18,1, merged,0,0,0.157516437572
26544,1000054,1,72,64,8,0.888889,0.111111,0.888889,6,2,73,65,8,0.890411,0.109589,0.890411,6,2,1, merged,0,0,0.52739508434
26544,1000121,2,1129,927,202,0.821081,0.178919,1.709969,193,9,1130,928,202,0.821239,0.178761,1.71165,193,9,1, merged,0,0,0.557188819566
26548,1000105,2,315,252,63,0.8,0.2,1.8,56,7,316,253,63,0.800633,0.199367,1.800633,56,7,1, merged,0,0,0.61726204258
26558,1000329,2,1642,1258,384,0.766139,0.233861,1.588225,344,40,1643,1259,384,0.766281,0.233719,1.588911,344,40,1, merged,0,0,0.588155702263
26558,1000592,1,326,268,58,0.822086,0.177914,0.822086,40,18,327,269,58,0.82263,0.17737,0.82263,40,18,1, merged,0,0,0.531120836372
26572,1000327,2,588,457,131,0.777211,0.222789,1.503919,100,31,589,458,131,0.777589,0.222411,1.505984,100,31,1, merged,0,0,0.664681600451
26572,1000329,3,1644,1260,384,0.766423,0.233577,2.270342,344,40,1645,1261,384,0.766565,0.233435,2.27255,344,40,1, merged,0,0,0.83587069779
26578,1000004,2,1477,1283,194,0.868653,0.131347,1.303947,155,39,1479,1285,194,0.86883,0.13117,1.299063,155,39,-1, merged,0,0,0.051480423421
26581,1000009,2,571,484,87,0.847636,0.152364,1.700934,79,8,572,485,87,0.847902,0.152098,1.701328,79,8,-1, abandoned,0,0,0.486578114154
26581,1000014,1,1152,983,169,0.853299,0.146701,0.853299,157,12,1153,984,169,0.853426,0.146574,0.853426,157,12,-1, abandoned,0,0,0.304484066653
26601,1000132,1,168,149,19,0.886905,0.113095,0.886905,16,3,170,151,19,0.888235,0.111765,0.888235,16,3,-1, merged,0,0,0.670514239823
26603,1000015,2,1209,1101,108,0.91067,0.08933,1.49817,96,12,1210,1102,108,0.910744,0.089256,1.503336,96,12,1, merged,0,0,0.0234835248148
26604,1000329,3,1647,1263,384,0.766849,0.233151,2.073727,344,40,1648,1264,384,0.76699,0.23301,2.086773,344,40,1, merged,0,0,0
26614,1000121,2,1131,929,202,0.821397,0.178603,1.581012,193,9,1132,930,202,0.821555,0.178445,1.58232,193,9,1, merged,0,0,0.0505278464517
26633,1000014,2,1158,985,173,0.850604,0.149396,1.67071,161,12,1159,986,173,0.850733,0.149267,1.670998,161,12,1, merged,0,0,0.0890300928193
26633,1000121,1,1134,930,204,0.820106,0.179894,0.820106,193,11,1135,931,204,0.820264,0.179736,0.820264,193,11,1, merged,0,0,0.0677751372401
26643,1000329,2,1651,1266,385,0.766808,0.233192,1.623951,345,40,1652,1267,385,0.766949,0.233051,1.641949,345,40,1, merged,0,0,0.540753693158
26655,1000329,1,1652,1267,385,0.766949,0.233051,0.766949,345,40,1653,1267,386,0.766485,0.233515,0.766485,346,40,1, abandoned,1,1,0.0831830788841
26655,1000592,2,328,269,59,0.820122,0.179878,1.587071,40,19,329,269,60,0.817629,0.182371,1.584114,41,19,1, abandoned,1,1,0.076127315094
26658,1000329,1,1654,1267,387,0.766022,0.233978,0.766022,347,40,1655,1268,387,0.766163,0.233837,0.766163,347,40,1, merged,0,0,0.892363758331
26662,1000014,1,1161,988,173,0.850991,0.149009,0.850991,161,12,1162,989,173,0.851119,0.148881,0.851119,161,12,1, merged,0,0,0.597906926665
26662,1000043,2,317,260,57,0.820189,0.179811,1.67118,49,8,318,261,57,0.820755,0.179245,1.671873,49,8,1, merged,0,0,0.763971926799
26663,1000043,2,318,261,57,0.820755,0.179245,1.820755,49,8,321,263,58,0.819315,0.180685,1.694315,50,8,-1, merged,1,0,0.942837986686
26666,1000153,2,608,556,52,0.914474,0.085526,1.792927,40,12,609,557,52,0.914614,0.085386,1.793735,40,12,1, merged,0,0,0.13927707498
26669,1000004,2,1481,1287,194,0.869007,0.130993,1.635171,155,39,1482,1288,194,0.869096,0.130904,1.6354,155,39,1, merged,0,0,0.0437624221545
26669,1000120,3,555,455,100,0.81982,0.18018,2.45499,92,8,556,456,100,0.820144,0.179856,2.455544,92,8,1, merged,0,0,0.111536777583
26669,1000329,1,1655,1268,387,0.766163,0.233837,0.766163,347,40,1656,1269,387,0.766304,0.233696,0.766304,347,40,1, merged,0,0,0.0141837323334
26684,1000015,2,1212,1104,108,0.910891,0.089109,1.624895,96,12,1214,1105,109,0.910214,0.089786,1.623377,97,12,1, merged,1,1,0.562008649141
26684,1000328,1,507,362,145,0.714004,0.285996,0.714004,131,14,509,363,146,0.713163,0.286837,0.713163,132,14,1, merged,1,1,1.01347644194
26689,1000014,2,1164,991,173,0.851375,0.148625,1.650257,161,12,1165,992,173,0.851502,0.148498,1.650945,161,12,1, merged,0,0,0.0530296777264
26694,1000070,3,741,661,80,0.892038,0.107962,2.295231,64,16,742,661,81,0.890836,0.109164,2.295597,65,16,1, merged,1,1,0.777081150309
26695,1000070,3,742,661,81,0.890836,0.109164,2.295597,65,16,744,662,82,0.889785,0.110215,2.289561,66,16,-1, merged,1,0,0.876266623985
26696,1000070,3,744,662,82,0.889785,0.110215,2.289561,66,16,747,664,83,0.888889,0.111111,2.279577,67,16,-1, merged,1,0,0.869418097178
26698,1000070,1,747,664,83,0.888889,0.111111,0.888889,67,16,748,664,84,0.887701,0.112299,0.887701,68,16,1, merged,1,1,0.388546438441
26711,1000327,3,589,458,131,0.777589,0.222411,2.242018,100,31,590,459,131,0.777966,0.222034,2.240402,100,31,1, merged,0,0,0.0492211491579
26712,1000121,1,1136,932,204,0.820423,0.179577,0.820423,193,11,1137,933,204,0.82058,0.17942,0.82058,193,11,1, merged,0,0,0.330837352744
26713,1000121,1,1137,933,204,0.82058,0.17942,0.82058,193,11,1138,934,204,0.820738,0.179262,0.820738,193,11,1, merged,0,0,0.0911253432684
26723,1000121,1,1138,934,204,0.820738,0.179262,0.820738,193,11,1139,935,204,0.820896,0.179104,0.820896,193,11,1, merged,0,0,0.272579485556
26724,1000121,1,1139,935,204,0.820896,0.179104,0.820896,193,11,1140,936,204,0.821053,0.178947,0.821053,193,11,1, merged,0,0,0.0547748725897
26725,1000121,1,1140,936,204,0.821053,0.178947,0.821053,193,11,1141,937,204,0.821209,0.178791,0.821209,193,11,1, merged,0,0,0.0549055069918
26728,1000014,1,1168,995,173,0.851884,0.148116,0.851884,161,12,1169,996,173,0.85201,0.14799,0.85201,161,12,1, merged,0,0,0.0937051973024
26741,1000118,2,667,591,76,0.886057,0.113943,1.780794,71,5,668,592,76,0.886228,0.113772,1.783663,71,5,1, merged,0,0,0.133069259595
26762,1000070,1,748,664,84,0.887701,0.112299,0.887701,68,16,749,665,84,0.88785,0.11215,0.88785,68,16,1, merged,0,0,0.217570503841
26762,1000121,3,1142,938,204,0.821366,0.178634,2.584067,193,11,1143,939,204,0.821522,0.178478,2.598262,193,11,1, merged,0,0,0.157648344355
26767,1000023,1,324,284,40,0.876543,0.123457,0.876543,37,3,325,285,40,0.876923,0.123077,0.876923,37,3,1, merged,0,0,0.0470713023667
26769,1000327,2,591,460,131,0.778342,0.221658,1.545209,100,31,592,461,131,0.778716,0.221284,1.545403,100,31,-1, merged,0,0,0.698030283858
26769,1000329,1,1660,1273,387,0.766867,0.233133,0.766867,347,40,1663,1275,388,0.766687,0.233313,0.766687,348,40,-1, merged,1,0,0.891200986763
26775,1000109,3,343,286,57,0.833819,0.166181,2.301466,54,3,344,287,57,0.834302,0.165698,2.307983,54,3,1, merged,0,0,0.271369030003
26777,1000043,2,324,266,58,0.820988,0.179012,1.584185,50,8,326,267,59,0.819018,0.180982,1.582928,50,9,-1, merged,1,0,0.305629544443
26782,1000121,2,1143,939,204,0.821522,0.178478,1.588209,193,11,1144,940,204,0.821678,0.178322,1.588505,193,11,1, merged,0,0,0.0115045936588
26782,1000329,1,1663,1275,388,0.766687,0.233313,0.766687,348,40,1664,1276,388,0.766827,0.233173,0.766827,348,40,1, merged,0,0,0.0326487625066
26787,1000070,2,749,665,84,0.88785,0.11215,1.541697,68,16,750,665,85,0.886667,0.113333,1.530417,69,16,1, merged,1,1,0.38844312718
26788,1000070,2,750,665,85,0.886667,0.113333,1.530417,69,16,751,665,86,0.885486,0.114514,1.523523,70,16,1, merged,1,1,0.77714054694
26791,1000004,1,1483,1289,194,0.869184,0.130816,0.869184,155,39,1485,1291,194,0.86936,0.13064,0.86936,155,39,-1, merged,0,0,0.0205089880499
26791,1000329,2,1664,1276,388,0.766827,0.233173,1.636011,348,40,1666,1277,389,0.766507,0.233493,1.635867,348,41,-1, merged,1,0,0.00829439662643
26794,1000012,1,352,304,48,0.863636,0.136364,0.863636,47,1,353,305,48,0.864023,0.135977,0.864023,47,1,1, merged,0,0,0.36237287114
26839,1000153,2,610,558,52,0.914754,0.085246,1.794536,40,12,611,559,52,0.914894,0.085106,1.795328,40,12,1, merged,0,0,0.475205994614
26840,1000153,2,611,559,52,0.914894,0.085106,1.678803,40,12,612,560,52,0.915033,0.084967,1.679297,40,12,1, merged,0,0,0.950782716515
26847,1000009,1,591,499,92,0.844332,0.155668,0.844332,84,8,594,500,94,0.841751,0.158249,0.841751,86,8,1, merged,1,1,0.398917401326
26847,1000153,2,612,560,52,0.915033,0.084967,1.759364,40,12,613,560,53,0.91354,0.08646,1.755291,41,12,1, merged,1,1,0.43092649933
26865,1000199,1,287,238,49,0.829268,0.170732,0.829268,45,4,290,241,49,0.831034,0.168966,0.831034,45,4,-1, merged,0,0,0.0398623637491
26869,1000004,2,1486,1292,194,0.869448,0.130552,1.301266,155,39,1487,1293,194,0.869536,0.130464,1.307738,155,39,1, merged,0,0,0.0532116806765
26875,1000063,1,1969,1757,212,0.892331,0.107669,0.892331,181,31,1971,1758,213,0.891933,0.108067,0.891933,181,32,-1, merged,1,0,0.00488473585572
26880,1000592,2,330,270,60,0.818182,0.181818,1.755682,41,19,331,271,60,0.818731,0.181269,1.756387,41,19,1, merged,0,0,0.365903937333
26883,1000091,1,325,250,75,0.769231,0.230769,0.769231,62,13,326,251,75,0.769939,0.230061,0.769939,62,13,-1, merged,0,0,0.0312946369698
26883,1000329,2,1672,1282,390,0.766746,0.233254,1.535977,349,41,1674,1283,391,0.766428,0.233572,1.536366,349,42,-1, merged,1,0,0.0389472978218
26892,1000004,1,1487,1293,194,0.869536,0.130464,0.869536,155,39,1488,1294,194,0.869624,0.130376,0.869624,155,39,1, merged,0,0,0.0205981400498
26898,1000121,2,1144,940,204,0.821678,0.178322,1.585943,193,11,1145,941,204,0.821834,0.178166,1.586452,193,11,1, merged,0,0,0.116833622737
26904,1000120,2,558,456,102,0.817204,0.182796,1.583654,92,10,559,456,103,0.815742,0.184258,1.581738,93,10,1, abandoned,1,1,0.236204555439
26904,1000329,1,1687,1293,394,0.766449,0.233551,0.766449,352,42,1688,1293,395,0.765995,0.234005,0.765995,353,42,1, abandoned,1,1,0.424374955938
26905,1000121,1,1145,941,204,0.821834,0.178166,0.821834,193,11,1146,942,204,0.82199,0.17801,0.82199,193,11,1, merged,0,0,0.483401546821
26916,1000121,2,1146,942,204,0.82199,0.17801,1.563369,193,11,1147,942,205,0.821273,0.178727,1.56413,194,11,1, merged,1,1,0.32347107786
26916,1000328,4,510,364,146,0.713725,0.286275,3.04309,132,14,511,365,146,0.714286,0.285714,3.044235,132,14,-1, merged,0,0,0.462174523957
26916,1000329,3,1688,1293,395,0.765995,0.234005,2.329364,353,42,1691,1295,396,0.765819,0.234181,2.329949,354,42,-1, merged,1,0,0.408722876034
26918,1000153,2,613,560,53,0.91354,0.08646,1.67851,41,12,614,561,53,0.913681,0.086319,1.679002,41,12,1, merged,0,0,0.15940978242
26919,1000014,1,1174,1001,173,0.852641,0.147359,0.852641,161,12,1175,1002,173,0.852766,0.147234,0.852766,161,12,1, merged,0,0,0.117569793346
26919,1000043,2,329,270,59,0.820669,0.179331,1.673309,50,9,330,271,59,0.821212,0.178788,1.673978,50,9,1, merged,0,0,0.152418247314
26922,1000070,1,754,668,86,0.885942,0.114058,0.885942,70,16,755,669,86,0.886093,0.113907,0.886093,70,16,1, merged,0,0,0.0876213868844
26932,1000043,2,330,271,59,0.821212,0.178788,1.564069,50,9,332,273,59,0.822289,0.177711,1.544511,50,9,-1, merged,0,0,0.143947236208
26939,1000329,1,1692,1296,396,0.765957,0.234043,0.765957,354,42,1693,1297,396,0.766096,0.233904,0.766096,354,42,1, merged,0,0,0
26948,1000007,1,623,531,92,0.852327,0.147673,0.852327,78,14,625,532,93,0.8512,0.1488,0.8512,78,15,-1, merged,1,0,1.29792273274
26948,1000009,2,602,508,94,0.843854,0.156146,1.696181,86,8,604,509,95,0.842715,0.157285,1.693915,87,8,1, merged,1,1,1.24646475363
26953,1000153,2,617,564,53,0.9141,0.0859,1.700093,41,12,618,565,53,0.914239,0.085761,1.701061,41,12,1, merged,0,0,1.08400841184
26954,1000199,2,291,242,49,0.831615,0.168385,1.618437,45,4,292,243,49,0.832192,0.167808,1.619837,45,4,1, merged,0,0,0.0337412682045
26956,1000015,1,1218,1109,109,0.910509,0.089491,0.910509,97,12,1220,1110,110,0.909836,0.090164,0.909836,98,12,1, merged,1,1,0.18761996267
26958,1000004,3,1488,1294,194,0.869624,0.130376,1.825067,155,39,1489,1295,194,0.869711,0.130289,1.847489,155,39,1, merged,0,0,0.0171149353688
26970,1000004,2,1489,1295,194,0.869711,0.130289,1.664892,155,39,1490,1296,194,0.869799,0.130201,1.667418,155,39,1, merged,0,0,0
26972,1000121,1,1148,943,205,0.821429,0.178571,0.821429,194,11,1149,944,205,0.821584,0.178416,0.821584,194,11,1, merged,0,0,0.692371435827
26973,1000121,3,1149,944,205,0.821584,0.178416,2.376762,194,11,1150,945,205,0.821739,0.178261,2.377408,194,11,1, merged,0,0,0.692641402246
26973,1000329,2,1694,1298,396,0.766234,0.233766,1.555178,354,42,1695,1299,396,0.766372,0.233628,1.555669,354,42,1, merged,0,0,0.893709093944
26986,1000014,1,1175,1002,173,0.852766,0.147234,0.852766,161,12,1177,1004,173,0.853016,0.146984,0.853016,161,12,1, merged,0,0,0.260614122241
27004,1000014,1,1177,1004,173,0.853016,0.146984,0.853016,161,12,1179,1006,173,0.853265,0.146735,0.853265,161,12,-1, merged,0,0,0.305557006092
27004,1000534,2,69,46,23,0.666667,0.333333,1.519683,22,1,70,47,23,0.671429,0.328571,1.524694,22,1,-1, merged,0,0,0.516687365209
27010,1000005,2,187,139,48,0.743316,0.256684,1.516043,43,5,188,140,48,0.744681,0.255319,1.518095,43,5,1, merged,0,0,0.178874445201
27010,1000091,1,330,255,75,0.772727,0.227273,0.772727,62,13,331,256,75,0.773414,0.226586,0.773414,62,13,1, merged,0,0,0.158271052788
27011,1000004,1,1490,1296,194,0.869799,0.130201,0.869799,155,39,1492,1297,195,0.869303,0.130697,0.869303,155,40,1, merged,1,0,0
27012,1000004,1,1492,1297,195,0.869303,0.130697,0.869303,155,40,1493,1297,196,0.868721,0.131279,0.868721,155,41,-1, merged,1,1,0
27012,1000091,2,331,256,75,0.773414,0.226586,1.642717,62,13,332,256,76,0.771084,0.228916,1.639805,62,14,-1, merged,1,1,0
27014,1000023,1,325,285,40,0.876923,0.123077,0.876923,37,3,326,286,40,0.877301,0.122699,0.877301,37,3,1, merged,0,0,0.00412983975472
27017,1000121,2,1150,945,205,0.821739,0.178261,1.588249,194,11,1151,946,205,0.821894,0.178106,1.588541,194,11,1, merged,0,0,0.0792012156204
27017,1000329,1,1696,1300,396,0.766509,0.233491,0.766509,354,42,1697,1301,396,0.766647,0.233353,0.766647,354,42,1, merged,0,0,0.0896171177029
27027,1000166,2,157,135,22,0.859873,0.140127,1.859873,21,1,158,136,22,0.860759,0.139241,1.860759,21,1,1, merged,0,0,0.146871457653
27056,1000121,1,1151,946,205,0.821894,0.178106,0.821894,194,11,1152,947,205,0.822049,0.177951,0.822049,194,11,1, merged,0,0,0
27059,1000199,2,293,244,49,0.832765,0.167235,1.521289,45,4,294,245,49,0.833333,0.166667,1.526882,45,4,1, merged,0,0,0.031522066965
27072,1000592,2,333,273,60,0.81982,0.18018,1.682565,41,19,334,274,60,0.820359,0.179641,1.688284,41,19,1, merged,0,0,0.705551618238
27073,1000592,2,334,274,60,0.820359,0.179641,1.688284,41,19,335,275,60,0.820896,0.179104,1.691266,41,19,1, merged,0,0,0.707884796978
27102,1000014,2,1181,1008,173,0.853514,0.146486,1.524943,161,12,1182,1009,173,0.853638,0.146362,1.529694,161,12,1, merged,0,0,0.306740062574
27102,1000534,1,70,47,23,0.671429,0.328571,0.671429,22,1,71,48,23,0.676056,0.323944,0.676056,22,1,1, merged,0,0,0.541609814169
27127,1000329,2,1697,1301,396,0.766647,0.233353,1.587543,354,42,1698,1302,396,0.766784,0.233216,1.588213,354,42,1, merged,0,0,0.119348982767
27127,1000592,1,335,275,60,0.820896,0.179104,0.820896,41,19,336,276,60,0.821429,0.178571,0.821429,41,19,1, merged,0,0,0.137038692319
27136,1000004,1,1493,1297,196,0.868721,0.131279,0.868721,155,41,1494,1298,196,0.868809,0.131191,0.868809,155,41,1, merged,0,0,0.0175386640342
27136,1000120,3,559,456,103,0.815742,0.184258,2.451248,93,10,560,456,104,0.814286,0.185714,2.450016,93,11,-1, merged,1,1,0.0354058721934
27136,1000329,2,1698,1302,396,0.766784,0.233216,1.635505,354,42,1699,1303,396,0.766922,0.233078,1.63573,354,42,1, merged,0,0,0.00352460172001
27145,1000199,2,294,245,49,0.833333,0.166667,1.526882,45,4,295,246,49,0.833898,0.166102,1.532311,45,4,1, merged,0,0,0.146860838302
27162,1000199,2,295,246,49,0.833898,0.166102,1.620158,45,4,296,247,49,0.834459,0.165541,1.621532,45,4,1, merged,0,0,0.138105860917
27164,1000153,2,618,565,53,0.914239,0.085761,1.794674,41,12,619,566,53,0.914378,0.085622,1.795459,41,12,1, merged,0,0,0.139543916683
27165,1000091,2,332,256,76,0.771084,0.228916,1.538143,62,14,333,257,76,0.771772,0.228228,1.539104,62,14,-1, abandoned,0,0,0
27165,1000329,1,1700,1304,396,0.767059,0.232941,0.767059,354,42,1702,1306,396,0.767333,0.232667,0.767333,354,42,-1, abandoned,0,0,0
27169,1000110,2,13,13,0,1,0,1.914378,0,0,14,14,0,1,0,1.913043,0,0,-1, abandoned,0,0,0.343902439024
27169,1000153,1,619,566,53,0.914378,0.085622,0.914378,41,12,621,567,54,0.913043,0.086957,0.913043,42,12,-1, abandoned,1,0,0.951428727659
27170,1000015,2,1226,1116,110,0.910277,0.089723,1.586334,98,12,1227,1117,110,0.91035,0.08965,1.577017,98,12,1, merged,0,0,0.489216749621
27170,1000534,1,71,48,23,0.676056,0.323944,0.676056,22,1,72,48,24,0.666667,0.333333,0.666667,23,1,1, merged,1,1,0.492951377258
27187,1000070,3,757,671,86,0.886394,0.113606,2.187981,70,16,758,672,86,0.886544,0.113456,2.198204,70,16,1, merged,0,0,0.788759015879
27188,1000070,2,758,672,86,0.886544,0.113456,1.747655,70,16,759,673,86,0.886693,0.113307,1.724531,70,16,1, merged,0,0,0.26368277867
27190,1000014,1,1184,1011,173,0.853885,0.146115,0.853885,161,12,1185,1011,174,0.853165,0.146835,0.853165,162,12,1, merged,1,1,0.14989883027
27195,1000004,2,1494,1298,196,0.868809,0.131191,1.319358,155,41,1495,1299,196,0.868896,0.131104,1.314548,155,41,-1, abandoned,0,0,0.0286199414792
27197,1000007,3,625,532,93,0.8512,0.1488,2.427476,78,15,628,534,94,0.850318,0.149682,2.416722,78,16,-1, merged,1,0,0
27197,1000015,1,1228,1117,111,0.909609,0.090391,0.909609,99,12,1229,1117,112,0.908869,0.091131,0.908869,100,12,1, merged,1,1,0
27197,1000534,2,72,48,24,0.666667,0.333333,1.576276,23,1,73,48,25,0.657534,0.342466,1.566403,24,1,1, merged,1,1,0
27217,1000070,2,762,676,86,0.887139,0.112861,1.332791,70,16,763,677,86,0.887287,0.112713,1.3389,70,16,1, merged,0,0,0.396621840868
27235,1000023,1,329,289,40,0.878419,0.121581,0.878419,37,3,330,290,40,0.878788,0.121212,0.878788,37,3,1, merged,0,0,0.0598673801109
27246,1000004,3,1499,1303,196,0.869246,0.130754,2.699451,155,41,1500,1304,196,0.869333,0.130667,2.696775,155,41,1, merged,0,0,0.0443216939567
27246,1000063,1,1971,1758,213,0.891933,0.108067,0.891933,181,32,1972,1758,214,0.891481,0.108519,0.891481,182,32,1, merged,1,1,0.00214874887364
27248,1000004,1,1500,1304,196,0.869333,0.130667,0.869333,155,41,1501,1304,197,0.868754,0.131246,0.868754,155,42,-1, merged,1,1,0.0641090049328
27248,1000120,2,560,456,104,0.814286,0.185714,1.683619,93,11,561,456,105,0.812834,0.187166,1.681588,93,12,-1, merged,1,1,0
27249,1000004,1,1501,1304,197,0.868754,0.131246,0.868754,155,42,1502,1304,198,0.868176,0.131824,0.868176,155,43,-1, merged,1,1,0.0192630745791
27249,1000120,2,561,456,105,0.812834,0.187166,1.681588,93,12,562,456,106,0.811388,0.188612,1.679564,93,13,-1, merged,1,1,0
27254,1000014,1,1185,1011,174,0.853165,0.146835,0.853165,162,12,1187,1012,175,0.85257,0.14743,0.85257,163,12,1, merged,1,1,0.200067171305
27254,1000070,2,763,677,86,0.887287,0.112713,1.740452,70,16,764,678,86,0.887435,0.112565,1.740004,70,16,1, merged,0,0,0.247859320064
27289,1000023,2,331,291,40,0.879154,0.120846,1.8162,37,3,332,292,40,0.879518,0.120482,1.816716,37,3,1, merged,0,0,0.000224666485941
27303,1000121,3,1153,948,205,0.822203,0.177797,2.374611,194,11,1154,949,205,0.822357,0.177643,2.382374,194,11,1, merged,0,0,0.0357527713184
27303,1000199,2,296,247,49,0.834459,0.165541,1.552408,45,4,297,248,49,0.835017,0.164983,1.560017,45,4,1, merged,0,0,0.00585256795809
27311,1000004,4,1507,1307,200,0.867286,0.132714,3.220978,156,44,1508,1308,200,0.867374,0.132626,3.220879,156,44,1, merged,0,0,0.0127878348308
27311,1000121,3,1154,949,205,0.822357,0.177643,2.353692,194,11,1155,949,206,0.821645,0.178355,2.353505,195,11,1, merged,1,1,0.00263933938968
27311,1000329,1,1705,1308,397,0.767155,0.232845,0.767155,355,42,1708,1310,398,0.766979,0.233021,0.766979,356,42,-1, merged,1,0,0.00416742650464
27316,1000329,1,1710,1312,398,0.767251,0.232749,0.767251,356,42,1714,1314,400,0.766628,0.233372,0.766628,358,42,1, merged,1,1,0.540439333628
27326,1000004,2,1509,1308,201,0.866799,0.133201,1.46436,157,44,1512,1310,202,0.866402,0.133598,1.459425,158,44,-1, merged,1,0,0.460742451883
27336,1000014,2,1189,1014,175,0.852817,0.147183,1.741706,163,12,1190,1015,175,0.852941,0.147059,1.743566,163,12,1, merged,0,0,0.030945969429
27353,1000009,1,610,515,95,0.844262,0.155738,0.844262,87,8,612,516,96,0.843137,0.156863,0.843137,88,8,1, merged,1,1,0.0741681275026
27353,1000011,2,434,403,31,0.928571,0.071429,1.772834,28,3,435,404,31,0.928736,0.071264,1.771873,28,3,1, merged,0,0,0.0758169903225
27359,1000070,2,764,678,86,0.887435,0.112565,1.808832,70,16,766,680,86,0.887728,0.112272,1.80512,70,16,-1, merged,0,0,0.07320967126
27360,1000124,1,433,401,32,0.926097,0.073903,0.926097,29,3,434,402,32,0.926267,0.073733,0.926267,29,3,1, merged,0,0,0.400157805887
27369,1000124,2,437,405,32,0.926773,0.073227,1.686389,29,3,439,406,33,0.924829,0.075171,1.685595,29,4,-1, merged,1,1,0.0347118378508
27399,1000004,2,1520,1316,204,0.865789,0.134211,1.713141,160,44,1521,1317,204,0.865878,0.134122,1.711079,160,44,-1, merged,0,0,0.235313597289
27437,1000329,2,1715,1315,400,0.766764,0.233236,1.570579,358,42,1716,1316,400,0.7669,0.2331,1.571248,358,42,1, merged,0,0,0.188891673675
27438,1000329,2,1716,1316,400,0.7669,0.2331,1.507013,358,42,1718,1318,400,0.767171,0.232829,1.503126,358,42,-1, merged,0,0,0.1769867784
27444,1000014,1,1192,1017,175,0.853188,0.146812,0.853188,163,12,1194,1018,176,0.852596,0.147404,0.852596,164,12,1, merged,1,1,0.261013197473
27446,1000105,1,318,255,63,0.801887,0.198113,0.801887,56,7,319,256,63,0.802508,0.197492,0.802508,56,7,1, merged,0,0,0
27451,1000023,1,332,292,40,0.879518,0.120482,0.879518,37,3,333,293,40,0.87988,0.12012,0.87988,37,3,1, merged,0,0,0.33390068847
27454,1000004,1,1527,1323,204,0.866405,0.133595,0.866405,160,44,1529,1325,204,0.866579,0.133421,0.866579,160,44,-1, merged,0,0,0.00566958887789
27461,1000004,1,1531,1327,204,0.866754,0.133246,0.866754,160,44,1532,1328,204,0.866841,0.133159,0.866841,160,44,1, merged,0,0,0.484683469235
27461,1000070,2,766,680,86,0.887728,0.112272,1.754482,70,16,767,681,86,0.887875,0.112125,1.754716,70,16,1, merged,0,0,0.590943163756
27467,1000121,2,1155,949,206,0.821645,0.178355,1.536481,195,11,1156,950,206,0.821799,0.178201,1.537184,195,11,1, merged,0,0,0.0599299841659
27467,1000328,1,519,371,148,0.714836,0.285164,0.714836,133,15,520,372,148,0.715385,0.284615,0.715385,133,15,1, merged,0,0,0.0993397368336
27471,1000328,1,523,375,148,0.717017,0.282983,0.717017,133,15,524,375,149,0.715649,0.284351,0.715649,134,15,1, merged,1,1,1.10681506091
27486,1000329,1,1722,1321,401,0.767131,0.232869,0.767131,359,42,1726,1324,402,0.767092,0.232908,0.767092,360,42,-1, merged,1,0,0.150216660718
27487,1000004,1,1532,1328,204,0.866841,0.133159,0.866841,160,44,1535,1330,205,0.86645,0.13355,0.86645,161,44,-1, merged,1,0,0.10586699479
27487,1000329,3,1726,1324,402,0.767092,0.232908,2.37825,360,42,1728,1326,402,0.767361,0.232639,2.382414,360,42,-1, merged,0,0,0.193029849736
27491,1000329,1,1728,1326,402,0.767361,0.232639,0.767361,360,42,1729,1327,402,0.767496,0.232504,0.767496,360,42,1, merged,0,0,0.138620271174
27492,1000329,1,1729,1327,402,0.767496,0.232504,0.767496,360,42,1731,1327,404,0.766609,0.233391,0.766609,362,42,1, abandoned,1,1,0
27496,1000329,1,1732,1328,404,0.766744,0.233256,0.766744,362,42,1733,1329,404,0.766878,0.233122,0.766878,362,42,1, merged,0,0,0.0673818387668
27498,1000121,2,1156,950,206,0.821799,0.178201,1.588946,195,11,1157,951,206,0.821953,0.178047,1.588927,195,11,1, merged,0,0,0.108044346202
27498,1000329,1,1735,1331,404,0.767147,0.232853,0.767147,362,42,1738,1333,405,0.766974,0.233026,0.766974,363,42,1, merged,1,1,0.135151564405
27500,1000130,2,209,176,33,0.842105,0.157895,1.608772,24,9,210,176,34,0.838095,0.161905,1.604456,25,9,1, merged,1,1,0.205049910872
27500,1000329,1,1740,1334,406,0.766667,0.233333,0.766667,364,42,1742,1335,407,0.766361,0.233639,0.766361,365,42,1, merged,1,1,0.0987014975733
27508,1000121,3,1157,951,206,0.821953,0.178047,2.307977,195,11,1158,952,206,0.822107,0.177893,2.310514,195,11,1, merged,0,0,0.0495163232288
27508,1000329,1,1757,1342,415,0.763802,0.236198,0.763802,373,42,1760,1344,416,0.763636,0.236364,0.763636,374,42,1, merged,1,1,0.0530727828288
27509,1000121,2,1158,952,206,0.822107,0.177893,1.585743,195,11,1159,953,206,0.822261,0.177739,1.585598,195,11,1, merged,0,0,0.291934189708
27509,1000329,1,1760,1344,416,0.763636,0.236364,0.763636,374,42,1762,1345,417,0.763337,0.236663,0.763337,375,42,1, merged,1,1,0.297917899401
27511,1000014,2,1195,1019,176,0.85272,0.14728,1.740595,164,12,1196,1020,176,0.852843,0.147157,1.739562,164,12,1, merged,0,0,0.294289467193
27511,1000070,1,767,681,86,0.887875,0.112125,0.887875,70,16,768,681,87,0.886719,0.113281,0.886719,71,16,1, merged,1,1,0.430569635795
27512,1000014,3,1196,1020,176,0.852843,0.147157,2.519223,164,12,1197,1021,176,0.852966,0.147034,2.519122,164,12,1, merged,0,0,0.196318481932
27512,1000070,1,768,681,87,0.886719,0.113281,0.886719,71,16,769,681,88,0.885566,0.114434,0.885566,72,16,1, merged,1,1,0.287334883596
27516,1000121,2,1160,954,206,0.822414,0.177586,1.704767,195,11,1161,955,206,0.822567,0.177433,1.711456,195,11,1, merged,0,0,0.258199994516
27518,1000063,1,1977,1763,214,0.891755,0.108245,0.891755,182,32,1979,1764,215,0.891359,0.108641,0.891359,182,33,-1, merged,1,0,0.000371453909952
27520,1000004,3,1537,1331,206,0.865973,0.134027,2.095208,162,44,1538,1332,206,0.86606,0.13394,2.102025,162,44,1, merged,0,0,0.0453544405922
27521,1000004,2,1538,1332,206,0.86606,0.13394,1.719026,162,44,1539,1333,206,0.866147,0.133853,1.718401,162,44,-1, abandoned,0,0,0.0065275098846
27521,1000014,1,1197,1021,176,0.852966,0.147034,0.852966,164,12,1198,1021,177,0.852254,0.147746,0.852254,165,12,1, abandoned,1,1,0.00327600589303
27528,1000004,2,1539,1333,206,0.866147,0.133853,1.751713,162,44,1540,1334,206,0.866234,0.133766,1.750799,162,44,1, merged,0,0,4.70690658163e-05
27528,1000070,1,769,681,88,0.885566,0.114434,0.885566,72,16,771,682,89,0.884565,0.115435,0.884565,73,16,1, merged,1,1,2.52970854494e-10
27531,1000004,3,1540,1334,206,0.866234,0.133766,2.393583,162,44,1541,1335,206,0.866321,0.133679,2.394151,162,44,1, merged,0,0,0.469037586582
27531,1000329,1,1762,1345,417,0.763337,0.236663,0.763337,375,42,1763,1346,417,0.763471,0.236529,0.763471,375,42,1, merged,0,0,0.872866106957
27536,1000004,2,1541,1335,206,0.866321,0.133679,1.649654,162,44,1542,1336,206,0.866407,0.133593,1.6483,162,44,-1, merged,0,0,0.0095494298898
27552,1000004,2,1542,1336,206,0.866407,0.133593,1.6483,162,44,1544,1338,206,0.86658,0.13342,1.646172,162,44,-1, merged,0,0,0.0454663887441
27564,1000121,2,1162,956,206,0.822719,0.177281,1.537005,195,11,1163,957,206,0.822872,0.177128,1.54701,195,11,1, merged,0,0,0.0780189854615
27570,1000023,1,333,293,40,0.87988,0.12012,0.87988,37,3,334,294,40,0.88024,0.11976,0.88024,37,3,1, merged,0,0,0.222290258585
27570,1000070,2,771,682,89,0.884565,0.115435,1.764445,73,16,772,683,89,0.884715,0.115285,1.764955,73,16,1, merged,0,0,0.0421152282068
27578,1000004,1,1544,1338,206,0.86658,0.13342,0.86658,162,44,1545,1339,206,0.866667,0.133333,0.866667,162,44,-1, merged,0,0,0.460213504625
27578,1000120,2,562,456,106,0.811388,0.188612,1.677968,93,13,563,457,106,0.811723,0.188277,1.67839,93,13,1, merged,0,0,0.481258078414
27591,1000004,2,1546,1340,206,0.866753,0.133247,1.591524,162,44,1549,1343,206,0.867011,0.132989,1.594284,162,44,-1, merged,0,0,0.0587948706021
27596,1000091,2,339,261,78,0.769912,0.230088,1.533352,64,14,340,262,78,0.770588,0.229412,1.534163,64,14,1, merged,0,0,0.111420684316
27596,1000329,1,1767,1349,418,0.763441,0.236559,0.763441,376,42,1768,1350,418,0.763575,0.236425,0.763575,376,42,1, merged,0,0,0.0947297471427
27616,1000199,2,297,248,49,0.835017,0.164983,1.622896,45,4,298,249,49,0.83557,0.16443,1.62425,45,4,1, merged,0,0,0.139097166749
27620,1000014,1,1201,1024,177,0.852623,0.147377,0.852623,165,12,1202,1025,177,0.852745,0.147255,0.852745,165,12,1, merged,0,0,0.199159682065
27620,1000070,2,774,684,90,0.883721,0.116279,1.736344,74,16,775,685,90,0.883871,0.116129,1.736616,74,16,1, merged,0,0,0.244532604402
27626,1000004,2,1549,1343,206,0.867011,0.132989,1.679068,162,44,1550,1344,206,0.867097,0.132903,1.679486,162,44,1, merged,0,0,0.0361362031151
27626,1000120,1,564,458,106,0.812057,0.187943,0.812057,93,13,565,459,106,0.812389,0.187611,0.812389,93,13,1, merged,0,0,0.144179324765
27630,1000004,2,1550,1344,206,0.867097,0.132903,1.680477,162,44,1551,1345,206,0.867182,0.132818,1.680891,162,44,1, merged,0,0,0.0169177639963
27630,1000120,1,568,462,106,0.81338,0.18662,0.81338,93,13,569,463,106,0.813708,0.186292,0.813708,93,13,1, merged,0,0,0.058714158579
27631,1000004,2,1551,1345,206,0.867182,0.132818,1.680891,162,44,1552,1346,206,0.867268,0.132732,1.681303,162,44,1, merged,0,0,0.0179153743895
27631,1000120,1,569,463,106,0.813708,0.186292,0.813708,93,13,570,464,106,0.814035,0.185965,0.814035,93,13,1, merged,0,0,0.0722427669736
27632,1000004,2,1552,1346,206,0.867268,0.132732,1.681303,162,44,1553,1347,206,0.867354,0.132646,1.681714,162,44,1, merged,0,0,0.0394659112019
27632,1000120,1,570,464,106,0.814035,0.185965,0.814035,93,13,571,465,106,0.814361,0.185639,0.814361,93,13,1, merged,0,0,0.158914016057
27639,1000004,2,1553,1347,206,0.867354,0.132646,1.683645,162,44,1554,1348,206,0.867439,0.132561,1.684048,162,44,1, merged,0,0,0.00933288019763
27639,1000120,1,577,471,106,0.816291,0.183709,0.816291,93,13,578,472,106,0.816609,0.183391,0.816609,93,13,1, merged,0,0,0.0376474819796
27640,1000004,2,1554,1348,206,0.867439,0.132561,1.684048,162,44,1555,1349,206,0.867524,0.132476,1.68445,162,44,1, merged,0,0,0.0502716688228
27640,1000120,1,578,472,106,0.816609,0.183391,0.816609,93,13,579,473,106,0.816926,0.183074,0.816926,93,13,1, merged,0,0,0.129158025715
27642,1000199,2,298,249,49,0.83557,0.16443,1.625833,45,4,300,251,49,0.836667,0.163333,1.627711,45,4,1, merged,0,0,0.138979596976
27658,1000014,3,1203,1026,177,0.852868,0.147132,2.387703,165,12,1204,1027,177,0.85299,0.14701,2.388628,165,12,1, merged,0,0,0.533909008964
27658,1000091,1,341,263,78,0.771261,0.228739,0.771261,64,14,342,264,78,0.77193,0.22807,0.77193,64,14,1, merged,0,0,0.593544208317
27658,1000329,2,1768,1350,418,0.763575,0.236425,1.534836,376,42,1769,1351,418,0.763708,0.236292,1.535638,376,42,1, merged,0,0,0.898324213035
27660,1000015,2,1244,1131,113,0.909164,0.090836,1.454619,101,12,1245,1132,113,0.909237,0.090763,1.49257,101,12,1, merged,0,0,0.0536323088217
27663,1000329,2,1770,1352,418,0.763842,0.236158,1.312229,376,42,1771,1353,418,0.763975,0.236025,1.326475,376,42,1, merged,0,0,0.190500006669
27670,1000328,2,527,377,150,0.71537,0.28463,1.479345,135,15,528,378,150,0.715909,0.284091,1.480017,135,15,1, merged,0,0,0.577994428969
27670,1000329,1,1771,1353,418,0.763975,0.236025,0.763975,376,42,1772,1354,418,0.764108,0.235892,0.764108,376,42,1, merged,0,0,0.583640647609
27675,1000004,3,1556,1350,206,0.867609,0.132391,2.413976,162,44,1558,1352,206,0.867779,0.132221,2.416021,162,44,-1, merged,0,0,0.0454447462596
27675,1000329,2,1772,1354,418,0.764108,0.235892,1.546366,376,42,1773,1355,418,0.764241,0.235759,1.548241,376,42,-1, merged,0,0,0
27708,1000105,1,320,257,63,0.803125,0.196875,0.803125,56,7,322,258,64,0.801242,0.198758,0.801242,56,8,-1, merged,1,1,0.629350163169
27708,1000327,2,594,463,131,0.779461,0.220539,1.582586,100,31,595,464,131,0.779832,0.220168,1.581074,100,31,1, merged,0,0,0.546727148571
27715,1000199,2,300,251,49,0.836667,0.163333,1.627711,45,4,301,252,49,0.837209,0.162791,1.629031,45,4,1, merged,0,0,0.137334736009
27717,1000004,1,1563,1357,206,0.868202,0.131798,0.868202,162,44,1567,1360,207,0.8679,0.1321,0.8679,163,44,-1, merged,1,0,0.021671189841
27718,1000004,2,1567,1360,207,0.8679,0.1321,1.75207,163,44,1569,1361,208,0.867431,0.132569,1.750465,164,44,1, merged,1,1,0.00305505776455
27718,1000070,1,777,687,90,0.88417,0.11583,0.88417,74,16,778,687,91,0.883033,0.116967,0.883033,75,16,1, merged,1,1,0.000895263461089
27721,1000329,1,1774,1356,418,0.764374,0.235626,0.764374,376,42,1775,1357,418,0.764507,0.235493,0.764507,376,42,1, merged,0,0,0.59729778745
27723,1000015,2,1245,1132,113,0.909237,0.090763,1.566771,101,12,1246,1133,113,0.90931,0.09069,1.571472,101,12,1, merged,0,0,0.21537815353
27723,1000534,1,73,48,25,0.657534,0.342466,0.657534,24,1,74,49,25,0.662162,0.337838,0.662162,24,1,-1, merged,0,0,0.227607615765
27734,1000199,2,301,252,49,0.837209,0.162791,1.629031,45,4,303,254,49,0.838284,0.161716,1.628725,45,4,-1, merged,0,0,0.288221100251
27754,1000007,1,629,535,94,0.850556,0.149444,0.850556,78,16,630,536,94,0.850794,0.149206,0.850794,78,16,1, merged,0,0,0.419931001351
27754,1000011,2,437,406,31,0.929062,0.070938,1.779618,28,3,438,407,31,0.929224,0.070776,1.780017,28,3,1, merged,0,0,0.530613352771
27755,1000120,1,580,473,107,0.815517,0.184483,0.815517,94,13,581,474,107,0.815835,0.184165,0.815835,94,13,1, merged,0,0,0.228588640999
27755,1000329,2,1775,1357,418,0.764507,0.235493,1.580024,376,42,1776,1358,418,0.76464,0.23536,1.580474,376,42,1, merged,0,0,0.301872427728
27757,1000120,1,581,474,107,0.815835,0.184165,0.815835,94,13,584,476,108,0.815068,0.184932,0.815068,95,13,-1, merged,1,0,0.152946707155
27757,1000329,2,1776,1358,418,0.76464,0.23536,1.580474,376,42,1777,1359,418,0.764772,0.235228,1.579841,376,42,1, merged,0,0,0.201415960653
27758,1000120,1,584,476,108,0.815068,0.184932,0.815068,95,13,586,477,109,0.813993,0.186007,0.813993,96,13,1, merged,1,1,0.435974348366
27758,1000329,2,1777,1359,418,0.764772,0.235228,1.579841,376,42,1778,1360,418,0.764904,0.235096,1.578898,376,42,1, merged,0,0,0.558538811012
27759,1000014,1,1206,1029,177,0.853234,0.146766,0.853234,165,12,1208,1031,177,0.853477,0.146523,0.853477,165,12,-1, merged,0,0,0.117190284413
27759,1000153,2,628,574,54,0.914013,0.085987,1.767247,42,12,629,575,54,0.914149,0.085851,1.767626,42,12,1, merged,0,0,0.180147666771
27766,1000014,3,1208,1031,177,0.853477,0.146523,2.432462,165,12,1211,1034,177,0.85384,0.14616,2.431788,165,12,-1, merged,0,0,0.683203603723
27766,1000120,2,588,479,109,0.814626,0.185374,1.578985,96,13,589,479,110,0.813243,0.186757,1.577949,97,13,1, merged,1,1,0.38740725474
27778,1000121,1,1165,959,206,0.823176,0.176824,0.823176,195,11,1167,961,206,0.823479,0.176521,0.823479,195,11,-1, merged,0,0,0.139777140569
27778,1000329,2,1778,1360,418,0.764904,0.235096,1.58808,376,42,1782,1361,421,0.763749,0.236251,1.587228,379,42,1, merged,1,1,0.180498077742
27782,1000004,3,1573,1365,208,0.867769,0.132231,1.859435,164,44,1574,1366,208,0.867853,0.132147,1.880157,164,44,1, merged,0,0,0.0188223763435
27790,1000003,1,871,739,132,0.84845,0.15155,0.84845,122,10,875,742,133,0.848,0.152,0.848,122,11,-1, merged,1,0,0.000381187682473
27801,1000004,2,1574,1366,208,0.867853,0.132147,1.688212,164,44,1575,1367,208,0.867937,0.132063,1.688832,164,44,1, merged,0,0,0.0317786321327
27801,1000043,1,334,274,60,0.820359,0.179641,0.820359,51,9,335,275,60,0.820896,0.179104,0.820896,51,9,1, merged,0,0,0.0215346534653
27835,1000070,2,781,690,91,0.883483,0.116517,1.684725,75,16,782,691,91,0.883632,0.116368,1.685489,75,16,1, merged,0,0,0.634614538656
27835,1000105,1,322,258,64,0.801242,0.198758,0.801242,56,8,323,259,64,0.801858,0.198142,0.801858,56,8,1, merged,0,0,0.53794029069
27839,1000004,3,1575,1367,208,0.867937,0.132063,2.465018,164,44,1576,1368,208,0.86802,0.13198,2.489044,164,44,1, merged,0,0,0.452057268754
27839,1000329,2,1782,1361,421,0.763749,0.236251,1.597082,379,42,1783,1362,421,0.763881,0.236119,1.621024,379,42,1, merged,0,0,0.825264711904
27845,1000109,3,346,289,57,0.83526,0.16474,2.556429,54,3,347,290,57,0.835735,0.164265,2.543004,54,3,1, merged,0,0,0.0915751407756
27845,1000199,2,304,255,49,0.838816,0.161184,1.721169,45,4,305,256,49,0.839344,0.160656,1.707269,45,4,1, merged,0,0,0.0947776896982
27848,1000011,1,439,408,31,0.929385,0.070615,0.929385,28,3,440,409,31,0.929545,0.070455,0.929545,28,3,1, merged,0,0,0.712946020128
27848,1000120,2,589,479,110,0.813243,0.186757,1.742628,97,13,590,480,110,0.813559,0.186441,1.743105,97,13,1, merged,0,0,0.426715441421
27849,1000011,1,440,409,31,0.929545,0.070455,0.929545,28,3,441,410,31,0.929705,0.070295,0.929705,28,3,1, merged,0,0,0.713948170732
27849,1000120,2,590,480,110,0.813559,0.186441,1.743105,97,13,591,481,110,0.813875,0.186125,1.74358,97,13,1, merged,0,0,0.428184719612
27851,1000118,2,684,607,77,0.887427,0.112573,1.668129,71,6,685,608,77,0.887591,0.112409,1.663453,71,6,1, merged,0,0,0.328425388191
27856,1000009,1,649,551,98,0.848998,0.151002,0.848998,90,8,650,552,98,0.849231,0.150769,0.849231,90,8,1, merged,0,0,0.348585290881
27856,1000011,2,441,410,31,0.929705,0.070295,1.778704,28,3,442,411,31,0.929864,0.070136,1.779095,28,3,1, merged,0,0,0.353627311522
27861,1000120,1,594,484,110,0.814815,0.185185,0.814815,97,13,596,486,110,0.815436,0.184564,0.815436,97,13,-1, merged,0,0,0
27861,1000153,2,629,575,54,0.914149,0.085851,1.728964,42,12,632,576,56,0.911392,0.088608,1.726829,42,14,-1, merged,1,0,0.197431685751
27864,1000054,2,79,70,9,0.886076,0.113924,1.823013,6,3,81,71,10,0.876543,0.123457,1.798282,7,3,1, merged,1,1,0.0373885918004
27865,1000004,1,1576,1368,208,0.86802,0.13198,0.86802,164,44,1577,1369,208,0.868104,0.131896,0.868104,164,44,1, merged,0,0,0.104075951909
27865,1000329,2,1786,1365,421,0.764278,0.235722,1.632298,379,42,1787,1366,421,0.76441,0.23559,1.632514,379,42,1, merged,0,0,0.18873438545
27867,1000004,1,1577,1369,208,0.868104,0.131896,0.868104,164,44,1579,1371,208,0.868271,0.131729,0.868271,164,44,-1, merged,0,0,0.480594392917
27867,1000121,3,1171,965,206,0.824082,0.175918,2.480739,195,11,1172,966,206,0.824232,0.175768,2.481392,195,11,1, merged,0,0,0.696115326823
27868,1000121,2,1172,966,206,0.824232,0.175768,1.613121,195,11,1173,967,206,0.824382,0.175618,1.613605,195,11,1, merged,0,0,0.115947839722
27881,1000329,2,1787,1366,421,0.76441,0.23559,1.497743,379,42,1789,1367,422,0.764114,0.235886,1.514114,380,42,1, merged,1,1,0.446465346444
27881,1000592,3,336,276,60,0.821429,0.178571,2.319172,41,19,337,277,60,0.821958,0.178042,2.336072,41,19,1, merged,0,0,0.357058460261
27883,1000004,1,1579,1371,208,0.868271,0.131729,0.868271,164,44,1580,1371,209,0.867722,0.132278,0.867722,165,44,1, merged,1,1,0.48376364374
27883,1000121,2,1173,967,206,0.824382,0.175618,1.692653,195,11,1174,968,206,0.824532,0.175468,1.692253,195,11,1, merged,0,0,0.697270028671
27889,1000121,1,1176,969,207,0.82398,0.17602,0.82398,196,11,1177,970,207,0.824129,0.175871,0.824129,196,11,1, merged,0,0,0.148503185388
27890,1000120,1,596,486,110,0.815436,0.184564,0.815436,97,13,597,486,111,0.81407,0.18593,0.81407,98,13,1, merged,1,1,0.0189935347074
27891,1000120,1,597,486,111,0.81407,0.18593,0.81407,98,13,598,486,112,0.812709,0.187291,0.812709,99,13,1, merged,1,1,0.0401239189455
27894,1000014,2,1211,1034,177,0.85384,0.14616,1.666549,165,12,1212,1035,177,0.85396,0.14604,1.665313,165,12,1, merged,0,0,0.420829400498
27894,1000120,1,598,486,112,0.812709,0.187291,0.812709,99,13,599,486,113,0.811352,0.188648,0.811352,100,13,1, merged,1,1,0.32137295082
27895,1000014,2,1212,1035,177,0.85396,0.14604,1.665313,165,12,1213,1036,177,0.854081,0.145919,1.664397,165,12,1, merged,0,0,0.140358354901
27895,1000120,1,599,486,113,0.811352,0.188648,0.811352,100,13,601,487,114,0.810316,0.189684,0.810316,101,13,1, merged,1,1,0.107422865127
27898,1000132,2,179,160,19,0.893855,0.106145,1.760521,16,3,180,161,19,0.894444,0.105556,1.765412,16,3,1, merged,0,0,0.317654942628
27914,1000070,2,782,691,91,0.883632,0.116368,1.669346,75,16,783,692,91,0.88378,0.11622,1.670342,75,16,1, merged,0,0,0.097763098905
27923,1000121,3,1177,970,207,0.824129,0.175871,2.48655,196,11,1178,970,208,0.82343,0.17657,2.287987,196,12,-1, merged,1,1,0
27924,1000121,2,1178,970,208,0.82343,0.17657,1.487987,196,12,1179,970,209,0.822731,0.177269,1.489398,196,13,-1, merged,1,1,0
27942,1000118,2,689,611,78,0.886792,0.113208,1.886792,72,6,690,612,78,0.886957,0.113043,1.886957,72,6,1, merged,0,0,0
27944,1000004,1,1584,1373,211,0.866793,0.133207,0.866793,167,44,1585,1374,211,0.866877,0.133123,0.866877,167,44,1, merged,0,0,0.00605102093588
27944,1000121,2,1181,972,209,0.823031,0.176969,1.689824,196,13,1182,973,209,0.823181,0.176819,1.690058,196,13,1, merged,0,0,0.00109271735746
27945,1000329,1,1790,1368,422,0.764246,0.235754,0.764246,380,42,1794,1370,424,0.763657,0.236343,0.763657,382,42,-1, merged,1,0,0.178865434798
27946,1000329,1,1794,1370,424,0.763657,0.236343,0.763657,382,42,1798,1371,427,0.762514,0.237486,0.762514,385,42,1, merged,1,1,0.301738826254
27957,1000004,3,1585,1374,211,0.866877,0.133123,2.117356,167,44,1587,1376,211,0.867045,0.132955,2.123834,167,44,-1, merged,0,0,0.0460359148464
27965,1000120,2,604,490,114,0.811258,0.188742,1.47342,101,13,605,491,114,0.81157,0.18843,1.478237,101,13,1, merged,0,0,0.430685892591
27965,1000534,1,74,49,25,0.662162,0.337838,0.662162,24,1,75,50,25,0.666667,0.333333,0.666667,24,1,1, merged,0,0,0.633090024331
27968,1000054,1,81,71,10,0.876543,0.123457,0.876543,7,3,82,71,11,0.865854,0.134146,0.865854,7,4,-1, merged,1,1,0.0166737342971
27976,1000004,1,1587,1376,211,0.867045,0.132955,0.867045,167,44,1588,1377,211,0.867128,0.132872,0.867128,167,44,1, merged,0,0,0.2224609388
27976,1000007,2,638,538,100,0.84326,0.15674,1.710305,84,16,639,539,100,0.843505,0.156495,1.710634,84,16,1, merged,0,0,0.657729520713
27977,1000003,2,875,742,133,0.848,0.152,1.620595,122,11,878,745,133,0.848519,0.151481,1.618868,122,11,-1, merged,0,0,0.104386584171
27977,1000091,1,343,265,78,0.772595,0.227405,0.772595,64,14,344,265,79,0.770349,0.229651,0.770349,65,14,1, merged,1,1,0.229574783116
27979,1000015,2,1260,1147,113,0.910317,0.089683,1.680666,101,12,1261,1148,113,0.910389,0.089611,1.681403,101,12,1, merged,0,0,0.0885016025641
27979,1000091,1,344,265,79,0.770349,0.229651,0.770349,65,14,345,266,79,0.771014,0.228986,0.771014,65,14,-1, merged,0,0,0
27980,1000109,2,347,290,57,0.835735,0.164265,1.703659,54,3,348,291,57,0.836207,0.163793,1.706577,54,3,1, merged,0,0,0.0428020207354
27981,1000105,3,323,259,64,0.801858,0.198142,2.444316,56,8,324,260,64,0.802469,0.197531,2.446914,56,8,1, merged,0,0,0.0375372496688
27983,1000011,1,443,412,31,0.930023,0.069977,0.930023,28,3,444,413,31,0.93018,0.06982,0.93018,28,3,1, merged,0,0,1.5854065534
27983,1000015,2,1261,1148,113,0.910389,0.089611,1.840411,101,12,1262,1149,113,0.91046,0.08954,1.84064,101,12,1, merged,0,0,1.06332328618
27986,1000070,2,783,692,91,0.88378,0.11622,1.707111,75,16,784,693,91,0.883929,0.116071,1.706564,75,16,1, merged,0,0,0.132525457355
27986,1000121,1,1183,974,209,0.823331,0.176669,0.823331,196,13,1184,974,210,0.822635,0.177365,0.822635,197,13,1, merged,1,1,0.0811431918553
27991,1000011,1,445,414,31,0.930337,0.069663,0.930337,28,3,446,415,31,0.930493,0.069507,0.930493,28,3,1, merged,0,0,0.0146729254997
27991,1000534,2,75,50,25,0.666667,0.333333,1.597004,24,1,76,51,25,0.671053,0.328947,1.601546,24,1,1, merged,0,0,0.0646844660194
27996,1000091,1,346,267,79,0.771676,0.228324,0.771676,65,14,347,268,79,0.772334,0.227666,0.772334,65,14,1, merged,0,0,0.216051665475
27996,1000121,2,1186,976,210,0.822934,0.177066,1.594611,197,13,1187,977,210,0.823083,0.176917,1.595418,197,13,1, merged,0,0,0.136133948401
28000,1000121,2,1190,980,210,0.823529,0.176471,1.613003,197,13,1191,981,210,0.823678,0.176322,1.618549,197,13,-1, abandoned,0,0,0.334315335972
28001,1000091,1,347,268,79,0.772334,0.227666,0.772334,65,14,348,268,80,0.770115,0.229885,0.770115,66,14,1, merged,1,1,0.24194059388
28002,1000121,2,1191,981,210,0.823678,0.176322,1.623678,197,13,1192,982,210,0.823826,0.176174,1.60954,197,13,1, merged,0,0,0.149435054617
28002,1000329,3,1798,1371,427,0.762514,0.237486,2.386191,385,42,1799,1372,427,0.762646,0.237354,2.372186,385,42,1, merged,0,0,0.187372081547
28007,1000121,2,1196,986,210,0.824415,0.175585,1.610129,197,13,1197,987,210,0.824561,0.175439,1.615259,197,13,1, merged,0,0,0.23075732367
28017,1000011,1,446,415,31,0.930493,0.069507,0.930493,28,3,447,416,31,0.930649,0.069351,0.930649,28,3,1, merged,0,0,0.398599792149
28017,1000015,2,1263,1150,113,0.91053,0.08947,1.841024,101,12,1264,1151,113,0.910601,0.089399,1.84125,101,12,1, merged,0,0,0.266123544936
28019,1000070,1,784,693,91,0.883929,0.116071,0.883929,75,16,785,693,92,0.882803,0.117197,0.882803,76,16,1, merged,1,1,0.219836321325
28037,1000118,2,690,612,78,0.886957,0.113043,1.386957,72,6,691,613,78,0.88712,0.11288,1.13712,72,6,-1, abandoned,0,0,0.32946833003
28038,1000004,1,1590,1379,211,0.867296,0.132704,0.867296,167,44,1591,1379,212,0.86675,0.13325,0.86675,168,44,1, merged,1,1,0.0149427067452
28052,1000063,1,1984,1769,215,0.891633,0.108367,0.891633,182,33,1985,1770,215,0.891688,0.108312,0.891688,182,33,1, merged,0,0,0.000385647202207
28052,1000329,5,1800,1373,427,0.762778,0.237222,3.296498,385,42,1801,1374,427,0.762909,0.237091,4.297595,385,42,1, merged,0,0,0.000270494159094
28052,1000592,4,337,277,60,0.821958,0.178042,2.53372,41,19,338,278,60,0.822485,0.177515,3.534686,41,19,1, merged,0,0,0
28053,1000063,2,1985,1770,215,0.891688,0.108312,1.832597,182,33,1986,1771,215,0.891742,0.108258,1.832785,182,33,1, merged,0,0,0.00455951592504
28057,1000063,2,1986,1771,215,0.891742,0.108258,1.832919,182,33,1987,1772,215,0.891797,0.108203,1.830849,182,33,1, merged,0,0,8.10295570037e-05
28063,1000118,1,692,614,78,0.887283,0.112717,0.887283,72,6,696,615,81,0.883621,0.116379,0.883621,75,6,1, merged,1,1,0.0590746735849
28086,1000121,2,1207,997,210,0.826015,0.173985,1.588924,197,13,1208,998,210,0.826159,0.173841,1.5892,197,13,1, merged,0,0,0.230905862464
28086,1000329,1,1801,1374,427,0.762909,0.237091,0.762909,385,42,1802,1375,427,0.763041,0.236959,0.763041,385,42,1, merged,0,0,0.21803833726
28102,1000329,1,1802,1375,427,0.763041,0.236959,0.763041,385,42,1803,1376,427,0.763172,0.236828,0.763172,385,42,1, merged,0,0,0.0385219482181
28102,1000592,3,338,278,60,0.822485,0.177515,2.476074,41,19,339,279,60,0.823009,0.176991,2.477,41,19,1, merged,0,0,0.0432685574231
28103,1000592,2,339,279,60,0.823009,0.176991,1.418247,41,19,341,280,61,0.821114,0.178886,1.412023,41,20,-1, merged,1,0,0.106267927979
28129,1000011,2,448,417,31,0.930804,0.069196,1.742995,28,3,449,418,31,0.930958,0.069042,1.741813,28,3,1, merged,0,0,0.181263685734
28129,1000120,1,607,493,114,0.812191,0.187809,0.812191,101,13,608,493,115,0.810855,0.189145,0.810855,102,13,1, merged,1,1,0.138088532802
28152,1000004,2,1591,1379,212,0.86675,0.13325,1.640855,168,44,1593,1381,212,0.866918,0.133082,1.639521,168,44,-1, abandoned,0,0,0
28178,1000014,2,1228,1048,180,0.85342,0.14658,1.764813,167,13,1230,1050,180,0.853659,0.146341,1.765191,167,13,1, merged,0,0,0.00138408304498
28178,1000153,1,632,576,56,0.911392,0.088608,0.911392,42,14,633,577,56,0.911532,0.088468,0.911532,42,14,1, merged,0,0,0.00209629872257
28179,1000004,2,1593,1381,212,0.866918,0.133082,1.630484,168,44,1595,1383,212,0.867085,0.132915,1.630781,168,44,-1, merged,0,0,0.0925650164345
28179,1000329,1,1806,1379,427,0.763566,0.236434,0.763566,385,42,1807,1380,427,0.763697,0.236303,0.763697,385,42,-1, merged,0,0,0.138803886225
28186,1000121,1,1215,1004,211,0.826337,0.173663,0.826337,198,13,1216,1005,211,0.82648,0.17352,0.82648,198,13,1, merged,0,0,1.57050986129e-10
28188,1000004,1,1595,1383,212,0.867085,0.132915,0.867085,168,44,1597,1384,213,0.866625,0.133375,0.866625,168,45,-1, merged,1,0,0.00217196882586
28188,1000063,2,1992,1777,215,0.892068,0.107932,1.759153,182,33,1993,1778,215,0.892122,0.107878,1.758747,182,33,1, merged,0,0,9.87009080484e-05
28211,1000063,2,1994,1779,215,0.892177,0.107823,1.718753,182,33,1995,1779,216,0.891729,0.108271,1.716448,183,33,1, merged,1,1,0.046469300691
28218,1000118,3,697,616,81,0.883788,0.116212,2.556126,75,6,698,617,81,0.883954,0.116046,2.550188,75,6,1, merged,0,0,0.0819320582739
28233,1000014,2,1231,1051,180,0.853777,0.146223,0.853777,167,13,1232,1052,180,0.853896,0.146104,1.853896,167,13,1, merged,0,0,0.0502629713076
28235,1000121,4,1216,1005,211,0.82648,0.17352,3.161808,198,13,1217,1006,211,0.826623,0.173377,3.139873,198,13,1, merged,0,0,0.0155907774033
28235,1000328,1,534,384,150,0.719101,0.280899,0.719101,135,15,537,385,152,0.716946,0.283054,0.716946,137,15,1, merged,1,1,0.0238812740495
28236,1000328,1,537,385,152,0.716946,0.283054,0.716946,137,15,538,386,152,0.717472,0.282528,0.717472,137,15,1, merged,0,0,0.584582000914
28236,1000329,2,1808,1381,427,0.763827,0.236173,1.480773,385,42,1809,1382,427,0.763958,0.236042,1.48143,385,42,1, merged,0,0,0.567265513237
28247,1000009,2,668,570,98,0.853293,0.146707,1.707308,90,8,670,571,99,0.852239,0.147761,1.706843,91,8,-1, merged,1,0,0.247029710988
28247,1000014,1,1233,1053,180,0.854015,0.145985,0.854015,167,13,1238,1058,180,0.854604,0.145396,0.854604,167,13,-1, merged,0,0,0.153290337895
28247,1000534,3,76,51,25,0.671053,0.328947,2.378361,24,1,77,52,25,0.675325,0.324675,2.382168,24,1,-1, merged,0,0,0.271694168295
28249,1000014,2,1238,1058,180,0.854604,0.145396,1.757382,167,13,1239,1059,180,0.854722,0.145278,1.746613,167,13,1, merged,0,0,0.340524664779
28256,1000121,2,1217,1006,211,0.826623,0.173377,1.49329,198,13,1218,1007,211,0.826765,0.173235,1.489342,198,13,-1, abandoned,0,0,0
28260,1000105,1,328,263,65,0.801829,0.198171,0.801829,57,8,329,264,65,0.802432,0.197568,0.802432,57,8,1, merged,0,0,0.306735142082
28260,1000121,2,1218,1007,211,0.826765,0.173235,1.628594,198,13,1219,1008,211,0.826907,0.173093,1.629339,198,13,1, merged,0,0,0.290007598469
28263,1000592,2,341,280,61,0.821114,0.178886,1.821114,41,20,342,281,61,0.821637,0.178363,1.821637,41,20,1, merged,0,0,0.14835073589
28265,1000592,2,343,282,61,0.822157,0.177843,1.676703,41,20,344,283,61,0.822674,0.177326,1.679817,41,20,1, merged,0,0,0.728220451527
28266,1000043,2,337,277,60,0.821958,0.178042,0.821958,51,9,338,278,60,0.822485,0.177515,1.822485,51,9,1, merged,0,0,0.2448524134
28273,1000004,2,1597,1384,213,0.866625,0.133375,1.513034,168,45,1598,1385,213,0.866708,0.133292,1.51506,168,45,1, merged,0,0,0.0466105298971
28278,1000328,3,538,386,152,0.717472,0.282528,2.076812,137,15,539,387,152,0.717996,0.282004,2.090618,137,15,1, merged,0,0,0
28297,1000063,1,1995,1779,216,0.891729,0.108271,0.891729,183,33,1996,1780,216,0.891784,0.108216,0.891784,183,33,-1, merged,0,0,0.277792729702
28310,1000004,2,1598,1385,213,0.866708,0.133292,1.806974,168,45,1599,1386,213,0.866792,0.133208,1.804982,168,45,-1, abandoned,0,0,0.000301226695141
28311,1000070,2,791,698,93,0.882427,0.117573,1.803261,77,16,792,699,93,0.882576,0.117424,1.799588,77,16,1, merged,0,0,0.224339955378
28314,1000109,2,348,291,57,0.836207,0.163793,1.676076,54,3,349,292,57,0.836676,0.163324,1.677067,54,3,1, merged,0,0,0.023152237927
28314,1000199,1,306,257,49,0.839869,0.160131,0.839869,45,4,307,258,49,0.840391,0.159609,0.840391,45,4,1, merged,0,0,0.0143913109066
28322,1000329,1,1809,1382,427,0.763958,0.236042,0.763958,385,42,1811,1383,428,0.763666,0.236334,0.763666,386,42,1, merged,1,1,0.892078535048
28334,1000070,3,793,700,93,0.882724,0.117276,2.357764,77,16,794,701,93,0.882872,0.117128,2.351286,77,16,1, merged,0,0,0.25372382886
28334,1000105,4,329,264,65,0.802432,0.197568,3.160195,57,8,330,265,65,0.80303,0.19697,3.154317,57,8,1, merged,0,0,0.238390083447
28334,1000121,2,1229,1016,213,0.826688,0.173312,1.47504,200,13,1232,1019,213,0.82711,0.17289,1.468415,200,13,1, merged,0,0,0.192810762303
28336,1000014,2,1240,1060,180,0.854839,0.145161,1.665694,167,13,1242,1062,180,0.855072,0.144928,1.666548,167,13,-1, merged,0,0,0.227285048186
28336,1000120,1,608,493,115,0.810855,0.189145,0.810855,102,13,610,495,115,0.811475,0.188525,0.811475,102,13,-1, merged,0,0,0.130500163876
28337,1000015,2,1276,1163,113,0.911442,0.088558,1.82353,101,12,1277,1164,113,0.911511,0.088489,1.82217,101,12,1, merged,0,0,1.04382852605
28337,1000153,1,637,581,56,0.912088,0.087912,0.912088,42,14,638,581,57,0.910658,0.089342,0.910658,43,14,1, merged,1,1,1.07946128419
28338,1000121,1,1232,1019,213,0.82711,0.17289,0.82711,200,13,1233,1020,213,0.827251,0.172749,0.827251,200,13,1, merged,0,0,0.00170890435039
28339,1000121,3,1233,1020,213,0.827251,0.172749,2.422943,200,13,1234,1021,213,0.827391,0.172609,2.429731,200,13,1, merged,0,0,0.117503673958
28340,1000004,1,1599,1386,213,0.866792,0.133208,0.866792,168,45,1600,1387,213,0.866875,0.133125,0.866875,168,45,-1, abandoned,0,0,0.453441632491
28340,1000329,2,1812,1384,428,0.763797,0.236203,1.630589,386,42,1813,1385,428,0.763927,0.236073,1.630802,386,42,-1, abandoned,0,0,0.823915514524
28341,1000004,2,1600,1387,213,0.866875,0.133125,1.548693,168,45,1601,1388,213,0.866958,0.133042,1.56261,168,45,1, merged,0,0,0
28350,1000043,1,338,278,60,0.822485,0.177515,0.822485,51,9,340,279,61,0.820588,0.179412,0.820588,52,9,1, merged,1,1,0.220732355562
28351,1000043,2,340,279,61,0.820588,0.179412,1.320588,52,9,342,281,61,0.821637,0.178363,1.299898,52,9,-1, merged,0,0,0.886165870604
28352,1000043,1,342,281,61,0.821637,0.178363,0.821637,52,9,343,281,62,0.819242,0.180758,0.819242,53,9,1, abandoned,1,1,0.887112037158
28354,1000014,2,1242,1062,180,0.855072,0.144928,1.738189,167,13,1243,1063,180,0.855189,0.144811,1.739804,167,13,1, merged,0,0,0.0784321058688
28355,1000004,2,1601,1388,213,0.866958,0.133042,1.666958,168,45,1604,1391,213,0.867207,0.132793,1.648816,168,45,-1, merged,0,0,0.0594728216334
28355,1000329,3,1814,1386,428,0.764057,0.235943,2.431015,386,42,1816,1387,429,0.763767,0.236233,2.412583,387,42,-1, merged,1,0,0.0830074952355
28364,1000004,2,1604,1391,213,0.867207,0.132793,1.648816,168,45,1607,1394,213,0.867455,0.132545,1.640182,168,45,-1, merged,0,0,0.0597239545873
28365,1000004,2,1607,1394,213,0.867455,0.132545,1.640182,168,45,1611,1398,213,0.867784,0.132216,1.631829,168,45,-1, merged,0,0,0.0261648788859
28377,1000118,3,698,617,81,0.883954,0.116046,2.610938,75,6,699,617,82,0.88269,0.11731,2.617595,76,6,1, merged,1,1,0.41414866556
28377,1000130,2,210,176,34,0.838095,0.161905,1.726984,25,9,212,177,35,0.834906,0.165094,1.734906,26,9,1, merged,1,1,0.141997755331
28379,1000329,2,1816,1387,429,0.763767,0.236233,1.546855,387,42,1818,1388,430,0.763476,0.236524,1.547359,387,43,1, merged,1,0,0.0833656206844
28380,1000014,1,1245,1065,180,0.855422,0.144578,0.855422,167,13,1247,1067,180,0.855654,0.144346,0.855654,167,13,-1, merged,0,0,0
28387,1000091,1,350,270,80,0.771429,0.228571,0.771429,66,14,352,272,80,0.772727,0.227273,0.772727,66,14,-1, merged,0,0,0.60639759969
28387,1000329,2,1818,1388,430,0.763476,0.236524,1.534905,387,43,1819,1389,430,0.763606,0.236394,1.536334,387,43,1, merged,0,0,0.896944407154
28399,1000004,3,1611,1398,213,0.867784,0.132216,1.975674,168,45,1612,1399,213,0.867866,0.132134,1.983027,168,45,1, merged,0,0,0.0469788680047
28400,1000004,2,1612,1399,213,0.867866,0.132134,1.513027,168,45,1613,1400,213,0.867948,0.132052,1.515007,168,45,1, merged,0,0,0.0472307169555
28403,1000592,2,344,283,61,0.822674,0.177326,1.565844,41,20,345,284,61,0.823188,0.176812,1.567754,41,20,1, merged,0,0,0.704406891981
28406,1000120,1,610,495,115,0.811475,0.188525,0.811475,102,13,613,497,116,0.810767,0.189233,0.810767,103,13,-1, merged,1,0,0.14261007128
28406,1000534,2,77,52,25,0.675325,0.324675,1.4868,24,1,78,53,25,0.679487,0.320513,1.490254,24,1,1, merged,0,0,0.206838603405
28407,1000120,1,613,497,116,0.810767,0.189233,0.810767,103,13,615,498,117,0.809756,0.190244,0.809756,104,13,1, merged,1,1,0.214234436448
28407,1000534,2,78,53,25,0.679487,0.320513,1.490254,24,1,79,53,26,0.670886,0.329114,1.480642,24,2,-1, merged,1,1,0.311380622837
28411,1000004,2,1613,1400,213,0.867948,0.132052,1.695478,168,45,1614,1401,213,0.86803,0.13197,1.695839,168,45,-1, merged,0,0,0.00131011123593
28411,1000121,1,1235,1022,213,0.82753,0.17247,0.82753,200,13,1237,1024,213,0.827809,0.172191,0.827809,200,13,-1, merged,0,0,0.00192729150131
28412,1000121,2,1237,1024,213,0.827809,0.172191,1.723984,200,13,1238,1025,213,0.827948,0.172052,1.714435,200,13,1, merged,0,0,0.146568449695
28412,1000132,1,183,164,19,0.896175,0.103825,0.896175,16,3,185,164,21,0.886486,0.113514,0.886486,16,5,-1, merged,1,1,0.327350383028
28420,1000043,3,344,281,63,0.81686,0.18314,2.442456,54,9,345,282,63,0.817391,0.182609,2.434908,54,9,1, merged,0,0,0.0206361735902
28430,1000091,2,352,272,80,0.772727,0.227273,1.535755,66,14,353,272,81,0.770538,0.229462,1.533956,67,14,1, merged,1,1,0.091298831499
28430,1000329,1,1823,1391,432,0.763028,0.236972,0.763028,388,44,1826,1394,432,0.763417,0.236583,0.763417,388,44,-1, merged,0,0,0.0770051459366
28434,1000124,2,445,412,33,0.925843,0.074157,1.675843,29,4,447,414,33,0.926174,0.073826,1.653447,29,4,-1, merged,0,0,0.406999017093
28435,1000109,3,349,292,57,0.836676,0.163324,2.467508,54,3,350,293,57,0.837143,0.162857,2.469261,54,3,1, merged,0,0,0.00858236419844
28435,1000199,1,307,258,49,0.840391,0.159609,0.840391,45,4,308,259,49,0.840909,0.159091,0.840909,45,4,1, merged,0,0,0.00888134741076
28440,1000007,1,653,552,101,0.845329,0.154671,0.845329,84,17,656,555,101,0.846037,0.153963,0.846037,84,17,-1, merged,0,0,0.260641815764
28440,1000009,2,673,574,99,0.852897,0.147103,1.698227,91,8,674,574,100,0.851632,0.148368,1.697669,92,8,1, merged,1,1,0.252949522803
28454,1000091,1,353,272,81,0.770538,0.229462,0.770538,67,14,354,273,81,0.771186,0.228814,0.771186,67,14,1, merged,0,0,0.287013188199
28454,1000327,2,595,464,131,0.779832,0.220168,1.55037,100,31,596,465,131,0.780201,0.219799,1.551388,100,31,1, merged,0,0,0.332170615209
28461,1000121,2,1240,1027,213,0.828226,0.171774,1.59499,200,13,1242,1028,214,0.827697,0.172303,1.593345,201,13,1, merged,1,1,0.691840956525
28464,1000004,3,1615,1402,213,0.868111,0.131889,2.404946,168,45,1617,1403,214,0.867656,0.132344,2.401547,169,45,-1, merged,1,0,0.459574341218
28464,1000091,1,354,273,81,0.771186,0.228814,0.771186,67,14,355,273,82,0.769014,0.230986,0.769014,68,14,1, merged,1,1,0.575650665124
28464,1000120,4,623,506,117,0.812199,0.187801,3.217145,104,13,627,507,120,0.808612,0.191388,3.210159,107,13,1, merged,1,1,0.459615384615
28464,1000124,5,448,415,33,0.926339,0.073661,4.143484,29,4,450,416,34,0.924444,0.075556,4.134604,30,4,1, merged,1,1,0.39521258361
28474,1000014,1,1250,1070,180,0.856,0.144,0.856,167,13,1252,1070,182,0.854633,0.145367,0.854633,169,13,1, abandoned,1,1,0
28491,1000121,2,1243,1029,214,0.827836,0.172164,1.591383,201,13,1244,1030,214,0.827974,0.172026,1.59165,201,13,1, merged,0,0,0.517828593145
28491,1000329,1,1827,1395,432,0.763547,0.236453,0.763547,388,44,1828,1396,432,0.763676,0.236324,0.763676,388,44,1, merged,0,0,0.552524141186
28492,1000004,1,1617,1403,214,0.867656,0.132344,0.867656,169,45,1621,1406,215,0.867366,0.132634,0.867366,170,45,-1, merged,1,0,0.459354084368
28492,1000329,3,1828,1396,432,0.763676,0.236324,2.405174,388,44,1830,1398,432,0.763934,0.236066,2.405757,388,44,1, merged,0,0,0.843800446834
28493,1000328,2,539,387,152,0.717996,0.282004,1.481931,137,15,540,388,152,0.718519,0.281481,1.482582,137,15,1, merged,0,0,0.509560449107
28493,1000329,1,1830,1398,432,0.763934,0.236066,0.763934,388,44,1831,1399,432,0.764063,0.235937,0.764063,388,44,1, merged,0,0,0.452862538365
28496,1000328,1,540,388,152,0.718519,0.281481,0.718519,137,15,541,389,152,0.719039,0.280961,0.719039,137,15,1, merged,0,0,1.01363024699
28496,1000329,2,1831,1399,432,0.764063,0.235937,1.482582,388,44,1832,1400,432,0.764192,0.235808,1.483231,388,44,1, merged,0,0,0.899230998066
28502,1000329,2,1832,1400,432,0.764192,0.235808,1.326692,388,44,1833,1401,432,0.764321,0.235679,1.340078,388,44,1, merged,0,0,0.248078746555
28507,1000004,3,1621,1406,215,0.867366,0.132634,2.531754,170,45,1622,1407,215,0.867448,0.132552,2.540725,170,45,1, merged,0,0,0.00126670910248
28507,1000014,1,1254,1072,182,0.854864,0.145136,0.854864,169,13,1256,1074,182,0.855096,0.144904,0.855096,169,13,-1, merged,0,0,0.00455884603612
28512,1000109,1,351,294,57,0.837607,0.162393,0.837607,54,3,353,295,58,0.835694,0.164306,0.835694,55,3,1, merged,1,1,0.0458143410283
28516,1000009,1,674,574,100,0.851632,0.148368,0.851632,92,8,675,574,101,0.85037,0.14963,0.85037,93,8,1, merged,1,1,0.141373004532
28516,1000014,2,1256,1074,182,0.855096,0.144904,1.706728,169,13,1257,1075,182,0.855211,0.144789,1.705581,169,13,1, merged,0,0,0.0876774495045
28542,1000063,1,2004,1786,218,0.891218,0.108782,0.891218,183,35,2005,1787,218,0.891272,0.108728,0.891272,183,35,-1, merged,0,0,0.00276107811952
28544,1000004,1,1622,1407,215,0.867448,0.132552,0.867448,170,45,1623,1408,215,0.867529,0.132471,0.867529,170,45,1, merged,0,0,0.0476948210383
28552,1000329,2,1836,1404,432,0.764706,0.235294,1.411765,388,44,1837,1405,432,0.764834,0.235166,1.41377,388,44,1, merged,0,0,0.0169806279225
28554,1000011,2,452,421,31,0.931416,0.068584,1.809076,28,3,453,422,31,0.931567,0.068433,1.810515,28,3,1, merged,0,0,0.00109052857361
28557,1000004,3,1623,1408,215,0.867529,0.132471,2.39724,170,45,1624,1409,215,0.867611,0.132389,2.395925,170,45,-1, abandoned,0,0,0.0479433165744
28557,1000329,1,1837,1405,432,0.764834,0.235166,0.764834,388,44,1839,1406,433,0.764546,0.235454,0.764546,389,44,1, abandoned,1,1,0.0348205539229
28559,1000329,1,1839,1406,433,0.764546,0.235454,0.764546,389,44,1840,1407,433,0.764674,0.235326,0.764674,389,44,1, merged,0,0,0.808703763773
28560,1000014,2,1257,1075,182,0.855211,0.144789,1.673393,169,13,1259,1077,182,0.855441,0.144559,1.647107,169,13,-1, merged,0,0,0.0036975464343
28563,1000070,1,797,704,93,0.883312,0.116688,0.883312,77,16,798,704,94,0.882206,0.117794,0.882206,78,16,1, merged,1,1,0
28563,1000105,2,331,266,65,0.803625,0.196375,1.686938,57,8,332,267,65,0.804217,0.195783,1.686422,57,8,1, merged,0,0,0
28570,1000105,1,332,267,65,0.804217,0.195783,0.804217,57,8,333,268,65,0.804805,0.195195,0.804805,57,8,1, merged,0,0,0.143239783831
28570,1000121,3,1249,1035,214,0.828663,0.171337,2.283673,201,13,1250,1036,214,0.8288,0.1712,2.286236,201,13,1, merged,0,0,0.115671774214
28571,1000070,2,798,704,94,0.882206,0.117794,1.68701,78,16,799,704,95,0.881101,0.118899,1.679321,79,16,1, merged,1,1,0.312937252155
28571,1000105,1,333,268,65,0.804805,0.195195,0.804805,57,8,337,269,68,0.79822,0.20178,0.79822,60,8,1, merged,1,1,0.289532146098
28578,1000054,2,83,72,11,0.86747,0.13253,1.748571,7,4,84,72,12,0.857143,0.142857,1.738393,8,4,1, abandoned,1,1,0.845677672542
28578,1000070,1,799,704,95,0.881101,0.118899,0.881101,79,16,800,705,95,0.88125,0.11875,0.88125,79,16,-1, abandoned,0,0,0.378628865794
28595,1000121,1,1250,1036,214,0.8288,0.1712,0.8288,201,13,1252,1038,214,0.829073,0.170927,0.829073,201,13,-1, merged,0,0,0.543835781565
28595,1000132,2,187,166,21,0.887701,0.112299,1.716501,16,5,188,167,21,0.888298,0.111702,1.717371,16,5,1, merged,0,0,0.680997304582
28597,1000004,1,1624,1409,215,0.867611,0.132389,0.867611,170,45,1627,1411,216,0.86724,0.13276,0.86724,171,45,-1, merged,1,0,0.0134066831518
28597,1000011,4,453,422,31,0.931567,0.068433,3.278677,28,3,455,423,32,0.92967,0.07033,3.269387,29,3,1, merged,1,1,0.0241046831956
28597,1000120,3,627,507,120,0.808612,0.191388,2.347109,107,13,631,511,120,0.809826,0.190174,2.339717,107,13,-1, merged,0,0,0.151467475256
28597,1000534,2,79,53,26,0.670886,0.329114,1.538497,24,2,83,55,28,0.662651,0.337349,1.529891,26,2,-1, merged,1,0,0.0789473684211
28601,1000011,2,455,423,32,0.92967,0.07033,1.794077,29,3,456,424,32,0.929825,0.070175,1.794613,29,3,1, merged,0,0,0.517043067407
28601,1000012,1,354,306,48,0.864407,0.135593,0.864407,47,1,355,307,48,0.864789,0.135211,0.864789,47,1,1, merged,0,0,0.373589642784
28604,1000004,3,1627,1411,216,0.86724,0.13276,2.196541,171,45,1630,1414,216,0.867485,0.132515,2.182485,171,45,-1, merged,0,0,0.0323912640537
28607,1000124,1,450,416,34,0.924444,0.075556,0.924444,30,4,451,417,34,0.924612,0.075388,0.924612,30,4,1, merged,0,0,0.237708706914
28611,1000015,2,1285,1172,113,0.912062,0.087938,1.495396,101,12,1286,1173,113,0.912131,0.087869,1.450592,101,12,1, merged,0,0,0.027032611749
28627,1000011,1,456,424,32,0.929825,0.070175,0.929825,29,3,457,425,32,0.929978,0.070022,0.929978,29,3,1, merged,0,0,0.713270421705
28631,1000070,2,800,705,95,0.88125,0.11875,1.35125,79,16,801,706,95,0.881398,0.118602,1.356646,79,16,1, merged,0,0,0.79882656906
28647,1000124,1,453,419,34,0.924945,0.075055,0.924945,30,4,454,420,34,0.92511,0.07489,0.92511,30,4,1, merged,0,0,0.0206522937259
28651,1000004,2,1630,1414,216,0.867485,0.132515,1.803748,171,45,1631,1415,216,0.867566,0.132434,1.803969,171,45,1, merged,0,0,0.000954380606986
28660,1000015,1,1288,1175,113,0.912267,0.087733,0.912267,101,12,1289,1176,113,0.912335,0.087665,0.912335,101,12,1, merged,0,0,0.0543201878377
28661,1000091,1,355,273,82,0.769014,0.230986,0.769014,68,14,356,274,82,0.769663,0.230337,0.769663,68,14,1, merged,0,0,0.610587980561
28661,1000329,2,1840,1407,433,0.764674,0.235326,1.533688,389,44,1841,1408,433,0.764802,0.235198,1.534465,389,44,1, merged,0,0,0.898787083963
28663,1000004,3,1631,1415,216,0.867566,0.132434,1.867566,171,45,1632,1416,216,0.867647,0.132353,2.367647,171,45,1, merged,0,0,0.0197862323451
28666,1000070,1,801,706,95,0.881398,0.118602,0.881398,79,16,803,707,96,0.880448,0.119552,0.880448,79,17,-1, merged,1,0,0.379387191624
28666,1000105,2,337,269,68,0.79822,0.20178,1.679618,60,8,338,270,68,0.798817,0.201183,1.679265,60,8,1, merged,0,0,0.396914579153
28671,1000329,1,1841,1408,433,0.764802,0.235198,0.764802,389,44,1842,1409,433,0.764929,0.235071,0.764929,389,44,1, merged,0,0,0.893833251841
28673,1000004,1,1632,1416,216,0.867647,0.132353,0.867647,171,45,1634,1416,218,0.866585,0.133415,0.866585,173,45,1, abandoned,1,1,0
28680,1000011,1,458,426,32,0.930131,0.069869,0.930131,29,3,459,426,33,0.928105,0.071895,0.928105,30,3,1, merged,1,1,0.0928059118004
28680,1000015,3,1291,1178,113,0.912471,0.087529,2.637981,101,12,1292,1179,113,0.912539,0.087461,2.636696,101,12,1, merged,0,0,0.0627041273671
28685,1000014,2,1260,1078,182,0.855556,0.144444,1.745799,169,13,1261,1079,182,0.85567,0.14433,1.747236,169,13,1, merged,0,0,0.340651139718
28688,1000004,1,1634,1416,218,0.866585,0.133415,0.866585,173,45,1637,1419,218,0.86683,0.13317,0.86683,173,45,-1, merged,0,0,0.0062980874586
28690,1000007,2,670,569,101,0.849254,0.150746,1.698589,84,17,672,570,102,0.848214,0.151786,1.697772,85,17,1, abandoned,1,1,1.31219296813
28690,1000009,1,677,575,102,0.849335,0.150665,0.849335,94,8,678,576,102,0.849558,0.150442,0.849558,94,8,-1, abandoned,0,0,1.22493619233
28704,1000005,1,194,146,48,0.752577,0.247423,0.752577,43,5,195,147,48,0.753846,0.246154,0.753846,43,5,1, merged,0,0,0
28705,1000329,1,1849,1416,433,0.765819,0.234181,0.765819,389,44,1850,1416,434,0.765405,0.234595,0.765405,390,44,1, abandoned,1,1,0
28711,1000014,3,1261,1079,182,0.85567,0.14433,1.946579,169,13,1262,1080,182,0.855784,0.144216,2.002181,169,13,1, merged,0,0,0.0945456609754
28713,1000109,1,353,295,58,0.835694,0.164306,0.835694,55,3,354,296,58,0.836158,0.163842,0.836158,55,3,1, merged,0,0,0.0178046989721
28715,1000109,1,354,296,58,0.836158,0.163842,0.836158,55,3,355,297,58,0.83662,0.16338,0.83662,55,3,1, merged,0,0,0.0226050810753
28722,1000121,1,1258,1044,214,0.829889,0.170111,0.829889,201,13,1259,1045,214,0.830024,0.169976,0.830024,201,13,1, merged,0,0,0.208928353712
28731,1000328,3,541,389,152,0.719039,0.280961,2.218669,137,15,542,390,152,0.719557,0.280443,2.233271,137,15,1, merged,0,0,0.950232129298
28733,1000070,1,803,707,96,0.880448,0.119552,0.880448,79,17,804,708,96,0.880597,0.119403,0.880597,79,17,1, merged,0,0,0.00886167301647
28733,1000105,2,338,270,68,0.798817,0.201183,1.679265,60,8,339,271,68,0.79941,0.20059,1.680007,60,8,1, merged,0,0,0.00815564359681
28734,1000592,2,347,286,61,0.824207,0.175793,0.824207,41,20,348,287,61,0.824713,0.175287,1.824713,41,20,1, merged,0,0,0.356877556977
28750,1000014,1,1262,1080,182,0.855784,0.144216,0.855784,169,13,1263,1080,183,0.855107,0.144893,0.855107,170,13,1, merged,1,1,0.00201258510081
28752,1000592,2,349,288,61,0.825215,0.174785,1.571161,41,20,350,289,61,0.825714,0.174286,1.574377,41,20,1, merged,0,0,0.582099978171
28756,1000329,1,1853,1419,434,0.765785,0.234215,0.765785,390,44,1854,1420,434,0.765912,0.234088,0.765912,390,44,1, merged,0,0,0.185101751095
28758,1000121,3,1261,1047,214,0.830293,0.169707,2.330052,201,13,1262,1048,214,0.830428,0.169572,2.331071,201,13,1, merged,0,0,0.345218255714
28758,1000327,2,596,465,131,0.780201,0.219799,1.499759,100,31,597,466,131,0.78057,0.21943,1.500643,100,31,1, merged,0,0,0.347138343424
28758,1000328,1,542,390,152,0.719557,0.280443,0.719557,137,15,543,391,152,0.720074,0.279926,0.720074,137,15,1, merged,0,0,0.505718172622
28764,1000121,2,1262,1048,214,0.830428,0.169572,1.597095,201,13,1263,1048,215,0.82977,0.17023,1.54852,202,13,1, merged,1,1,0.00101821771012
28766,1000327,3,597,466,131,0.78057,0.21943,1.613903,100,31,598,467,131,0.780936,0.219064,2.638079,100,31,1, merged,0,0,0.586560707689
28767,1000015,2,1295,1182,113,0.912741,0.087259,1.668839,101,12,1296,1183,113,0.912809,0.087191,1.674713,101,12,1, merged,0,0,0.523797261034
28768,1000004,2,1638,1420,218,0.866911,0.133089,1.633075,173,45,1642,1423,219,0.866626,0.133374,1.632377,174,45,-1, merged,1,0,0.0230924150603
28768,1000329,1,1856,1422,434,0.766164,0.233836,0.766164,390,44,1857,1422,435,0.765751,0.234249,0.765751,391,44,1, merged,1,1,0.0294395060827
28769,1000007,2,675,573,102,0.848889,0.151111,1.697418,85,17,678,575,103,0.848083,0.151917,1.69559,86,17,-1, merged,1,0,0.20150759631
28769,1000009,1,680,577,103,0.848529,0.151471,0.848529,95,8,682,578,104,0.847507,0.152493,0.847507,96,8,-1, merged,1,0,0.191189174822
28770,1000091,1,356,274,82,0.769663,0.230337,0.769663,68,14,357,275,82,0.770308,0.229692,0.770308,68,14,-1, abandoned,0,0,0.240588494236
28781,1000329,2,1857,1422,435,0.765751,0.234249,0.765751,391,44,1858,1423,435,0.765877,0.234123,1.765877,391,44,1, merged,0,0,0.283351049694
28782,1000004,1,1642,1423,219,0.866626,0.133374,0.866626,174,45,1643,1424,219,0.866707,0.133293,0.866707,174,45,1, merged,0,0,0.308716248295
28782,1000124,2,457,423,34,0.925602,0.074398,1.792228,30,4,458,424,34,0.925764,0.074236,1.792471,30,4,1, merged,0,0,0.507897373282
28789,1000329,1,1859,1424,435,0.766003,0.233997,0.766003,391,44,1860,1424,436,0.765591,0.234409,0.765591,392,44,1, abandoned,1,1,0
28791,1000329,1,1860,1424,436,0.765591,0.234409,0.765591,392,44,1861,1424,437,0.76518,0.23482,0.76518,393,44,1, abandoned,1,1,0
28798,1000105,1,341,273,68,0.800587,0.199413,0.800587,60,8,342,274,68,0.80117,0.19883,0.80117,60,8,1, merged,0,0,0.784142348528
28798,1000121,4,1263,1048,215,0.82977,0.17023,2.218592,202,13,1264,1049,215,0.829905,0.170095,3.231075,202,13,1, merged,0,0,0.624752694908
28800,1000043,1,346,283,63,0.817919,0.182081,0.817919,54,9,347,284,63,0.818444,0.181556,0.818444,54,9,1, merged,0,0,0
28800,1000110,2,15,15,0,1,0,1.817919,0,0,16,15,1,0.9375,0.0625,1.755944,0,1,-1, merged,1,1,0
28801,1000120,2,633,513,120,0.810427,0.189573,1.560427,107,13,634,514,120,0.810726,0.189274,1.525011,107,13,1, merged,0,0,0.42496
28803,1000120,2,635,515,120,0.811024,0.188976,1.473674,107,13,636,516,120,0.811321,0.188679,1.481909,107,13,1, merged,0,0,0.00716275406741
28803,1000534,1,83,55,28,0.662651,0.337349,0.662651,26,2,85,57,28,0.670588,0.329412,0.670588,26,2,-1, merged,0,0,0.0104981553365
28814,1000004,1,1643,1424,219,0.866707,0.133293,0.866707,174,45,1644,1425,219,0.866788,0.133212,0.866788,174,45,1, merged,0,0,0.0124123679352
28814,1000329,2,1863,1425,438,0.764895,0.235105,1.631603,394,44,1864,1426,438,0.765021,0.234979,1.63181,394,44,1, merged,0,0,0.00426641117201
28828,1000091,2,359,276,83,0.768802,0.231198,1.643802,69,14,360,277,83,0.769444,0.230556,1.658333,69,14,1, merged,0,0,0.676730510753
28831,1000004,1,1644,1425,219,0.866788,0.133212,0.866788,174,45,1647,1427,220,0.866424,0.133576,0.866424,175,45,1, merged,1,1,0.226648315468
28835,1000004,4,1647,1427,220,0.866424,0.133576,3.399849,175,45,1649,1429,220,0.866586,0.133414,3.396989,175,45,-1, merged,0,0,0
28835,1000063,1,2010,1791,219,0.891045,0.108955,0.891045,183,36,2011,1791,220,0.890602,0.109398,0.890602,184,36,1, merged,1,1,0
28835,1000120,2,639,519,120,0.812207,0.187793,1.703251,107,13,640,519,121,0.810937,0.189062,1.701539,108,13,1, merged,1,1,0
28835,1000121,3,1266,1051,215,0.830174,0.169826,2.533425,202,13,1268,1051,217,0.828864,0.171136,2.530404,204,13,1, merged,1,1,0
28835,1000329,6,1868,1429,439,0.764989,0.235011,5.027036,395,44,1869,1430,439,0.765115,0.234885,5.022699,395,44,1, merged,0,0,0
28837,1000091,2,360,277,83,0.769444,0.230556,1.534559,69,14,361,278,83,0.770083,0.229917,1.535324,69,14,1, merged,0,0,0.608874386167
28837,1000329,1,1869,1430,439,0.765115,0.234885,0.765115,395,44,1870,1431,439,0.765241,0.234759,0.765241,395,44,1, merged,0,0,0.896216976823
28845,1000091,1,361,278,83,0.770083,0.229917,0.770083,69,14,363,279,84,0.768595,0.231405,0.768595,70,14,1, merged,1,1,0.574522690204
28851,1000105,2,342,274,68,0.80117,0.19883,1.70117,60,8,343,275,68,0.801749,0.198251,1.679798,60,8,1, merged,0,0,0.634116743472
28874,1000004,2,1650,1430,220,0.866667,0.133333,1.633333,175,45,1651,1431,220,0.866747,0.133253,1.635978,175,45,1, merged,0,0,0.121059957399
28875,1000004,2,1651,1431,220,0.866747,0.133253,1.635978,175,45,1652,1432,220,0.866828,0.133172,1.638567,175,45,1, merged,0,0,0.258160784136
28879,1000004,3,1652,1432,220,0.866828,0.133172,2.527385,175,45,1653,1432,221,0.866304,0.133696,2.510039,176,45,1, abandoned,1,1,0
28888,1000091,1,363,279,84,0.768595,0.231405,0.768595,70,14,364,280,84,0.769231,0.230769,0.769231,70,14,1, merged,0,0,0.66253776435
28888,1000328,3,546,394,152,0.721612,0.278388,2.254658,137,15,547,395,152,0.722121,0.277879,2.256142,137,15,1, merged,0,0,1.08476623377
28891,1000091,1,364,280,84,0.769231,0.230769,0.769231,70,14,365,281,84,0.769863,0.230137,0.769863,70,14,1, merged,0,0,0.487931447747
28891,1000328,3,547,395,152,0.722121,0.277879,2.256142,137,15,548,396,152,0.722628,0.277372,2.25762,137,15,1, merged,0,0,0.49485515242
28892,1000091,1,365,281,84,0.769863,0.230137,0.769863,70,14,366,281,85,0.76776,0.23224,0.76776,71,14,1, merged,1,1,0.193141601455
28894,1000329,1,1873,1434,439,0.765617,0.234383,0.765617,395,44,1874,1435,439,0.765742,0.234258,0.765742,395,44,1, merged,0,0,0.537362394587
28895,1000121,2,1268,1051,217,0.828864,0.171136,1.61575,204,13,1269,1052,217,0.828999,0.171001,1.617617,204,13,1, merged,0,0,0.131026924665
28900,1000014,4,1264,1081,183,0.855222,0.144778,2.508852,170,13,1265,1082,183,0.855336,0.144664,3.487676,170,13,1, merged,0,0,0.167802252149
28918,1000004,2,1653,1432,221,0.866304,0.133696,1.63217,176,45,1654,1433,221,0.866385,0.133615,1.631843,176,45,-1, abandoned,0,0,0.454771009839
28918,1000329,1,1875,1436,439,0.765867,0.234133,0.765867,395,44,1876,1436,440,0.765458,0.234542,0.765458,396,44,1, abandoned,1,1,0.824019379357
28919,1000014,1,1266,1083,183,0.85545,0.14455,0.85545,170,13,1267,1084,183,0.855564,0.144436,0.855564,170,13,1, merged,0,0,0.0308320627392
28919,1000070,3,811,715,96,0.881628,0.118372,2.54831,79,17,812,716,96,0.881773,0.118227,2.548864,79,17,1, merged,0,0,0.0263071163682
28919,1000120,2,641,520,121,0.811232,0.188768,1.666683,108,13,642,521,121,0.811526,0.188474,1.667091,108,13,1, merged,0,0,0.012805620358
28920,1000153,2,640,583,57,0.910937,0.089063,1.910937,43,14,641,584,57,0.911076,0.088924,1.911076,43,14,1, merged,0,0,0.215760285149
28921,1000105,1,344,276,68,0.802326,0.197674,0.802326,60,8,345,277,68,0.802899,0.197101,0.802899,60,8,1, merged,0,0,0
28929,1000121,1,1272,1055,217,0.829403,0.170597,0.829403,204,13,1274,1057,217,0.82967,0.17033,0.82967,204,13,1, merged,0,0,0.0125440186404
28931,1000592,2,350,289,61,0.825714,0.174286,1.614447,41,20,351,290,61,0.826211,0.173789,1.617877,41,20,1, merged,0,0,0.0583222663634
28936,1000004,1,1657,1436,221,0.866626,0.133374,0.866626,176,45,1658,1436,222,0.866104,0.133896,0.866104,176,46,-1, merged,1,1,0
28936,1000063,2,2015,1793,222,0.889826,0.110174,1.756453,184,38,2016,1794,222,0.889881,0.110119,1.755985,184,38,1, merged,0,0,0.000879554328577
28936,1000120,3,642,521,121,0.811526,0.188474,2.567979,108,13,643,522,121,0.81182,0.18818,2.567804,108,13,1, merged,0,0,2.13987351182e-06
28939,1000004,1,1659,1437,222,0.866184,0.133816,0.866184,176,46,1660,1437,223,0.865663,0.134337,0.865663,176,47,-1, merged,1,1,0
28939,1000121,2,1275,1058,217,0.829804,0.170196,1.695988,204,13,1276,1059,217,0.829937,0.170063,1.6956,204,13,1, merged,0,0,0
28940,1000004,1,1660,1437,223,0.865663,0.134337,0.865663,176,47,1662,1439,223,0.865824,0.134176,0.865824,176,47,-1, merged,0,0,0
28943,1000329,1,1876,1436,440,0.765458,0.234542,0.765458,396,44,1877,1437,440,0.765583,0.234417,0.765583,396,44,1, merged,0,0,0.593158971454
28946,1000063,1,2017,1795,222,0.889936,0.110064,0.889936,184,38,2018,1795,223,0.889495,0.110505,0.889495,185,38,1, merged,1,1,0.0011882707386
28953,1000004,1,1662,1439,223,0.865824,0.134176,0.865824,176,47,1664,1440,224,0.865385,0.134615,0.865385,176,48,-1, merged,1,0,0.105706597929
28953,1000063,3,2020,1797,223,0.889604,0.110396,2.616796,185,38,2021,1798,223,0.889659,0.110341,2.616667,185,38,1, merged,0,0,0.0841066199222
28954,1000004,1,1664,1440,224,0.865385,0.134615,0.865385,176,48,1667,1442,225,0.865027,0.134973,0.865027,176,49,-1, merged,1,0,0.0235240377919
28954,1000063,4,2021,1798,223,0.889659,0.110341,3.428779,185,38,2022,1799,223,0.889713,0.110287,3.429022,185,38,1, merged,0,0,0.0555528187901
28954,1000120,2,644,523,121,0.812112,0.187888,1.677496,108,13,645,524,121,0.812403,0.187597,1.67743,108,13,1, merged,0,0,0.0138198639355
28955,1000070,6,812,716,96,0.881773,0.118227,5.183543,79,17,813,717,96,0.881919,0.118081,5.179324,79,17,1, merged,0,0,0.000999356877257
28959,1000004,1,1667,1442,225,0.865027,0.134973,0.865027,176,49,1668,1443,225,0.865108,0.134892,0.865108,176,49,1, merged,0,0,0.130516403638
28960,1000004,1,1668,1443,225,0.865108,0.134892,0.865108,176,49,1669,1444,225,0.865189,0.134811,0.865189,176,49,1, merged,0,0,0.0275753824009
28961,1000004,1,1669,1444,225,0.865189,0.134811,0.865189,176,49,1670,1445,225,0.865269,0.134731,0.865269,176,49,1, merged,0,0,0.0401070307397
28995,1000014,1,1271,1088,183,0.856019,0.143981,0.856019,170,13,1272,1089,183,0.856132,0.143868,0.856132,170,13,1, merged,0,0,0.00149950288885
28998,1000118,1,707,625,82,0.884017,0.115983,0.884017,76,6,708,625,83,0.882768,0.117232,0.882768,77,6,1, merged,1,1,0.000922399686722
29009,1000004,2,1671,1446,225,0.86535,0.13465,1.676064,176,49,1672,1447,225,0.865431,0.134569,1.676819,176,49,1, merged,0,0,0.134323273423
29010,1000091,1,366,281,85,0.76776,0.23224,0.76776,71,14,367,282,85,0.768392,0.231608,0.768392,71,14,1, merged,0,0,0.612706128378
29010,1000329,2,1877,1437,440,0.765583,0.234417,1.533343,396,44,1878,1437,441,0.765176,0.234824,1.533568,396,45,-1, merged,1,1,0.897822128235
29018,1000015,2,1297,1184,113,0.912876,0.087124,1.784671,101,12,1298,1185,113,0.912943,0.087057,1.785392,101,12,1, merged,0,0,0.988810208886
29023,1000014,2,1275,1092,183,0.856471,0.143529,1.611679,170,13,1276,1093,183,0.856583,0.143417,1.61306,170,13,1, merged,0,0,0.601529896617
29025,1000014,2,1276,1093,183,0.856583,0.143417,1.277636,170,13,1277,1094,183,0.856695,0.143305,1.306695,170,13,1, merged,0,0,0.131470982261
29025,1000043,3,347,284,63,0.818444,0.181556,2.09608,54,9,348,285,63,0.818966,0.181034,2.125661,54,9,1, merged,0,0,0.178139912407
29027,1000592,2,351,290,61,0.826211,0.173789,1.566952,41,20,353,291,62,0.824363,0.175637,1.548501,41,21,1, merged,1,0,0
29049,1000120,2,645,524,121,0.812403,0.187597,1.526689,108,13,646,525,121,0.812693,0.187307,1.539966,108,13,1, merged,0,0,0.438161452298
29057,1000063,1,2027,1804,223,0.889985,0.110015,0.889985,185,38,2028,1805,223,0.890039,0.109961,0.890039,185,38,1, merged,0,0,0.00684640583934
29057,1000121,2,1280,1063,217,0.830469,0.169531,1.720454,204,13,1281,1064,217,0.830601,0.169399,1.720641,204,13,1, merged,0,0,0.0125894802365
29058,1000063,1,2028,1805,223,0.890039,0.109961,0.890039,185,38,2029,1806,223,0.890094,0.109906,0.890094,185,38,1, merged,0,0,0.332522222018
29058,1000121,2,1281,1064,217,0.830601,0.169399,1.720641,204,13,1282,1065,217,0.830733,0.169267,1.720827,204,13,1, merged,0,0,0.213796204703
29059,1000070,1,814,718,96,0.882064,0.117936,0.882064,79,17,816,720,96,0.882353,0.117647,0.882353,79,17,1, merged,0,0,0.045322333895
29059,1000105,3,349,281,68,0.805158,0.194842,2.687221,60,8,350,282,68,0.805714,0.194286,2.688067,60,8,1, merged,0,0,0.04227215402
29061,1000004,1,1679,1453,226,0.865396,0.134604,0.865396,177,49,1680,1453,227,0.864881,0.135119,0.864881,178,49,1, abandoned,1,1,0.0522756961798
29061,1000105,2,350,282,68,0.805714,0.194286,1.67111,60,8,351,282,69,0.803419,0.196581,1.6683,61,8,1, abandoned,1,1,0.0822112893139
29075,1000004,2,1680,1453,227,0.864881,0.135119,1.614881,178,49,1681,1454,227,0.864961,0.135039,1.642739,178,49,1, merged,0,0,0.0318504410946
29087,1000063,1,2029,1806,223,0.890094,0.109906,0.890094,185,38,2031,1807,224,0.88971,0.11029,0.88971,185,39,-1, merged,1,0,0.00145315810776
29091,1000063,1,2031,1807,224,0.88971,0.11029,0.88971,185,39,2032,1808,224,0.889764,0.110236,0.889764,185,39,-1, merged,0,0,0.0256194378218
29125,1000070,1,816,720,96,0.882353,0.117647,0.882353,79,17,817,720,97,0.881273,0.118727,0.881273,80,17,1, merged,1,1,0.257601115652
29134,1000108,1,15,14,1,0.933333,0.066667,0.933333,1,0,17,15,2,0.882353,0.117647,0.882353,2,0,1, merged,1,1,0.0163043478261
29134,1000110,2,20,19,1,0.95,0.05,1.883333,0,1,21,20,1,0.952381,0.047619,1.834734,0,1,1, merged,0,0,0.42513368984
29135,1000328,2,550,397,153,0.721818,0.278182,1.487368,138,15,552,398,154,0.721014,0.278986,1.486158,139,15,1, merged,1,1,0.0607608484556
29135,1000329,1,1881,1440,441,0.76555,0.23445,0.76555,396,45,1882,1440,442,0.765143,0.234857,0.765143,397,45,1, merged,1,1,0
29137,1000014,2,1277,1094,183,0.856695,0.143305,1.738258,170,13,1278,1095,183,0.856808,0.143192,1.738515,170,13,1, merged,0,0,0.327899343621
29137,1000070,1,819,722,97,0.881563,0.118437,0.881563,80,17,820,723,97,0.881707,0.118293,0.881707,80,17,1, merged,0,0,0.396776271644
29138,1000329,1,1882,1440,442,0.765143,0.234857,0.765143,397,45,1883,1441,442,0.765268,0.234732,0.765268,397,45,1, merged,0,0,0.557446882094
29139,1000329,2,1883,1441,442,0.765268,0.234732,0.765268,397,45,1884,1442,442,0.765393,0.234607,1.765393,397,45,-1, abandoned,0,0,0.897190681571
29140,1000004,2,1683,1456,227,0.865122,0.134878,1.459716,178,49,1685,1458,227,0.865282,0.134718,1.470545,178,49,1, merged,0,0,0.00673767354009
29141,1000004,4,1685,1458,227,0.865282,0.134718,2.677975,178,49,1686,1459,227,0.865362,0.134638,2.928345,178,49,1, merged,0,0,0.0511918213613
29141,1000120,3,646,525,121,0.812693,0.187307,1.812693,108,13,647,526,121,0.812983,0.187017,2.062983,108,13,1, merged,0,0,0.198145604396
29153,1000004,2,1686,1459,227,0.865362,0.134638,1.284717,178,49,1690,1463,227,0.86568,0.13432,1.278052,178,49,-1, merged,0,0,0.0603561190969
29162,1000063,2,2033,1809,224,0.889818,0.110182,1.889818,185,39,2038,1814,224,0.890088,0.109912,1.799179,185,39,-1, merged,0,0,0.000239718564179
29177,1000327,1,599,468,131,0.781302,0.218698,0.781302,100,31,600,469,131,0.781667,0.218333,0.781667,100,31,1, merged,0,0,0.0292586083988
29184,1000063,1,2039,1815,224,0.890142,0.109858,0.890142,185,39,2042,1818,224,0.890304,0.109696,0.890304,185,39,-1, merged,0,0,0.0100800684681
29187,1000153,1,641,584,57,0.911076,0.088924,0.911076,43,14,642,585,57,0.911215,0.088785,0.911215,43,14,-1, abandoned,0,0,1.08510288486
29188,1000003,2,878,745,133,0.848519,0.151481,1.614161,122,11,879,746,133,0.848692,0.151308,1.614176,122,11,-1, abandoned,0,0,0.282551807255
29188,1000329,1,1886,1444,442,0.765642,0.234358,0.765642,397,45,1889,1446,443,0.765484,0.234516,0.765484,398,45,1, abandoned,1,1,0.412376223167
29190,1000003,2,879,746,133,0.848692,0.151308,1.705499,122,11,882,747,135,0.846939,0.153061,1.703076,124,11,1, merged,1,1,0.569670057464
29190,1000014,1,1278,1095,183,0.856808,0.143192,0.856808,170,13,1279,1095,184,0.856138,0.143862,0.856138,171,13,1, merged,1,1,0
29190,1000329,4,1889,1446,443,0.765484,0.234516,3.295346,398,45,1890,1447,443,0.765608,0.234392,3.29122,398,45,-1, merged,0,0,0.827152765994
29190,1000592,3,353,291,62,0.824363,0.175637,2.529862,41,21,355,292,63,0.822535,0.177465,2.525612,42,21,1, merged,1,1,0
29193,1000328,1,552,398,154,0.721014,0.278986,0.721014,139,15,553,399,154,0.721519,0.278481,0.721519,139,15,1, merged,0,0,0.536396044376
29198,1000004,1,1697,1470,227,0.866235,0.133765,0.866235,178,49,1699,1472,227,0.866392,0.133608,0.866392,178,49,-1, merged,0,0,0.0357824036261
29205,1000004,1,1702,1475,227,0.866627,0.133373,0.866627,178,49,1703,1476,227,0.866706,0.133294,0.866706,178,49,-1, merged,0,0,0.185521342931
29208,1000004,2,1705,1478,227,0.866862,0.133138,1.632471,178,49,1707,1480,227,0.867018,0.132982,1.632222,178,49,1, merged,0,0,0.123805006236
29208,1000329,1,1890,1447,443,0.765608,0.234392,0.765608,398,45,1891,1447,444,0.765204,0.234796,0.765204,399,45,1, merged,1,1,0.184715351478
29218,1000004,2,1710,1483,227,0.867251,0.132749,1.562904,178,49,1711,1484,227,0.867329,0.132671,1.575662,178,49,1, merged,0,0,0
29221,1000007,2,707,591,116,0.835926,0.164074,1.692064,98,18,708,592,116,0.836158,0.163842,1.692408,98,18,1, merged,0,0,0.617700577233
29221,1000014,1,1279,1095,184,0.856138,0.143862,0.856138,171,13,1280,1096,184,0.85625,0.14375,0.85625,171,13,1, merged,0,0,0.352757753185
29223,1000054,2,84,72,12,0.857143,0.142857,1.783069,8,4,85,73,12,0.858824,0.141176,1.782737,8,4,-1, abandoned,0,0,0.0119568401523
29223,1000124,1,459,425,34,0.925926,0.074074,0.925926,30,4,460,425,35,0.923913,0.076087,0.923913,31,4,1, abandoned,1,1,0.0823163220757
29227,1000070,2,824,727,97,0.882282,0.117718,1.647609,80,17,825,728,97,0.882424,0.117576,1.647876,80,17,1, merged,0,0,0.127075231249
29227,1000329,1,1892,1448,444,0.765328,0.234672,0.765328,399,45,1893,1449,444,0.765452,0.234548,0.765452,399,45,1, merged,0,0,0.10357591472
29231,1000120,2,647,526,121,0.812983,0.187017,1.483571,108,13,652,527,125,0.808282,0.191718,1.463455,112,13,1, merged,1,1,0.0868936888865
29231,1000534,1,85,57,28,0.670588,0.329412,0.670588,26,2,87,57,30,0.655172,0.344828,0.655172,28,2,1, merged,1,1,0.140996465368
29232,1000004,1,1711,1484,227,0.867329,0.132671,0.867329,178,49,1712,1485,227,0.867407,0.132593,0.867407,178,49,-1, merged,0,0,0.0134265042682
29232,1000120,2,652,527,125,0.808282,0.191718,1.675611,112,13,654,528,126,0.807339,0.192661,1.674746,113,13,1, merged,1,1,0.147697590736
29234,1000329,1,1894,1450,444,0.765576,0.234424,0.765576,399,45,1896,1451,445,0.765295,0.234705,0.765295,400,45,1, merged,1,1,0.540675095257
29235,1000004,1,1712,1485,227,0.867407,0.132593,0.867407,178,49,1713,1486,227,0.867484,0.132516,0.867484,178,49,-1, merged,0,0,0.013680549979
29235,1000120,2,654,528,126,0.807339,0.192661,1.674746,113,13,655,529,126,0.807634,0.192366,1.675118,113,13,1, merged,0,0,0.14712971078
29236,1000004,2,1713,1486,227,0.867484,0.132516,1.757948,178,49,1714,1487,227,0.867561,0.132439,1.758133,178,49,1, merged,0,0,0.0711535568544
29236,1000063,1,2045,1821,224,0.890465,0.109535,0.890465,185,39,2047,1823,224,0.890572,0.109428,0.890572,185,39,-1, merged,0,0,0.166428913252
29237,1000070,3,825,728,97,0.882424,0.117576,2.741915,80,17,826,729,97,0.882567,0.117433,2.743147,80,17,1, merged,0,0,0.0539841918079
29242,1000327,2,600,469,131,0.781667,0.218333,1.505805,100,31,601,470,131,0.78203,0.21797,1.515363,100,31,1, merged,0,0,0.598699294533
29244,1000327,3,601,470,131,0.78203,0.21797,2.280659,100,31,602,471,131,0.782392,0.217608,2.289747,100,31,1, merged,0,0,0.0315779569609
29244,1000329,1,1896,1451,445,0.765295,0.234705,0.765295,400,45,1897,1452,445,0.765419,0.234581,0.765419,400,45,1, merged,0,0,0.0312469771905
29252,1000070,2,827,730,97,0.882709,0.117291,1.609981,80,17,828,730,98,0.881643,0.118357,1.585346,81,17,1, merged,1,1,0.195107419177
29252,1000130,3,213,178,35,0.835681,0.164319,2.445662,26,9,214,179,35,0.836449,0.163551,2.421795,26,9,1, merged,0,0,0.211527965255
29253,1000105,2,352,283,69,0.803977,0.196023,1.569396,61,8,353,284,69,0.804533,0.195467,1.570075,61,8,1, merged,0,0,0.312928227787
29253,1000329,1,1897,1452,445,0.765419,0.234581,0.765419,400,45,1898,1453,445,0.765543,0.234457,0.765543,400,45,-1, merged,0,0,0
29254,1000014,3,1280,1096,184,0.85625,0.14375,2.62138,171,13,1281,1097,184,0.856362,0.143638,2.62073,171,13,-1, abandoned,0,0,0
29260,1000005,4,197,148,49,0.751269,0.248731,3.026024,44,5,198,149,49,0.752525,0.247475,3.025561,44,5,-1, merged,0,0,0.00742584626915
29260,1000014,2,1281,1097,184,0.856362,0.143638,1.621905,171,13,1286,1099,187,0.854588,0.145412,1.619975,174,13,-1, merged,1,0,0.00669940893675
29260,1000070,5,829,731,98,0.881785,0.118215,3.907809,81,17,830,731,99,0.880723,0.119277,3.906284,82,17,1, merged,1,1,0.00696762717338
29260,1000121,7,1284,1067,217,0.830997,0.169003,5.298806,204,13,1286,1068,218,0.830482,0.169518,5.285786,205,13,1, merged,1,1,0.00842383570994
29260,1000329,1,1898,1453,445,0.765543,0.234457,0.765543,400,45,1901,1455,446,0.765387,0.234613,0.765387,401,45,-1, merged,1,0,0.00792020651997
29261,1000014,1,1286,1099,187,0.854588,0.145412,0.854588,174,13,1288,1101,187,0.854814,0.145186,0.854814,174,13,-1, merged,0,0,0.30373849034
29261,1000121,2,1286,1068,218,0.830482,0.169518,1.68507,205,13,1287,1068,219,0.829837,0.170163,1.68465,206,13,1, merged,1,1,0.230297919658
29263,1000121,2,1287,1068,219,0.829837,0.170163,1.704837,206,13,1289,1070,219,0.830101,0.169899,1.708889,206,13,-1, merged,0,0,0.484011732069
29264,1000592,2,356,293,63,0.823034,0.176966,1.665139,42,21,357,294,63,0.823529,0.176471,1.668357,42,21,1, merged,0,0,0.333106227106
29272,1000004,1,1716,1489,227,0.867716,0.132284,0.867716,178,49,1718,1491,227,0.86787,0.13213,0.86787,178,49,-1, abandoned,0,0,0.368515297734
29272,1000120,3,656,530,126,0.807927,0.192073,2.371295,113,13,657,531,126,0.808219,0.191781,2.396089,113,13,-1, abandoned,0,0,0.582109573052
29283,1000070,2,830,731,99,0.880723,0.119277,1.804801,82,17,831,732,99,0.880866,0.119134,1.805109,82,17,1, merged,0,0,0.126033741307
29283,1000124,1,461,426,35,0.924078,0.075922,0.924078,31,4,462,427,35,0.924242,0.075758,0.924242,31,4,1, merged,0,0,0.0691928636898
29290,1000118,1,717,634,83,0.88424,0.11576,0.88424,77,6,718,634,84,0.883008,0.116992,0.883008,78,6,1, merged,1,1,0.0201709610235
29293,1000009,1,687,583,104,0.848617,0.151383,0.848617,96,8,690,584,106,0.846377,0.153623,0.846377,98,8,1, merged,1,1,0.233159335223
29297,1000004,1,1718,1491,227,0.86787,0.13213,0.86787,178,49,1719,1492,227,0.867946,0.132054,0.867946,178,49,-1, abandoned,0,0,0.0481552003996
29298,1000063,1,2055,1830,225,0.890511,0.109489,0.890511,186,39,2058,1832,226,0.890185,0.109815,0.890185,187,39,-1, abandoned,1,0,0.0410502635748
29321,1000063,3,2059,1833,226,0.890238,0.109762,2.750676,187,39,2060,1834,226,0.890291,0.109709,2.749275,187,39,-1, merged,0,0,0.000972589920577
29326,1000004,1,1722,1495,227,0.868177,0.131823,0.868177,178,49,1723,1496,227,0.868253,0.131747,0.868253,178,49,1, merged,0,0,0.0484147787555
29326,1000592,2,359,296,63,0.824513,0.175487,1.692689,42,21,360,297,63,0.825,0.175,1.693253,42,21,1, merged,0,0,0.146811771919
29327,1000004,1,1723,1496,227,0.868253,0.131747,0.868253,178,49,1724,1497,227,0.868329,0.131671,0.868329,178,49,1, merged,0,0,0.0486613829256
29327,1000592,3,360,297,63,0.825,0.175,2.693253,42,21,361,298,63,0.825485,0.174515,2.693814,42,21,1, merged,0,0,0.149172794118
29328,1000592,2,361,298,63,0.825485,0.174515,1.654753,42,21,362,299,63,0.825967,0.174033,1.6593,42,21,1, merged,0,0,0.151530924679
29330,1000009,1,692,586,106,0.846821,0.153179,0.846821,98,8,694,588,106,0.847262,0.152738,0.847262,98,8,1, merged,0,0,0.583659331019
29334,1000063,1,2060,1834,226,0.890291,0.109709,0.890291,187,39,2061,1835,226,0.890344,0.109656,0.890344,187,39,1, merged,0,0,0.0018288700196
29334,1000121,2,1290,1071,219,0.830233,0.169767,1.720524,206,13,1291,1072,219,0.830364,0.169636,1.720709,206,13,1, merged,0,0,0.0034018865007
29344,1000009,2,696,590,106,0.847701,0.152299,1.502874,98,8,697,591,106,0.84792,0.15208,1.507011,98,8,1, merged,0,0,1.20002743961
29344,1000534,1,87,57,30,0.655172,0.344828,0.655172,28,2,88,58,30,0.659091,0.340909,0.659091,28,2,-1, merged,0,0,1.25483558994
29345,1000063,1,2062,1836,226,0.890398,0.109602,0.890398,187,39,2064,1837,227,0.890019,0.109981,0.890019,188,39,-1, abandoned,1,0,0.0018661590714
29345,1000124,2,462,427,35,0.924242,0.075758,1.81464,31,4,463,427,36,0.922246,0.077754,1.812266,32,4,1, abandoned,1,1,0.000640409862312
29348,1000004,3,1725,1498,227,0.868406,0.131594,2.335716,178,49,1726,1499,227,0.868482,0.131518,2.328678,178,49,-1, abandoned,0,0,0.394072019792
29348,1000120,1,657,531,126,0.808219,0.191781,0.808219,113,13,658,532,126,0.808511,0.191489,0.808511,113,13,-1, abandoned,0,0,0.551650805805
29348,1000534,2,88,58,30,0.659091,0.340909,1.46731,28,2,89,58,31,0.651685,0.348315,1.460196,29,2,1, abandoned,1,1,0.648069498069
29350,1000105,1,354,285,69,0.805085,0.194915,0.805085,61,8,356,286,70,0.803371,0.196629,0.803371,62,8,1, merged,1,1,0.107991128242
29350,1000121,2,1292,1073,219,0.830495,0.169505,1.63558,206,13,1293,1074,219,0.830626,0.169374,1.633997,206,13,1, merged,0,0,0.102125669891
29352,1000004,1,1726,1499,227,0.868482,0.131518,0.868482,178,49,1727,1500,227,0.868558,0.131442,0.868558,178,49,-1, merged,0,0,0.0600884564352
29352,1000063,2,2064,1837,227,0.890019,0.109981,1.758501,188,39,2065,1838,227,0.890073,0.109927,1.758631,188,39,1, merged,0,0,0.0269067857798
29352,1000329,3,1907,1461,446,0.766125,0.233875,2.524626,401,45,1908,1462,446,0.766247,0.233753,2.524878,401,45,1, merged,0,0,0.0847057412294
29353,1000014,1,1288,1101,187,0.854814,0.145186,0.854814,174,13,1289,1102,187,0.854926,0.145074,0.854926,174,13,1, merged,0,0,0.200641882167
29353,1000070,2,833,734,99,0.881152,0.118848,1.735966,82,17,834,735,99,0.881295,0.118705,1.736221,82,17,1, merged,0,0,0.242250587416
29359,1000009,1,697,591,106,0.84792,0.15208,0.84792,98,8,698,592,106,0.848138,0.151862,0.848138,98,8,1, merged,0,0,1.2717927615
29360,1000009,1,698,592,106,0.848138,0.151862,0.848138,98,8,699,593,106,0.848355,0.151645,0.848355,98,8,1, merged,0,0,1.27236942759
29361,1000124,1,463,427,36,0.922246,0.077754,0.922246,32,4,466,430,36,0.922747,0.077253,0.922747,32,4,-1, merged,0,0,0.466497061447
29375,1000070,2,834,735,99,0.881295,0.118705,1.795929,82,17,836,735,101,0.879187,0.120813,1.790118,84,17,1, merged,1,1,0.016195211843
29375,1000121,3,1295,1076,219,0.830888,0.169112,2.626817,206,13,1297,1076,221,0.829607,0.170393,2.619725,208,13,1, merged,1,1,0.0141660783536
29377,1000063,2,2068,1840,228,0.889749,0.110251,1.773082,189,39,2070,1842,228,0.889855,0.110145,1.771963,189,39,-1, merged,0,0,0.347322729576
29377,1000118,1,720,636,84,0.883333,0.116667,0.883333,78,6,721,636,85,0.882108,0.117892,0.882108,79,6,1, merged,1,1,0.595900962678
29410,1000004,1,1727,1500,227,0.868558,0.131442,0.868558,178,49,1729,1502,227,0.86871,0.13129,0.86871,178,49,-1, merged,0,0,0.0425116677345
29410,1000120,2,658,532,126,0.808511,0.191489,1.677069,113,13,659,533,126,0.808801,0.191199,1.677511,113,13,-1, merged,0,0,0.02762442163
29411,1000014,1,1289,1102,187,0.854926,0.145074,0.854926,174,13,1290,1103,187,0.855039,0.144961,0.855039,174,13,1, merged,0,0,0.0030098452788
29413,1000007,2,713,596,117,0.835905,0.164095,1.684259,99,18,714,597,117,0.836134,0.163866,1.684706,99,18,1, merged,0,0,1.30611889787
29413,1000009,1,699,593,106,0.848355,0.151645,0.848355,98,8,700,594,106,0.848571,0.151429,0.848571,98,8,-1, merged,0,0,1.27368549491
29416,1000592,1,362,299,63,0.825967,0.174033,0.825967,42,21,363,300,63,0.826446,0.173554,0.826446,42,21,1, merged,0,0,0.657881923311
29418,1000007,1,717,600,117,0.83682,0.16318,0.83682,99,18,719,601,118,0.835883,0.164117,0.835883,100,18,1, merged,1,1,1.30691503057
29418,1000534,2,89,58,31,0.651685,0.348315,1.488505,29,2,90,59,31,0.655556,0.344444,1.491439,29,2,1, merged,0,0,1.20462427746
29423,1000328,2,555,401,154,0.722523,0.277477,1.488892,139,15,556,402,154,0.723022,0.276978,1.48899,139,15,1, merged,0,0,0.0900601905791
29423,1000329,1,1909,1463,446,0.76637,0.23363,0.76637,401,45,1910,1463,447,0.765969,0.234031,0.765969,402,45,1, merged,1,1,0.0663651479863
29427,1000592,2,363,300,63,0.826446,0.173554,1.568382,42,21,364,301,63,0.826923,0.173077,1.576923,42,21,1, merged,0,0,0.0428962460897
29433,1000014,1,1290,1103,187,0.855039,0.144961,0.855039,174,13,1291,1103,188,0.854376,0.145624,0.854376,175,13,1, merged,1,1,0.688912234185
29433,1000070,2,836,735,101,0.879187,0.120813,1.734225,84,17,837,736,101,0.879331,0.120669,1.733707,84,17,1, merged,0,0,0.786147416413
29439,1000120,2,660,534,126,0.809091,0.190909,1.575059,113,13,661,535,126,0.80938,0.19062,1.575471,113,13,1, merged,0,0,0.0705453527697
29439,1000329,1,1910,1463,447,0.765969,0.234031,0.765969,402,45,1911,1464,447,0.766091,0.233909,0.766091,402,45,1, merged,0,0,0.00141779982655
29440,1000120,2,661,535,126,0.80938,0.19062,1.575471,113,13,662,536,126,0.809668,0.190332,1.575881,113,13,1, merged,0,0,0.0716338380492
29440,1000329,1,1911,1464,447,0.766091,0.233909,0.766091,402,45,1912,1465,447,0.766213,0.233787,0.766213,402,45,1, merged,0,0,0.00180400746626
29441,1000004,1,1730,1503,227,0.868786,0.131214,0.868786,178,49,1731,1504,227,0.868862,0.131138,0.868862,178,49,-1, abandoned,0,0,0
29441,1000329,2,1912,1465,447,0.766213,0.233787,1.635,402,45,1913,1466,447,0.766336,0.233664,1.635198,402,45,-1, abandoned,0,0,0
29442,1000014,2,1291,1103,188,0.854376,0.145624,1.304376,175,13,1292,1104,188,0.854489,0.145511,1.33068,175,13,1, merged,0,0,0.144911252588
29443,1000054,3,85,73,12,0.858824,0.141176,2.77549,8,4,86,74,12,0.860465,0.139535,2.270301,8,4,-1, merged,0,0,0.0284614333221
29443,1000124,4,466,430,36,0.922747,0.077253,3.698237,32,4,468,432,36,0.923077,0.076923,3.193378,32,4,-1, merged,0,0,0.0173529860749
29447,1000014,1,1292,1104,188,0.854489,0.145511,0.854489,175,13,1293,1104,189,0.853828,0.146172,0.853828,176,13,1, abandoned,1,1,0
29447,1000105,2,357,287,70,0.803922,0.196078,1.658411,62,8,358,287,71,0.801676,0.198324,1.655504,63,8,1, abandoned,1,1,0
29453,1000004,1,1731,1504,227,0.868862,0.131138,0.868862,178,49,1733,1505,228,0.868436,0.131564,0.868436,179,49,-1, abandoned,1,0,0
29460,1000328,2,556,402,154,0.723022,0.276978,1.328285,139,15,557,403,154,0.723519,0.276481,1.338903,139,15,1, merged,0,0,0.585841100755
29473,1000063,2,2074,1846,228,0.890068,0.109932,1.616563,189,39,2076,1848,228,0.890173,0.109827,1.610512,189,39,-1, merged,0,0,0.173833317516
29490,1000004,1,1736,1508,228,0.868664,0.131336,0.868664,179,49,1738,1510,228,0.868815,0.131185,0.868815,179,49,-1, merged,0,0,0.069634129784
29492,1000014,3,1294,1105,189,0.853941,0.146059,2.425855,176,13,1295,1106,189,0.854054,0.145946,2.43399,176,13,1, merged,0,0,0
29492,1000109,2,355,297,58,0.83662,0.16338,1.571914,55,3,356,298,58,0.837079,0.162921,1.579936,55,3,1, merged,0,0,0
29504,1000004,1,1738,1510,228,0.868815,0.131185,0.868815,179,49,1740,1512,228,0.868966,0.131034,0.868966,179,49,-1, merged,0,0,0.378070430691
29504,1000063,2,2077,1849,228,0.890226,0.109774,1.759041,189,39,2078,1850,228,0.890279,0.109721,1.759245,189,39,1, merged,0,0,0.27904389667
29504,1000592,3,364,301,63,0.826923,0.173077,2.585964,42,21,365,302,63,0.827397,0.172603,2.586642,42,21,1, merged,0,0,0.495319703347
29515,1000004,2,1741,1513,228,0.869041,0.130959,1.616614,179,49,1742,1514,228,0.869116,0.130884,1.619116,179,49,1, merged,0,0,0
29518,1000007,2,725,605,120,0.834483,0.165517,1.493823,102,18,726,606,120,0.834711,0.165289,1.501377,102,18,1, merged,0,0,1.32285062052
29518,1000534,1,91,60,31,0.659341,0.340659,0.659341,29,2,93,62,31,0.666667,0.333333,0.666667,29,2,-1, merged,0,0,1.20269230769
29519,1000063,1,2078,1850,228,0.890279,0.109721,0.890279,189,39,2079,1851,228,0.890332,0.109668,0.890332,189,39,-1, merged,0,0,0
29527,1000124,2,468,432,36,0.923077,0.076923,1.842432,32,4,469,433,36,0.923241,0.076759,1.843876,32,4,1, merged,0,0,0.404214616138
29528,1000124,2,469,433,36,0.923241,0.076759,1.843876,32,4,470,434,36,0.923404,0.076596,1.845279,32,4,1, merged,0,0,0.403950786056
29535,1000004,1,1742,1514,228,0.869116,0.130884,0.869116,179,49,1743,1515,228,0.869191,0.130809,0.869191,179,49,1, merged,0,0,0.0611950326062
29542,1000091,3,369,284,85,0.769648,0.230352,2.297527,71,14,370,284,86,0.767568,0.232432,2.296367,72,14,1, merged,1,1,0.152359964049
29542,1000329,2,1914,1467,447,0.766458,0.233542,1.527879,402,45,1918,1470,448,0.766423,0.233577,1.5288,403,45,-1, merged,1,0,0.125603777685
29547,1000063,2,2079,1851,228,0.890332,0.109668,1.656755,189,39,2080,1852,228,0.890385,0.109615,1.65693,189,39,1, merged,0,0,0.0430750840222
29547,1000329,1,1918,1470,448,0.766423,0.233577,0.766423,403,45,1919,1471,448,0.766545,0.233455,0.766545,403,45,1, merged,0,0,0.080286106212
29555,1000007,2,726,606,120,0.834711,0.165289,1.699499,102,18,727,607,120,0.834938,0.165062,1.697298,102,18,1, merged,0,0,0.0471448913778
29555,1000012,1,355,307,48,0.864789,0.135211,0.864789,47,1,356,307,49,0.86236,0.13764,0.86236,48,1,1, merged,1,1,0.408432965461
29560,1000009,2,703,597,106,0.849218,0.150782,1.515884,98,8,704,598,106,0.849432,0.150568,1.519645,98,8,1, merged,0,0,0.0132869069926
29560,1000534,1,93,62,31,0.666667,0.333333,0.666667,29,2,94,63,31,0.670213,0.329787,0.670213,29,2,-1, merged,0,0,0.0143473299794
29566,1000063,1,2082,1854,228,0.89049,0.10951,0.89049,189,39,2087,1858,229,0.890273,0.109727,0.890273,190,39,-1, merged,1,0,0.000435226412528
29592,1000004,1,1746,1517,229,0.868843,0.131157,0.868843,180,49,1747,1518,229,0.868918,0.131082,0.868918,180,49,1, merged,0,0,0.0728861402355
29592,1000014,3,1302,1113,189,0.854839,0.145161,2.484366,176,13,1303,1114,189,0.85495,0.14505,2.48557,176,13,1, merged,0,0,0.11744546581
29603,1000004,3,1747,1518,229,0.868918,0.131082,2.640406,180,49,1748,1519,229,0.868993,0.131007,2.637441,180,49,-1, abandoned,0,0,0.133795819959
29603,1000023,2,336,296,40,0.880952,0.119048,1.771488,37,3,337,296,41,0.878338,0.121662,1.768448,38,3,1, abandoned,1,1,0.650616009438
29603,1000063,1,2092,1863,229,0.890535,0.109465,0.890535,190,39,2093,1863,230,0.89011,0.10989,0.89011,191,39,1, abandoned,1,1,0.323796638754
29604,1000004,2,1748,1519,229,0.868993,0.131007,1.661072,180,49,1749,1520,229,0.869068,0.130932,1.663186,180,49,1, merged,0,0,0
29610,1000014,1,1303,1114,189,0.85495,0.14505,0.85495,176,13,1306,1116,190,0.854518,0.145482,0.854518,177,13,1, merged,1,1,0.301260732259
29610,1000120,3,663,537,126,0.809955,0.190045,2.366054,113,13,664,538,126,0.810241,0.189759,2.369304,113,13,1, merged,0,0,0.214902882214
29613,1000004,2,1749,1520,229,0.869068,0.130932,1.792635,180,49,1750,1521,229,0.869143,0.130857,1.792872,180,49,1, merged,0,0,0.0654827855062
29613,1000124,1,471,435,36,0.923567,0.076433,0.923567,32,4,472,436,36,0.923729,0.076271,0.923729,32,4,-1, merged,0,0,0.245073826216
29615,1000009,2,706,599,107,0.848442,0.151558,1.723442,99,8,707,600,107,0.848656,0.151344,1.737545,99,8,1, merged,0,0,1.15810111151
29619,1000009,2,707,600,107,0.848656,0.151344,1.518869,99,8,708,601,107,0.84887,0.15113,1.522554,99,8,1, merged,0,0,0.614628579774
29619,1000534,1,94,63,31,0.670213,0.329787,0.670213,29,2,95,64,31,0.673684,0.326316,0.673684,29,2,1, merged,0,0,0.5925825386
29621,1000329,1,1920,1472,448,0.766667,0.233333,0.766667,403,45,1922,1474,448,0.766909,0.233091,0.766909,403,45,-1, merged,0,0,0.89468228612
29624,1000004,2,1750,1521,229,0.869143,0.130857,1.53581,180,49,1751,1522,229,0.869218,0.130782,1.202551,180,49,-1, abandoned,0,0,0.406782710623
29629,1000329,1,1922,1474,448,0.766909,0.233091,0.766909,403,45,1925,1476,449,0.766753,0.233247,0.766753,404,45,-1, merged,1,0,0.625145558415
29638,1000110,2,23,22,1,0.956522,0.043478,1.956522,0,1,24,22,2,0.916667,0.083333,1.666667,1,1,1, abandoned,1,1,0.587939698492
29638,1000140,1,3,3,0,1,0,1,0,0,4,3,1,0.75,0.25,0.75,1,0,1, abandoned,1,1,0.53125
29650,1000130,5,214,179,35,0.836449,0.163551,3.703789,26,9,215,180,35,0.837209,0.162791,3.75611,26,9,-1, abandoned,0,0,0
29650,1000327,2,606,474,132,0.782178,0.217822,1.485882,101,31,607,475,132,0.782537,0.217463,1.50981,101,31,-1, abandoned,0,0,0
29652,1000014,2,1308,1118,190,0.85474,0.14526,1.60474,177,13,1309,1119,190,0.854851,0.145149,1.640565,177,13,1, merged,0,0,0.00128638224571
29658,1000007,2,733,613,120,0.836289,0.163711,1.686219,102,18,736,614,122,0.834239,0.165761,1.681792,104,18,1, merged,1,1,0.081285553802
29658,1000009,1,713,606,107,0.84993,0.15007,0.84993,99,8,715,606,109,0.847552,0.152448,0.847552,101,8,1, merged,1,1,0.0778598478158
29660,1000009,1,716,607,109,0.847765,0.152235,0.847765,101,8,717,608,109,0.847978,0.152022,0.847978,101,8,1, merged,0,0,0.98621135659
29660,1000015,2,1310,1197,113,0.91374,0.08626,1.761506,101,12,1311,1198,113,0.913806,0.086194,1.761784,101,12,1, merged,0,0,0.918108145203
29661,1000004,2,1758,1529,229,0.869738,0.130262,1.636457,180,49,1759,1530,229,0.869812,0.130188,1.636652,180,49,1, merged,0,0,0.0250623476531
29661,1000329,1,1929,1479,450,0.766719,0.233281,0.766719,405,45,1930,1480,450,0.766839,0.233161,0.766839,405,45,1, merged,0,0,0.00854348884631
29662,1000004,2,1759,1530,229,0.869812,0.130188,1.636652,180,49,1760,1531,229,0.869886,0.130114,1.636846,180,49,1, merged,0,0,0.00252953830955
29662,1000329,1,1930,1480,450,0.766839,0.233161,0.766839,405,45,1931,1481,450,0.76696,0.23304,0.76696,405,45,1, merged,0,0,0.000876305190041
29683,1000007,1,736,614,122,0.834239,0.165761,0.834239,104,18,740,617,123,0.833784,0.166216,0.833784,105,18,-1, merged,1,0,0.00695161381043
29683,1000009,2,717,608,109,0.847978,0.152022,1.682217,101,8,718,609,109,0.848189,0.151811,1.681973,101,8,-1, merged,0,0,0.00674418000997
29688,1000118,2,729,644,85,0.883402,0.116598,1.573324,79,6,732,645,87,0.881148,0.118852,1.557839,81,6,1, merged,1,1,0.045188984181
29691,1000014,1,1309,1119,190,0.854851,0.145149,0.854851,177,13,1311,1119,192,0.853547,0.146453,0.853547,179,13,1, merged,1,1,0.00257133830122
29691,1000063,3,2096,1866,230,0.890267,0.109733,2.495118,191,39,2097,1866,231,0.889843,0.110157,2.473119,192,39,1, merged,1,1,4.96948763896e-05
29700,1000328,1,561,406,155,0.723708,0.276292,0.723708,139,16,562,407,155,0.724199,0.275801,0.724199,139,16,-1, abandoned,0,0,0.217965575333
29710,1000004,1,1763,1534,229,0.870108,0.129892,0.870108,180,49,1765,1536,229,0.870255,0.129745,0.870255,180,49,-1, merged,0,0,0.0609096868023
29710,1000063,2,2097,1866,231,0.889843,0.110157,1.75995,192,39,2098,1867,231,0.889895,0.110105,1.76015,192,39,1, merged,0,0,0.00680046462802
29711,1000063,1,2098,1867,231,0.889895,0.110105,0.889895,192,39,2099,1868,231,0.889948,0.110052,0.889948,192,39,1, merged,0,0,0.0833421149655
29711,1000592,2,365,302,63,0.827397,0.172603,1.717292,42,21,366,303,63,0.827869,0.172131,1.717816,42,21,1, merged,0,0,0.0903122424119
29713,1000004,2,1765,1536,229,0.870255,0.129745,1.723802,180,49,1766,1537,229,0.870328,0.129672,1.723987,180,49,1, merged,0,0,0.413169999473
29713,1000014,1,1311,1119,192,0.853547,0.146453,0.853547,179,13,1312,1120,192,0.853659,0.146341,0.853659,179,13,1, merged,0,0,0.552385870056
29714,1000014,2,1312,1120,192,0.853659,0.146341,1.639373,179,13,1313,1121,192,0.85377,0.14623,1.65377,179,13,1, merged,0,0,0.00270722857097
29717,1000004,2,1766,1537,229,0.870328,0.129672,1.637409,180,49,1767,1538,229,0.870402,0.129598,1.637206,180,49,1, merged,0,0,0.0512921526853
29717,1000329,1,1932,1482,450,0.767081,0.232919,0.767081,405,45,1934,1483,451,0.766805,0.233195,0.766805,406,45,1, merged,1,1,0.0942643179104
29719,1000070,2,838,737,101,0.879475,0.120525,1.790765,84,17,839,738,101,0.879619,0.120381,1.791265,84,17,1, merged,0,0,0.885074181482
29720,1000070,2,839,738,101,0.879619,0.120381,1.791265,84,17,840,739,101,0.879762,0.120238,1.791762,84,17,1, merged,0,0,0.870489805523
29727,1000004,2,1767,1538,229,0.870402,0.129598,1.724172,180,49,1768,1539,229,0.870475,0.129525,1.723819,180,49,-1, merged,0,0,0.373053802884
29727,1000014,1,1313,1121,192,0.85377,0.14623,0.85377,179,13,1316,1123,193,0.853343,0.146657,0.853343,180,13,1, merged,1,1,0.610832934736
29732,1000105,1,358,287,71,0.801676,0.198324,0.801676,63,8,359,288,71,0.802228,0.197772,0.802228,63,8,1, merged,0,0,0.391759261801
29732,1000329,2,1934,1483,451,0.766805,0.233195,1.568481,406,45,1935,1484,451,0.766925,0.233075,1.569153,406,45,1, merged,0,0,0.331369989536
29741,1000110,2,26,24,2,0.923077,0.076923,1.760286,1,1,27,25,2,0.925926,0.074074,1.759259,1,1,1, merged,0,0,0
29741,1000130,1,215,180,35,0.837209,0.162791,0.837209,26,9,216,180,36,0.833333,0.166667,0.833333,27,9,1, merged,1,1,0
29743,1000004,2,1768,1539,229,0.870475,0.129525,1.70493,180,49,1769,1540,229,0.870548,0.129452,1.705226,180,49,1, merged,0,0,0.365434973253
29743,1000007,1,743,620,123,0.834455,0.165545,0.834455,105,18,744,621,123,0.834677,0.165323,0.834677,105,18,1, merged,0,0,0.652756217514
29754,1000004,2,1769,1540,229,0.870548,0.129452,1.707418,180,49,1770,1541,229,0.870621,0.129379,1.707708,180,49,1, merged,0,0,0.0146758018481
29754,1000007,1,754,631,123,0.83687,0.16313,0.83687,105,18,755,632,123,0.837086,0.162914,0.837086,105,18,1, merged,0,0,0.00497077713712
29755,1000004,2,1770,1541,229,0.870621,0.129379,1.707708,180,49,1771,1542,229,0.870695,0.129305,1.70689,180,49,1, merged,0,0,0.0147366430154
29755,1000007,1,755,632,123,0.837086,0.162914,0.837086,105,18,757,633,124,0.836196,0.163804,0.836196,106,18,1, merged,1,1,0.00509861923953
29759,1000004,2,1771,1542,229,0.870695,0.129305,1.707537,180,49,1772,1543,229,0.870767,0.129233,1.707824,180,49,1, merged,0,0,0.0929349864024
29759,1000007,1,760,636,124,0.836842,0.163158,0.836842,106,18,761,637,124,0.837057,0.162943,0.837057,106,18,1, merged,0,0,0.165587980833
29763,1000007,1,764,640,124,0.837696,0.162304,0.837696,106,18,765,641,124,0.837908,0.162092,0.837908,106,18,1, merged,0,0,0.332747785092
29763,1000009,2,718,609,109,0.848189,0.151811,1.685886,101,8,719,610,109,0.848401,0.151599,1.686309,101,8,1, merged,0,0,0.298697291744
29765,1000004,2,1772,1543,229,0.870767,0.129233,1.708888,180,49,1773,1544,229,0.87084,0.12916,1.709172,180,49,1, merged,0,0,0.124875745381
29765,1000007,1,766,642,124,0.83812,0.16188,0.83812,106,18,767,643,124,0.838331,0.161669,0.838331,106,18,1, merged,0,0,0.22240982293
29766,1000004,2,1773,1544,229,0.87084,0.12916,1.709172,180,49,1774,1545,229,0.870913,0.129087,1.709455,180,49,1, merged,0,0,0.187487001856
29766,1000007,1,767,643,124,0.838331,0.161669,0.838331,106,18,768,644,124,0.838542,0.161458,0.838542,106,18,1, merged,0,0,0.333907960598
29767,1000004,2,1774,1545,229,0.870913,0.129087,1.709455,180,49,1775,1546,229,0.870986,0.129014,1.709738,180,49,1, merged,0,0,0.125101796199
29767,1000007,1,768,644,124,0.838542,0.161458,0.838542,106,18,769,645,124,0.838752,0.161248,0.838752,106,18,1, merged,0,0,0.222798416081
29768,1000004,2,1775,1546,229,0.870986,0.129014,1.709738,180,49,1776,1547,229,0.871059,0.128941,1.71002,180,49,1, merged,0,0,0.187879275725
29768,1000007,1,769,645,124,0.838752,0.161248,0.838752,106,18,770,646,124,0.838961,0.161039,0.838961,106,18,1, merged,0,0,0.334595947504
29769,1000004,2,1776,1547,229,0.871059,0.128941,1.71002,180,49,1777,1548,229,0.871131,0.128869,1.710301,180,49,1, merged,0,0,0.0937553992215
29769,1000007,1,770,646,124,0.838961,0.161039,0.838961,106,18,771,647,124,0.83917,0.16083,0.83917,106,18,1, merged,0,0,0.166928594583
29773,1000004,2,1777,1548,229,0.871131,0.128869,1.709841,180,49,1778,1549,229,0.871204,0.128796,1.710121,180,49,1, merged,0,0,0.377763377636
29773,1000007,1,775,650,125,0.83871,0.16129,0.83871,107,18,776,651,125,0.838918,0.161082,0.838918,107,18,1, merged,0,0,0.672679245067
29781,1000004,2,1778,1549,229,0.871204,0.128796,1.711561,180,49,1779,1550,229,0.871276,0.128724,1.711837,180,49,1, merged,0,0,0.379982095053
29781,1000007,1,783,658,125,0.840358,0.159642,0.840358,107,18,784,659,125,0.840561,0.159439,0.840561,107,18,1, merged,0,0,0.676637870825
29782,1000004,2,1779,1550,229,0.871276,0.128724,1.711837,180,49,1780,1551,229,0.871348,0.128652,1.712113,180,49,1, merged,0,0,0.0946527698763
29782,1000007,1,784,659,125,0.840561,0.159439,0.840561,107,18,785,660,125,0.840764,0.159236,0.840764,107,18,1, merged,0,0,0.168475543331
29786,1000004,2,1780,1551,229,0.871348,0.128652,1.711652,180,49,1781,1552,229,0.871421,0.128579,1.711927,180,49,1, merged,0,0,0.0541820301323
29786,1000007,1,789,663,126,0.840304,0.159696,0.840304,107,19,790,664,126,0.840506,0.159494,0.840506,107,19,1, merged,0,0,0.0963787778079
29787,1000004,2,1781,1552,229,0.871421,0.128579,1.711927,180,49,1782,1553,229,0.871493,0.128507,1.712201,180,49,1, merged,0,0,0.126691425983
29787,1000007,1,790,664,126,0.840506,0.159494,0.840506,107,19,791,665,126,0.840708,0.159292,0.840708,107,19,1, merged,0,0,0.225329707402
29789,1000004,2,1782,1553,229,0.871493,0.128507,1.712402,180,49,1783,1554,229,0.871565,0.128435,1.712674,180,49,1, merged,0,0,0.383793094472
29789,1000007,1,792,666,126,0.840909,0.159091,0.840909,107,19,793,667,126,0.84111,0.15889,0.84111,107,19,1, merged,0,0,0.683196382208
29790,1000004,2,1783,1554,229,0.871565,0.128435,1.712674,180,49,1784,1555,229,0.871637,0.128363,1.712947,180,49,1, merged,0,0,0.191321298611
29790,1000007,1,793,667,126,0.84111,0.15889,0.84111,107,19,794,668,126,0.84131,0.15869,0.84131,107,19,1, merged,0,0,0.340454445628
29797,1000004,2,1784,1555,229,0.871637,0.128363,1.714137,180,49,1786,1557,229,0.871781,0.128219,1.713426,180,49,-1, merged,0,0,0.0958416501227
29797,1000007,1,800,674,126,0.8425,0.1575,0.8425,107,19,802,675,127,0.841646,0.158354,0.841646,108,19,1, merged,1,1,0.17046578892
29799,1000004,2,1786,1557,229,0.871781,0.128219,1.713624,180,49,1787,1558,229,0.871852,0.128148,1.712846,180,49,1, merged,0,0,0.387185230759
29799,1000007,1,803,676,127,0.841843,0.158157,0.841843,108,19,805,677,128,0.840994,0.159006,0.840994,109,19,1, merged,1,1,0.689056382591
29800,1000004,2,1787,1558,229,0.871852,0.128148,1.712846,180,49,1788,1559,229,0.871924,0.128076,1.712073,180,49,1, merged,0,0,0.192752757217
29800,1000007,1,805,677,128,0.840994,0.159006,0.840994,109,19,807,678,129,0.840149,0.159851,0.840149,110,19,1, merged,1,1,0.342864651423
29802,1000004,2,1788,1559,229,0.871924,0.128076,1.711232,180,49,1789,1560,229,0.871996,0.128004,1.710467,180,49,1, merged,0,0,0.388068383621
29802,1000007,1,809,679,130,0.839308,0.160692,0.839308,111,19,811,680,131,0.838471,0.161529,0.838471,112,19,1, merged,1,1,0.690615527233
29803,1000004,2,1789,1560,229,0.871996,0.128004,1.710467,180,49,1790,1561,229,0.872067,0.127933,1.709705,180,49,1, merged,0,0,0.388287394754
29803,1000007,1,811,680,131,0.838471,0.161529,0.838471,112,19,813,681,132,0.837638,0.162362,0.837638,113,19,1, merged,1,1,0.691010724806
29804,1000004,2,1790,1561,229,0.872067,0.127933,1.709705,180,49,1791,1562,229,0.872138,0.127862,1.708948,180,49,1, merged,0,0,0.38850637933
29804,1000007,1,813,681,132,0.837638,0.162362,0.837638,113,19,815,682,133,0.83681,0.16319,0.83681,114,19,1, merged,1,1,0.691405828003
29807,1000004,2,1791,1562,229,0.872138,0.127862,1.709348,180,49,1793,1564,229,0.872281,0.127719,1.708667,180,49,-1, merged,0,0,0.0427985457118
29807,1000007,1,817,684,133,0.837209,0.162791,0.837209,114,19,819,685,134,0.836386,0.163614,0.836386,115,19,1, merged,1,1,0.0760810733313
29808,1000004,3,1793,1564,229,0.872281,0.127719,2.557067,180,49,1795,1565,230,0.871866,0.128134,2.554867,180,50,-1, merged,1,0,0.19482639836
29808,1000007,1,819,685,134,0.836386,0.163614,0.836386,115,19,821,686,135,0.835566,0.164434,0.835566,116,19,1, merged,1,1,0.346619538751
29808,1000009,2,719,610,109,0.848401,0.151599,1.684786,101,8,721,611,110,0.847434,0.152566,1.683001,102,8,-1, merged,1,0,0.298875836923
29809,1000004,2,1795,1565,230,0.871866,0.128134,1.707433,180,50,1796,1566,230,0.871938,0.128062,1.707704,180,50,1, merged,0,0,0.193090642543
29809,1000007,1,821,686,135,0.835566,0.164434,0.835566,116,19,822,687,135,0.835766,0.164234,0.835766,116,19,1, merged,0,0,0.343153789799
29810,1000004,2,1796,1566,230,0.871938,0.128062,1.707704,180,50,1797,1567,230,0.872009,0.127991,1.70696,180,50,1, merged,0,0,0.0221325017017
29810,1000007,1,822,687,135,0.835766,0.164234,0.835766,116,19,824,688,136,0.834951,0.165049,0.834951,117,19,1, merged,1,1,0.00846005246262
29812,1000004,2,1797,1567,230,0.872009,0.127991,1.706149,180,50,1798,1568,230,0.87208,0.12792,1.705413,180,50,1, merged,0,0,0.0971193841097
29812,1000007,1,826,689,137,0.83414,0.16586,0.83414,118,19,828,690,138,0.833333,0.166667,0.833333,119,19,1, merged,1,1,0.172623159982
29814,1000004,2,1798,1568,230,0.87208,0.12792,1.705614,180,50,1799,1569,230,0.872151,0.127849,1.705886,180,50,1, merged,0,0,0.38638698186
29814,1000007,1,829,691,138,0.833534,0.166466,0.833534,119,19,830,692,138,0.833735,0.166265,0.833735,119,19,1, merged,0,0,0.686372419029
29817,1000592,3,366,303,63,0.827869,0.172131,2.263481,42,21,367,304,63,0.828338,0.171662,2.286213,42,21,1, merged,0,0,0.193485634476
29818,1000121,4,1304,1083,221,0.830521,0.169479,3.014234,208,13,1305,1083,222,0.829885,0.170115,3.016391,209,13,1, abandoned,1,1,0.644941473966
29818,1000329,1,1936,1485,451,0.767045,0.232955,0.767045,406,45,1937,1485,452,0.766649,0.233351,0.766649,407,45,1, abandoned,1,1,0.811113029605
29820,1000009,2,721,611,110,0.847434,0.152566,1.771677,102,8,722,612,110,0.847645,0.152355,1.773019,102,8,1, merged,0,0,1.26649461485
29822,1000009,2,722,612,110,0.847645,0.152355,1.614295,102,8,723,613,110,0.847856,0.152144,1.614626,102,8,1, merged,0,0,0.259127843064
29822,1000329,1,1937,1485,452,0.766649,0.233351,0.766649,407,45,1938,1486,452,0.76677,0.23323,0.76677,407,45,1, merged,0,0,0.118898976811
29825,1000004,1,1801,1571,230,0.872293,0.127707,0.872293,180,50,1802,1572,230,0.872364,0.127636,0.872364,180,50,-1, abandoned,0,0,0
29825,1000120,2,664,538,126,0.810241,0.189759,1.682534,113,13,666,540,126,0.810811,0.189189,1.683175,113,13,-1, abandoned,0,0,0
29831,1000004,1,1802,1572,230,0.872364,0.127636,0.872364,180,50,1803,1573,230,0.872435,0.127565,0.872435,180,50,-1, abandoned,0,0,0.000736703468267
29835,1000004,1,1803,1573,230,0.872435,0.127565,0.872435,180,50,1804,1574,230,0.872506,0.127494,0.872506,180,50,1, merged,0,0,0.311904761905
29835,1000014,2,1320,1127,193,0.853788,0.146212,1.726223,180,13,1321,1128,193,0.853899,0.146101,1.726404,180,13,1, merged,0,0,0.474090057381
29836,1000004,2,1804,1574,230,0.872506,0.127494,1.797879,180,50,1805,1575,230,0.872576,0.127424,1.799047,180,50,1, merged,0,0,0.378900201506
29841,1000328,1,564,409,155,0.725177,0.274823,0.725177,139,16,566,410,156,0.724382,0.275618,0.724382,139,17,-1, merged,1,0,0
29845,1000009,2,725,615,110,0.848276,0.151724,1.52196,102,8,726,616,110,0.848485,0.151515,1.525568,102,8,1, merged,0,0,0.234134670484
29845,1000534,1,95,64,31,0.673684,0.326316,0.673684,29,2,96,65,31,0.677083,0.322917,0.677083,29,2,-1, merged,0,0,0.229158318508
29847,1000004,2,1805,1575,230,0.872576,0.127424,1.762576,180,50,1807,1577,230,0.872717,0.127283,1.76277,180,50,-1, abandoned,0,0,0.0599002849003
29847,1000063,1,2100,1869,231,0.89,0.11,0.89,192,39,2101,1870,231,0.890052,0.109948,0.890052,192,39,-1, abandoned,0,0,0.00683728831456
29849,1000063,1,2101,1870,231,0.890052,0.109948,0.890052,192,39,2105,1874,231,0.890261,0.109739,0.890261,192,39,-1, merged,0,0,0.00401243294422
29854,1000063,1,2106,1875,231,0.890313,0.109687,0.890313,192,39,2108,1877,231,0.890417,0.109583,0.890417,192,39,-1, merged,0,0,0.323903983213
29859,1000063,3,2108,1877,231,0.890417,0.109583,2.750549,192,39,2110,1879,231,0.890521,0.109479,2.74596,192,39,-1, merged,0,0,0.000859045886394
29869,1000007,2,830,692,138,0.833735,0.166265,1.68222,119,19,831,693,138,0.833935,0.166065,1.682628,119,19,-1, abandoned,0,0,0.0715256039975
29869,1000009,1,726,616,110,0.848485,0.151515,0.848485,102,8,727,617,110,0.848693,0.151307,0.848693,102,8,-1, abandoned,0,0,0.0625434548105
29877,1000328,1,567,411,156,0.724868,0.275132,0.724868,139,17,569,412,157,0.724077,0.275923,0.724077,140,17,1, merged,1,1,0.252454738089
29877,1000592,2,367,304,63,0.828338,0.171662,1.553206,42,21,368,305,63,0.828804,0.171196,1.552882,42,21,1, merged,0,0,0.19811286913
29889,1000124,2,472,436,36,0.923729,0.076271,1.690739,32,4,473,437,36,0.92389,0.07611,1.690625,32,4,-1, merged,0,0,0.0777512751732
29889,1000329,1,1940,1488,452,0.76701,0.23299,0.76701,407,45,1942,1489,453,0.766735,0.233265,0.766735,408,45,1, merged,1,1,0.14877814956
29899,1000105,2,359,288,71,0.802228,0.197772,1.593474,63,8,360,289,71,0.802778,0.197222,1.594724,63,8,1, merged,0,0,0.514460108605
29900,1000070,1,841,740,101,0.879905,0.120095,0.879905,84,17,842,740,102,0.87886,0.12114,0.87886,85,17,1, abandoned,1,1,0.0450836451126
29902,1000329,3,1946,1491,455,0.766187,0.233813,1.989615,410,45,1949,1493,456,0.766034,0.233966,1.982852,411,45,-1, merged,1,0,0.837137463497
29903,1000105,3,360,289,71,0.802778,0.197222,2.318875,63,8,361,290,71,0.803324,0.196676,2.321419,63,8,1, merged,0,0,0.36234099865
29913,1000063,2,2112,1881,231,0.890625,0.109375,1.701436,192,39,2113,1882,231,0.890677,0.109323,1.701771,192,39,1, merged,0,0,0.00254524009064
29913,1000120,1,666,540,126,0.810811,0.189189,0.810811,113,13,667,541,126,0.811094,0.188906,0.811094,113,13,1, merged,0,0,0.0235115661737
29914,1000004,1,1808,1578,230,0.872788,0.127212,0.872788,180,50,1809,1579,230,0.872858,0.127142,0.872858,180,50,-1, merged,0,0,0.002886002886
29914,1000329,2,1950,1493,457,0.765641,0.234359,1.638429,411,46,1952,1495,457,0.765881,0.234119,1.638739,411,46,-1, merged,0,0,0.00152052711607
29929,1000014,3,1325,1132,193,0.85434,0.14566,2.605524,180,13,1326,1133,193,0.854449,0.145551,2.606268,180,13,-1, merged,0,0,0.0611806261088
29929,1000063,1,2113,1882,231,0.890677,0.109323,0.890677,192,39,2115,1883,232,0.890307,0.109693,0.890307,193,39,-1, merged,1,0,0.107207378674
29930,1000110,2,29,26,3,0.896552,0.103448,0.896552,2,1,30,27,3,0.9,0.1,1.4,2,1,-1, abandoned,0,0,0.00925194960821
29931,1000118,2,736,649,87,0.881793,0.118207,1.381793,81,6,738,649,89,0.879404,0.120596,1.212737,83,6,1, merged,1,1,0.334626060028
29931,1000130,3,217,181,36,0.834101,0.165899,2.215895,27,9,219,182,37,0.83105,0.16895,2.043787,28,9,1, merged,1,1,0.640254063113
29938,1000014,1,1326,1133,193,0.854449,0.145551,0.854449,180,13,1328,1135,193,0.854669,0.145331,0.854669,180,13,-1, merged,0,0,0.606788921045
29938,1000070,2,843,740,103,0.877817,0.122183,1.732267,86,17,844,741,103,0.877962,0.122038,1.732631,86,17,1, merged,0,0,0.735874103639
29953,1000091,2,372,286,86,0.768817,0.231183,1.518817,72,14,373,286,87,0.766756,0.233244,1.508861,73,14,1, merged,1,1,0.572480969789
29953,1000328,3,569,412,157,0.724077,0.275923,2.242895,140,17,570,413,157,0.724561,0.275439,2.233423,140,17,1, merged,0,0,0.908104395604
29955,1000004,1,1818,1588,230,0.873487,0.126513,0.873487,180,50,1820,1589,231,0.873077,0.126923,0.873077,181,50,-1, abandoned,1,0,0.116160845164
29955,1000105,2,361,290,71,0.803324,0.196676,1.676811,63,8,362,290,72,0.801105,0.198895,1.674182,64,8,1, abandoned,1,1,0.151274639713
29956,1000014,3,1330,1137,193,0.854887,0.145113,2.519516,180,13,1331,1137,194,0.854245,0.145755,2.512625,181,13,1, abandoned,1,1,0.222817731102
29956,1000070,1,844,741,103,0.877962,0.122038,0.877962,86,17,845,741,104,0.876923,0.123077,0.876923,87,17,1, abandoned,1,1,0.259013696756
29956,1000105,4,362,290,72,0.801105,0.198895,3.320621,64,8,363,290,73,0.798898,0.201102,3.311523,65,8,1, abandoned,1,1,0.173210105938
29957,1000063,2,2116,1884,232,0.890359,0.109641,1.308727,193,39,2117,1885,232,0.890411,0.109589,1.314653,193,39,1, merged,0,0,0.332643460068
29961,1000063,1,2117,1885,232,0.890411,0.109589,0.890411,193,39,2118,1886,232,0.890463,0.109537,0.890463,193,39,1, merged,0,0,0.314180822643
29970,1000118,3,742,652,90,0.878706,0.121294,2.537562,84,6,743,653,90,0.878869,0.121131,2.515847,84,6,1, merged,0,0,0.0689407909629
29972,1000023,1,337,296,41,0.878338,0.121662,0.878338,38,3,338,297,41,0.878698,0.121302,0.878698,38,3,1, merged,0,0,0.00022099079497
29994,1000328,2,570,413,157,0.724561,0.275439,1.535035,140,17,571,414,157,0.725044,0.274956,1.535989,140,17,1, merged,0,0,0.0483861550689
30008,1000014,1,1331,1137,194,0.854245,0.145755,0.854245,181,13,1332,1138,194,0.854354,0.145646,0.854354,181,13,1, merged,0,0,0.00852146967685
30014,1000329,2,1953,1496,457,0.766001,0.233999,1.317725,411,46,1954,1497,457,0.766121,0.233879,1.325443,411,46,1, merged,0,0,0.0240900261802
30016,1000014,1,1332,1138,194,0.854354,0.145646,0.854354,181,13,1333,1139,194,0.854464,0.145536,0.854464,181,13,1, merged,0,0,0.00179246084612
30018,1000014,1,1333,1139,194,0.854464,0.145536,0.854464,181,13,1334,1140,194,0.854573,0.145427,0.854573,181,13,1, merged,0,0,0.201742014369
30018,1000105,2,363,290,73,0.798898,0.201102,1.653362,65,8,364,291,73,0.799451,0.200549,1.654023,65,8,1, merged,0,0,0.218156805713
30029,1000329,1,1954,1497,457,0.766121,0.233879,0.766121,411,46,1955,1498,457,0.76624,0.23376,0.76624,411,46,1, merged,0,0,0.221449168591
30030,1000592,2,368,305,63,0.828804,0.171196,1.662138,42,21,369,306,63,0.829268,0.170732,1.666478,42,21,1, merged,0,0,0.510110913052
30031,1000592,2,369,306,63,0.829268,0.170732,1.666478,42,21,370,307,63,0.82973,0.17027,1.670639,42,21,1, merged,0,0,0.512183293745
30035,1000014,1,1335,1141,194,0.854682,0.145318,0.854682,181,13,1336,1142,194,0.85479,0.14521,0.85479,181,13,-1, merged,0,0,0.206964950233
30035,1000120,2,667,541,126,0.811094,0.188906,1.665776,113,13,668,542,126,0.811377,0.188623,1.666168,113,13,1, merged,0,0,0.0883250736192
30038,1000004,1,1823,1592,231,0.873286,0.126714,0.873286,181,50,1824,1593,231,0.873355,0.126645,0.873355,181,50,-1, abandoned,0,0,0.0474502973152
30039,1000004,2,1824,1593,231,0.873355,0.126645,1.684733,181,50,1825,1594,231,0.873425,0.126575,1.685084,181,50,1, merged,0,0,0.050441012441
30039,1000120,1,668,542,126,0.811377,0.188623,0.811377,113,13,669,543,126,0.811659,0.188341,0.811659,113,13,1, merged,0,0,0.199316138065
30040,1000329,1,1955,1498,457,0.76624,0.23376,0.76624,411,46,1956,1499,457,0.76636,0.23364,0.76636,411,46,1, merged,0,0,0.0436594691472
30041,1000014,1,1336,1142,194,0.85479,0.14521,0.85479,181,13,1337,1143,194,0.854899,0.145101,0.854899,181,13,-1, abandoned,0,0,0
30041,1000120,2,669,543,126,0.811659,0.188341,1.66645,113,13,670,544,126,0.81194,0.18806,1.666839,113,13,-1, abandoned,0,0,0
30042,1000329,2,1956,1499,457,0.76636,0.23364,1.425451,411,46,1957,1500,457,0.766479,0.233521,1.433146,411,46,1, merged,0,0,0.214056631641
30056,1000120,2,670,544,126,0.81194,0.18806,1.587185,113,13,671,545,126,0.812221,0.187779,1.588195,113,13,1, merged,0,0,0.0266064257028
30063,1000023,1,338,297,41,0.878698,0.121302,0.878698,38,3,339,298,41,0.879056,0.120944,0.879056,38,3,1, merged,0,0,6.79710248608e-05
30064,1000023,1,339,298,41,0.879056,0.120944,0.879056,38,3,340,299,41,0.879412,0.120588,0.879412,38,3,1, merged,0,0,0
30064,1000063,3,2120,1888,232,0.890566,0.109434,2.627273,193,39,2121,1889,232,0.890618,0.109382,2.628185,193,39,1, merged,0,0,3.72210745724e-05
30066,1000004,1,1827,1596,231,0.873563,0.126437,0.873563,181,50,1828,1597,231,0.873632,0.126368,0.873632,181,50,1, merged,0,0,0.185060447539
30084,1000592,2,370,307,63,0.82973,0.17027,1.670639,42,21,371,308,63,0.830189,0.169811,1.674633,42,21,1, merged,0,0,0.0412450472724
30090,1000014,1,1338,1144,194,0.855007,0.144993,0.855007,181,13,1339,1145,194,0.855116,0.144884,0.855116,181,13,1, merged,0,0,0.20740299434
30090,1000023,2,340,299,41,0.879412,0.120588,1.734419,38,3,341,300,41,0.879765,0.120235,1.734881,38,3,1, merged,0,0,0.663389657771
30093,1000091,3,373,286,87,0.766756,0.233244,2.253705,73,14,374,287,87,0.76738,0.23262,2.268414,73,14,-1, abandoned,0,0,0
30093,1000328,1,571,414,157,0.725044,0.274956,0.725044,140,17,572,415,157,0.725524,0.274476,0.725524,140,17,-1, abandoned,0,0,0
30094,1000105,2,365,292,73,0.8,0.2,1.712351,65,8,366,292,74,0.797814,0.202186,1.706544,66,8,1, abandoned,1,1,0.327326717913
30096,1000043,2,350,287,63,0.82,0.18,1.729091,54,9,351,288,63,0.820513,0.179487,1.702866,54,9,1, merged,0,0,0.183010197362
30096,1000110,1,33,30,3,0.909091,0.090909,0.909091,2,1,34,30,4,0.882353,0.117647,0.882353,3,1,1, merged,1,1,0.172397767378
30100,1000014,4,1340,1146,194,0.855224,0.144776,2.190199,181,13,1341,1147,194,0.855332,0.144668,3.204653,181,13,1, merged,0,0,0.592466803397
30111,1000004,2,1829,1598,231,0.873701,0.126299,1.649212,181,50,1830,1599,231,0.87377,0.12623,1.65377,181,50,-1, merged,0,0,0.474345214333
30111,1000121,7,1305,1083,222,0.829885,0.170115,5.496493,209,13,1306,1084,222,0.830015,0.169985,5.504044,209,13,1, merged,0,0,0.681666526543
30111,1000329,4,1957,1500,457,0.766479,0.233521,3.092964,411,46,1958,1500,458,0.766088,0.233912,3.098591,411,47,-1, merged,1,1,0.868483524211
30111,1000592,6,371,308,63,0.830189,0.169811,4.666608,42,21,372,309,63,0.830645,0.169355,4.674028,42,21,1, merged,0,0,0.71509202972
30114,1000108,1,18,15,3,0.833333,0.166667,0.833333,3,0,20,15,5,0.75,0.25,0.75,3,2,-1, merged,1,1,0.213095746764
30114,1000140,2,4,3,1,0.75,0.25,1.583333,1,0,5,4,1,0.8,0.2,1.55,1,0,1, merged,0,0,0.454942491319
30122,1000118,1,744,654,90,0.879032,0.120968,0.879032,84,6,745,655,90,0.879195,0.120805,0.879195,84,6,1, merged,0,0,0.00102517478482
30133,1000004,4,1830,1599,231,0.87377,0.12623,3.471855,181,50,1831,1600,231,0.873839,0.126161,3.473442,181,50,1, merged,0,0,0.0632968107612
30133,1000014,3,1342,1148,194,0.85544,0.14456,2.598084,181,13,1343,1149,194,0.855547,0.144453,2.599602,181,13,1, merged,0,0,0.00593267108168
30167,1000118,2,749,658,91,0.878505,0.121495,1.702829,85,6,750,659,91,0.878667,0.121333,1.703779,85,6,1, merged,0,0,0.000287795722993
30167,1000130,1,222,183,39,0.824324,0.175676,0.824324,30,9,223,184,39,0.825112,0.174888,0.825112,30,9,-1, merged,0,0,0.000350831638148
30172,1000004,2,1835,1604,231,0.874114,0.125886,1.70685,181,50,1839,1608,231,0.874388,0.125612,1.706331,181,50,-1, merged,0,0,0.0786221883631
30172,1000007,1,837,697,140,0.832736,0.167264,0.832736,121,19,839,698,141,0.831943,0.168057,0.831943,122,19,1, merged,1,1,0.139401658962
30177,1000011,2,461,428,33,0.928416,0.071584,1.58059,30,3,462,429,33,0.928571,0.071429,1.595238,30,3,-1, merged,0,0,0.420398587061
30184,1000004,2,1842,1611,231,0.874593,0.125407,1.76521,181,50,1843,1612,231,0.874661,0.125339,1.76533,181,50,-1, abandoned,0,0,0.380511812146
30184,1000063,1,2121,1889,232,0.890618,0.109382,0.890618,193,39,2122,1890,232,0.890669,0.109331,0.890669,193,39,-1, abandoned,0,0,0.276514991411
30185,1000014,1,1345,1151,194,0.855762,0.144238,0.855762,181,13,1346,1152,194,0.855869,0.144131,0.855869,181,13,1, merged,0,0,0.00656443071492
30186,1000014,1,1346,1152,194,0.855869,0.144131,0.855869,181,13,1347,1153,194,0.855976,0.144024,0.855976,181,13,1, merged,0,0,0.00700496414782
30191,1000014,1,1347,1153,194,0.855976,0.144024,0.855976,181,13,1349,1154,195,0.855448,0.144552,0.855448,182,13,1, merged,1,1,0.00148121744705
30201,1000110,2,35,31,4,0.885714,0.114286,1.731868,3,1,36,32,4,0.888889,0.111111,1.746032,3,1,1, merged,0,0,0.657258064516
30209,1000120,2,671,545,126,0.812221,0.187779,1.712221,113,13,672,546,126,0.8125,0.1875,1.721591,113,13,1, merged,0,0,0.00601051840721
30214,1000004,2,1844,1613,231,0.874729,0.125271,1.687229,181,50,1845,1614,231,0.874797,0.125203,1.687575,181,50,1, merged,0,0,0.00754473587693
30214,1000120,1,672,546,126,0.8125,0.1875,0.8125,113,13,673,547,126,0.812779,0.187221,0.812779,113,13,1, merged,0,0,0.0218204162577
30215,1000004,2,1845,1614,231,0.874797,0.125203,1.687575,181,50,1846,1615,231,0.874865,0.125135,1.687921,181,50,1, merged,0,0,0.0153155848041
30215,1000120,1,673,547,126,0.812779,0.187221,0.812779,113,13,674,548,126,0.813056,0.186944,0.813056,113,13,1, merged,0,0,0.0450281425891
30223,1000118,3,750,659,91,0.878667,0.121333,2.557253,85,6,751,660,91,0.878828,0.121172,2.562162,85,6,1, merged,0,0,0.167857643848
30229,1000014,1,1354,1158,196,0.855244,0.144756,0.855244,183,13,1356,1158,198,0.853982,0.146018,0.853982,185,13,1, merged,1,1,0
30229,1000329,4,1958,1500,458,0.766088,0.233912,3.151891,411,47,1959,1501,458,0.766207,0.233793,3.156411,411,47,1, merged,0,0,0.103869486789
30233,1000004,1,1848,1617,231,0.875,0.125,0.875,181,50,1850,1619,231,0.875135,0.124865,0.875135,181,50,-1, merged,0,0,0.0138273824347
30235,1000004,3,1850,1619,231,0.875135,0.124865,2.731975,181,50,1851,1620,231,0.875203,0.124797,2.732436,181,50,1, merged,0,0,0.0611881701144
30236,1000118,2,751,660,91,0.878828,0.121172,1.55552,85,6,752,661,91,0.878989,0.121011,1.558094,85,6,1, merged,0,0,0.0544462017067
30241,1000105,3,371,296,75,0.797844,0.202156,1.580178,66,9,372,296,76,0.795699,0.204301,1.573128,67,9,1, abandoned,1,1,0.0856750067699
30242,1000105,3,372,296,76,0.795699,0.204301,1.573128,67,9,373,296,77,0.793566,0.206434,1.566151,68,9,1, abandoned,1,1,0.269500859269
30243,1000105,3,373,296,77,0.793566,0.206434,1.566151,68,9,374,296,78,0.791444,0.208556,1.756876,69,9,1, abandoned,1,1,0.179908772729
30254,1000014,2,1356,1158,198,0.853982,0.146018,1.715684,185,13,1357,1159,198,0.85409,0.14591,1.716037,185,13,1, merged,0,0,0.0014782841479
30285,1000004,1,1852,1621,231,0.87527,0.12473,0.87527,181,50,1854,1623,231,0.875405,0.124595,0.875405,181,50,-1, abandoned,0,0,0.0476446355006
30291,1000004,3,1856,1625,231,0.875539,0.124461,2.145995,181,50,1857,1626,231,0.875606,0.124394,2.134183,181,50,-1, abandoned,0,0,0.376820205913
30299,1000009,2,733,623,110,0.849932,0.150068,1.474932,102,8,734,624,110,0.850136,0.149864,1.516803,102,8,1, merged,0,0,0.389981835463
30309,1000007,3,840,699,141,0.832143,0.167857,2.356419,122,19,842,701,141,0.832542,0.167458,2.358974,122,19,-1, abandoned,0,0,0
30309,1000009,2,744,633,111,0.850806,0.149194,1.524276,102,9,745,633,112,0.849664,0.150336,1.526432,103,9,1, abandoned,1,1,0
30309,1000534,1,98,66,32,0.673469,0.326531,0.673469,30,2,99,67,32,0.676768,0.323232,0.676768,30,2,-1, abandoned,0,0,0
30315,1000004,3,1858,1627,231,0.875673,0.124327,2.40899,181,50,1859,1628,231,0.87574,0.12426,2.401801,181,50,1, merged,0,0,0.487644266783
30315,1000329,2,1960,1502,458,0.766327,0.233673,1.533317,411,47,1961,1503,458,0.766446,0.233554,1.526061,411,47,1, merged,0,0,0.88879500007
30319,1000014,1,1362,1164,198,0.854626,0.145374,0.854626,185,13,1367,1167,200,0.853694,0.146306,0.853694,187,13,1, merged,1,1,0.0963659423521
30321,1000004,1,1859,1628,231,0.87574,0.12426,0.87574,181,50,1861,1629,232,0.875336,0.124664,0.875336,182,50,1, merged,1,1,0.0155112755041
30321,1000329,2,1961,1503,458,0.766446,0.233554,1.642185,411,47,1963,1505,458,0.766684,0.233316,1.642019,411,47,-1, merged,0,0,0.00453972257251
30333,1000329,3,1963,1505,458,0.766684,0.233316,2.209827,411,47,1965,1506,459,0.766412,0.233588,2.196715,412,47,1, merged,1,1,0.124850641258
30334,1000014,1,1374,1172,202,0.852984,0.147016,0.852984,189,13,1376,1173,203,0.852471,0.147529,0.852471,190,13,1, merged,1,1,0.195863810886
30336,1000004,1,1864,1632,232,0.875536,0.124464,0.875536,182,50,1866,1634,232,0.87567,0.12433,0.87567,182,50,-1, merged,0,0,0.0608456931583
30337,1000004,1,1866,1634,232,0.87567,0.12433,0.87567,182,50,1867,1635,232,0.875736,0.124264,0.875736,182,50,-1, merged,0,0,0.0251186801205
30337,1000328,2,572,415,157,0.725524,0.274476,1.601194,140,17,575,417,158,0.725217,0.274783,1.600954,141,17,-1, merged,1,0,0.0576848389875
30339,1000108,2,21,15,6,0.714286,0.285714,1.478571,4,2,22,16,6,0.727273,0.272727,1.491895,4,2,-1, merged,0,0,0.0413318045099
30359,1000004,2,1867,1635,232,0.875736,0.124264,1.710631,182,50,1868,1636,232,0.875803,0.124197,1.710891,182,50,1, merged,0,0,0.0456601397506
30359,1000007,1,854,713,141,0.834895,0.165105,0.834895,122,19,855,714,141,0.835088,0.164912,0.835088,122,19,1, merged,0,0,0.00777310194541
30361,1000004,2,1868,1636,232,0.875803,0.124197,1.711083,182,50,1869,1637,232,0.875869,0.124131,1.711342,182,50,1, merged,0,0,0.39444689777
30361,1000007,1,856,715,141,0.83528,0.16472,0.83528,122,19,857,716,141,0.835473,0.164527,0.835473,122,19,1, merged,0,0,0.699079023565
30362,1000004,2,1869,1637,232,0.875869,0.124131,1.711342,182,50,1870,1638,232,0.875936,0.124064,1.710627,182,50,-1, merged,0,0,0.389147935225
30362,1000007,1,857,716,141,0.835473,0.164527,0.835473,122,19,859,717,142,0.834692,0.165308,0.834692,123,19,1, merged,1,1,0.688796189585
30364,1000007,1,861,717,144,0.832753,0.167247,0.832753,125,19,863,717,146,0.830823,0.169177,0.830823,127,19,1, abandoned,1,1,0
30364,1000120,2,675,549,126,0.813333,0.186667,1.646086,113,13,676,549,127,0.81213,0.18787,1.642953,114,13,1, abandoned,1,1,0
30367,1000063,2,2145,1913,232,0.891841,0.108159,1.83865,193,39,2146,1914,232,0.891892,0.108108,1.83926,193,39,1, merged,0,0,0.280963081033
30370,1000007,1,863,717,146,0.830823,0.169177,0.830823,127,19,864,718,146,0.831019,0.168981,0.831019,127,19,-1, merged,0,0,0.645729603407
30370,1000015,5,1312,1199,113,0.913872,0.086128,3.524695,101,12,1314,1201,113,0.914003,0.085997,3.52348,101,12,1, merged,0,0,0.506156014009
30370,1000534,6,99,67,32,0.676768,0.323232,4.201462,30,2,100,68,32,0.68,0.32,4.20348,30,2,1, merged,0,0,0.595838666841
30376,1000120,2,676,549,127,0.81213,0.18787,1.49213,114,13,677,550,127,0.812408,0.187592,1.495576,114,13,1, merged,0,0,0
30376,1000534,1,100,68,32,0.68,0.32,0.68,30,2,101,69,32,0.683168,0.316832,0.683168,30,2,-1, merged,0,0,0
30386,1000132,1,200,179,21,0.895,0.105,0.895,16,5,201,180,21,0.895522,0.104478,0.895522,16,5,1, merged,0,0,0.370227499807
30393,1000004,2,1870,1638,232,0.875936,0.124064,1.642467,182,50,1871,1639,232,0.876002,0.123998,1.642381,182,50,-1, merged,0,0,0.244842433842
30393,1000121,3,1306,1084,222,0.830015,0.169985,2.472482,209,13,1308,1085,223,0.829511,0.170489,2.471892,209,14,-1, merged,1,0,0
30393,1000329,1,1966,1507,459,0.766531,0.233469,0.766531,412,47,1969,1509,460,0.766379,0.233621,0.766379,412,48,-1, merged,1,0,0.447040685626
30394,1000105,3,376,298,78,0.792553,0.207447,1.757985,69,9,377,298,79,0.790451,0.209549,1.717854,70,9,1, abandoned,1,1,0.514980309467
30395,1000105,3,377,298,79,0.790451,0.209549,1.717854,70,9,378,298,80,0.78836,0.21164,1.687314,71,9,1, abandoned,1,1,0.257897675815
30396,1000105,3,378,298,80,0.78836,0.21164,1.687314,71,9,379,298,81,0.78628,0.21372,1.662795,72,9,1, abandoned,1,1,0.18073042512
30397,1000105,3,379,298,81,0.78628,0.21372,1.662795,72,9,380,298,82,0.784211,0.215789,1.64231,73,9,1, abandoned,1,1,0.135728232521
30400,1000004,1,1871,1639,232,0.876002,0.123998,0.876002,182,50,1872,1639,233,0.875534,0.124466,0.875534,183,50,1, merged,1,1,0.489047666205
30400,1000124,2,478,442,36,0.924686,0.075314,1.800688,32,4,480,444,36,0.925,0.075,1.800534,32,4,-1, merged,0,0,0.468838267246
30405,1000004,1,1873,1640,233,0.875601,0.124399,0.875601,183,50,1875,1642,233,0.875733,0.124267,0.875733,183,50,-1, abandoned,0,0,0.0749025246734
30407,1000004,2,1875,1642,233,0.875733,0.124267,1.642112,183,50,1876,1643,233,0.8758,0.1242,1.642416,183,50,-1, abandoned,0,0,0
30407,1000329,1,1969,1509,460,0.766379,0.233621,0.766379,412,48,1971,1511,460,0.766616,0.233384,0.766616,412,48,-1, abandoned,0,0,0
30418,1000063,1,2146,1914,232,0.891892,0.108108,0.891892,193,39,2148,1916,232,0.891993,0.108007,0.891993,193,39,-1, abandoned,0,0,0.162971381619
30421,1000023,1,341,300,41,0.879765,0.120235,0.879765,38,3,342,301,41,0.880117,0.119883,0.880117,38,3,1, merged,0,0,0.00480390826435
30422,1000063,1,2150,1917,233,0.891628,0.108372,0.891628,194,39,2155,1922,233,0.891879,0.108121,0.891879,194,39,-1, merged,0,0,0.000330961914963
30438,1000105,1,380,298,82,0.784211,0.215789,0.784211,73,9,382,298,84,0.780105,0.219895,0.780105,75,9,1, merged,1,1,0.159416893391
30439,1000014,1,1379,1176,203,0.852792,0.147208,0.852792,190,13,1380,1177,203,0.852899,0.147101,0.852899,190,13,1, merged,0,0,0.607012395788
30446,1000105,3,382,298,84,0.780105,0.219895,1.638964,75,9,383,298,85,0.778068,0.221932,1.621351,76,9,1, abandoned,1,1,0.181652840934
30458,1000004,2,1879,1646,233,0.875998,0.124002,1.561587,183,50,1880,1647,233,0.876064,0.123936,1.56302,183,50,1, merged,0,0,0.00379506641366
30463,1000329,4,1973,1513,460,0.766853,0.233147,2.614182,412,48,1974,1514,460,0.766971,0.233029,2.595237,412,48,-1, merged,0,0,0.83561169889
30465,1000014,1,1384,1179,205,0.851879,0.148121,0.851879,192,13,1385,1180,205,0.851986,0.148014,0.851986,192,13,1, merged,0,0,0.00374246575342
30465,1000124,2,483,447,36,0.925466,0.074534,1.777344,32,4,484,448,36,0.92562,0.07438,1.777605,32,4,1, merged,0,0,0.24089010525
30466,1000329,3,1974,1514,460,0.766971,0.233029,2.028073,412,48,1975,1515,460,0.767089,0.232911,2.035873,412,48,1, merged,0,0,0.823688690127
30467,1000014,1,1385,1180,205,0.851986,0.148014,0.851986,192,13,1386,1181,205,0.852092,0.147908,0.852092,192,13,1, merged,0,0,0.295755794083
30467,1000105,3,383,298,85,0.778068,0.221932,2.380053,76,9,384,298,86,0.776042,0.223958,2.428134,76,10,-1, merged,1,1,0
30484,1000063,2,2160,1927,233,0.89213,0.10787,1.708946,194,39,2161,1928,233,0.89218,0.10782,1.709545,194,39,1, merged,0,0,0.00695623239546
30490,1000063,2,2165,1931,234,0.891917,0.108083,1.709282,194,40,2167,1932,235,0.891555,0.108445,1.709466,194,41,-1, merged,1,1,0.00428700465099
30498,1000004,3,1882,1649,233,0.876196,0.123804,2.620349,183,50,1883,1650,233,0.876261,0.123739,2.620111,183,50,1, merged,0,0,0.128678864402
30498,1000014,2,1387,1182,205,0.852199,0.147801,1.744153,192,13,1388,1183,205,0.852305,0.147695,1.74385,192,13,1, merged,0,0,0.168802771327
30498,1000063,1,2175,1940,235,0.891954,0.108046,0.891954,194,41,2176,1940,236,0.891544,0.108456,0.891544,195,41,1, merged,1,1,0.0958911076134
30500,1000004,3,1883,1650,233,0.876261,0.123739,2.620161,183,50,1884,1651,233,0.876327,0.123673,2.619923,183,50,1, merged,0,0,0.0465356724601
30500,1000014,2,1388,1183,205,0.852305,0.147695,1.743899,192,13,1389,1184,205,0.852412,0.147588,1.743596,192,13,1, merged,0,0,0.0624739883388
30500,1000063,1,2177,1941,236,0.891594,0.108406,0.891594,195,41,2178,1941,237,0.891185,0.108815,0.891185,196,41,1, merged,1,1,0.0348141087095
30507,1000023,1,342,301,41,0.880117,0.119883,0.880117,38,3,343,302,41,0.880466,0.119534,0.880466,38,3,1, merged,0,0,0.00291038157004
30519,1000063,2,2180,1943,237,0.891284,0.108716,1.83006,196,41,2181,1944,237,0.891334,0.108666,1.830728,196,41,1, merged,0,0,0.00193014364723
30532,1000014,2,1389,1184,205,0.852412,0.147588,1.743746,192,13,1390,1185,205,0.852518,0.147482,1.743952,192,13,1, merged,0,0,0.00587239156561
30532,1000063,1,2181,1944,237,0.891334,0.108666,0.891334,196,41,2183,1946,237,0.891434,0.108566,0.891434,196,41,-1, merged,0,0,0.00702562674956
30539,1000329,2,1977,1517,460,0.767324,0.232676,1.509898,412,48,1978,1518,460,0.767442,0.232558,1.511284,412,48,1, merged,0,0,0.377080827304
30543,1000004,1,1885,1652,233,0.876393,0.123607,0.876393,183,50,1886,1653,233,0.876458,0.123542,0.876458,183,50,1, merged,0,0,0.376375458953
30543,1000007,2,870,722,148,0.829885,0.170115,1.706278,129,19,871,723,148,0.83008,0.16992,1.706538,129,19,1, merged,0,0,0.716354524532
30548,1000004,2,1887,1654,233,0.876524,0.123476,1.587791,183,50,1888,1655,233,0.876589,0.123411,1.589876,183,50,-1, abandoned,0,0,0.0664350137974
30551,1000014,1,1392,1187,205,0.85273,0.14727,0.85273,192,13,1393,1188,205,0.852836,0.147164,0.852836,192,13,1, merged,0,0,0.606065982458
30554,1000105,3,384,298,86,0.776042,0.223958,2.409375,76,10,387,298,89,0.770026,0.229974,2.150978,79,10,1, abandoned,1,1,0
30556,1000592,3,372,309,63,0.830645,0.169355,2.422971,42,21,373,310,63,0.831099,0.168901,2.426248,42,21,-1, abandoned,0,0,0.0278886001263
30559,1000091,3,375,288,87,0.768,0.232,2.297347,73,14,376,289,87,0.768617,0.231383,2.315823,73,14,-1, abandoned,0,0,0
30559,1000329,2,1978,1518,460,0.767442,0.232558,1.529347,412,48,1981,1521,460,0.767794,0.232206,1.547206,412,48,-1, abandoned,0,0,0
30560,1000004,1,1893,1660,233,0.876915,0.123085,0.876915,183,50,1894,1661,233,0.87698,0.12302,0.87698,183,50,1, merged,0,0,0.19928973573
30562,1000592,2,373,310,63,0.831099,0.168901,1.675544,42,21,374,311,63,0.831551,0.168449,1.679377,42,21,1, merged,0,0,0.0820707070707
30568,1000328,1,594,429,165,0.722222,0.277778,0.722222,148,17,596,430,166,0.721477,0.278523,0.721477,149,17,1, merged,1,1,0.943459293395
30572,1000153,2,649,592,57,0.912173,0.087827,1.595341,43,14,651,594,57,0.912442,0.087558,1.598717,43,14,1, merged,0,0,0.372500429399
30572,1000534,1,101,69,32,0.683168,0.316832,0.683168,30,2,102,70,32,0.686275,0.313725,0.686275,30,2,1, merged,0,0,0.391251849649
30576,1000063,2,2184,1947,237,0.891484,0.108516,1.704719,196,41,2185,1948,237,0.891533,0.108467,1.705043,196,41,1, merged,0,0,0.00234175245029
30576,1000120,1,680,553,127,0.813235,0.186765,0.813235,114,13,681,554,127,0.81351,0.18649,0.81351,114,13,1, merged,0,0,0.0463920928353
30580,1000120,2,681,554,127,0.81351,0.18649,1.64506,114,13,682,555,127,0.813783,0.186217,1.645783,114,13,1, merged,0,0,0.047075021451
30580,1000592,1,374,311,63,0.831551,0.168449,0.831551,42,21,375,312,63,0.832,0.168,0.832,42,21,1, merged,0,0,0.0209891548241
30582,1000329,1,1982,1522,460,0.767911,0.232089,0.767911,412,48,1986,1525,461,0.767875,0.232125,0.767875,413,48,-1, merged,1,0,0.00889139239372
30582,1002169,2,0,0,0,0,0,0.767911,0,0,3,1,2,0.333333,0.666667,1.101208,2,0,1, merged,1,1,0
30587,1000118,2,760,669,91,0.880263,0.119737,1.7439,85,6,761,669,92,0.879106,0.120894,1.708894,86,6,1, merged,1,1,0.0142254984692
30600,1000592,2,375,312,63,0.832,0.168,1.575516,42,21,377,314,63,0.832891,0.167109,1.572146,42,21,1, merged,0,0,0.00223964165733
30607,1000063,2,2187,1950,237,0.891632,0.108368,1.727759,196,41,2188,1951,237,0.891682,0.108318,1.726561,196,41,1, merged,0,0,0.16068368921
30608,1000118,2,763,670,93,0.878113,0.121887,1.761446,87,6,764,671,93,0.878272,0.121728,1.76225,87,6,1, merged,0,0,0.00710218004696
30615,1000063,3,2188,1951,237,0.891682,0.108318,2.749826,196,41,2189,1952,237,0.891731,0.108269,2.750123,196,41,1, merged,0,0,0.368063119501
30630,1000063,1,2190,1953,237,0.891781,0.108219,0.891781,196,41,2191,1954,237,0.89183,0.10817,0.89183,196,41,1, merged,0,0,0.00681133352495
30630,1000592,2,377,314,63,0.832891,0.167109,1.724672,42,21,378,315,63,0.833333,0.166667,1.725164,42,21,1, merged,0,0,0.149412751678
30634,1000007,1,871,723,148,0.83008,0.16992,0.83008,129,19,872,724,148,0.830275,0.169725,0.830275,129,19,1, merged,0,0,0.000611936558924
30639,1000120,1,683,556,127,0.814056,0.185944,0.814056,114,13,684,557,127,0.814327,0.185673,0.814327,114,13,1, merged,0,0,0.00711078089303
30640,1000023,2,344,303,41,0.880814,0.119186,1.755814,38,3,345,304,41,0.881159,0.118841,1.763512,38,3,1, merged,0,0,0
30641,1000105,2,387,298,89,0.770026,0.229974,1.681316,79,10,390,299,91,0.766667,0.233333,1.680052,81,10,1, merged,1,1,0.0321293891672
30643,1000592,1,378,315,63,0.833333,0.166667,0.833333,42,21,379,315,64,0.831135,0.168865,0.831135,43,21,1, abandoned,1,1,0.00113467394613
30664,1000004,1,1898,1665,233,0.877239,0.122761,0.877239,183,50,1899,1666,233,0.877304,0.122696,0.877304,183,50,-1, abandoned,0,0,0.00260401427819
30666,1000063,2,2192,1955,237,0.89188,0.10812,1.822914,196,41,2195,1957,238,0.891572,0.108428,1.822885,197,41,-1, merged,1,0,0.160100572229
30674,1000012,2,359,310,49,0.86351,0.13649,1.660231,48,1,360,311,49,0.863889,0.136111,1.661275,48,1,1, merged,0,0,0
30691,1000014,2,1397,1192,205,0.853257,0.146743,1.591575,192,13,1398,1193,205,0.853362,0.146638,1.594103,192,13,1, merged,0,0,0.102893458726
30704,1000004,1,1900,1667,233,0.877368,0.122632,0.877368,183,50,1907,1674,233,0.877819,0.122181,0.877819,183,50,-1, merged,0,0,0.0476997720231
30704,1000329,2,1988,1527,461,0.768109,0.231891,1.645477,413,48,1991,1530,461,0.768458,0.231542,1.646277,413,48,-1, merged,0,0,0.0342601787488
30706,1000007,2,872,724,148,0.830275,0.169725,1.519596,129,19,873,725,148,0.83047,0.16953,1.513162,129,19,1, merged,0,0,0.644299925281
30706,1000534,1,103,71,32,0.68932,0.31068,0.68932,30,2,104,71,33,0.682692,0.317308,0.682692,31,2,1, merged,1,1,0.606314153439
30713,1000120,2,690,563,127,0.815942,0.184058,1.401656,114,13,691,564,127,0.816208,0.183792,1.407758,114,13,1, merged,0,0,0.150508166969
30715,1000004,1,1907,1674,233,0.877819,0.122181,0.877819,183,50,1912,1678,234,0.877615,0.122385,0.877615,184,50,-1, merged,1,0,0.150222164133
30715,1000014,2,1399,1194,205,0.853467,0.146533,1.731285,192,13,1400,1195,205,0.853571,0.146429,1.731186,192,13,1, merged,0,0,0.235187145257
30717,1000124,2,489,453,36,0.92638,0.07362,1.86638,32,4,490,454,36,0.926531,0.073469,1.867125,32,4,1, merged,0,0,0.0339295311407
30719,1000328,3,604,432,172,0.715232,0.284768,2.317206,155,17,605,433,172,0.715702,0.284298,2.322587,155,17,1, merged,0,0,0.1938057107
30720,1000014,3,1400,1195,205,0.853571,0.146429,2.585446,192,13,1401,1196,205,0.853676,0.146324,2.590878,192,13,1, merged,0,0,0.577545968883
30721,1000592,2,380,316,64,0.831579,0.168421,1.773327,43,21,381,317,64,0.832021,0.167979,1.774329,43,21,1, merged,0,0,0.389926335175
30722,1000592,2,381,317,64,0.832021,0.167979,1.774329,43,21,383,319,64,0.832898,0.167102,1.775755,43,21,1, merged,0,0,0.0843236875046
30732,1000004,1,1912,1678,234,0.877615,0.122385,0.877615,184,50,1913,1679,234,0.877679,0.122321,0.877679,184,50,-1, abandoned,0,0,0.381683589644
30732,1000007,3,874,726,148,0.830664,0.169336,2.537789,129,19,875,727,148,0.830857,0.169143,2.538177,129,19,-1, abandoned,0,0,0.642072890923
30732,1000121,2,1308,1085,223,0.829511,0.170489,1.707126,209,14,1309,1086,223,0.829641,0.170359,1.70732,209,14,-1, abandoned,0,0,0.525697582395
30746,1000105,2,390,299,91,0.766667,0.233333,1.515985,81,10,391,300,91,0.767263,0.232737,1.517263,81,10,1, merged,0,0,0.274881676756
30750,1000004,1,1913,1679,234,0.877679,0.122321,0.877679,184,50,1915,1679,236,0.876762,0.123238,0.876762,184,52,-1, merged,1,1,0.186958231704
30751,1000014,1,1401,1196,205,0.853676,0.146324,0.853676,192,13,1402,1197,205,0.85378,0.14622,0.85378,192,13,1, merged,0,0,0.152555793858
30751,1000130,2,224,185,39,0.825893,0.174107,1.679569,30,9,225,186,39,0.826667,0.173333,1.680447,30,9,1, merged,0,0,0.165615141956
30759,1000004,2,1915,1679,236,0.876762,0.123238,1.617503,184,52,1916,1680,236,0.876827,0.123173,1.610772,184,52,1, merged,0,0,0.0496874817454
30761,1000153,3,652,595,57,0.912577,0.087423,2.536749,43,14,653,596,57,0.912711,0.087289,2.54682,43,14,1, merged,0,0,0.543131987833
30761,1000199,2,319,270,49,0.846395,0.153605,1.624173,45,4,320,271,49,0.846875,0.153125,1.634109,45,4,1, merged,0,0,0.0707958760288
30767,1000007,2,875,727,148,0.830857,0.169143,1.776312,129,19,876,728,148,0.83105,0.16895,1.776996,129,19,1, merged,0,0,0.644787708231
30769,1000063,1,2201,1963,238,0.891867,0.108133,0.891867,197,41,2202,1964,238,0.891916,0.108084,0.891916,197,41,1, merged,0,0,0
30770,1000328,2,607,435,172,0.716639,0.283361,1.549973,155,17,608,436,172,0.717105,0.282895,1.551302,155,17,1, merged,0,0,0.526379442395
30770,1000592,1,384,320,64,0.833333,0.166667,0.833333,43,21,386,322,64,0.834197,0.165803,0.834197,43,21,1, merged,0,0,0.352704100818
30771,1000009,2,748,636,112,0.850267,0.149733,1.796213,103,9,749,637,112,0.850467,0.149533,1.796896,103,9,1, merged,0,0,1.17497679697
30773,1000015,2,1315,1202,113,0.914068,0.085932,1.844503,101,12,1316,1203,113,0.914134,0.085866,1.845168,101,12,1, merged,0,0,0.457624661403
30775,1000015,2,1316,1203,113,0.914134,0.085866,1.845168,101,12,1317,1204,113,0.914199,0.085801,1.845823,101,12,1, merged,0,0,0.490755826999
30776,1000011,2,466,432,34,0.927039,0.072961,1.858663,31,3,467,433,34,0.927195,0.072805,1.859398,31,3,1, merged,0,0,0.780662308775
30782,1000004,2,1916,1680,236,0.876827,0.123173,1.571387,184,52,1917,1681,236,0.876891,0.123109,1.572724,184,52,1, merged,0,0,0
30786,1000023,2,345,304,41,0.881159,0.118841,1.813363,38,3,347,305,42,0.878963,0.121037,1.803332,39,3,1, merged,1,1,0.0202361288439
30786,1000063,3,2203,1965,238,0.891966,0.108034,2.705328,197,41,2204,1965,239,0.891561,0.108439,2.694893,198,41,1, merged,1,1,0.142659762012
30786,1000120,5,691,564,127,0.816208,0.183792,4.355734,114,13,692,565,127,0.816474,0.183526,4.346843,114,13,1, merged,0,0,0.218204721497
30786,1000592,4,386,322,64,0.834197,0.165803,3.539525,43,21,389,325,64,0.835476,0.164524,3.530369,43,21,-1, merged,0,0,0.249501700671
30792,1000329,2,1992,1531,461,0.768574,0.231426,1.693574,413,48,1993,1532,461,0.76869,0.23131,1.69431,413,48,1, merged,0,0,0.8185682221
30794,1000023,2,347,305,42,0.878963,0.121037,1.804582,39,3,348,306,42,0.87931,0.12069,1.80554,39,3,1, merged,0,0,0.0437279613364
30795,1000015,2,1317,1204,113,0.914199,0.085801,1.63244,101,12,1318,1205,113,0.914264,0.085736,1.631337,101,12,1, merged,0,0,0.548299388248
30795,1000328,1,614,441,173,0.718241,0.281759,0.718241,156,17,615,441,174,0.717073,0.282927,0.717073,156,18,-1, merged,1,1,0.623539323602
30797,1000329,2,1993,1532,461,0.76869,0.23131,1.54776,413,48,1996,1535,461,0.769038,0.230962,1.564737,413,48,-1, merged,0,0,0.0952474113052
30799,1000063,2,2204,1965,239,0.891561,0.108439,1.748952,198,41,2210,1970,240,0.891403,0.108597,1.749534,199,41,-1, merged,1,0,0.062585341221
30800,1000023,2,348,306,42,0.87931,0.12069,1.80554,39,3,349,307,42,0.879656,0.120344,1.806485,39,3,1, merged,0,0,0.0249401480146
30803,1000007,2,877,729,148,0.831243,0.168757,1.758072,129,19,878,730,148,0.831435,0.168565,1.758854,129,19,1, merged,0,0,0.30568474382
30805,1000153,1,653,596,57,0.912711,0.087289,0.912711,43,14,656,599,57,0.91311,0.08689,0.91311,43,14,-1, abandoned,0,0,0.158991789455
30805,1000534,3,104,71,33,0.682692,0.317308,2.595403,31,2,105,71,34,0.67619,0.32381,2.1893,32,2,1, abandoned,1,1,0.158818918213
30807,1000009,2,750,638,112,0.850667,0.149333,1.764996,103,9,751,639,112,0.850866,0.149134,1.764502,103,9,1, merged,0,0,0.613481444954
30807,1000015,1,1319,1206,113,0.914329,0.085671,0.914329,101,12,1320,1206,114,0.913636,0.086364,0.913636,102,12,1, merged,1,1,0.500686461629
30810,1000063,1,2210,1970,240,0.891403,0.108597,0.891403,199,41,2211,1971,240,0.891452,0.108548,0.891452,199,41,1, merged,0,0,0.160187133526
30816,1000132,2,222,201,21,0.905405,0.094595,1.738739,16,5,223,202,21,0.90583,0.09417,1.742564,16,5,1, merged,0,0,0.160302189183
30824,1000023,1,349,307,42,0.879656,0.120344,0.879656,39,3,350,308,42,0.88,0.12,0.88,39,3,1, merged,0,0,0
30829,1000023,2,350,308,42,0.88,0.12,1.546667,39,3,351,309,42,0.880342,0.119658,1.580342,39,3,1, merged,0,0,0.654037795534
30830,1000014,2,1407,1202,205,0.8543,0.1457,1.445849,192,13,1408,1203,205,0.854403,0.145597,1.437737,192,13,1, merged,0,0,0.210083592133
30853,1000014,2,1409,1204,205,0.854507,0.145493,1.568792,192,13,1410,1205,205,0.85461,0.14539,1.587943,192,13,1, merged,0,0,0.693052009017
30856,1000004,1,1917,1681,236,0.876891,0.123109,0.876891,184,52,1919,1683,236,0.877019,0.122981,0.877019,184,52,-1, merged,0,0,0.116838195556
30866,1000091,2,376,289,87,0.768617,0.231383,1.564316,73,14,377,289,88,0.766578,0.233422,1.553812,73,15,-1, merged,1,1,0.665297933157
30872,1000004,1,1919,1683,236,0.877019,0.122981,0.877019,184,52,1920,1683,237,0.876563,0.123438,0.876563,185,52,1, abandoned,1,1,0.0800077543939
30872,1000132,2,223,202,21,0.90583,0.09417,1.782849,16,5,224,202,22,0.901786,0.098214,1.778348,17,5,1, abandoned,1,1,0.126526280323
30873,1000124,2,501,465,36,0.928144,0.071856,1.855563,32,4,502,466,36,0.928287,0.071713,1.856287,32,4,1, merged,0,0,0.417898775767
30874,1000130,2,226,187,39,0.827434,0.172566,1.755434,30,9,227,188,39,0.828194,0.171806,1.756765,30,9,1, merged,0,0,0.604603624689
30879,1000124,2,502,466,36,0.928287,0.071713,1.856858,32,4,503,467,36,0.928429,0.071571,1.857563,32,4,1, merged,0,0,0.104688680051
30887,1000091,1,377,289,88,0.766578,0.233422,0.766578,73,15,380,289,91,0.760526,0.239474,0.760526,76,15,1, abandoned,1,1,0.134661806854
30902,1000004,5,1923,1686,237,0.876755,0.123245,3.710226,185,52,1924,1687,237,0.876819,0.123181,3.675424,185,52,-1, abandoned,0,0,0.0904506041504
30906,1000004,1,1925,1688,237,0.876883,0.123117,0.876883,185,52,1929,1692,237,0.877138,0.122862,0.877138,185,52,-1, merged,0,0,0.0621324315395
30906,1000166,2,174,152,22,0.873563,0.126437,1.750446,21,1,176,152,24,0.863636,0.136364,1.740775,23,1,1, merged,1,1,0.157630662021
30908,1000329,1,2000,1537,463,0.7685,0.2315,0.7685,415,48,2001,1538,463,0.768616,0.231384,0.768616,415,48,1, merged,0,0,0.887085574467
30909,1000015,2,1320,1206,114,0.913636,0.086364,1.589827,102,12,1321,1207,114,0.913702,0.086298,1.592947,102,12,1, merged,0,0,0.111289736802
30909,1000534,1,105,71,34,0.67619,0.32381,0.67619,32,2,106,72,34,0.679245,0.320755,0.679245,32,2,1, merged,0,0,0.129675918536
30911,1000004,1,1929,1692,237,0.877138,0.122862,0.877138,185,52,1930,1693,237,0.877202,0.122798,0.877202,185,52,-1, merged,0,0,0.0314960879703
30911,1000120,3,700,573,127,0.818571,0.181429,2.532027,114,13,702,575,127,0.819088,0.180912,2.533025,114,13,1, merged,0,0,0.0749761682221
30911,1000592,2,391,327,64,0.836317,0.163683,1.713456,43,21,392,328,64,0.836735,0.163265,1.713937,43,21,1, merged,0,0,0.033114205989
30912,1000004,2,1930,1693,237,0.877202,0.122798,1.460535,185,52,1931,1694,237,0.877266,0.122734,1.466307,185,52,1, merged,0,0,0.0480354436283
30921,1000105,1,393,302,91,0.768448,0.231552,0.768448,81,10,394,303,91,0.769036,0.230964,0.769036,81,10,1, merged,0,0,0.315625191674
30933,1000004,3,1931,1694,237,0.877266,0.122734,2.465201,185,52,1932,1695,237,0.877329,0.122671,2.465138,185,52,1, merged,0,0,0.0171670067036
30933,1000120,1,702,575,127,0.819088,0.180912,0.819088,114,13,703,576,127,0.819346,0.180654,0.819346,114,13,1, merged,0,0,0.0352541159628
30933,1000329,2,2003,1540,463,0.768847,0.231153,1.587935,415,48,2004,1540,464,0.768463,0.231537,1.587809,415,49,-1, merged,1,1,0
30934,1000329,1,2004,1540,464,0.768463,0.231537,0.768463,415,49,2005,1541,464,0.768579,0.231421,0.768579,415,49,1, merged,0,0,0.00168532376126
30937,1000004,2,1932,1695,237,0.877329,0.122671,1.59805,185,52,1933,1696,237,0.877393,0.122607,1.600607,185,52,1, merged,0,0,0.0002331002331
30942,1000014,3,1413,1208,205,0.854919,0.145081,2.476102,192,13,1416,1210,206,0.85452,0.14548,2.390467,193,13,-1, merged,1,0,0.344054283771
30942,1000120,4,704,577,127,0.819602,0.180398,3.295705,114,13,706,579,127,0.820113,0.179887,3.210581,114,13,-1, merged,0,0,0.204550733273
30943,1000014,1,1416,1210,206,0.85452,0.14548,0.85452,193,13,1419,1212,207,0.854123,0.145877,0.854123,194,13,-1, merged,1,0,0.344325560969
30943,1000120,3,706,579,127,0.820113,0.179887,2.563522,114,13,707,580,127,0.820368,0.179632,2.564399,114,13,1, merged,0,0,0.205548016689
30959,1000023,1,352,310,42,0.880682,0.119318,0.880682,39,3,355,312,43,0.878873,0.121127,0.878873,40,3,1, merged,1,1,0
30975,1000121,6,1310,1087,223,0.829771,0.170229,4.149285,209,14,1311,1088,223,0.829901,0.170099,4.168296,209,14,1, merged,0,0,0.645769463977
30980,1000014,5,1420,1213,207,0.854225,0.145775,3.664199,194,13,1422,1215,207,0.85443,0.14557,3.617502,194,13,-1, merged,0,0,0.0714086681118
30981,1000070,5,845,741,104,0.876923,0.123077,3.771308,87,17,846,741,105,0.875887,0.124113,3.611959,88,17,1, merged,1,1,0.785464510027
30987,1000124,2,507,471,36,0.928994,0.071006,1.674186,32,4,508,472,36,0.929134,0.070866,1.675545,32,4,1, merged,0,0,0
30997,1000329,2,2005,1541,464,0.768579,0.231421,0.768579,415,49,2007,1542,465,0.768311,0.231689,1.768311,416,49,1, abandoned,1,1,0
31003,1000014,8,1423,1215,208,0.85383,0.14617,5.626649,195,13,1424,1215,209,0.85323,0.14677,5.569388,196,13,1, merged,1,1,0.258053069428
31003,1000121,6,1311,1088,223,0.829901,0.170099,4.047156,209,14,1312,1089,223,0.83003,0.16997,3.994418,209,14,-1, merged,0,0,0.323025476692
31006,1000014,2,1424,1215,209,0.85323,0.14677,1.636482,196,13,1427,1218,209,0.853539,0.146461,1.635506,196,13,-1, merged,0,0,0.220162637273
31006,1000327,1,609,477,132,0.783251,0.216749,0.783251,101,31,610,477,133,0.781967,0.218033,0.781967,102,31,1, merged,1,1,0.225815071313
31007,1000014,2,1427,1218,209,0.853539,0.146461,1.635506,196,13,1428,1219,209,0.853641,0.146359,1.633053,196,13,1, merged,0,0,0.662234536903
31007,1000070,3,846,741,105,0.875887,0.124113,2.511393,88,17,847,742,105,0.876033,0.123967,2.509086,88,17,1, merged,0,0,0.8160968523
31007,1000327,1,610,477,133,0.781967,0.218033,0.781967,102,31,612,477,135,0.779412,0.220588,0.779412,104,31,1, merged,1,1,0.680670078666
31009,1000091,1,380,289,91,0.760526,0.239474,0.760526,76,15,381,290,91,0.761155,0.238845,0.761155,76,15,1, merged,0,0,0.579849261192
31010,1000014,1,1428,1219,209,0.853641,0.146359,0.853641,196,13,1430,1220,210,0.853147,0.146853,0.853147,197,13,-1, merged,1,0,0.501669490438
31010,1000063,2,2214,1973,241,0.891147,0.108853,1.744789,200,41,2215,1973,242,0.890745,0.109255,1.743892,201,41,1, merged,1,1,0.285262503309
31010,1000592,4,392,328,64,0.836735,0.163265,3.440387,43,21,394,329,65,0.835025,0.164975,3.438024,43,22,-1, merged,1,1,0.498812075741
31011,1000329,1,2007,1542,465,0.768311,0.231689,0.768311,416,49,2008,1543,465,0.768426,0.231574,0.768426,416,49,1, merged,0,0,0.863773135928
31012,1000004,2,1940,1703,237,0.877835,0.122165,1.599574,185,52,1941,1704,237,0.877898,0.122102,1.593415,185,52,1, merged,0,0,0.0621264812488
31024,1000166,1,176,152,24,0.863636,0.136364,0.863636,23,1,178,153,25,0.859551,0.140449,0.859551,23,2,-1, merged,1,1,0.378850732601
31026,1000166,2,178,153,25,0.859551,0.140449,1.808269,23,2,179,154,25,0.860335,0.139665,1.809702,23,2,1, merged,0,0,0.384922922099
31027,1000091,3,381,290,91,0.761155,0.238845,2.395812,76,15,382,291,91,0.76178,0.23822,2.39752,76,15,1, merged,0,0,0.688793859649
31027,1000328,2,617,443,174,0.71799,0.28201,1.634657,156,18,618,444,174,0.718447,0.281553,1.63574,156,18,1, merged,0,0,1.07155404194
31029,1000023,2,359,316,43,0.880223,0.119777,1.6525,40,3,360,317,43,0.880556,0.119444,1.655065,40,3,1, merged,0,0,0.644969200905
31030,1000009,1,755,642,113,0.850331,0.149669,0.850331,104,9,756,642,114,0.849206,0.150794,0.849206,105,9,1, merged,1,1,0.068487008935
31030,1000015,2,1329,1215,114,0.914221,0.085779,1.764552,102,12,1330,1215,115,0.913534,0.086466,1.76274,103,12,1, merged,1,1,0.0596105287843
31030,1000534,4,106,72,34,0.679245,0.320755,3.343798,32,2,107,73,34,0.682243,0.317757,3.354074,32,2,1, merged,0,0,0.0683530563601
31033,1000004,1,1944,1705,239,0.877058,0.122942,0.877058,187,52,1947,1708,239,0.877247,0.122753,0.877247,187,52,-1, merged,0,0,0.0400978279858
31033,1000132,2,224,202,22,0.901786,0.098214,1.778843,17,5,225,203,22,0.902222,0.097778,1.779469,17,5,1, merged,0,0,0.00439624853458
31037,1000132,1,225,203,22,0.902222,0.097778,0.902222,17,5,226,204,22,0.902655,0.097345,0.902655,17,5,1, merged,0,0,0.15050075475
31037,1000153,2,660,602,58,0.912121,0.087879,1.814343,44,14,661,603,58,0.912254,0.087746,1.814909,44,14,1, merged,0,0,0.227064146975
31038,1000132,1,226,204,22,0.902655,0.097345,0.902655,17,5,227,205,22,0.903084,0.096916,0.903084,17,5,1, merged,0,0,0.605068102629
31038,1000153,2,661,603,58,0.912254,0.087746,1.814909,44,14,662,604,58,0.912387,0.087613,1.81547,44,14,1, merged,0,0,0.908554038743
31039,1000004,2,1948,1709,239,0.87731,0.12269,1.780394,187,52,1949,1710,239,0.877373,0.122627,1.776496,187,52,-1, abandoned,0,0,0.233001338347
31039,1000132,1,227,205,22,0.903084,0.096916,0.903084,17,5,228,205,23,0.899123,0.100877,0.899123,18,5,1, abandoned,1,1,0.352771998469
31039,1000153,3,662,604,58,0.912387,0.087613,2.69278,44,14,664,606,58,0.912651,0.087349,2.689146,44,14,-1, abandoned,0,0,0.537170476883
31040,1000004,1,1949,1710,239,0.877373,0.122627,0.877373,187,52,1951,1712,239,0.877499,0.122501,0.877499,187,52,-1, merged,0,0,0.37901537358
31040,1000153,3,664,606,58,0.912651,0.087349,2.55845,44,14,665,606,59,0.911278,0.088722,2.557051,45,14,1, merged,1,1,0.495033712868
31040,1000329,2,2008,1543,465,0.768426,0.231574,1.645799,416,49,2011,1545,466,0.768274,0.231726,1.645773,417,49,-1, merged,1,0,0.665930396464
31053,1000063,1,2217,1975,242,0.890843,0.109157,0.890843,201,41,2218,1976,242,0.890893,0.109107,0.890893,201,41,-1, merged,0,0,0.0037995010218
31058,1000328,2,618,444,174,0.718447,0.281553,1.63574,156,18,619,445,174,0.718901,0.281099,1.636812,156,18,1, merged,0,0,1.09033683708
31059,1000005,1,206,156,50,0.757282,0.242718,0.757282,45,5,207,156,51,0.753623,0.246377,0.753623,46,5,1, abandoned,1,1,0.211309010452
31069,1000063,1,2218,1976,242,0.890893,0.109107,0.890893,201,41,2219,1977,242,0.890942,0.109058,0.890942,201,41,1, merged,0,0,0.000608671595196
31070,1000004,2,1951,1712,239,0.877499,0.122501,1.787273,187,52,1952,1713,239,0.877561,0.122439,1.77719,187,52,-1, merged,0,0,0.0175794359723
31070,1000132,3,229,206,23,0.899563,0.100437,2.686836,18,5,231,207,24,0.896104,0.103896,2.673294,19,5,1, merged,1,1,0.027949282177
31072,1000005,1,207,156,51,0.753623,0.246377,0.753623,46,5,208,157,51,0.754808,0.245192,0.754808,46,5,1, merged,0,0,0.212408472148
31074,1000004,1,1952,1713,239,0.877561,0.122439,0.877561,187,52,1954,1715,239,0.877687,0.122313,0.877687,187,52,-1, merged,0,0,1.84317258365e-05
31074,1000023,2,360,317,43,0.880556,0.119444,1.758117,40,3,361,317,44,0.878116,0.121884,1.755803,41,3,1, merged,1,1,8.00784199916e-05
31074,1000153,3,666,607,59,0.911411,0.088589,2.669528,45,14,667,608,59,0.911544,0.088456,2.667347,45,14,-1, merged,0,0,9.30920216864e-06
31089,1000121,3,1312,1089,223,0.83003,0.16997,2.41889,209,14,1314,1091,223,0.830289,0.169711,2.40653,209,14,-1, merged,0,0,0
31089,1000132,2,232,208,24,0.896552,0.103448,1.588859,19,5,233,209,24,0.896996,0.103004,1.576241,19,5,-1, merged,0,0,0
31090,1000121,2,1314,1091,223,0.830289,0.169711,1.509534,209,14,1316,1093,223,0.830547,0.169453,1.515732,209,14,-1, merged,0,0,0
31103,1000091,2,382,291,91,0.76178,0.23822,1.480682,76,15,383,291,92,0.759791,0.240209,1.478441,77,15,1, merged,1,1,0.228451615339
31103,1000328,1,619,445,174,0.718901,0.281099,0.718901,156,18,622,447,175,0.71865,0.28135,0.71865,157,18,1, merged,1,1,0.354881664717
31107,1000015,2,1333,1218,115,0.913728,0.086272,1.666488,103,12,1334,1219,115,0.913793,0.086207,1.664894,103,12,1, merged,0,0,0.334615326823
31117,1000007,1,888,740,148,0.833333,0.166667,0.833333,129,19,889,741,148,0.833521,0.166479,0.833521,129,19,1, merged,0,0,0.290958292829
31117,1000015,2,1335,1220,115,0.913858,0.086142,1.747191,103,12,1336,1221,115,0.913922,0.086078,1.747443,103,12,1, merged,0,0,0.279013873637
31145,1000004,2,1956,1717,239,0.877812,0.122188,1.646086,187,52,1957,1718,239,0.877874,0.122126,1.646379,187,52,-1, merged,0,0,0.0393185615465
31145,1000329,1,2011,1545,466,0.768274,0.231726,0.768274,417,49,2013,1547,466,0.768505,0.231495,0.768505,417,49,-1, merged,0,0,0.0345606041949
31154,1000004,3,1957,1718,239,0.877874,0.122126,1.731021,187,52,1958,1719,239,0.877937,0.122063,1.731186,187,52,-1, abandoned,0,0,0.0234532364137
31154,1000014,2,1430,1220,210,0.853147,0.146853,0.853147,197,13,1431,1221,210,0.853249,0.146751,0.853249,197,13,-1, abandoned,0,0,0.0325681535517
31156,1000004,1,1958,1719,239,0.877937,0.122063,0.877937,187,52,1960,1721,239,0.878061,0.121939,0.878061,187,52,-1, abandoned,0,0,0
31169,1000023,1,361,317,44,0.878116,0.121884,0.878116,41,3,362,318,44,0.878453,0.121547,0.878453,41,3,1, merged,0,0,0.00907312900044
31169,1000063,2,2234,1991,243,0.891226,0.108774,1.769343,202,41,2235,1992,243,0.891275,0.108725,1.769728,202,41,1, merged,0,0,0.00362246093096
31173,1000329,1,2013,1547,466,0.768505,0.231495,0.768505,417,49,2017,1550,467,0.768468,0.231532,0.768468,418,49,-1, merged,1,0,0.119595121752
31177,1000063,1,2236,1993,243,0.891324,0.108676,0.891324,202,41,2238,1995,243,0.891421,0.108579,0.891421,202,41,-1, merged,0,0,0.166024181009
31179,1000014,4,1434,1224,210,0.853556,0.146444,3.149956,197,13,1435,1225,210,0.853659,0.146341,3.151242,197,13,1, merged,0,0,0.127114482888
31179,1000328,1,622,447,175,0.71865,0.28135,0.71865,157,18,623,448,175,0.719101,0.280899,0.719101,157,18,1, merged,0,0,0.163175613594
31179,1000329,2,2024,1553,471,0.767292,0.232708,1.485942,422,49,2025,1554,471,0.767407,0.232593,1.486509,422,49,1, merged,0,0,0.149841172207
31186,1000329,2,2025,1554,471,0.767407,0.232593,1.517407,422,49,2026,1555,471,0.767522,0.232478,1.518192,422,49,1, merged,0,0,0.00583360107624
31188,1000063,2,2239,1996,243,0.891469,0.108531,1.727328,202,41,2240,1997,243,0.891518,0.108482,1.723176,202,41,1, merged,0,0,0.165932610834
31188,1000592,1,396,331,65,0.835859,0.164141,0.835859,43,22,398,331,67,0.831658,0.168342,0.831658,43,24,-1, merged,1,1,0
31190,1000004,1,1963,1724,239,0.878248,0.121752,0.878248,187,52,1964,1725,239,0.87831,0.12169,0.87831,187,52,-1, merged,0,0,0.0197374235943
31190,1000329,2,2026,1555,471,0.767522,0.232478,1.64577,422,49,2027,1556,471,0.767637,0.232363,1.645946,422,49,1, merged,0,0,0.01773384633
31203,1000014,1,1435,1225,210,0.853659,0.146341,0.853659,197,13,1436,1226,210,0.85376,0.14624,0.85376,197,13,1, merged,0,0,0.685799237605
31205,1000329,2,2027,1556,471,0.767637,0.232363,1.600137,422,49,2028,1557,471,0.767751,0.232249,1.600669,422,49,1, merged,0,0,0.819419438741
31205,1000592,1,400,333,67,0.8325,0.1675,0.8325,43,24,401,334,67,0.832918,0.167082,0.832918,43,24,1, merged,0,0,0.617657238334
31206,1000091,2,383,291,92,0.759791,0.240209,1.592709,77,15,384,291,93,0.757812,0.242188,1.589078,78,15,1, merged,1,1,0.258234701327
31206,1000328,3,623,448,175,0.719101,0.280899,2.31181,157,18,624,448,176,0.717949,0.282051,2.307027,158,18,1, merged,1,1,0.25523609158
31206,1000592,1,401,334,67,0.832918,0.167082,0.832918,43,24,403,335,68,0.831266,0.168734,0.831266,44,24,1, merged,1,1,0.208233080192
31207,1000014,1,1437,1227,210,0.853862,0.146138,0.853862,197,13,1438,1228,210,0.853964,0.146036,0.853964,197,13,1, merged,0,0,0.569659013697
31207,1000592,2,403,335,68,0.831266,0.168734,1.685128,44,24,404,336,68,0.831683,0.168317,1.685647,44,24,1, merged,0,0,0.548510415177
31216,1000004,1,1964,1725,239,0.87831,0.12169,0.87831,187,52,1965,1726,239,0.878372,0.121628,0.878372,187,52,1, merged,0,0,0.287590720156
31220,1000329,2,2032,1558,474,0.766732,0.233268,1.533087,425,49,2033,1559,474,0.766847,0.233153,1.535366,425,49,-1, abandoned,0,0,0.287060745904
31225,1000070,3,850,745,105,0.876471,0.123529,2.315903,88,17,852,746,106,0.875587,0.124413,2.314922,89,17,1, merged,1,1,0.385665103796
31225,1000105,2,396,304,92,0.767677,0.232323,1.439432,82,10,398,305,93,0.766332,0.233668,1.439335,83,10,1, merged,1,1,0.365874154747
31226,1000329,2,2038,1561,477,0.765947,0.234053,1.534466,428,49,2040,1562,478,0.765686,0.234314,1.527154,429,49,1, merged,1,1,0.0946416163062
31231,1000070,2,853,747,106,0.875733,0.124267,1.548737,89,17,854,748,106,0.875878,0.124122,1.550121,89,17,-1, abandoned,0,0,0
31231,1000105,4,398,305,93,0.766332,0.233668,2.962127,83,10,401,305,96,0.760599,0.239401,2.92183,86,10,1, abandoned,1,1,0
31238,1000118,2,767,674,93,0.878748,0.121252,1.55758,87,6,768,675,93,0.878906,0.121094,1.547971,87,6,-1, merged,0,0,0.0620926289847
31245,1000592,2,405,337,68,0.832099,0.167901,1.832099,44,24,406,338,68,0.832512,0.167488,1.832512,44,24,1, merged,0,0,0.0955371491224
31246,1000329,2,2042,1564,478,0.765916,0.234084,1.600113,429,49,2044,1565,479,0.765656,0.234344,1.600138,429,50,-1, merged,1,0,0.0229666216693
31249,1000004,2,1967,1727,240,0.877987,0.122013,1.710499,188,52,1968,1728,240,0.878049,0.121951,1.711382,188,52,1, merged,0,0,0.148577348869
31249,1000592,1,406,338,68,0.832512,0.167488,0.832512,44,24,408,340,68,0.833333,0.166667,0.833333,44,24,-1, merged,0,0,0.165150581909
31260,1000023,2,368,324,44,0.880435,0.119565,1.439959,41,3,369,325,44,0.880759,0.119241,1.445465,41,3,1, merged,0,0,0.00977275666436
31289,1000014,1,1451,1241,210,0.855272,0.144728,0.855272,197,13,1453,1242,211,0.854783,0.145217,0.854783,198,13,1, merged,1,1,0.00748879880521
31289,1000120,2,709,582,127,0.820874,0.179126,1.676147,114,13,710,583,127,0.821127,0.178873,1.67591,114,13,1, merged,0,0,0.132554219293
31290,1000014,1,1453,1242,211,0.854783,0.145217,0.854783,198,13,1455,1243,212,0.854296,0.145704,0.854296,199,13,1, merged,1,1,0.00791466666667
31290,1000120,2,710,583,127,0.821127,0.178873,1.67591,114,13,711,584,127,0.821378,0.178622,1.675674,114,13,1, merged,0,0,0.133915995976
31291,1000014,1,1455,1243,212,0.854296,0.145704,0.854296,199,13,1457,1244,213,0.853809,0.146191,0.853809,200,13,1, merged,1,1,0.00834044368601
31291,1000120,2,711,584,127,0.821378,0.178622,1.675674,114,13,712,585,127,0.821629,0.178371,1.675438,114,13,1, merged,0,0,0.135276813999
31292,1000014,1,1457,1244,213,0.853809,0.146191,0.853809,200,13,1459,1245,214,0.853324,0.146676,0.853324,201,13,1, merged,1,1,0.00876612989229
31292,1000120,2,712,585,127,0.821629,0.178371,1.675438,114,13,713,586,127,0.821879,0.178121,1.675204,114,13,1, merged,0,0,0.136636674374
31293,1000014,1,1459,1245,214,0.853324,0.146676,0.853324,201,13,1461,1246,215,0.852841,0.147159,0.852841,202,13,1, merged,1,1,0.00919172531457
31293,1000120,2,713,586,127,0.821879,0.178121,1.675204,114,13,714,587,127,0.822129,0.177871,1.674969,114,13,1, merged,0,0,0.137995578112
31294,1000014,1,1461,1246,215,0.852841,0.147159,0.852841,202,13,1463,1246,217,0.851675,0.148325,0.851675,203,14,1, merged,1,1,0.00961722998187
31294,1000120,2,714,587,127,0.822129,0.177871,1.674969,114,13,715,588,127,0.822378,0.177622,1.674052,114,13,1, merged,0,0,0.139353526221
31295,1000014,1,1463,1246,217,0.851675,0.148325,0.851675,203,14,1466,1247,219,0.850614,0.149386,0.850614,205,14,1, merged,1,1,0.00748400852878
31295,1000120,2,715,588,127,0.822378,0.177622,1.674052,114,13,717,589,128,0.821478,0.178522,1.672092,115,13,1, merged,1,1,0.172960080341
31296,1000014,1,1466,1247,219,0.850614,0.149386,0.850614,205,14,1468,1248,220,0.850136,0.149864,0.850136,206,14,1, merged,1,1,0.0103080695022
31296,1000120,2,717,589,128,0.821478,0.178522,1.672092,115,13,718,590,128,0.821727,0.178273,1.671863,115,13,1, merged,0,0,0.147161429575
31297,1000014,1,1468,1248,220,0.850136,0.149864,0.850136,206,14,1470,1249,221,0.84966,0.15034,0.84966,207,14,1, merged,1,1,0.00214670004354
31297,1000120,2,718,590,128,0.821727,0.178273,1.671863,115,13,719,591,128,0.821975,0.178025,1.671635,115,13,1, merged,0,0,0.0297048064347
31298,1000014,1,1470,1249,221,0.84966,0.15034,0.84966,207,14,1472,1250,222,0.849185,0.150815,0.849185,208,14,1, merged,1,1,0.00437864021819
31298,1000120,2,719,591,128,0.821975,0.178025,1.671635,115,13,720,592,128,0.822222,0.177778,1.671407,115,13,1, merged,0,0,0.0820758242291
31299,1000014,1,1472,1250,222,0.849185,0.150815,0.849185,208,14,1474,1251,223,0.848711,0.151289,0.848711,209,14,1, merged,1,1,0.00605527258014
31299,1000120,2,720,592,128,0.822222,0.177778,1.671407,115,13,721,593,128,0.822469,0.177531,1.67118,115,13,1, merged,0,0,0.0763655389709
31303,1000014,2,1474,1251,223,0.848711,0.151289,1.602199,209,14,1475,1252,223,0.848814,0.151186,1.603443,209,14,1, merged,0,0,0.493671372287
31305,1000026,2,266,244,22,0.917293,0.082707,1.58396,20,2,267,244,23,0.913858,0.086142,1.459312,21,2,1, abandoned,1,1,0
31308,1000070,1,854,748,106,0.875878,0.124122,0.875878,89,17,856,749,107,0.875,0.125,0.875,90,17,1, merged,1,1,0.767093820958
31308,1000124,2,527,491,36,0.931689,0.068311,1.807567,32,4,529,493,36,0.931947,0.068053,1.806947,32,4,-1, merged,0,0,0.433941189379
31323,1000091,2,384,291,93,0.757812,0.242188,1.51928,78,15,385,291,94,0.755844,0.244156,1.519481,79,15,1, merged,1,1,0.113214901124
31323,1000592,3,408,340,68,0.833333,0.166667,2.352614,44,24,409,341,68,0.833741,0.166259,2.353221,44,24,1, merged,0,0,0.123447112351
31325,1000091,3,385,291,94,0.755844,0.244156,2.353221,79,15,387,293,94,0.757106,0.242894,2.357422,79,15,-1, merged,0,0,0.0189740922305
31325,1000592,2,409,341,68,0.833741,0.166259,1.597377,44,24,411,343,68,0.83455,0.16545,1.600316,44,24,-1, merged,0,0,0.0211649547104
31326,1000592,2,411,343,68,0.83455,0.16545,1.600316,44,24,412,344,68,0.834951,0.165049,1.602809,44,24,1, merged,0,0,0.138445184
31327,1000592,3,412,344,68,0.834951,0.165049,2.281913,44,24,413,345,68,0.835351,0.164649,2.28304,44,24,1, merged,0,0,0.471953305594
31343,1000121,2,1317,1094,223,0.830676,0.169324,1.521585,209,14,1318,1094,224,0.830046,0.169954,1.508617,210,14,1, abandoned,1,1,0
31350,1000014,2,1478,1255,223,0.84912,0.15088,1.413826,209,14,1479,1256,223,0.849222,0.150778,1.41899,209,14,1, merged,0,0,0.538870452497
31350,1000592,3,414,346,68,0.835749,0.164251,2.249575,44,24,415,347,68,0.836145,0.163855,2.255134,44,24,1, merged,0,0,0.678079410955
31351,1000054,1,90,78,12,0.866667,0.133333,0.866667,8,4,92,80,12,0.869565,0.130435,0.869565,8,4,-1, merged,0,0,0.848541475574
31352,1000329,1,2045,1566,479,0.76577,0.23423,0.76577,429,50,2047,1567,480,0.765511,0.234489,0.765511,430,50,-1, abandoned,1,0,0.00426309166509
31354,1000054,2,92,80,12,0.869565,0.130435,1.70571,8,4,93,81,12,0.870968,0.129032,1.707506,8,4,1, merged,0,0,0.273601809808
31354,1000592,1,415,347,68,0.836145,0.163855,0.836145,44,24,416,348,68,0.836538,0.163462,0.836538,44,24,1, merged,0,0,0.319250653357
31356,1000121,3,1319,1095,224,0.830174,0.169826,2.356054,210,14,1320,1096,224,0.830303,0.169697,2.35232,210,14,1, merged,0,0,0.215907657591
31356,1000329,2,2047,1567,480,0.765511,0.234489,1.525879,430,50,2048,1567,481,0.765137,0.234863,1.522017,430,51,-1, merged,1,1,0.267741935351
31365,1000091,2,387,293,94,0.757106,0.242894,1.527017,79,15,388,294,94,0.757732,0.242268,1.531645,79,15,1, merged,0,0,0.256690600395
31369,1000054,1,93,81,12,0.870968,0.129032,0.870968,8,4,94,82,12,0.87234,0.12766,0.87234,8,4,1, merged,0,0,0.0170260996476
31372,1000091,2,388,294,94,0.757732,0.242268,1.477477,79,15,389,295,94,0.758355,0.241645,1.478546,79,15,1, merged,0,0,0.00651076473191
31372,1000328,1,628,452,176,0.719745,0.280255,0.719745,158,18,629,453,176,0.720191,0.279809,0.720191,158,18,1, merged,0,0,0.00504546447536
31372,1000592,3,416,348,68,0.836538,0.163462,2.314016,44,24,418,349,69,0.834928,0.165072,2.313474,44,25,1, merged,1,0,0.00500576607568
31376,1000054,2,94,82,12,0.87234,0.12766,1.52234,8,4,95,83,12,0.873684,0.126316,1.492732,8,4,-1, merged,0,0,0.626500382856
31377,1000121,2,1320,1096,224,0.830303,0.169697,1.762342,210,14,1321,1097,224,0.830431,0.169569,1.762602,210,14,1, merged,0,0,0
31378,1000063,1,2244,2001,243,0.891711,0.108289,0.891711,202,41,2245,2001,244,0.891314,0.108686,0.891314,203,41,1, abandoned,1,1,0
31391,1000004,3,1975,1735,240,0.878481,0.121519,2.274145,188,52,1976,1736,240,0.878543,0.121457,2.257115,188,52,-1, abandoned,0,0,0.0171368107376
31393,1000004,2,1976,1736,240,0.878543,0.121457,1.581932,188,52,1978,1738,240,0.878665,0.121335,1.578665,188,52,-1, merged,0,0,0.0302128368251
31395,1000328,2,629,453,176,0.720191,0.279809,1.494104,158,18,630,454,176,0.720635,0.279365,1.489866,158,18,1, merged,0,0,0.176006283112
31396,1000328,2,630,454,176,0.720635,0.279365,1.489866,158,18,631,455,176,0.721078,0.278922,1.492264,158,18,1, merged,0,0,0.32103133167
31402,1000054,2,95,83,12,0.873684,0.126316,1.805888,8,4,96,84,12,0.875,0.125,1.805582,8,4,1, merged,0,0,0.848105678829
31402,1000124,1,531,495,36,0.932203,0.067797,0.932203,32,4,533,496,37,0.930582,0.069418,0.930582,32,5,-1, merged,1,1,0.527408459941
31416,1000004,2,1978,1738,240,0.878665,0.121335,1.644716,188,52,1979,1739,240,0.878727,0.121273,1.644632,188,52,1, merged,0,0,0.0395082451314
31416,1000329,1,2056,1575,481,0.766051,0.233949,0.766051,430,51,2059,1577,482,0.765906,0.234094,0.765906,431,51,-1, merged,1,0,0.0355609558526
31423,1000023,3,378,333,45,0.880952,0.119048,2.73872,42,3,379,333,46,0.878628,0.121372,2.731731,43,3,1, merged,1,1,0.0138604890301
31424,1000023,3,379,333,46,0.878628,0.121372,2.660577,43,3,380,334,46,0.878947,0.121053,2.661616,43,3,1, merged,0,0,0.289216173231
31425,1000023,1,380,334,46,0.878947,0.121053,0.878947,43,3,381,335,46,0.879265,0.120735,0.879265,43,3,1, merged,0,0,0.00683420567781
31425,1000063,2,2246,2001,245,0.890917,0.109083,1.769865,204,41,2247,2002,245,0.890966,0.109034,1.770231,204,41,1, merged,0,0,0.00472918626499
31429,1000023,2,381,335,46,0.879265,0.120735,1.770231,43,3,382,336,46,0.879581,0.120419,1.770692,43,3,1, merged,0,0,0.00245224382873
31429,1000063,1,2247,2002,245,0.890966,0.109034,0.890966,204,41,2250,2005,245,0.891111,0.108889,0.891111,204,41,-1, merged,0,0,0.00165783266245
31434,1000004,1,1979,1739,240,0.878727,0.121273,0.878727,188,52,1983,1743,240,0.878971,0.121029,0.878971,188,52,-1, merged,0,0,0.225177030143
31434,1000329,2,2059,1577,482,0.765906,0.234094,1.644632,431,51,2062,1578,484,0.765276,0.234724,1.644248,433,51,1, merged,1,1,0.313868617741
31436,1000023,1,382,336,46,0.879581,0.120419,0.879581,43,3,383,337,46,0.879896,0.120104,0.879896,43,3,1, merged,0,0,0.00694584691608
31436,1000063,2,2250,2005,245,0.891111,0.108889,1.770692,204,41,2251,2006,245,0.891159,0.108841,1.771055,204,41,1, merged,0,0,0.00476427685508
31438,1000023,1,383,337,46,0.879896,0.120104,0.879896,43,3,384,338,46,0.880208,0.119792,0.880208,43,3,1, merged,0,0,0.00699929605084
31438,1000063,2,2251,2006,245,0.891159,0.108841,1.771055,204,41,2252,2007,245,0.891208,0.108792,1.771416,204,41,1, merged,0,0,0.00478107306288
31439,1000023,1,384,338,46,0.880208,0.119792,0.880208,43,3,385,339,46,0.880519,0.119481,0.880519,43,3,1, merged,0,0,0.00705273572938
31439,1000063,2,2252,2007,245,0.891208,0.108792,1.771416,204,41,2253,2008,245,0.891256,0.108744,1.771776,204,41,1, merged,0,0,0.00479786834018
31445,1000004,1,1983,1743,240,0.878971,0.121029,0.878971,188,52,1984,1743,241,0.878528,0.121472,0.878528,188,53,-1, merged,1,1,0.48677586723
31445,1000063,2,2254,2009,245,0.891304,0.108696,1.770276,204,41,2255,2010,245,0.891353,0.108647,1.769881,204,41,1, merged,0,0,0.324446048965
31445,1000592,3,422,353,69,0.836493,0.163507,2.606768,44,25,423,354,69,0.836879,0.163121,2.60676,44,25,1, merged,0,0,0.597991822992
31460,1000023,3,385,339,46,0.880519,0.119481,2.529863,43,3,386,340,46,0.880829,0.119171,2.523361,43,3,1, merged,0,0,0.0734024261835
31460,1000063,2,2255,2010,245,0.891353,0.108647,1.649343,204,41,2256,2011,245,0.891401,0.108599,1.642532,204,41,-1, merged,0,0,0.0455266348114
31464,1000004,2,1984,1743,241,0.878528,0.121472,1.701733,188,53,1985,1744,241,0.878589,0.121411,1.701081,188,53,1, merged,0,0,0
31464,1000007,1,905,745,160,0.823204,0.176796,0.823204,141,19,907,746,161,0.822492,0.177508,0.822492,142,19,1, merged,1,1,0
31467,1000004,2,1985,1744,241,0.878589,0.121411,1.699665,188,53,1987,1746,241,0.878712,0.121288,1.697989,188,53,-1, merged,0,0,0
31467,1000007,1,911,748,163,0.821076,0.178924,0.821076,144,19,913,748,165,0.819277,0.180723,0.819277,146,19,1, merged,1,1,0
31467,1000120,3,721,593,128,0.822469,0.177531,2.522134,115,13,722,594,128,0.822715,0.177285,2.520703,115,13,1, merged,0,0,0
31468,1000004,2,1987,1746,241,0.878712,0.121288,1.697989,188,53,1989,1748,241,0.878834,0.121166,1.69632,188,53,-1, merged,0,0,0
31468,1000007,1,913,748,165,0.819277,0.180723,0.819277,146,19,915,748,167,0.817486,0.182514,0.817486,148,19,1, merged,1,1,0
31468,1000120,3,722,594,128,0.822715,0.177285,2.520703,115,13,723,595,128,0.82296,0.17704,2.51928,115,13,1, merged,0,0,0
31469,1000004,2,1989,1748,241,0.878834,0.121166,1.69632,188,53,1990,1749,241,0.878894,0.121106,1.695688,188,53,1, merged,0,0,0
31469,1000007,1,915,748,167,0.817486,0.182514,0.817486,148,19,917,749,168,0.816794,0.183206,0.816794,149,19,1, merged,1,1,0
31477,1000004,2,1990,1749,241,0.878894,0.121106,1.430177,188,53,1991,1750,241,0.878955,0.121045,1.435917,188,53,1, merged,0,0,0.0529408108402
31478,1000004,2,1991,1750,241,0.878955,0.121045,1.435917,188,53,1992,1751,241,0.879016,0.120984,1.441516,188,53,1, merged,0,0,0.0551642426503
31482,1000329,1,2062,1578,484,0.765276,0.234724,0.765276,433,51,2064,1580,484,0.765504,0.234496,0.765504,433,51,-1, merged,0,0,0.430824978342
31489,1000054,1,97,85,12,0.876289,0.123711,0.876289,8,4,98,86,12,0.877551,0.122449,0.877551,8,4,1, merged,0,0,0.73397393212
31489,1000124,2,533,496,37,0.930582,0.069418,1.80687,32,5,534,497,37,0.930712,0.069288,1.808263,32,5,1, merged,0,0,0.486109350411
31490,1000054,1,98,86,12,0.877551,0.122449,0.877551,8,4,99,87,12,0.878788,0.121212,0.878788,8,4,1, merged,0,0,0.849848029806
31490,1000124,2,534,497,37,0.930712,0.069288,1.808263,32,5,535,498,37,0.930841,0.069159,1.809629,32,5,1, merged,0,0,0.52804257086
31502,1000329,2,2073,1587,486,0.765557,0.234443,1.538666,435,51,2074,1588,486,0.76567,0.23433,1.54067,435,51,1, merged,0,0,0.841004874239
31505,1000329,1,2074,1588,486,0.76567,0.23433,0.76567,435,51,2076,1589,487,0.765414,0.234586,0.765414,436,51,1, merged,1,1,0.820991597091
31523,1000004,1,1995,1754,241,0.879198,0.120802,0.879198,188,53,1996,1755,241,0.879259,0.120741,0.879259,188,53,-1, merged,0,0,0.0148006509306
31526,1000004,2,1996,1755,241,0.879259,0.120741,1.694194,188,53,1997,1756,241,0.879319,0.120681,1.693574,188,53,1, merged,0,0,0.14362899064
31526,1000007,1,924,753,171,0.814935,0.185065,0.814935,152,19,926,754,172,0.814255,0.185745,0.814255,153,19,1, merged,1,1,0.231257954751
31527,1000004,2,1997,1756,241,0.879319,0.120681,1.693574,188,53,1998,1757,241,0.879379,0.120621,1.692957,188,53,1, merged,0,0,0.429667608421
31527,1000007,1,926,754,172,0.814255,0.185745,0.814255,153,19,928,755,173,0.813578,0.186422,0.813578,154,19,1, merged,1,1,0.690654041444
31528,1000004,2,1998,1757,241,0.879379,0.120621,1.692957,188,53,1999,1758,241,0.87944,0.12056,1.692343,188,53,1, merged,0,0,0.42983384823
31528,1000007,1,928,755,173,0.813578,0.186422,0.813578,154,19,930,756,174,0.812903,0.187097,0.812903,155,19,1, merged,1,1,0.691035478276
31531,1000004,2,1999,1758,241,0.87944,0.12056,1.691873,188,53,2000,1759,241,0.8795,0.1205,1.692134,188,53,1, merged,0,0,0.430519994342
31531,1000007,1,933,758,175,0.812433,0.187567,0.812433,156,19,934,759,175,0.812634,0.187366,0.812634,156,19,1, merged,0,0,0.692522608491
31532,1000004,2,2000,1759,241,0.8795,0.1205,1.692134,188,53,2001,1760,241,0.87956,0.12044,1.692394,188,53,1, merged,0,0,0.430686132578
31532,1000007,1,934,759,175,0.812634,0.187366,0.812634,156,19,935,760,175,0.812834,0.187166,0.812834,156,19,1, merged,0,0,0.692903478757
31533,1000004,2,2001,1760,241,0.87956,0.12044,1.692394,188,53,2002,1761,241,0.87962,0.12038,1.692655,188,53,1, merged,0,0,0.43085225535
31533,1000007,1,935,760,175,0.812834,0.187166,0.812834,156,19,936,761,175,0.813034,0.186966,0.813034,156,19,1, merged,0,0,0.693284261315
31534,1000004,2,2002,1761,241,0.87962,0.12038,1.692655,188,53,2003,1762,241,0.87968,0.12032,1.692914,188,53,1, merged,0,0,0.143675009176
31534,1000007,1,936,761,175,0.813034,0.186966,0.813034,156,19,937,762,175,0.813234,0.186766,0.813234,156,19,1, merged,0,0,0.231230479949
31537,1000063,2,2257,2012,245,0.891449,0.108551,1.811157,204,41,2258,2013,245,0.891497,0.108503,1.811787,204,41,1, merged,0,0,0.0726216145059
31537,1000124,3,535,498,37,0.930841,0.069159,2.741998,32,5,536,499,37,0.93097,0.06903,2.742757,32,5,1, merged,0,0,0.113810817029
31549,1000118,2,771,678,93,0.879377,0.120623,1.719377,87,6,772,679,93,0.879534,0.120466,1.706457,87,6,1, merged,0,0,0.0875628888657
31570,1000091,2,389,295,94,0.758355,0.241645,1.678645,79,15,390,296,94,0.758974,0.241026,1.679838,79,15,1, merged,0,0,0.691229893253
31571,1000118,1,773,680,93,0.87969,0.12031,0.87969,87,6,774,681,93,0.879845,0.120155,0.879845,87,6,-1, merged,0,0,0.069121908511
31577,1000120,2,726,598,128,0.823691,0.176309,1.654123,115,13,727,599,128,0.823934,0.176066,1.654494,115,13,1, merged,0,0,0
31577,1000121,1,1321,1097,224,0.830431,0.169569,0.830431,210,14,1322,1098,224,0.83056,0.16944,0.83056,210,14,1, merged,0,0,0.00015229972586
31578,1000120,2,727,599,128,0.823934,0.176066,1.654494,115,13,728,600,128,0.824176,0.175824,1.654864,115,13,1, merged,0,0,0.00139324277255
31578,1000121,1,1322,1098,224,0.83056,0.16944,0.83056,210,14,1323,1099,224,0.830688,0.169312,0.830688,210,14,1, merged,0,0,0.000456864387421
31588,1000015,2,1378,1236,142,0.896952,0.103048,1.667444,130,12,1380,1238,142,0.897101,0.102899,1.661329,130,12,-1, merged,0,0,0.143550244967
31589,1000120,2,728,600,128,0.824176,0.175824,1.684005,115,13,729,601,128,0.824417,0.175583,1.684485,115,13,1, merged,0,0,0.0505174840481
31596,1000124,2,540,503,37,0.931481,0.068519,1.697009,32,5,542,505,37,0.931734,0.068266,1.696893,32,5,-1, merged,0,0,0.209948943868
31596,1000329,1,2077,1590,487,0.765527,0.234473,0.765527,436,51,2078,1590,488,0.765159,0.234841,0.765159,437,51,1, merged,1,1,0.423053394024
31600,1000009,2,757,643,114,0.849406,0.150594,1.746656,105,9,758,644,114,0.849604,0.150396,1.746929,105,9,1, merged,0,0,0.00381825124093
31600,1000015,1,1382,1240,142,0.89725,0.10275,0.89725,130,12,1383,1241,142,0.897325,0.102675,0.897325,130,12,1, merged,0,0,0.000152178048317
31602,1000124,2,543,506,37,0.93186,0.06814,1.852723,32,5,544,507,37,0.931985,0.068015,1.853414,32,5,1, merged,0,0,0.430296840367
31603,1000004,2,2007,1766,241,0.87992,0.12008,1.73667,188,53,2009,1768,241,0.88004,0.11996,1.737574,188,53,-1, merged,0,0,0.0149405112919
31604,1000015,2,1383,1241,142,0.897325,0.102675,1.818753,130,12,1384,1242,142,0.897399,0.102601,1.819385,130,12,1, merged,0,0,0.912730716254
31612,1000121,2,1323,1099,224,0.830688,0.169312,1.768959,210,14,1324,1100,224,0.830816,0.169184,1.746478,210,14,1, merged,0,0,0.000197021698611
31613,1000121,3,1324,1100,224,0.830816,0.169184,2.495812,210,14,1325,1101,224,0.830943,0.169057,2.475061,210,14,1, merged,0,0,0.0142446839994
31620,1000091,2,390,296,94,0.758974,0.241026,1.68096,79,15,391,297,94,0.759591,0.240409,1.682126,79,15,1, merged,0,0,0.692779571767
31622,1000118,2,774,681,93,0.879845,0.120155,1.719223,87,6,775,682,93,0.88,0.12,1.720206,87,6,1, merged,0,0,0.207389619626
31629,1000023,1,387,341,46,0.881137,0.118863,0.881137,43,3,388,341,47,0.878866,0.121134,0.878866,44,3,1, merged,1,1,0.000142406085562
31635,1000329,2,2079,1591,488,0.765272,0.234728,1.529499,437,51,2080,1592,488,0.765385,0.234615,1.531514,437,51,1, merged,0,0,0
31646,1000005,3,210,159,51,0.757143,0.242857,1.846118,46,5,211,160,51,0.758294,0.241706,1.819304,46,5,-1, abandoned,0,0,0.200354333044
31667,1000124,2,546,509,37,0.932234,0.067766,1.770263,32,5,547,510,37,0.932358,0.067642,1.768424,32,5,1, merged,0,0,0.430219028806
31667,1000592,1,426,357,69,0.838028,0.161972,0.838028,44,25,427,357,70,0.836066,0.163934,0.836066,45,25,1, merged,1,1,0.662797005038
31668,1000121,1,1325,1101,224,0.830943,0.169057,0.830943,210,14,1326,1101,225,0.830317,0.169683,0.830317,211,14,1, merged,1,1,0.0346036797473
31669,1000592,1,427,357,70,0.836066,0.163934,0.836066,45,25,428,358,70,0.836449,0.163551,0.836449,45,25,1, merged,0,0,0.356924541801
31672,1000166,3,185,160,25,0.864865,0.135135,2.66913,23,2,186,161,25,0.865591,0.134409,2.670976,23,2,1, merged,0,0,0.00346583769212
31673,1000166,2,186,161,25,0.865591,0.134409,1.592864,23,2,188,162,26,0.861702,0.138298,1.580803,24,2,1, merged,1,1,0.00915793282037
31675,1000166,2,188,162,26,0.861702,0.138298,1.785313,24,2,189,163,26,0.862434,0.137566,1.786572,24,2,1, merged,0,0,0.0523963646347
31676,1000166,2,189,163,26,0.862434,0.137566,1.581535,24,2,190,164,26,0.863158,0.136842,1.58538,24,2,1, merged,0,0,0.0389015649932
31677,1000004,1,2013,1771,242,0.879781,0.120219,0.879781,188,54,2016,1773,243,0.879464,0.120536,0.879464,189,54,-1, merged,1,0,0.0183454751017
31679,1000004,1,2016,1773,243,0.879464,0.120536,0.879464,189,54,2020,1777,243,0.879703,0.120297,0.879703,189,54,-1, merged,0,0,0.142902228141
31679,1000014,3,1481,1258,223,0.849426,0.150574,2.653028,209,14,1484,1259,225,0.848383,0.151617,2.653256,211,14,1, merged,1,1,0.168307133592
31682,1000124,3,548,511,37,0.932482,0.067518,2.579874,32,5,549,512,37,0.932605,0.067395,2.583555,32,5,1, merged,0,0,0.0378871351267
31684,1000124,2,549,512,37,0.932605,0.067395,1.657879,32,5,550,513,37,0.932727,0.067273,1.660988,32,5,1, merged,0,0,0.0263144815617
31685,1000124,3,550,513,37,0.932727,0.067273,2.586664,32,5,551,514,37,0.932849,0.067151,2.590207,32,5,1, merged,0,0,0.0601644832387
31688,1000124,1,551,514,37,0.932849,0.067151,0.932849,32,5,552,515,37,0.932971,0.067029,0.932971,32,5,1, merged,0,0,0.0844424549033
31694,1000004,1,2022,1779,243,0.879822,0.120178,0.879822,189,54,2023,1780,243,0.879881,0.120119,0.879881,189,54,1, merged,0,0,0.298765765102
31694,1000124,3,552,515,37,0.932971,0.067029,2.734871,32,5,554,516,38,0.931408,0.068592,2.73387,32,6,-1, merged,1,1,0.453987693954
31695,1000070,2,860,753,107,0.875581,0.124419,1.798162,90,17,861,754,107,0.875726,0.124274,1.798803,90,17,1, merged,0,0,0.772502161591
31697,1000004,2,2023,1780,243,0.879881,0.120119,1.693115,189,54,2024,1781,243,0.879941,0.120059,1.693374,189,54,1, merged,0,0,0.217122158236
31697,1000007,1,937,762,175,0.813234,0.186766,0.813234,156,19,938,763,175,0.813433,0.186567,0.813433,156,19,1, merged,0,0,0.351149212302
31698,1000004,2,2024,1781,243,0.879941,0.120059,1.693374,189,54,2025,1782,243,0.88,0.12,1.693632,189,54,1, merged,0,0,0.217247167214
31698,1000007,1,938,763,175,0.813433,0.186567,0.813433,156,19,939,764,175,0.813632,0.186368,0.813632,156,19,1, merged,0,0,0.351427988209
31699,1000004,2,2025,1782,243,0.88,0.12,1.693632,189,54,2026,1783,243,0.880059,0.119941,1.693889,189,54,1, merged,0,0,0.430286379513
31699,1000007,1,939,764,175,0.813632,0.186368,0.813632,156,19,940,765,175,0.81383,0.18617,0.81383,156,19,1, merged,0,0,0.692473692571
31700,1000004,2,2026,1783,243,0.880059,0.119941,1.693889,189,54,2027,1784,243,0.880118,0.119882,1.694146,189,54,1, merged,0,0,0.0716883952245
31700,1000007,1,940,765,175,0.81383,0.18617,0.81383,156,19,941,766,175,0.814028,0.185972,0.814028,156,19,1, merged,0,0,0.115324539672
31701,1000004,2,2027,1784,243,0.880118,0.119882,1.694146,189,54,2028,1785,243,0.880178,0.119822,1.694403,189,54,1, merged,0,0,0.144324789158
31701,1000007,1,941,766,175,0.814028,0.185972,0.814028,156,19,942,767,175,0.814225,0.185775,0.814225,156,19,1, merged,0,0,0.232937117166
31705,1000329,2,2084,1596,488,0.765835,0.234165,1.523544,437,51,2085,1597,488,0.765947,0.234053,1.520333,437,51,-1, abandoned,0,0,0.838119224156
31709,1000004,1,2028,1785,243,0.880178,0.119822,0.880178,189,54,2032,1788,244,0.879921,0.120079,0.879921,190,54,-1, merged,1,0,0.422560007976
31712,1000004,2,2032,1788,244,0.879921,0.120079,1.803972,190,54,2034,1790,244,0.880039,0.119961,1.798789,190,54,-1, merged,0,0,0.211363993379
31715,1000004,1,2034,1790,244,0.880039,0.119961,0.880039,190,54,2036,1791,245,0.879666,0.120334,0.879666,191,54,1, merged,1,1,0.0401114206128
31715,1000132,3,233,209,24,0.896996,0.103004,2.527698,19,5,234,210,24,0.897436,0.102564,2.528425,19,5,1, merged,0,0,0.00860215053763
31715,1000153,4,676,617,59,0.912722,0.087278,3.44042,45,14,677,618,59,0.912851,0.087149,3.441275,45,14,1, merged,0,0,0.000601805416249
31721,1000121,4,1326,1101,225,0.830317,0.169683,2.741086,211,14,1327,1102,225,0.830445,0.169555,2.633489,211,14,-1, abandoned,0,0,0
31721,1000132,3,234,210,24,0.897436,0.102564,1.910769,19,5,235,211,24,0.897872,0.102128,1.803045,19,5,-1, abandoned,0,0,0.0101028078474
31721,1002169,2,3,1,2,0.333333,0.666667,1.013333,2,0,4,1,3,0.25,0.75,0.905172,3,0,1, abandoned,1,1,0
31723,1000132,3,235,211,24,0.897872,0.102128,1.803045,19,5,237,212,25,0.894515,0.105485,1.727848,20,5,1, merged,1,1,0.161630592581
31723,1002169,1,4,1,3,0.25,0.75,0.25,3,0,5,1,4,0.2,0.8,0.2,4,0,1, merged,1,1,0
31727,1000004,2,2036,1791,245,0.879666,0.120334,1.728151,191,54,2037,1792,245,0.879725,0.120275,1.727639,191,54,-1, abandoned,0,0,0.0845713634201
31727,1000014,1,1485,1260,225,0.848485,0.151515,0.848485,211,14,1486,1260,226,0.847914,0.152086,0.847914,212,14,1, abandoned,1,1,0.0997793186263
31741,1000023,2,388,341,47,0.878866,0.121134,1.799839,44,3,389,342,47,0.879177,0.120823,1.800389,44,3,1, merged,0,0,0.0331010751193
31743,1000023,1,389,342,47,0.879177,0.120823,0.879177,44,3,390,343,47,0.879487,0.120513,0.879487,44,3,1, merged,0,0,0.00291971885749
31759,1000005,2,211,160,51,0.758294,0.241706,1.258294,46,5,213,162,51,0.760563,0.239437,1.260563,46,5,1, merged,0,0,0.0806319313026
31760,1000004,2,2038,1793,245,0.879784,0.120216,1.727698,191,54,2041,1796,245,0.879961,0.120039,1.727714,191,54,-1, merged,0,0,0.00870005921066
31760,1000014,1,1486,1260,226,0.847914,0.152086,0.847914,212,14,1491,1264,227,0.847753,0.152247,0.847753,213,14,-1, merged,1,0,0.00468746969662
31760,1000121,3,1327,1102,225,0.830445,0.169555,2.558143,211,14,1328,1103,225,0.830572,0.169428,2.558286,211,14,-1, merged,0,0,0.00988175861211
31763,1000004,1,2041,1796,245,0.879961,0.120039,0.879961,191,54,2045,1799,246,0.879707,0.120293,0.879707,192,54,-1, merged,1,0,0.000649593838131
31766,1000003,2,884,748,136,0.846154,0.153846,1.765409,125,11,885,749,136,0.846328,0.153672,1.766081,125,11,1, merged,0,0,0.928273743839
31769,1000534,1,108,74,34,0.685185,0.314815,0.685185,32,2,110,76,34,0.690909,0.309091,0.690909,32,2,-1, merged,0,0,1.10425968426
31770,1000023,2,390,343,47,0.879487,0.120513,1.740031,44,3,391,344,47,0.879795,0.120205,1.740812,44,3,1, merged,0,0,2.652774847e-07
31775,1000014,1,1492,1265,227,0.847855,0.152145,0.847855,213,14,1493,1266,227,0.847957,0.152043,0.847957,213,14,1, merged,0,0,0.654025618819
31775,1000070,2,861,754,107,0.875726,0.124274,1.723581,90,17,862,755,107,0.87587,0.12413,1.723827,90,17,1, merged,0,0,0.806752635497
31776,1000014,1,1493,1266,227,0.847957,0.152043,0.847957,213,14,1495,1267,228,0.847492,0.152508,0.847492,214,14,1, merged,1,1,0.654375323499
31776,1000070,2,862,755,107,0.87587,0.12413,1.723827,90,17,863,756,107,0.876014,0.123986,1.723506,90,17,1, merged,0,0,0.807289315726
31785,1000004,1,2048,1802,246,0.879883,0.120117,0.879883,192,54,2049,1803,246,0.879941,0.120059,0.879941,192,54,-1, merged,0,0,0.508068532629
31785,1000328,2,633,456,177,0.720379,0.279621,1.600262,159,18,634,457,177,0.72082,0.27918,1.600762,159,18,1, merged,0,0,0.978044464959
31787,1000014,2,1495,1267,228,0.847492,0.152508,1.762621,214,14,1496,1268,228,0.847594,0.152406,1.763035,214,14,1, merged,0,0,0.609409998458
31787,1000026,1,271,248,23,0.915129,0.084871,0.915129,21,2,272,249,23,0.915441,0.084559,0.915441,21,2,1, merged,0,0,0.402349374763
31793,1000004,1,2049,1803,246,0.879941,0.120059,0.879941,192,54,2051,1804,247,0.879571,0.120429,0.879571,192,55,-1, merged,1,1,0.000637680352562
31793,1000063,2,2266,2021,245,0.89188,0.10812,1.771821,204,41,2267,2022,245,0.891928,0.108072,1.771499,204,41,1, merged,0,0,0.00814637481785
31794,1000070,2,865,758,107,0.876301,0.123699,1.562712,90,17,866,759,107,0.876443,0.123557,1.565025,90,17,1, merged,0,0,0.255759513774
31808,1000023,2,391,344,47,0.879795,0.120205,1.801246,44,3,392,345,47,0.880102,0.119898,1.802024,44,3,1, merged,0,0,0.00195941340706
31810,1000023,2,393,346,47,0.880407,0.119593,1.802329,44,3,394,347,47,0.880711,0.119289,1.802866,44,3,1, merged,0,0,0.00650147255689
31811,1000063,2,2268,2023,245,0.891975,0.108025,1.725589,204,41,2271,2026,245,0.892118,0.107882,1.724614,204,41,-1, merged,0,0,0.165996567063
31815,1000004,3,2051,1804,247,0.879571,0.120429,2.682437,192,55,2052,1805,247,0.87963,0.12037,2.68303,192,55,1, merged,0,0,0.00142159589591
31815,1000023,2,394,347,47,0.880711,0.119289,1.802866,44,3,395,348,47,0.881013,0.118987,1.803401,44,3,1, merged,0,0,0.0174117125453
31816,1000004,3,2052,1805,247,0.87963,0.12037,2.68303,192,55,2053,1806,247,0.879688,0.120312,2.68362,192,55,1, merged,0,0,0.00157692706712
31816,1000023,2,395,348,47,0.881013,0.118987,1.803401,44,3,396,349,47,0.881313,0.118687,1.803932,44,3,1, merged,0,0,0.00854604649398
31817,1000014,3,1499,1271,228,0.847899,0.152101,2.387187,214,14,1500,1272,228,0.848,0.152,2.394429,214,14,1, merged,0,0,0.498328761746
31827,1000023,1,396,349,47,0.881313,0.118687,0.881313,44,3,397,350,47,0.881612,0.118388,0.881612,44,3,1, merged,0,0,0.00448394799276
31829,1000014,1,1500,1272,228,0.848,0.152,0.848,214,14,1501,1272,229,0.847435,0.152565,0.847435,215,14,1, merged,1,1,0.141814513591
31833,1000014,1,1501,1272,229,0.847435,0.152565,0.847435,215,14,1506,1276,230,0.847278,0.152722,0.847278,216,14,1, merged,1,1,0.582692279039
31833,1000120,3,729,601,128,0.824417,0.175583,2.282963,115,13,730,602,128,0.824658,0.175342,2.250882,115,13,1, merged,0,0,0.404942705237
31838,1000015,1,1388,1245,143,0.896974,0.103026,0.896974,131,12,1390,1247,143,0.897122,0.102878,0.897122,131,12,1, merged,0,0,0.0265084746656
31838,1000327,2,612,477,135,0.779412,0.220588,1.676386,104,31,613,478,135,0.779772,0.220228,1.676894,104,31,1, merged,0,0,0.0172250838249
31842,1000054,1,102,90,12,0.882353,0.117647,0.882353,8,4,103,90,13,0.873786,0.126214,0.873786,9,4,1, merged,1,1,0.19060181501
31842,1000124,2,554,516,38,0.931408,0.068592,1.813761,32,6,556,518,38,0.931655,0.068345,1.805441,32,6,-1, merged,0,0,0.187740059846
31852,1000121,1,1330,1104,226,0.830075,0.169925,0.830075,212,14,1331,1105,226,0.830203,0.169797,0.830203,212,14,1, merged,0,0,0.135169779178
31853,1000121,2,1331,1105,226,0.830203,0.169797,1.585661,212,14,1332,1106,226,0.83033,0.16967,1.586852,212,14,1, merged,0,0,0.135325528597
31854,1000121,1,1332,1106,226,0.83033,0.16967,0.83033,212,14,1335,1108,227,0.829963,0.170037,0.829963,213,14,1, merged,1,1,0.0677374712327
31855,1000121,1,1335,1108,227,0.829963,0.170037,0.829963,213,14,1337,1109,228,0.829469,0.170531,0.829469,214,14,1, merged,1,1,0.0904416794692
31856,1000054,1,104,91,13,0.875,0.125,0.875,9,4,105,92,13,0.87619,0.12381,0.87619,9,4,-1, merged,0,0,0.751402430408
31869,1000063,1,2272,2027,245,0.892165,0.107835,0.892165,204,41,2276,2031,245,0.892355,0.107645,0.892355,204,41,-1, abandoned,0,0,0.320404214611
31873,1000023,2,398,351,47,0.88191,0.11809,1.804986,44,3,399,352,47,0.882206,0.117794,1.799853,44,3,1, merged,0,0,0.00232823868775
31875,1000023,2,399,352,47,0.882206,0.117794,1.799853,44,3,400,353,47,0.8825,0.1175,1.800389,44,3,1, merged,0,0,0.00141902161108
31877,1000023,1,400,353,47,0.8825,0.1175,0.8825,44,3,401,354,47,0.882793,0.117207,0.882793,44,3,1, merged,0,0,0.00328071423524
31878,1000023,1,401,354,47,0.882793,0.117207,0.882793,44,3,402,354,48,0.880597,0.119403,0.880597,45,3,1, merged,1,1,0.00364577677074
31896,1000014,2,1513,1283,230,0.847984,0.152016,1.677453,216,14,1514,1284,230,0.848085,0.151915,1.677681,216,14,1, merged,0,0,0.00927373137439
31896,1000121,1,1337,1109,228,0.829469,0.170531,0.829469,214,14,1338,1110,228,0.829596,0.170404,0.829596,214,14,1, merged,0,0,0.00233768192444
31902,1000054,1,105,92,13,0.87619,0.12381,0.87619,9,4,106,93,13,0.877358,0.122642,0.877358,9,4,-1, merged,0,0,0.79419392806
31908,1000004,1,2055,1808,247,0.879805,0.120195,0.879805,192,55,2057,1810,247,0.879922,0.120078,0.879922,192,55,-1, merged,0,0,0.0384770421165
31916,1000004,2,2058,1810,248,0.879495,0.120505,1.694309,192,56,2059,1811,248,0.879553,0.120447,1.694564,192,56,1, merged,0,0,0.432980122836
31916,1000007,1,945,770,175,0.814815,0.185185,0.814815,156,19,946,771,175,0.815011,0.184989,0.815011,156,19,1, merged,0,0,0.698412425023
31917,1000004,2,2059,1811,248,0.879553,0.120447,1.694564,192,56,2060,1812,248,0.879612,0.120388,1.694818,192,56,1, merged,0,0,0.433145346787
31917,1000007,1,946,771,175,0.815011,0.184989,0.815011,156,19,947,772,175,0.815206,0.184794,0.815206,156,19,1, merged,0,0,0.69879148215
31919,1000004,2,2060,1812,248,0.879612,0.120388,1.695012,192,56,2061,1813,248,0.87967,0.12033,1.695265,192,56,1, merged,0,0,0.144629249202
31919,1000007,1,948,773,175,0.815401,0.184599,0.815401,156,19,949,774,175,0.815595,0.184405,0.815595,156,19,1, merged,0,0,0.23352691353
31920,1000004,2,2061,1813,248,0.87967,0.12033,1.695265,192,56,2062,1814,248,0.879728,0.120272,1.695518,192,56,1, merged,0,0,0.43380915494
31920,1000007,1,949,774,175,0.815595,0.184405,0.815595,156,19,950,775,175,0.815789,0.184211,0.815789,156,19,1, merged,0,0,0.700283856514
31921,1000004,2,2062,1814,248,0.879728,0.120272,1.695518,192,56,2064,1816,248,0.879845,0.120155,1.694777,192,56,-1, merged,0,0,0.217154245865
31921,1000007,1,950,775,175,0.815789,0.184211,0.815789,156,19,951,775,176,0.814932,0.185068,0.814932,157,19,1, merged,1,1,0.350752876362
31921,1000120,3,731,603,128,0.824897,0.175103,2.520415,115,13,732,604,128,0.825137,0.174863,2.519913,115,13,1, merged,0,0,0.19656751963
31922,1000004,2,2064,1816,248,0.879845,0.120155,1.694777,192,56,2065,1817,248,0.879903,0.120097,1.695029,192,56,1, merged,0,0,0.14485145396
31922,1000007,1,951,775,176,0.814932,0.185068,0.814932,157,19,952,776,176,0.815126,0.184874,0.815126,157,19,1, merged,0,0,0.234016205283
31923,1000004,2,2065,1817,248,0.879903,0.120097,1.695029,192,56,2067,1819,248,0.880019,0.119981,1.69429,192,56,-1, merged,0,0,0.217445452487
31923,1000007,1,952,776,176,0.815126,0.184874,0.815126,157,19,953,776,177,0.814271,0.185729,0.814271,158,19,1, merged,1,1,0.351397672105
31923,1000120,3,732,604,128,0.825137,0.174863,2.520166,115,13,733,605,128,0.825375,0.174625,2.519665,115,13,1, merged,0,0,0.197511605942
31925,1000004,2,2067,1819,248,0.880019,0.119981,1.694485,192,56,2068,1820,248,0.880077,0.119923,1.694737,192,56,1, merged,0,0,0.434808817839
31925,1000007,1,954,777,177,0.814465,0.185535,0.814465,158,19,955,778,177,0.81466,0.18534,0.81466,158,19,1, merged,0,0,0.702484388987
31926,1000004,2,2068,1820,248,0.880077,0.119923,1.694737,192,56,2069,1821,248,0.880135,0.119865,1.694989,192,56,1, merged,0,0,0.434973842426
31926,1000007,1,955,778,177,0.81466,0.18534,0.81466,158,19,956,779,177,0.814854,0.185146,0.814854,158,19,1, merged,0,0,0.702862327739
31927,1000004,2,2069,1821,248,0.880135,0.119865,1.694989,192,56,2070,1822,248,0.880193,0.119807,1.69524,192,56,1, merged,0,0,0.435138851737
31927,1000007,1,956,779,177,0.814854,0.185146,0.814854,158,19,957,780,177,0.815047,0.184953,0.815047,158,19,1, merged,0,0,0.703240179868
31928,1000004,2,2070,1822,248,0.880193,0.119807,1.69524,192,56,2071,1823,248,0.880251,0.119749,1.695491,192,56,1, merged,0,0,0.217737955746
31928,1000007,1,957,780,177,0.815047,0.184953,0.815047,158,19,958,781,177,0.81524,0.18476,0.81524,158,19,1, merged,0,0,0.352029656153
31929,1000121,1,1338,1110,228,0.829596,0.170404,0.829596,214,14,1339,1111,228,0.829724,0.170276,0.829724,214,14,1, merged,0,0,0.000150025905785
31929,1000328,2,635,458,177,0.72126,0.27874,1.550856,159,18,636,459,177,0.721698,0.278302,1.551422,159,18,1, merged,0,0,0.000157804217962
31936,1000121,2,1339,1111,228,0.829724,0.170276,1.552728,214,14,1341,1112,229,0.829232,0.170768,1.551107,215,14,1, merged,1,1,0.00162768562129
31936,1000328,1,639,462,177,0.723005,0.276995,0.723005,159,18,640,462,178,0.721875,0.278125,0.721875,160,18,1, merged,1,1,0.00228387071142
31958,1000328,1,641,463,178,0.722309,0.277691,0.722309,160,18,642,464,178,0.722741,0.277259,0.722741,160,18,1, merged,0,0,0.492214739777
31958,1000592,2,431,361,70,0.837587,0.162413,1.559896,45,25,432,362,70,0.837963,0.162037,1.560704,45,25,1, merged,0,0,0.322856109906
31978,1000004,3,2077,1829,248,0.880597,0.119403,2.568361,192,56,2081,1832,249,0.880346,0.119654,2.48912,193,56,-1, merged,1,0,0.0107366658392
31978,1000121,2,1352,1123,229,0.830621,0.169379,1.687764,215,14,1355,1126,229,0.830996,0.169004,1.608774,215,14,-1, merged,0,0,0.0265611369645
31983,1000121,1,1355,1126,229,0.830996,0.169004,0.830996,215,14,1356,1127,229,0.831121,0.168879,0.831121,215,14,1, merged,0,0,0.00842041438214
31983,1000329,2,2098,1609,489,0.766921,0.233079,1.597917,438,51,2099,1610,489,0.767032,0.232968,1.598153,438,51,1, merged,0,0,0.00483057323587
31987,1000004,2,2084,1835,249,0.880518,0.119482,1.64755,193,56,2085,1836,249,0.880576,0.119424,1.647829,193,56,-1, merged,0,0,0.0189767796062
31987,1000329,1,2099,1610,489,0.767032,0.232968,0.767032,438,51,2101,1612,489,0.767254,0.232746,0.767254,438,51,-1, merged,0,0,0.0544099766831
31991,1000004,2,2085,1836,249,0.880576,0.119424,1.706662,193,56,2086,1837,249,0.880633,0.119367,1.706956,193,56,1, merged,0,0,0.218335822796
31991,1000120,1,736,608,128,0.826087,0.173913,0.826087,115,13,737,609,128,0.826323,0.173677,0.826323,115,13,1, merged,0,0,0.200112005088
31995,1000063,1,2281,2035,246,0.892153,0.107847,0.892153,205,41,2282,2036,246,0.8922,0.1078,0.8922,205,41,1, merged,0,0,0.332405679084
32020,1000054,2,106,93,13,0.877358,0.122642,1.809863,9,4,107,94,13,0.878505,0.121495,1.811129,9,4,1, merged,0,0,0.72028902097
32020,1000118,3,780,687,93,0.880769,0.119231,2.690632,87,6,781,688,93,0.880922,0.119078,2.692051,87,6,1, merged,0,0,0.350106021648
32020,1000124,1,563,525,38,0.932504,0.067496,0.932504,32,6,564,526,38,0.932624,0.067376,0.932624,32,6,-1, merged,0,0,0.444131008206
32025,1000004,1,2087,1838,249,0.88069,0.11931,0.88069,193,56,2089,1840,249,0.880804,0.119196,0.880804,193,56,-1, merged,0,0,0.424311763835
32029,1000120,2,739,611,128,0.826793,0.173207,1.40574,115,13,740,612,128,0.827027,0.172973,1.427027,115,13,1, merged,0,0,0.202500801538
32034,1000054,1,108,95,13,0.87963,0.12037,0.87963,9,4,109,96,13,0.880734,0.119266,0.880734,9,4,-1, merged,0,0,0.0555469396473
32034,1000166,2,192,166,26,0.864583,0.135417,1.744213,24,2,194,167,27,0.860825,0.139175,1.741559,25,2,1, merged,1,1,0.0310674196472
32038,1000043,6,351,288,63,0.820513,0.179487,3.112676,54,9,352,288,64,0.818182,0.181818,3.087786,55,9,1, abandoned,1,1,0
32039,1000014,1,1515,1285,230,0.848185,0.151815,0.848185,216,14,1516,1286,230,0.848285,0.151715,0.848285,216,14,1, merged,0,0,0.0444445344735
32039,1000124,2,565,527,38,0.932743,0.067257,1.780928,32,6,566,528,38,0.932862,0.067138,1.781147,32,6,1, merged,0,0,0.0365418130043
32041,1000105,2,402,306,96,0.761194,0.238806,1.484367,86,10,403,307,96,0.761787,0.238213,1.485389,86,10,1, merged,0,0,0.359943587765
32041,1000328,1,643,465,178,0.723173,0.276827,0.723173,160,18,644,466,178,0.723602,0.276398,0.723602,160,18,1, merged,0,0,0.198053123699
32046,1000004,1,2090,1841,249,0.880861,0.119139,0.880861,193,56,2091,1842,249,0.880918,0.119082,0.880918,193,56,1, merged,0,0,0.0262596636125
32048,1000004,1,2091,1842,249,0.880918,0.119082,0.880918,193,56,2092,1842,250,0.880497,0.119503,0.880497,193,57,-1, merged,1,1,0.21024166103
32048,1000120,2,740,612,128,0.827027,0.172973,1.707945,115,13,741,613,128,0.82726,0.17274,1.707758,115,13,1, merged,0,0,0.209883097591
32051,1000120,3,741,613,128,0.82726,0.17274,2.389803,115,13,742,614,128,0.827493,0.172507,2.392986,115,13,1, merged,0,0,0.0634661894957
32052,1000120,2,742,614,128,0.827493,0.172507,1.75057,115,13,743,615,128,0.827725,0.172275,1.756297,115,13,1, merged,0,0,0.145834354325
32054,1000004,2,2092,1842,250,0.880497,0.119503,1.708223,193,57,2093,1843,250,0.880554,0.119446,1.708511,193,57,1, merged,0,0,0.0582564504721
32054,1000120,1,743,615,128,0.827725,0.172275,0.827725,115,13,744,616,128,0.827957,0.172043,0.827957,115,13,1, merged,0,0,0.166546639232
32061,1000014,1,1516,1286,230,0.848285,0.151715,0.848285,216,14,1517,1287,230,0.848385,0.151615,0.848385,216,14,1, merged,0,0,0.587445853731
32061,1000121,2,1359,1130,229,0.831494,0.168506,1.679779,215,14,1360,1131,229,0.831618,0.168382,1.680003,215,14,1, merged,0,0,0.576894426762
32066,1000120,2,748,620,128,0.828877,0.171123,1.531356,115,13,749,621,128,0.829105,0.170895,1.534024,115,13,1, merged,0,0,0.0705692129743
32067,1000120,2,749,621,128,0.829105,0.170895,1.667815,115,13,750,622,128,0.829333,0.170667,1.668414,115,13,1, merged,0,0,0.0359592044116
32067,1000592,1,434,364,70,0.83871,0.16129,0.83871,45,25,435,365,70,0.83908,0.16092,0.83908,45,25,1, merged,0,0,0.0193218375753
32071,1000329,2,2103,1614,489,0.767475,0.232525,1.521321,438,51,2104,1615,489,0.767586,0.232414,1.534009,438,51,1, merged,0,0,0.175299522579
32072,1000329,3,2104,1615,489,0.767586,0.232414,2.296341,438,51,2105,1616,489,0.767696,0.232304,2.293679,438,51,1, merged,0,0,0.0538359220039
32075,1000120,2,751,623,128,0.829561,0.170439,1.597257,115,13,752,624,128,0.829787,0.170213,1.597594,115,13,1, merged,0,0,0.0799416670587
32075,1000329,1,2105,1616,489,0.767696,0.232304,0.767696,438,51,2106,1617,489,0.767806,0.232194,0.767806,438,51,1, merged,0,0,0.00888465382924
32076,1000120,2,752,624,128,0.829787,0.170213,1.597594,115,13,753,625,128,0.830013,0.169987,1.59793,115,13,1, merged,0,0,0.150785250939
32076,1000329,1,2106,1617,489,0.767806,0.232194,0.767806,438,51,2107,1618,489,0.767916,0.232084,0.767916,438,51,1, merged,0,0,0.0173593512418
32088,1000014,2,1517,1287,230,0.848385,0.151615,1.771462,216,14,1518,1288,230,0.848485,0.151515,1.772014,216,14,1, merged,0,0,0.580168577658
32090,1000004,1,2093,1843,250,0.880554,0.119446,0.880554,193,57,2095,1844,251,0.880191,0.119809,0.880191,194,57,-1, abandoned,1,0,0.0557607243857
32090,1000121,5,1360,1131,229,0.831618,0.168382,3.359704,215,14,1361,1132,229,0.831741,0.168259,3.710155,215,14,-1, abandoned,0,0,0
32090,1002169,4,5,1,4,0.2,0.8,2.528086,4,0,9,5,4,0.555556,0.444444,2.878413,4,0,-1, abandoned,0,0,0
32103,1000063,2,2287,2040,247,0.891998,0.108002,1.809612,206,41,2291,2044,247,0.892187,0.107813,1.804863,206,41,-1, merged,0,0,0.00168033456556
32109,1000121,1,1361,1132,229,0.831741,0.168259,0.831741,215,14,1362,1133,229,0.831865,0.168135,0.831865,215,14,1, merged,0,0,0
32111,1000109,2,359,301,58,0.83844,0.16156,1.83844,55,3,360,302,58,0.838889,0.161111,1.838889,55,3,1, merged,0,0,0.141411240829
32115,1000329,1,2110,1621,489,0.768246,0.231754,0.768246,438,51,2113,1624,489,0.768575,0.231425,0.768575,438,51,-1, merged,0,0,0.71086638005
32125,1000329,1,2113,1624,489,0.768575,0.231425,0.768575,438,51,2115,1625,490,0.768322,0.231678,0.768322,439,51,1, merged,1,1,0.361001991109
32134,1000329,1,2115,1625,490,0.768322,0.231678,0.768322,439,51,2116,1626,490,0.768431,0.231569,0.768431,439,51,1, merged,0,0,0.769224725281
32136,1000592,2,435,365,70,0.83908,0.16092,1.83908,45,25,436,366,70,0.83945,0.16055,1.63945,45,25,1, merged,0,0,0.607833343548
32142,1000003,2,885,749,136,0.846328,0.153672,1.769857,125,11,886,749,137,0.845372,0.154628,1.758163,126,11,1, merged,1,1,0.284758885569
32142,1000328,5,647,469,178,0.724884,0.275116,4.027458,160,18,648,470,178,0.725309,0.274691,4.017135,160,18,1, merged,0,0,0.297119543128
32142,1000329,4,2116,1626,490,0.768431,0.231569,3.302574,439,51,2118,1626,492,0.767705,0.232295,3.291826,441,51,1, merged,1,1,0.354989165922
32143,1000329,2,2118,1626,492,0.767705,0.232295,1.680496,441,51,2119,1627,492,0.767815,0.232185,1.68111,441,51,1, merged,0,0,0.728355342676
32144,1000329,2,2119,1627,492,0.767815,0.232185,1.533772,441,51,2122,1629,493,0.767672,0.232328,1.535278,442,51,-1, merged,1,0,0.355272935911
32145,1000592,2,436,366,70,0.83945,0.16055,1.752744,45,25,437,367,70,0.839817,0.160183,1.75361,45,25,1, merged,0,0,0.583522669435
32150,1000043,3,352,288,64,0.818182,0.181818,1.85972,55,9,353,289,64,0.818697,0.181303,1.884337,55,9,1, merged,0,0,0.717627678229
32151,1000534,1,112,78,34,0.696429,0.303571,0.696429,32,2,113,79,34,0.699115,0.300885,0.699115,32,2,1, merged,0,0,0.938890045092
32156,1000063,2,2292,2045,247,0.892234,0.107766,1.806027,206,41,2293,2046,247,0.892281,0.107719,1.806567,206,41,1, merged,0,0,0.176585687211
32164,1000014,1,1521,1290,231,0.848126,0.151874,0.848126,216,15,1522,1291,231,0.848226,0.151774,0.848226,216,15,1, merged,0,0,0.495909104382
32166,1000054,1,112,99,13,0.883929,0.116071,0.883929,9,4,114,101,13,0.885965,0.114035,0.885965,9,4,-1, merged,0,0,0.120418544365
32166,1000166,3,194,167,27,0.860825,0.139175,2.603064,25,2,195,168,27,0.861538,0.138462,2.606199,25,2,1, merged,0,0,0.067832415788
32167,1000004,1,2096,1845,251,0.880248,0.119752,0.880248,194,57,2098,1846,252,0.879886,0.120114,0.879886,195,57,-1, merged,1,0,0.024640420928
32167,1000329,2,2123,1630,493,0.767781,0.232219,1.64803,442,51,2126,1632,494,0.767639,0.232361,1.647524,443,51,-1, merged,1,0,0.0282062399506
32168,1000121,2,1367,1138,229,0.83248,0.16752,1.557789,215,14,1368,1138,230,0.831871,0.168129,1.556487,216,14,1, abandoned,1,1,0.293938730414
32168,1000328,1,648,470,178,0.725309,0.274691,0.725309,160,18,650,471,179,0.724615,0.275385,0.724615,161,18,1, abandoned,1,1,0.29650653235
32169,1000121,1,1368,1138,230,0.831871,0.168129,0.831871,216,14,1369,1138,231,0.831264,0.168736,0.831264,217,14,1, abandoned,1,1,0.196149828672
32169,1000328,2,650,471,179,0.724615,0.275385,1.556487,161,18,652,472,180,0.723926,0.276074,1.55519,162,18,1, abandoned,1,1,0.198368775557
32174,1000004,2,2101,1849,252,0.880057,0.119943,1.794343,195,57,2103,1851,252,0.880171,0.119829,1.795425,195,57,-1, merged,0,0,0.0410793271806
32192,1000328,2,652,472,180,0.723926,0.276074,1.491674,162,18,653,473,180,0.724349,0.275651,1.492206,162,18,1, merged,0,0,0.706141331419
32192,1000329,1,2127,1633,494,0.767748,0.232252,0.767748,443,51,2128,1634,494,0.767857,0.232143,0.767857,443,51,1, merged,0,0,0.756446516781
32207,1000023,1,404,356,48,0.881188,0.118812,0.881188,45,3,406,356,50,0.876847,0.123153,0.876847,47,3,1, merged,1,1,0.0144189582554
32212,1000121,2,1369,1138,231,0.831264,0.168736,1.599121,217,14,1370,1139,231,0.831387,0.168613,1.599353,217,14,1, merged,0,0,0.594994768256
32212,1000329,1,2128,1634,494,0.767857,0.232143,0.767857,443,51,2129,1635,494,0.767966,0.232034,0.767966,443,51,1, merged,0,0,0.705343154393
32215,1000329,1,2129,1635,494,0.767966,0.232034,0.767966,443,51,2130,1636,494,0.768075,0.231925,0.768075,443,51,1, merged,0,0,0.000241230274464
32216,1000004,2,2110,1858,252,0.880569,0.119431,0.880569,195,57,2113,1860,253,0.880265,0.119735,0.880265,196,57,1, merged,1,1,0.0154844429737
32219,1000105,1,405,308,97,0.760494,0.239506,0.760494,87,10,406,309,97,0.761084,0.238916,0.761084,87,10,1, merged,0,0,0.10519109727
32219,1000592,2,438,368,70,0.840183,0.159817,1.600676,45,25,440,369,71,0.838636,0.161364,1.59972,45,26,-1, merged,1,1,0.178100673076
32222,1000004,2,2113,1860,253,0.880265,0.119735,0.880265,196,57,2118,1865,253,0.880548,0.119452,0.880548,196,57,-1, merged,0,0,0
32230,1000329,2,2130,1636,494,0.768075,0.231925,1.387123,443,51,2132,1637,495,0.767824,0.232176,1.358733,444,51,1, merged,1,1,0.773403210323
32231,1000592,2,440,369,71,0.838636,0.161364,1.606242,45,26,441,370,71,0.839002,0.160998,1.60452,45,26,1, merged,0,0,0.267365714768
32234,1000153,2,681,622,59,0.913363,0.086637,1.830029,45,14,682,623,59,0.91349,0.08651,1.836567,45,14,1, merged,0,0,0
32235,1000592,2,441,370,71,0.839002,0.160998,1.429911,45,26,442,371,71,0.839367,0.160633,1.448062,45,26,1, merged,0,0,0.4042414504
32243,1000004,2,2118,1865,253,0.880548,0.119452,1.513881,196,57,2119,1866,253,0.880604,0.119396,1.493507,196,57,-1, abandoned,0,0,0.0466889949226
32245,1000328,1,653,473,180,0.724349,0.275651,0.724349,162,18,657,475,182,0.722983,0.277017,0.722983,164,18,-1, merged,1,0,0.259427041465
32245,1000592,4,442,371,71,0.839367,0.160633,2.329233,45,26,443,372,71,0.839729,0.160271,2.817814,45,26,1, merged,0,0,0.193463252411
32246,1000054,1,116,103,13,0.887931,0.112069,0.887931,9,4,117,104,13,0.888889,0.111111,0.888889,9,4,1, merged,0,0,0.559205911997
32246,1000105,2,408,311,97,0.762255,0.237745,1.650186,87,10,409,312,97,0.762836,0.237164,1.651725,87,10,1, merged,0,0,0.725741978207
32252,1000054,1,117,104,13,0.888889,0.111111,0.888889,9,4,119,104,15,0.87395,0.12605,0.87395,11,4,1, merged,1,1,0.560203243616
32252,1000105,2,409,312,97,0.762836,0.237164,1.651725,87,10,411,314,97,0.76399,0.23601,1.63794,87,10,-1, merged,0,0,0.726431731319
32253,1000328,2,657,475,182,0.722983,0.277017,1.478085,164,18,659,476,183,0.722307,0.277693,1.480696,164,19,-1, merged,1,1,0.259134458597
32263,1000070,2,868,761,107,0.876728,0.123272,1.708606,90,17,871,763,108,0.876005,0.123995,1.707645,91,17,1, merged,1,1,0.26947180336
32263,1000121,1,1374,1143,231,0.831878,0.168122,0.831878,217,14,1378,1146,232,0.83164,0.16836,0.83164,218,14,-1, merged,1,0,0.146720313518
32264,1000004,2,2120,1867,253,0.88066,0.11934,1.644651,196,57,2122,1869,253,0.880773,0.119227,1.643485,196,57,-1, merged,0,0,0.141258602804
32264,1000105,1,411,314,97,0.76399,0.23601,0.76399,87,10,413,315,98,0.762712,0.237288,0.762712,88,10,1, merged,1,1,0.180855837177
32265,1000014,1,1522,1291,231,0.848226,0.151774,0.848226,216,15,1523,1292,231,0.848326,0.151674,0.848326,216,15,1, merged,0,0,0.0140946119835
32268,1000121,2,1378,1146,232,0.83164,0.16836,1.764621,218,14,1379,1147,232,0.831762,0.168238,1.7631,218,14,1, merged,0,0,0.114785446754
32268,1000124,1,567,529,38,0.932981,0.067019,0.932981,32,6,568,529,39,0.931338,0.068662,0.931338,33,6,1, merged,1,1,0.103354722094
32269,1000121,1,1379,1147,232,0.831762,0.168238,0.831762,218,14,1382,1149,233,0.831404,0.168596,0.831404,219,14,-1, merged,1,0,0.294658571558
32270,1000121,1,1382,1149,233,0.831404,0.168596,0.831404,219,14,1384,1150,234,0.830925,0.169075,0.830925,220,14,1, merged,1,1,0.632451262241
32271,1000003,1,886,749,137,0.845372,0.154628,0.845372,126,11,887,749,138,0.844419,0.155581,0.844419,127,11,1, merged,1,1,0.578431172072
32271,1000124,2,568,529,39,0.931338,0.068662,1.77671,33,6,570,530,40,0.929825,0.070175,1.774244,34,6,1, merged,1,1,0.432375335455
32272,1000329,2,2133,1638,495,0.767932,0.232068,1.519566,444,51,2134,1639,495,0.768041,0.231959,1.516428,444,51,1, merged,0,0,0.234963483966
32273,1000329,2,2134,1639,495,0.768041,0.231959,1.524451,444,51,2135,1640,495,0.76815,0.23185,1.525597,444,51,1, merged,0,0,0.729370572034
32275,1000121,2,1384,1150,234,0.830925,0.169075,1.579312,220,14,1386,1151,235,0.830447,0.169553,1.577283,221,14,1, merged,1,1,0.0789972027199
32278,1000328,2,662,479,183,0.723565,0.276435,1.4704,164,19,663,480,183,0.723982,0.276018,1.47241,164,19,1, merged,0,0,0.426020491612
32282,1000121,2,1386,1151,235,0.830447,0.169553,1.578875,221,14,1388,1152,236,0.829971,0.170029,1.575313,222,14,1, merged,1,1,0.049123865931
32299,1000004,2,2126,1873,253,0.880997,0.119003,1.714331,196,57,2127,1874,253,0.881053,0.118947,1.714603,196,57,1, merged,0,0,0.00473930687247
32299,1000120,1,768,640,128,0.833333,0.166667,0.833333,115,13,769,641,128,0.83355,0.16645,0.83355,115,13,1, merged,0,0,0.0128511365609
32303,1000004,2,2127,1874,253,0.881053,0.118947,1.714171,196,57,2128,1875,253,0.881109,0.118891,1.713367,196,57,1, merged,0,0,0.0550784349631
32303,1000120,1,773,644,129,0.833118,0.166882,0.833118,116,13,775,645,130,0.832258,0.167742,0.832258,117,13,1, merged,1,1,0.15725833614
32304,1000004,1,2128,1875,253,0.881109,0.118891,0.881109,196,57,2129,1876,253,0.881165,0.118835,0.881165,196,57,-1, merged,0,0,0
32304,1000120,2,775,645,130,0.832258,0.167742,1.713367,117,13,778,647,131,0.83162,0.16838,1.712784,118,13,-1, merged,1,0,0
32304,1000121,3,1388,1152,236,0.829971,0.170029,2.543338,222,14,1389,1153,236,0.830094,0.169906,2.542878,222,14,1, merged,0,0,0
32308,1000105,1,413,315,98,0.762712,0.237288,0.762712,88,10,414,316,98,0.763285,0.236715,0.763285,88,10,1, merged,0,0,0.128887239582
32308,1000329,2,2138,1642,496,0.768007,0.231993,1.530719,445,51,2139,1643,496,0.768116,0.231884,1.531401,445,51,1, merged,0,0,0.107445262148
32315,1000329,1,2143,1646,497,0.768082,0.231918,0.768082,446,51,2147,1649,498,0.768048,0.231952,0.768048,447,51,-1, merged,1,0,0.35913870383
32318,1000063,1,2297,2050,247,0.892468,0.107532,0.892468,206,41,2298,2051,247,0.892515,0.107485,0.892515,206,41,-1, abandoned,0,0,0.332196845104
32320,1000014,2,1525,1293,232,0.847869,0.152131,1.737777,217,15,1526,1294,232,0.847969,0.152031,1.738878,217,15,1, merged,0,0,0.111639513657
32323,1000121,3,1389,1153,236,0.830094,0.169906,2.451161,222,14,1390,1154,236,0.830216,0.169784,2.4566,222,14,1, merged,0,0,0.468833344502
32336,1000023,3,406,356,50,0.876847,0.123153,1.737274,47,3,407,357,50,0.87715,0.12285,1.73476,47,3,-1, abandoned,0,0,0
32342,1000121,1,1393,1157,236,0.830581,0.169419,0.830581,222,14,1395,1159,236,0.830824,0.169176,0.830824,222,14,-1, merged,0,0,0.0188511007595
32346,1000121,1,1395,1159,236,0.830824,0.169176,0.830824,222,14,1396,1160,236,0.830946,0.169054,0.830946,222,14,1, merged,0,0,0.00295552566026
32350,1000009,2,764,650,114,0.850785,0.149215,1.557682,105,9,765,651,114,0.85098,0.14902,1.560382,105,9,1, merged,0,0,0.14713219783
32350,1000534,1,116,82,34,0.706897,0.293103,0.706897,32,2,117,83,34,0.709402,0.290598,0.709402,32,2,1, merged,0,0,0.135267907358
32351,1000009,2,765,651,114,0.85098,0.14902,1.560382,105,9,766,652,114,0.851175,0.148825,1.563039,105,9,1, merged,0,0,0.639184815798
32351,1000534,1,117,83,34,0.709402,0.290598,0.709402,32,2,118,84,34,0.711864,0.288136,0.711864,32,2,1, merged,0,0,0.561243531606
32353,1000043,1,353,289,64,0.818697,0.181303,0.818697,55,9,354,289,65,0.816384,0.183616,0.816384,56,9,1, merged,1,1,0.00430710777183
32353,1000108,3,22,16,6,0.727273,0.272727,2.437862,4,2,24,17,7,0.708333,0.291667,2.399718,4,3,-1, merged,1,1,0.00488440247476
32353,1000110,2,37,33,4,0.891892,0.108108,1.710589,3,1,40,35,5,0.875,0.125,1.691384,4,1,1, merged,1,1,0.000615889960994
32355,1000012,1,361,312,49,0.864266,0.135734,0.864266,48,1,363,314,49,0.865014,0.134986,0.865014,48,1,-1, merged,0,0,0.0565628731467
32355,1000015,2,1408,1265,143,0.898438,0.101562,1.762703,131,12,1409,1266,143,0.89851,0.10149,1.763523,131,12,1, merged,0,0,0.0744439545325
32361,1000015,2,1409,1266,143,0.89851,0.10149,1.803271,131,12,1410,1267,143,0.898582,0.101418,1.804832,131,12,1, merged,0,0,0.0631269153089
32362,1000015,2,1410,1267,143,0.898582,0.101418,1.804832,131,12,1411,1268,143,0.898653,0.101347,1.805389,131,12,1, merged,0,0,0.336658564236
32367,1000004,1,2131,1878,253,0.881276,0.118724,0.881276,196,57,2132,1879,253,0.881332,0.118668,0.881332,196,57,1, merged,0,0,0.011317969534
32367,1000120,2,778,647,131,0.83162,0.16838,1.712896,118,13,779,648,131,0.831836,0.168164,1.713168,118,13,1, merged,0,0,0.0529031843153
32372,1000004,3,2136,1883,253,0.881554,0.118446,2.52404,196,57,2137,1884,253,0.88161,0.11839,2.521064,196,57,1, merged,0,0,0.0840437152626
32372,1000120,2,781,650,131,0.832266,0.167734,1.642485,118,13,782,650,132,0.831202,0.168798,1.639454,119,13,1, merged,1,1,0.0833188762117
32375,1000120,2,784,652,132,0.831633,0.168367,1.639885,119,13,785,653,132,0.831847,0.168153,1.640564,119,13,1, merged,0,0,0
32386,1000120,2,794,662,132,0.833753,0.166247,1.644651,119,13,795,663,132,0.833962,0.166038,1.642269,119,13,1, merged,0,0,0.139591836735
32389,1000004,2,2137,1884,253,0.88161,0.11839,0.88161,196,57,2139,1885,254,0.881253,0.118747,0.881253,197,57,1, merged,1,1,0.00764758215182
32413,1000004,1,2139,1885,254,0.881253,0.118747,0.881253,197,57,2141,1887,254,0.881364,0.118636,0.881364,197,57,-1, merged,0,0,0.0393867494068
32422,1000120,2,808,676,132,0.836634,0.163366,1.420792,119,13,809,677,132,0.836836,0.163164,1.425071,119,13,1, merged,0,0,0.0442497635996
32424,1000004,2,2141,1887,254,0.881364,0.118636,1.718401,197,57,2142,1888,254,0.881419,0.118581,1.718657,197,57,1, merged,0,0,0.0578649465895
32424,1000120,1,810,678,132,0.837037,0.162963,0.837037,119,13,811,679,132,0.837238,0.162762,0.837238,119,13,1, merged,0,0,0.163049853372
32427,1000120,1,812,680,132,0.837438,0.162562,0.837438,119,13,814,682,132,0.837838,0.162162,0.837838,119,13,1, merged,0,0,0.197378271921
32429,1000091,2,391,297,94,0.759591,0.240409,1.484142,79,15,392,298,94,0.760204,0.239796,1.485167,79,15,1, merged,0,0,0.201066036048
32429,1000328,1,668,484,184,0.724551,0.275449,0.724551,165,19,669,485,184,0.724963,0.275037,0.724963,165,19,1, merged,0,0,0.170401466242
32430,1000091,3,392,298,94,0.760204,0.239796,2.293883,79,15,393,298,95,0.75827,0.24173,2.289124,80,15,1, merged,1,1,0.130707879193
32430,1000328,2,669,485,184,0.724963,0.275037,1.533679,165,19,673,487,186,0.723626,0.276374,1.530854,166,20,1, merged,1,1,0.173032844681
32438,1000004,3,2144,1890,254,0.88153,0.11847,2.426685,197,57,2145,1891,254,0.881585,0.118415,2.420208,197,57,1, merged,0,0,0.0239945769693
32438,1000120,2,814,682,132,0.837838,0.162162,1.545155,119,13,816,683,133,0.83701,0.16299,1.538623,119,14,-1, merged,1,0,0.0703839252568
32439,1000105,2,414,316,98,0.763285,0.236715,1.454007,88,10,415,317,98,0.763855,0.236145,1.455636,88,10,1, merged,0,0,0.163837918595
32441,1000054,1,122,107,15,0.877049,0.122951,0.877049,11,4,125,109,16,0.872,0.128,0.872,12,4,-1, abandoned,1,0,0.559409462469
32441,1000166,2,196,169,27,0.862245,0.137755,1.739294,25,2,198,169,29,0.853535,0.146465,1.725535,27,2,1, abandoned,1,1,0.394477744478
32446,1000329,1,2148,1650,498,0.768156,0.231844,0.768156,447,51,2151,1653,498,0.76848,0.23152,0.76848,447,51,-1, merged,0,0,0.255579096919
32447,1000329,1,2151,1653,498,0.76848,0.23152,0.76848,447,51,2153,1654,499,0.76823,0.23177,0.76823,448,51,1, merged,1,1,0.255840102641
32448,1000329,3,2153,1654,499,0.76823,0.23177,2.380309,448,51,2154,1655,499,0.768338,0.231662,2.374576,448,51,1, merged,0,0,0.256101004133
32449,1000592,2,448,377,71,0.841518,0.158482,1.69337,45,26,450,379,71,0.842222,0.157778,1.691339,45,26,1, merged,0,0,0.269126023304
32451,1000329,1,2154,1655,499,0.768338,0.231662,0.768338,448,51,2157,1657,500,0.768197,0.231803,0.768197,448,52,-1, merged,1,0,0.256361801456
32451,1002169,2,9,5,4,0.555556,0.444444,1.323894,4,0,10,6,4,0.6,0.4,1.368197,4,0,1, merged,0,0,0
32452,1000329,1,2157,1657,500,0.768197,0.231803,0.768197,448,52,2159,1659,500,0.768411,0.231589,0.768411,448,52,-1, merged,0,0,0.513219382155
32453,1000329,1,2159,1659,500,0.768411,0.231589,0.768411,448,52,2161,1660,501,0.768163,0.231837,0.768163,449,52,1, merged,1,1,0
32456,1000105,1,415,317,98,0.763855,0.236145,0.763855,88,10,418,319,99,0.763158,0.236842,0.763158,89,10,-1, merged,1,0,0.600062485628
32459,1000329,2,2161,1660,501,0.768163,0.231837,1.518163,449,52,2162,1661,501,0.76827,0.23173,1.515329,449,52,1, merged,0,0,0.0320106317574
32460,1000328,2,674,488,186,0.724036,0.275964,1.492306,166,20,675,489,186,0.724444,0.275556,1.492822,166,20,1, merged,0,0,0.0771513745865
32460,1000329,1,2162,1661,501,0.76827,0.23173,0.76827,449,52,2163,1662,501,0.768377,0.231623,0.768377,449,52,-1, merged,0,0,0.0520624155837
32462,1000329,2,2163,1662,501,0.768377,0.231623,1.377073,449,52,2164,1663,501,0.768484,0.231516,1.393484,449,52,1, merged,0,0,0.01067303863
32466,1000014,3,1526,1294,232,0.847969,0.152031,2.328096,217,15,1527,1295,232,0.848068,0.151932,2.333158,217,15,1, merged,0,0,0.681362267358
32467,1000014,3,1527,1295,232,0.848068,0.151932,2.333158,217,15,1528,1296,232,0.848168,0.151832,2.328511,217,15,-1, abandoned,0,0,0.681704642034
32474,1000592,2,450,379,71,0.842222,0.157778,1.589281,45,26,451,380,71,0.842572,0.157428,1.592572,45,26,1, merged,0,0,0.0796961624386
32480,1000153,1,687,628,59,0.914119,0.085881,0.914119,45,14,689,630,59,0.914369,0.085631,0.914369,45,14,-1, merged,0,0,0.557963565228
32480,1000534,2,118,84,34,0.711864,0.288136,1.625984,32,2,119,85,34,0.714286,0.285714,1.628654,32,2,1, merged,0,0,0.561888187003
32481,1000592,2,451,380,71,0.842572,0.157428,1.592572,45,26,452,381,71,0.84292,0.15708,1.594365,45,26,1, merged,0,0,0.195639454696
32484,1000329,2,2164,1663,501,0.768484,0.231516,1.683057,449,52,2166,1664,502,0.768236,0.231764,1.678236,450,52,1, merged,1,1,0.000119379228014
32488,1000063,1,2302,2055,247,0.892702,0.107298,0.892702,206,41,2303,2056,247,0.892749,0.107251,0.892749,206,41,-1, merged,0,0,0.165861683836
32491,1000004,2,2149,1895,254,0.881805,0.118195,1.650042,197,57,2150,1896,254,0.88186,0.11814,1.650204,197,57,1, merged,0,0,0.0813592165906
32491,1000329,1,2166,1664,502,0.768236,0.231764,0.768236,450,52,2167,1665,502,0.768343,0.231657,0.768343,450,52,1, merged,0,0,0.122466159737
32498,1000004,2,2150,1896,254,0.88186,0.11814,1.719467,197,57,2151,1897,254,0.881915,0.118085,1.71972,197,57,1, merged,0,0,0.0187863518193
32498,1000120,1,819,686,133,0.837607,0.162393,0.837607,119,14,820,687,133,0.837805,0.162195,0.837805,119,14,1, merged,0,0,0.0534852257092
32499,1000004,1,2151,1897,254,0.881915,0.118085,0.881915,197,57,2152,1898,254,0.88197,0.11803,0.88197,197,57,-1, abandoned,0,0,0
32499,1000120,2,820,687,133,0.837805,0.162195,1.71972,119,14,821,688,133,0.838002,0.161998,1.719973,119,14,-1, abandoned,0,0,0
32513,1000023,1,408,358,50,0.877451,0.122549,0.877451,47,3,409,359,50,0.877751,0.122249,0.877751,47,3,1, merged,0,0,0.000783146668039
32514,1000118,3,783,690,93,0.881226,0.118774,2.392355,87,6,785,691,94,0.880255,0.119745,2.386882,88,6,1, merged,1,1,0.00100502595996
32519,1000329,2,2167,1665,502,0.768343,0.231657,1.472343,450,52,2168,1666,502,0.76845,0.23155,1.474799,450,52,1, merged,0,0,0.718167415424
32520,1000014,2,1531,1299,232,0.848465,0.151535,1.435004,217,15,1533,1301,232,0.848663,0.151337,1.437448,217,15,-1, merged,0,0,0.520930994859
32531,1000009,2,775,658,117,0.849032,0.150968,1.563318,108,9,777,660,117,0.849421,0.150579,1.568429,108,9,-1, merged,0,0,0.38823675611
32531,1000534,1,119,85,34,0.714286,0.285714,0.714286,32,2,121,87,34,0.719008,0.280992,0.719008,32,2,-1, merged,0,0,0.361539869212
32532,1000004,2,2152,1898,254,0.88197,0.11803,1.642339,197,57,2154,1900,254,0.88208,0.11792,1.638961,197,57,-1, merged,0,0,0.0412724405628
32532,1000005,1,217,165,52,0.760369,0.239631,0.760369,47,5,218,165,53,0.756881,0.243119,0.756881,48,5,1, merged,1,1,0.0226732492229
32532,1000329,3,2168,1666,502,0.76845,0.23155,2.410789,450,52,2170,1668,502,0.768664,0.231336,2.407624,450,52,-1, merged,0,0,0.0304837640822
32535,1000592,2,452,381,71,0.84292,0.15708,1.598107,45,26,453,382,71,0.843267,0.156733,1.599465,45,26,1, merged,0,0,0.130153497915
32536,1000005,1,218,165,53,0.756881,0.243119,0.756881,48,5,220,166,54,0.754545,0.245455,0.754545,49,5,1, merged,1,1,0.00706192811815
32536,1000120,2,823,690,133,0.838396,0.161604,1.595277,119,14,824,691,133,0.838592,0.161408,1.593138,119,14,1, merged,0,0,0.0180697870779
32539,1000014,1,1533,1301,232,0.848663,0.151337,0.848663,217,15,1534,1302,232,0.848761,0.151239,0.848761,217,15,1, merged,0,0,0.564114261168
32541,1000153,1,689,630,59,0.914369,0.085631,0.914369,45,14,690,630,60,0.913043,0.086957,0.913043,46,14,1, merged,1,1,0
32551,1000054,2,126,110,16,0.873016,0.126984,1.641679,12,4,128,112,16,0.875,0.125,1.643983,12,4,-1, merged,0,0,0.547732534078
32551,1000329,1,2170,1668,502,0.768664,0.231336,0.768664,450,52,2173,1671,502,0.768983,0.231017,0.768983,450,52,-1, merged,0,0,0.754602259641
32557,1000009,2,777,660,117,0.849421,0.150579,1.568429,108,9,778,661,117,0.849614,0.150386,1.570926,108,9,1, merged,0,0,0.0796890578225
32557,1000534,1,121,87,34,0.719008,0.280992,0.719008,32,2,122,88,34,0.721311,0.278689,0.721311,32,2,-1, merged,0,0,0.07048169487
32569,1000004,1,2157,1903,254,0.882244,0.117756,0.882244,197,57,2159,1905,254,0.882353,0.117647,0.882353,197,57,-1, merged,0,0,0.116915945625
32569,1000063,2,2307,2060,247,0.892935,0.107065,1.775178,206,41,2308,2061,247,0.892981,0.107019,1.775334,206,41,1, merged,0,0,0.332933101333
32572,1000005,1,220,166,54,0.754545,0.245455,0.754545,49,5,221,167,54,0.755656,0.244344,0.755656,49,5,1, merged,0,0,0.224794246751
32572,1000328,2,675,489,186,0.724444,0.275556,1.47899,166,20,676,490,186,0.724852,0.275148,1.480508,166,20,1, merged,0,0,0.183787438692
32579,1000004,2,2160,1906,254,0.882407,0.117593,1.721,197,57,2162,1908,254,0.882516,0.117484,1.721304,197,57,-1, merged,0,0,0.00416583813899
32579,1000120,1,824,691,133,0.838592,0.161408,0.838592,119,14,825,692,133,0.838788,0.161212,0.838788,119,14,-1, merged,0,0,0.018953392594
32581,1000328,1,676,490,186,0.724852,0.275148,0.724852,166,20,678,492,186,0.725664,0.274336,0.725664,166,20,-1, merged,0,0,0.349596094096
32581,1000329,2,2174,1672,502,0.769089,0.230911,1.493941,450,52,2176,1674,502,0.769301,0.230699,1.494965,450,52,-1, merged,0,0,0.379228205437
32584,1000153,1,692,632,60,0.913295,0.086705,0.913295,46,14,693,633,60,0.91342,0.08658,0.91342,46,14,1, merged,0,0,0.317756152176
32593,1000328,1,680,494,186,0.726471,0.273529,0.726471,166,20,681,495,186,0.726872,0.273128,0.726872,166,20,1, merged,0,0,0.607712215321
32596,1000121,2,1405,1165,240,0.829181,0.170819,1.556189,226,14,1407,1166,241,0.828714,0.171286,1.556516,227,14,1, merged,1,1,0.294601304464
32596,1000328,1,685,498,187,0.727007,0.272993,0.727007,167,20,687,500,187,0.727802,0.272198,0.727802,167,20,-1, merged,0,0,0.305516773384
32597,1000121,2,1407,1166,241,0.828714,0.171286,1.556516,227,14,1409,1167,242,0.828247,0.171753,1.553283,228,14,1, merged,1,1,0.58952113174
32597,1000328,1,687,500,187,0.727802,0.272198,0.727802,167,20,691,501,190,0.725036,0.274964,0.725036,170,20,1, merged,1,1,0.612172310448
32599,1000121,2,1412,1169,243,0.827904,0.172096,1.55294,229,14,1414,1170,244,0.82744,0.17256,1.549742,230,14,1, merged,1,1,0.590197214366
32599,1000328,1,691,501,190,0.725036,0.274964,0.725036,170,20,695,502,193,0.722302,0.277698,0.722302,173,20,1, merged,1,1,0.614593729566
32600,1000121,3,1414,1170,244,0.82744,0.17256,2.302616,230,14,1416,1171,245,0.826977,0.173023,2.28815,231,14,1, merged,1,1,0.590424504246
32600,1000328,1,695,502,193,0.722302,0.277698,0.722302,173,20,699,503,196,0.719599,0.280401,0.719599,176,20,1, merged,1,1,0.615409097165
32601,1000004,1,2167,1913,254,0.882787,0.117213,0.882787,197,57,2169,1914,255,0.882434,0.117566,0.882434,198,57,-1, merged,1,0,0.239401216321
32601,1000121,3,1416,1171,245,0.826977,0.173023,2.429364,231,14,1418,1172,246,0.826516,0.173484,2.427923,231,15,-1, merged,1,1,0.295044113853
32601,1000328,2,699,503,196,0.719599,0.280401,1.602387,176,20,701,504,197,0.718973,0.281027,1.601407,177,20,1, merged,1,1,0.306463526534
32605,1000004,2,2169,1914,255,0.882434,0.117566,1.652053,198,57,2170,1915,255,0.882488,0.117512,1.652213,198,57,1, merged,0,0,0.0417972831766
32605,1000329,1,2179,1677,502,0.769619,0.230381,0.769619,450,52,2180,1678,502,0.769725,0.230275,0.769725,450,52,1, merged,0,0,0.0307773594875
32609,1000120,2,825,692,133,0.838788,0.161212,1.608513,119,14,826,693,133,0.838983,0.161017,1.609024,119,14,1, merged,0,0,0.0165758449393
32609,1000329,1,2180,1678,502,0.769725,0.230275,0.769725,450,52,2183,1681,502,0.770041,0.229959,0.770041,450,52,-1, merged,0,0,0.015811907346
32611,1000121,3,1418,1172,246,0.826516,0.173484,2.287862,231,15,1419,1173,246,0.826638,0.173362,2.284277,231,15,1, merged,0,0,0.295446312868
32611,1000328,1,703,506,197,0.719772,0.280228,0.719772,177,20,704,506,198,0.71875,0.28125,0.71875,178,20,1, merged,1,1,0.307644584223
32614,1000121,2,1420,1174,246,0.826761,0.173239,1.602761,231,15,1421,1175,246,0.826882,0.173118,1.601418,231,15,1, merged,0,0,0.15858133963
32620,1000009,1,778,661,117,0.849614,0.150386,0.849614,108,9,779,661,118,0.848524,0.151476,0.848524,109,9,1, merged,1,1,0
32620,1000015,2,1422,1279,143,0.899437,0.100563,1.749052,131,12,1425,1280,145,0.898246,0.101754,1.746769,133,12,1, merged,1,1,0
32623,1000004,1,2175,1920,255,0.882759,0.117241,0.882759,198,57,2176,1921,255,0.882812,0.117188,0.882812,198,57,-1, merged,0,0,0.0832464216835
32623,1000120,2,826,693,133,0.838983,0.161017,1.721742,119,14,828,695,133,0.839372,0.160628,1.722184,119,14,-1, merged,0,0,0.10806246156
32624,1000121,2,1421,1175,246,0.826882,0.173118,1.670484,231,15,1422,1176,246,0.827004,0.172996,1.670853,231,15,1, merged,0,0,0.295567628943
32650,1000121,2,1422,1176,246,0.827004,0.172996,1.415789,231,15,1423,1177,246,0.827126,0.172874,1.419718,231,15,1, merged,0,0,0.262091406587
32651,1000121,2,1423,1177,246,0.827126,0.172874,1.419718,231,15,1424,1178,246,0.827247,0.172753,1.423577,231,15,1, merged,0,0,0.0102430183827
32652,1000121,2,1424,1178,246,0.827247,0.172753,1.423577,231,15,1425,1179,246,0.827368,0.172632,1.427368,231,15,1, merged,0,0,0.00912636318956
32654,1000121,2,1425,1179,246,0.827368,0.172632,1.427368,231,15,1426,1180,246,0.827489,0.172511,1.431093,231,15,1, merged,0,0,0.0683479636445
32655,1000121,2,1426,1180,246,0.827489,0.172511,1.431093,231,15,1427,1181,246,0.82761,0.17239,1.434753,231,15,1, merged,0,0,0.297489112903
32656,1000121,2,1427,1181,246,0.82761,0.17239,1.715577,231,15,1428,1182,246,0.827731,0.172269,1.716161,231,15,1, merged,0,0,0.234334558018
32656,1000132,1,241,214,27,0.887967,0.112033,0.887967,20,7,242,215,27,0.88843,0.11157,0.88843,20,7,1, merged,0,0,0.315164270538
32659,1000592,2,454,383,71,0.843612,0.156388,1.582501,45,26,455,384,71,0.843956,0.156044,1.58022,45,26,1, merged,0,0,0.197074519731
32669,1000014,2,1534,1302,232,0.848761,0.151239,1.626539,217,15,1536,1303,233,0.848307,0.151693,1.585149,218,15,1, abandoned,1,1,0.132844381925
32682,1000592,2,455,384,71,0.843956,0.156044,1.58022,45,26,456,385,71,0.844298,0.155702,1.583429,45,26,1, merged,0,0,0.180758756894
32683,1000004,1,2179,1924,255,0.882974,0.117026,0.882974,198,57,2181,1926,255,0.883081,0.116919,0.883081,198,57,-1, abandoned,0,0,0
32683,1000120,2,830,697,133,0.839759,0.160241,1.722733,119,14,831,697,134,0.838748,0.161252,1.72183,120,14,1, abandoned,1,1,0
32687,1000004,2,2182,1927,255,0.883135,0.116865,1.722077,198,57,2183,1928,255,0.883188,0.116812,1.722324,198,57,1, merged,0,0,0.0287560321817
32687,1000120,1,832,698,134,0.838942,0.161058,0.838942,120,14,833,699,134,0.839136,0.160864,0.839136,120,14,1, merged,0,0,0.0821924956835
32688,1000004,2,2183,1928,255,0.883188,0.116812,1.722324,198,57,2184,1929,255,0.883242,0.116758,1.72257,198,57,1, merged,0,0,0.0287987766298
32688,1000120,1,833,699,134,0.839136,0.160864,0.839136,120,14,834,700,134,0.839329,0.160671,0.839329,120,14,1, merged,0,0,0.0831030544649
32696,1000014,1,1537,1304,233,0.848406,0.151594,0.848406,218,15,1538,1305,233,0.848505,0.151495,0.848505,218,15,1, merged,0,0,0.65454102832
32696,1000070,2,874,766,108,0.87643,0.12357,1.724836,91,17,875,767,108,0.876571,0.123429,1.725076,91,17,1, merged,0,0,0.805884449937
32699,1000004,2,2184,1929,255,0.883242,0.116758,1.653283,198,57,2185,1930,255,0.883295,0.116705,1.653547,198,57,-1, abandoned,0,0,0.0557198365794
32699,1000329,1,2183,1681,502,0.770041,0.229959,0.770041,450,52,2185,1683,502,0.770252,0.229748,0.770252,450,52,-1, abandoned,0,0,0.153891916658
32701,1000004,2,2185,1930,255,0.883295,0.116705,1.727144,198,57,2186,1931,255,0.883349,0.116651,1.726116,198,57,-1, abandoned,0,0,0.00052151829849
32703,1000121,6,1429,1183,246,0.827852,0.172148,4.306947,231,15,1430,1184,246,0.827972,0.172028,5.313813,231,15,1, merged,0,0,0.598237511104
32703,1000329,5,2185,1683,502,0.770252,0.229748,3.479095,450,52,2186,1684,502,0.770357,0.229643,4.485841,450,52,1, merged,0,0,0.733720154729
32713,1000592,1,456,385,71,0.844298,0.155702,0.844298,45,26,457,385,72,0.842451,0.157549,0.842451,46,26,1, merged,1,1,0
32717,1000091,2,393,298,95,0.75827,0.24173,1.528627,80,15,394,299,95,0.758883,0.241117,1.529345,80,15,1, merged,0,0,0.340557495787
32717,1000329,1,2186,1684,502,0.770357,0.229643,0.770357,450,52,2187,1685,502,0.770462,0.229538,0.770462,450,52,1, merged,0,0,0.380250190155
32721,1000005,2,224,170,54,0.758929,0.241071,1.478475,49,5,225,171,54,0.76,0.24,1.479943,49,5,1, merged,0,0,0.155813943693
32721,1000328,1,706,508,198,0.719547,0.280453,0.719547,178,20,707,509,198,0.719943,0.280057,0.719943,178,20,1, merged,0,0,0.220324407073
32726,1000009,1,784,666,118,0.84949,0.15051,0.84949,109,9,785,667,118,0.849682,0.150318,0.849682,109,9,1, merged,0,0,0.295135309756
32726,1000015,2,1431,1286,145,0.898672,0.101328,1.748162,133,12,1432,1287,145,0.898743,0.101257,1.748425,133,12,1, merged,0,0,0.252515307559
32745,1000009,1,785,667,118,0.849682,0.150318,0.849682,109,9,786,668,118,0.849873,0.150127,0.849873,109,9,1, merged,0,0,0.590853237918
32745,1000015,2,1433,1288,145,0.898814,0.101186,1.748495,133,12,1434,1289,145,0.898884,0.101116,1.748757,133,12,1, merged,0,0,0.505469219682
32765,1000004,1,2187,1932,255,0.883402,0.116598,0.883402,198,57,2188,1933,255,0.883455,0.116545,0.883455,198,57,-1, merged,0,0,0.00727743049723
32765,1000120,2,848,710,138,0.837264,0.162736,1.720666,124,14,850,712,138,0.837647,0.162353,1.721102,124,14,-1, merged,0,0,0.00822966356723
32771,1000132,2,242,215,27,0.88843,0.11157,1.88843,20,7,243,216,27,0.888889,0.111111,1.555556,20,7,1, merged,0,0,0.199901819203
32776,1000091,3,394,299,95,0.758883,0.241117,2.269565,80,15,396,300,96,0.757576,0.242424,2.263972,81,15,1, merged,1,1,0.0611235029328
32776,1000121,4,1430,1184,246,0.827972,0.172028,3.097537,231,15,1431,1185,246,0.828092,0.171908,3.092064,231,15,1, merged,0,0,0.031904752493
32797,1000005,2,226,172,54,0.761062,0.238938,1.518638,49,5,227,173,54,0.762115,0.237885,1.520301,49,5,1, merged,0,0,0.540908855381
32797,1000091,1,396,300,96,0.757576,0.242424,0.757576,81,15,397,301,96,0.758186,0.241814,0.758186,81,15,1, merged,0,0,0.472949942001
32801,1000009,2,786,668,118,0.849873,0.150127,1.683206,109,9,787,669,118,0.850064,0.149936,1.696217,109,9,-1, abandoned,0,0,0
32806,1000015,2,1441,1296,145,0.899375,0.100625,1.737213,133,12,1442,1297,145,0.899445,0.100555,1.737473,133,12,1, merged,0,0,0.0635849185456
32806,1000120,1,851,713,138,0.837838,0.162162,0.837838,124,14,852,714,138,0.838028,0.161972,0.838028,124,14,1, merged,0,0,0.0277067746149
32808,1000124,2,581,541,40,0.931153,0.068847,1.731153,34,6,582,542,40,0.931271,0.068729,1.764605,34,6,1, merged,0,0,0.46616252155
32808,1000140,1,5,4,1,0.8,0.2,0.8,1,0,6,5,1,0.833333,0.166667,0.833333,1,0,1, merged,0,0,0.484090909091
32811,1000004,1,2190,1934,256,0.883105,0.116895,0.883105,199,57,2191,1934,257,0.882702,0.117298,0.882702,200,57,1, merged,1,1,0
32811,1000153,2,694,634,60,0.913545,0.086455,1.79665,46,14,695,635,60,0.913669,0.086331,1.796371,46,14,1, merged,0,0,0
32817,1000124,2,583,543,40,0.931389,0.068611,1.764723,34,6,584,543,41,0.929795,0.070205,1.596461,35,6,1, merged,1,1,0.23829882032
32817,1000140,1,6,5,1,0.833333,0.166667,0.833333,1,0,9,6,3,0.666667,0.333333,0.666667,3,0,1, merged,1,1,0.0149253731343
32824,1000329,1,2190,1688,502,0.770776,0.229224,0.770776,450,52,2192,1690,502,0.770985,0.229015,0.770985,450,52,-1, merged,0,0,0.121790782556
32834,1000015,2,1446,1300,146,0.899032,0.100968,1.635874,134,12,1447,1301,146,0.899102,0.100898,1.649102,134,12,1, merged,0,0,0.0264008854967
32836,1000130,2,244,203,41,0.831967,0.168033,1.627049,32,9,245,204,41,0.832653,0.167347,1.625336,32,9,-1, merged,0,0,0.778271095672
32845,1000328,2,710,511,199,0.719718,0.280282,1.490704,179,20,711,512,199,0.720113,0.279887,1.491202,179,20,1, merged,0,0,0.698813603057
32845,1000329,1,2192,1690,502,0.770985,0.229015,0.770985,450,52,2193,1691,502,0.77109,0.22891,0.77109,450,52,1, merged,0,0,0.758149385169
32848,1000014,2,1540,1307,233,0.848701,0.151299,1.455844,218,15,1541,1308,233,0.848799,0.151201,1.462835,218,15,1, merged,0,0,0.498452209343
32850,1000130,2,245,204,41,0.832653,0.167347,1.675104,32,9,248,207,41,0.834677,0.165323,1.677472,32,9,-1, merged,0,0,0.0832774782768
32850,1000592,1,457,385,72,0.842451,0.157549,0.842451,46,26,458,386,72,0.842795,0.157205,0.842795,46,26,-1, merged,0,0,0.065472826053
32852,1000120,2,853,715,138,0.838218,0.161782,1.838218,124,14,854,716,138,0.838407,0.161593,1.838407,124,14,1, merged,0,0,0.00379867046534
32858,1000005,2,227,173,54,0.762115,0.237885,1.48262,49,5,228,174,54,0.763158,0.236842,1.484056,49,5,1, merged,0,0,0.448873611435
32858,1000328,1,712,513,199,0.720506,0.279494,0.720506,179,20,713,514,199,0.720898,0.279102,0.720898,179,20,1, merged,0,0,0.618370029015
32859,1000004,1,2197,1940,257,0.883022,0.116978,0.883022,200,57,2198,1941,257,0.883076,0.116924,0.883076,200,57,1, merged,0,0,0.0377049322562
32859,1000015,2,1450,1304,146,0.89931,0.10069,1.782333,134,12,1451,1305,146,0.89938,0.10062,1.782455,134,12,1, merged,0,0,0.0516604244065
32860,1000004,1,2198,1941,257,0.883076,0.116924,0.883076,200,57,2199,1942,257,0.883129,0.116871,0.883129,200,57,1, merged,0,0,0.364863238318
32860,1000011,2,487,453,34,0.930185,0.069815,1.81326,31,3,488,454,34,0.930328,0.069672,1.813457,31,3,1, merged,0,0,0.915455925217
32861,1000130,2,249,208,41,0.835341,0.164659,1.678136,32,9,252,211,41,0.837302,0.162698,1.67826,32,9,-1, merged,0,0,0.0170220078985
32861,1000592,1,458,386,72,0.842795,0.157205,0.842795,46,26,459,386,73,0.840959,0.159041,0.840959,47,26,1, merged,1,1,0
32863,1000004,1,2199,1942,257,0.883129,0.116871,0.883129,200,57,2200,1943,257,0.883182,0.116818,0.883182,200,57,-1, merged,0,0,0.0182846956513
32863,1000120,2,854,716,138,0.838407,0.161593,1.721536,124,14,855,717,138,0.838596,0.161404,1.721778,124,14,1, merged,0,0,0.0159156887657
32864,1000329,1,2193,1691,502,0.77109,0.22891,0.77109,450,52,2195,1692,503,0.770843,0.229157,0.770843,450,53,-1, merged,1,1,0.26645227581
32868,1000004,3,2200,1943,257,0.883182,0.116818,2.492352,200,57,2201,1944,257,0.883235,0.116765,2.491268,200,57,1, merged,0,0,0.0184450905812
32868,1000120,1,857,718,139,0.837806,0.162194,0.837806,125,14,859,719,140,0.83702,0.16298,0.83702,126,14,1, merged,1,1,0.0243459559952
32868,1000329,2,2200,1697,503,0.771364,0.228636,1.60917,450,53,2201,1697,504,0.771013,0.228987,1.608033,450,54,-1, merged,1,1,0.0266116537348
32882,1000124,2,588,547,41,0.930272,0.069728,1.701351,35,6,589,548,41,0.93039,0.06961,1.701573,35,6,1, merged,0,0,0.0312885412202
32882,1000329,1,2206,1701,505,0.771079,0.228921,0.771079,451,54,2207,1702,505,0.771183,0.228817,0.771183,451,54,1, merged,0,0,0.0364167843815
32894,1000014,2,1541,1308,233,0.848799,0.151201,1.462835,218,15,1542,1309,233,0.848898,0.151102,1.466289,218,15,1, merged,0,0,0
32896,1000091,3,397,301,96,0.758186,0.241814,2.286685,81,15,398,302,96,0.758794,0.241206,2.285732,81,15,1, merged,0,0,0.698815594507
32896,1000328,1,713,514,199,0.720898,0.279102,0.720898,179,20,715,514,201,0.718881,0.281119,0.718881,179,22,-1, merged,1,1,0.714088201955
32897,1000091,2,398,302,96,0.758794,0.241206,1.477675,81,15,399,303,96,0.759398,0.240602,1.479454,81,15,-1, merged,0,0,0.0692611572001
32897,1000328,1,715,514,201,0.718881,0.281119,0.718881,179,22,718,517,201,0.720056,0.279944,0.720056,179,22,-1, merged,0,0,0.0927602999551
32898,1000153,2,695,635,60,0.913669,0.086331,1.513669,46,14,696,636,60,0.913793,0.086207,1.413793,46,14,1, merged,0,0,1.07737484376
32900,1000153,2,696,636,60,0.913793,0.086207,1.635105,46,14,697,637,60,0.913917,0.086083,1.637494,46,14,-1, abandoned,0,0,0
32900,1000534,1,122,88,34,0.721311,0.278689,0.721311,32,2,123,89,34,0.723577,0.276423,0.723577,32,2,-1, abandoned,0,0,0
32906,1000043,2,356,291,65,0.817416,0.182584,1.579769,56,9,357,292,65,0.817927,0.182073,1.580838,56,9,1, merged,0,0,0.00608728380972
32906,1000105,1,425,324,101,0.762353,0.237647,0.762353,91,10,426,325,101,0.762911,0.237089,0.762911,91,10,1, merged,0,0,0.000108778470921
32907,1000043,3,357,292,65,0.817927,0.182073,2.40917,56,9,358,293,65,0.818436,0.181564,2.410354,56,9,1, merged,0,0,0.00648048553811
32907,1000105,1,426,325,101,0.762911,0.237089,0.762911,91,10,427,326,101,0.763466,0.236534,0.763466,91,10,1, merged,0,0,0.000398288836907
32907,1000121,2,1433,1187,246,0.828332,0.171668,1.591243,231,15,1434,1188,246,0.828452,0.171548,1.591918,231,15,1, merged,0,0,0.000994184553237
32912,1000091,2,400,304,96,0.76,0.24,1.569339,81,15,401,305,96,0.760599,0.239401,1.570307,81,15,1, merged,0,0,0.117043191966
32913,1000005,2,228,174,54,0.763158,0.236842,1.572867,49,5,229,175,54,0.764192,0.235808,1.57427,49,5,1, merged,0,0,0.133124132422
32920,1000004,2,2202,1945,257,0.883288,0.116712,1.790504,200,57,2204,1947,257,0.883394,0.116606,1.786947,200,57,-1, merged,0,0,0.0555207195327
32926,1000329,2,2215,1708,507,0.771106,0.228894,1.509074,452,55,2216,1709,507,0.771209,0.228791,1.510571,452,55,1, merged,0,0,0.358767652566
32935,1000329,2,2216,1709,507,0.771209,0.228791,1.158306,452,55,2217,1710,507,0.771313,0.228687,1.177563,452,55,1, merged,0,0,0.785166562546
32936,1000329,2,2217,1710,507,0.771313,0.228687,1.177563,452,55,2220,1712,508,0.771171,0.228829,1.165111,453,55,-1, merged,1,0,0.785481279475
32943,1000063,1,2310,2063,247,0.893074,0.106926,0.893074,206,41,2312,2065,247,0.893166,0.106834,0.893166,206,41,-1, merged,0,0,0.00836896437812
32951,1000023,1,410,360,50,0.878049,0.121951,0.878049,47,3,411,361,50,0.878345,0.121655,0.878345,47,3,1, merged,0,0,0.048207964025
32952,1000023,1,411,361,50,0.878345,0.121655,0.878345,47,3,412,362,50,0.878641,0.121359,0.878641,47,3,1, merged,0,0,0.00804936255559
32953,1000023,1,412,362,50,0.878641,0.121359,0.878641,47,3,413,363,50,0.878935,0.121065,0.878935,47,3,1, merged,0,0,0.0081259247082
32958,1000121,1,1437,1191,246,0.82881,0.17119,0.82881,231,15,1438,1191,247,0.828234,0.171766,0.828234,232,15,1, merged,1,1,0.00250874760679
32965,1000007,3,958,781,177,0.81524,0.18476,1.586411,158,19,959,782,177,0.815433,0.184567,2.086257,158,19,1, merged,0,0,0
32965,1000329,1,2220,1712,508,0.771171,0.228829,0.771171,453,55,2221,1712,509,0.770824,0.229176,0.770824,454,55,1, merged,1,1,0
32965,1000534,4,123,89,34,0.723577,0.276423,2.309988,32,2,124,90,34,0.725806,0.274194,2.812063,32,2,1, merged,0,0,0
32973,1000004,2,2205,1948,257,0.883447,0.116553,1.722156,200,57,2207,1949,258,0.883099,0.116901,1.720844,201,57,1, merged,1,1,0.435722090574
32973,1000120,1,868,728,140,0.83871,0.16129,0.83871,126,14,869,728,141,0.837745,0.162255,0.837745,127,14,1, merged,1,1,0.420618718593
32974,1000014,2,1542,1309,233,0.848898,0.151102,1.74455,218,15,1543,1310,233,0.848995,0.151005,1.746431,218,15,1, merged,0,0,0.19170098259
32975,1000015,2,1457,1311,146,0.899794,0.100206,1.653069,134,12,1458,1312,146,0.899863,0.100137,1.653675,134,12,1, merged,0,0,0.59662604252
32976,1000015,2,1458,1312,146,0.899863,0.100137,1.653675,134,12,1459,1313,146,0.899931,0.100069,1.654279,134,12,1, merged,0,0,0.298324252919
32978,1000091,1,401,305,96,0.760599,0.239401,0.760599,81,15,402,306,96,0.761194,0.238806,0.761194,81,15,1, merged,0,0,0.146234426042
32978,1000121,2,1438,1191,247,0.828234,0.171766,1.588832,232,15,1439,1192,247,0.828353,0.171647,1.589547,232,15,1, merged,0,0,0.178411993639
32979,1000091,1,402,306,96,0.761194,0.238806,0.761194,81,15,403,307,96,0.761787,0.238213,0.761787,81,15,1, merged,0,0,0.186385367602
32979,1000121,2,1439,1192,247,0.828353,0.171647,1.589547,232,15,1440,1193,247,0.828472,0.171528,1.590259,232,15,1, merged,0,0,0.147419189273
32990,1000124,1,593,550,43,0.927487,0.072513,0.927487,37,6,594,551,43,0.927609,0.072391,0.927609,37,6,-1, merged,0,0,0.113377751739
32990,1000166,2,199,170,29,0.854271,0.145729,1.781759,27,2,201,171,30,0.850746,0.149254,1.778356,28,2,1, merged,1,1,0.199021153095
32994,1000007,2,959,782,177,0.815433,0.184567,1.729473,158,19,961,783,178,0.814776,0.185224,1.728939,159,19,1, merged,1,1,0.067888946792
32994,1000153,1,698,638,60,0.91404,0.08596,0.91404,46,14,699,639,60,0.914163,0.085837,0.914163,46,14,-1, merged,0,0,0.0617535461042
32998,1000329,2,2222,1713,509,0.770927,0.229073,1.770927,454,55,2224,1715,509,0.771133,0.228867,1.771133,454,55,-1, abandoned,0,0,0.114453289721
33001,1000105,1,430,327,103,0.760465,0.239535,0.760465,93,10,432,328,104,0.759259,0.240741,0.759259,94,10,-1, merged,1,0,0.384294492203
33001,1000110,2,42,36,6,0.857143,0.142857,1.617608,5,1,43,37,6,0.860465,0.139535,1.619724,5,1,1, merged,0,0,0.185458171745
33007,1000120,2,870,729,141,0.837931,0.162069,1.546592,127,14,871,730,141,0.838117,0.161883,1.551295,127,14,1, merged,0,0,0.0707729317399
33009,1000329,2,2227,1718,509,0.771441,0.228559,1.771441,454,55,2228,1719,509,0.771544,0.228456,1.771544,454,55,-1, abandoned,0,0,0.114562291172
33016,1000105,1,433,329,104,0.759815,0.240185,0.759815,94,10,435,329,106,0.756322,0.243678,0.756322,96,10,1, abandoned,1,1,0.383548649965
33016,1002169,2,10,6,4,0.6,0.4,1.359815,4,0,15,11,4,0.733333,0.266667,1.489655,4,0,-1, abandoned,0,0,0
33019,1000328,2,722,521,201,0.721607,0.278393,1.49356,179,22,723,522,201,0.721992,0.278008,1.493804,179,22,1, merged,0,0,0.701662851401
33019,1000329,1,2232,1723,509,0.771953,0.228047,0.771953,454,55,2235,1725,510,0.771812,0.228188,0.771812,455,55,-1, merged,1,0,0.76138335945
33022,1000004,2,2209,1951,258,0.883205,0.116795,1.633205,201,57,2210,1952,258,0.883258,0.116742,1.647964,201,57,1, merged,0,0,0.0311631047137
33022,1000108,1,32,24,8,0.75,0.25,0.75,4,4,34,26,8,0.764706,0.235294,0.764706,4,4,-1, merged,0,0,0
33024,1000014,2,1543,1310,233,0.848995,0.151005,1.677468,218,15,1544,1310,234,0.848446,0.151554,1.677037,218,16,-1, merged,1,1,0.493314942968
33024,1000121,1,1440,1193,247,0.828472,0.171528,0.828472,232,15,1441,1194,247,0.828591,0.171409,0.828591,232,15,1, merged,0,0,0
33029,1000130,1,255,213,42,0.835294,0.164706,0.835294,33,9,257,214,43,0.832685,0.167315,0.832685,33,10,1, merged,1,0,0
33031,1000329,2,2235,1725,510,0.771812,0.228188,1.578416,455,55,2236,1725,511,0.771467,0.228533,1.575205,456,55,1, merged,1,1,0.0868382738856
33033,1000124,2,595,552,43,0.927731,0.072269,1.831284,37,6,596,553,43,0.927852,0.072148,1.826842,37,6,-1, abandoned,0,0,0.0737235126363
33034,1000140,2,15,11,4,0.733333,0.266667,1.529487,4,0,16,12,4,0.75,0.25,1.54771,4,0,1, merged,0,0,0.0185278855305
33035,1000140,2,16,12,4,0.75,0.25,1.64899,4,0,17,12,5,0.705882,0.294118,1.595882,5,0,1, merged,1,1,0.0362106017192
33036,1000004,3,2210,1952,258,0.883258,0.116742,2.321391,201,57,2212,1954,258,0.883363,0.116637,2.311488,201,57,-1, merged,0,0,0.022809958859
33036,1000329,2,2236,1725,511,0.771467,0.228533,1.438134,456,55,2240,1727,513,0.770982,0.229018,1.428125,458,55,-1, merged,1,0,0.00826255289759
33044,1000003,2,887,749,138,0.844419,0.155581,1.615504,127,11,890,750,140,0.842697,0.157303,1.613641,127,13,1, merged,1,0,0.0019801980198
33044,1000329,1,2241,1728,513,0.771084,0.228916,0.771084,458,55,2244,1730,514,0.770945,0.229055,0.770945,458,56,1, merged,1,0,0.0182359254561
33063,1000118,1,790,695,95,0.879747,0.120253,0.879747,89,6,791,696,95,0.879899,0.120101,0.879899,89,6,1, merged,0,0,0.0872558377949
33065,1000120,2,874,733,141,0.838673,0.161327,1.60972,127,14,875,734,141,0.838857,0.161143,1.610108,127,14,1, merged,0,0,0
33065,1000329,1,2245,1731,514,0.771047,0.228953,0.771047,458,56,2247,1733,514,0.771251,0.228749,0.771251,458,56,-1, merged,0,0,0
33073,1000121,2,1441,1194,247,0.828591,0.171409,1.60035,232,15,1442,1195,247,0.82871,0.17129,1.60057,232,15,1, merged,0,0,0.0657821774373
33073,1000329,1,2252,1738,514,0.771758,0.228242,0.771758,458,56,2253,1739,514,0.77186,0.22814,0.77186,458,56,1, merged,0,0,0.0788900813764
33075,1000124,2,596,553,43,0.927852,0.072148,1.699813,37,6,597,554,43,0.927973,0.072027,1.700035,37,6,1, merged,0,0,0.507597905328
33075,1000329,1,2254,1740,514,0.771961,0.228039,0.771961,458,56,2255,1741,514,0.772062,0.227938,0.772062,458,56,1, merged,0,0,0.587672611709
33078,1000003,3,890,750,140,0.842697,0.157303,2.498175,127,13,891,750,141,0.841751,0.158249,2.497002,128,13,1, abandoned,1,1,0.574735769803
33078,1000004,2,2213,1955,258,0.883416,0.116584,1.655478,201,57,2214,1956,258,0.883469,0.116531,1.655251,201,57,-1, abandoned,0,0,0.50713691637
33078,1000329,1,2255,1741,514,0.772062,0.227938,0.772062,458,56,2261,1745,516,0.771782,0.228218,0.771782,460,56,-1, abandoned,1,0,0
33086,1000015,1,1460,1314,146,0.9,0.1,0.9,134,12,1462,1315,147,0.899453,0.100547,0.899453,135,12,1, merged,1,1,0.126699386622
33086,1000026,2,282,259,23,0.91844,0.08156,1.81844,21,2,283,260,23,0.918728,0.081272,1.818181,21,2,1, merged,0,0,0.0610526315818
33093,1000015,2,1462,1315,147,0.899453,0.100547,1.625259,135,12,1463,1316,147,0.899522,0.100478,1.627522,135,12,1, merged,0,0,1.00806031618
33093,1000534,1,124,90,34,0.725806,0.274194,0.725806,32,2,125,91,34,0.728,0.272,0.728,32,2,1, merged,0,0,1.08148336383
33095,1000009,1,796,673,123,0.845477,0.154523,0.845477,110,13,798,675,123,0.845865,0.154135,0.845865,110,13,1, merged,0,0,0.984601887758
33097,1000014,2,1544,1310,234,0.848446,0.151554,1.576446,218,16,1545,1311,234,0.848544,0.151456,1.580827,218,16,1, merged,0,0,0.173575370028
33097,1000534,1,125,91,34,0.728,0.272,0.728,32,2,127,93,34,0.732283,0.267717,0.732283,32,2,-1, merged,0,0,0.270443970492
33102,1000004,2,2215,1957,258,0.883521,0.116479,1.540664,201,57,2216,1958,258,0.883574,0.116426,1.532223,201,57,1, merged,0,0,0.0170170730291
33107,1000007,2,961,783,178,0.814776,0.185224,1.660641,159,19,963,784,179,0.814123,0.185877,1.658929,160,19,1, merged,1,1,0.0762549279981
33107,1000009,1,798,675,123,0.845865,0.154135,0.845865,110,13,799,675,124,0.844806,0.155194,0.844806,111,13,1, merged,1,1,0.0731378215041
33112,1000108,1,35,27,8,0.771429,0.228571,0.771429,4,4,36,28,8,0.777778,0.222222,0.777778,4,4,1, merged,0,0,0.0184410087975
33112,1000140,2,19,13,6,0.684211,0.315789,1.455639,6,0,20,14,6,0.7,0.3,1.477778,6,0,1, merged,0,0,0.018865075832
33117,1000091,2,404,307,97,0.759901,0.240099,1.384901,82,15,405,308,97,0.760494,0.239506,1.360494,82,15,1, merged,0,0,0.691067311615
33124,1000007,2,963,784,179,0.814123,0.185877,1.662666,160,19,964,785,179,0.814315,0.185685,1.662957,160,19,1, merged,0,0,1.28890350592
33124,1000014,1,1545,1311,234,0.848544,0.151456,0.848544,218,16,1546,1312,234,0.848642,0.151358,0.848642,218,16,1, merged,0,0,0.706639589265
33127,1000004,1,2216,1958,258,0.883574,0.116426,0.883574,201,57,2217,1959,258,0.883627,0.116373,0.883627,201,57,-1, merged,0,0,0.0528633598362
33127,1000124,2,598,555,43,0.928094,0.071906,1.811668,37,6,599,556,43,0.928214,0.071786,1.81184,37,6,1, merged,0,0,0.255685535838
33132,1000328,2,723,522,201,0.721992,0.278008,1.493976,179,22,724,523,201,0.722376,0.277624,1.49446,179,22,1, merged,0,0,0.703061116767
33132,1000329,1,2263,1747,516,0.771984,0.228016,0.771984,460,56,2264,1748,516,0.772085,0.227915,0.772085,460,56,1, merged,0,0,0.763298669014
33133,1000328,2,724,523,201,0.722376,0.277624,1.49446,179,22,725,524,201,0.722759,0.277241,1.494603,179,22,1, merged,0,0,0.35196499614
33133,1000329,1,2264,1748,516,0.772085,0.227915,0.772085,460,56,2266,1749,517,0.771845,0.228155,0.771845,460,57,-1, merged,1,1,0.381825484566
33135,1000110,2,44,38,6,0.863636,0.136364,1.577922,5,1,45,39,6,0.866667,0.133333,1.593939,5,1,1, merged,0,0,0.0107856532878
33135,1000124,3,601,558,43,0.928453,0.071547,2.506375,37,6,602,559,43,0.928571,0.071429,2.522511,37,6,1, merged,0,0,0.0312671984379
33135,1000140,1,21,15,6,0.714286,0.285714,0.714286,6,0,22,16,6,0.727273,0.272727,0.727273,6,0,1, merged,0,0,0.0903505005478
33137,1000015,2,1464,1317,147,0.89959,0.10041,1.638952,135,12,1465,1318,147,0.899659,0.100341,1.640399,135,12,1, merged,0,0,0.56129762384
33140,1000329,1,2266,1749,517,0.771845,0.228155,0.771845,460,57,2268,1751,517,0.772046,0.227954,0.772046,460,57,-1, abandoned,0,0,0.0203849561347
33142,1000004,3,2217,1959,258,0.883627,0.116373,2.655672,201,57,2220,1960,260,0.882883,0.117117,2.321255,203,57,1, abandoned,1,1,0.0171117832039
33142,1000329,1,2268,1751,517,0.772046,0.227954,0.772046,460,57,2269,1751,518,0.771706,0.228294,0.771706,461,57,1, abandoned,1,1,0.00621958728257
33143,1000007,1,964,785,179,0.814315,0.185685,0.814315,160,19,965,785,180,0.813472,0.186528,0.813472,161,19,1, merged,1,1,0.0815852145898
33143,1000009,2,801,677,124,0.845194,0.154806,1.659509,111,13,802,678,124,0.845387,0.154613,1.658858,111,13,1, merged,0,0,0.0780711441115
33144,1000004,1,2220,1960,260,0.882883,0.117117,0.882883,203,57,2224,1963,261,0.882644,0.117356,0.882644,204,57,-1, merged,1,0,0.0244367388923
33144,1000120,2,877,736,141,0.839225,0.160775,1.722108,127,14,878,737,141,0.839408,0.160592,1.722052,127,14,1, merged,0,0,0.0217796727927
33146,1000329,2,2269,1751,518,0.771706,0.228294,1.470066,461,57,2270,1752,518,0.771806,0.228194,1.471153,461,57,1, merged,0,0,0.434088489595
33148,1000105,1,437,331,106,0.757437,0.242563,0.757437,96,10,438,331,107,0.755708,0.244292,0.755708,97,10,1, merged,1,1,0.0401323590966
33148,1000121,3,1444,1197,247,0.828947,0.171053,2.186384,232,15,1449,1199,250,0.827467,0.172533,2.154604,235,15,1, merged,1,1,0.0337134998063
33160,1000121,2,1449,1199,250,0.827467,0.172533,0.827467,235,15,1450,1200,250,0.827586,0.172414,1.16092,235,15,1, merged,0,0,0.00259988152439
33162,1000121,2,1450,1200,250,0.827586,0.172414,1.327586,235,15,1451,1201,250,0.827705,0.172295,1.427705,235,15,1, merged,0,0,0.00289549881548
33167,1000091,1,405,308,97,0.760494,0.239506,0.760494,82,15,406,309,97,0.761084,0.238916,0.761084,82,15,1, merged,0,0,0.683170884466
33168,1000132,1,245,218,27,0.889796,0.110204,0.889796,20,7,246,219,27,0.890244,0.109756,0.890244,20,7,1, merged,0,0,0.534756995582
33172,1000070,2,877,769,108,0.876853,0.123147,1.733996,91,17,878,770,108,0.876993,0.123007,1.74366,91,17,1, merged,0,0,0.861864226682
33175,1000004,1,2224,1963,261,0.882644,0.117356,0.882644,204,57,2226,1964,262,0.8823,0.1177,0.8823,205,57,-1, merged,1,0,0.108828052425
33177,1000327,3,613,478,135,0.779772,0.220228,2.219859,104,31,614,479,135,0.78013,0.21987,2.222561,104,31,1, merged,0,0,0.662843278409
33178,1000329,1,2270,1752,518,0.771806,0.228194,0.771806,461,57,2272,1753,519,0.771567,0.228433,0.771567,462,57,1, merged,1,1,0.0973003110443
33181,1000109,2,360,302,58,0.838889,0.161111,1.686241,55,3,361,303,58,0.839335,0.160665,1.687161,55,3,1, merged,0,0,0
33181,1000199,1,321,272,49,0.847352,0.152648,0.847352,45,4,322,273,49,0.847826,0.152174,0.847826,45,4,1, merged,0,0,0
33184,1000015,2,1468,1321,147,0.899864,0.100136,1.649864,135,12,1469,1322,147,0.899932,0.100068,1.661837,135,12,1, merged,0,0,0.156273525619
33185,1000009,1,802,678,124,0.845387,0.154613,0.845387,111,13,804,679,125,0.844527,0.155473,0.844527,111,14,-1, merged,1,0,0.208712131982
33189,1000009,1,804,679,125,0.844527,0.155473,0.844527,111,14,806,681,125,0.844913,0.155087,0.844913,111,14,1, merged,0,0,1.16586389758
33189,1000534,2,128,94,34,0.734375,0.265625,1.578902,32,2,129,95,34,0.736434,0.263566,1.581347,32,2,1, merged,0,0,1.0831438625
33191,1000592,2,462,389,73,0.841991,0.158009,1.689817,47,26,463,390,73,0.842333,0.157667,1.693396,47,26,1, merged,0,0,0.129230459307
33193,1000004,1,2228,1966,262,0.882406,0.117594,0.882406,205,57,2229,1966,263,0.88201,0.11799,0.88201,206,57,1, merged,1,1,0.0298809708925
33193,1000592,4,463,390,73,0.842333,0.157667,3.375802,47,26,464,391,73,0.842672,0.157328,3.412182,47,26,1, merged,0,0,0.0364968143137
33198,1000003,1,893,752,141,0.842105,0.157895,0.842105,128,13,894,753,141,0.842282,0.157718,0.842282,128,13,-1, merged,0,0,0.930940086428
33198,1000004,2,2229,1966,263,0.88201,0.11799,1.724115,206,57,2231,1968,263,0.882116,0.117884,1.724398,206,57,-1, merged,0,0,0.56405717881
33198,1000014,4,1547,1313,234,0.848739,0.151261,3.412262,218,16,1548,1314,234,0.848837,0.151163,3.412825,218,16,1, merged,0,0,0.705207859758
33198,1000120,3,878,737,141,0.839408,0.160592,2.563523,127,14,879,738,141,0.83959,0.16041,2.563988,127,14,1, merged,0,0,0.478070448878
33204,1000108,4,44,36,8,0.818182,0.181818,3.425998,4,4,46,37,9,0.804348,0.195652,3.324226,5,4,1, merged,1,1,0.119697803116
33210,1000120,3,879,738,141,0.83959,0.16041,2.83959,127,14,880,739,141,0.839773,0.160227,2.839773,127,14,1, merged,0,0,0.00498597693986
33211,1000063,2,2313,2066,247,0.893212,0.106788,1.734657,206,41,2314,2067,247,0.893258,0.106742,1.734951,206,41,-1, merged,0,0,0.331634769037
33219,1000091,2,406,309,97,0.761084,0.238916,1.593769,82,15,417,318,99,0.76259,0.23741,1.597205,84,15,-1, abandoned,1,0,0
33219,1000130,1,257,214,43,0.832685,0.167315,0.832685,33,10,260,217,43,0.834615,0.165385,0.834615,33,10,-1, abandoned,0,0,0
33219,1002169,3,15,11,4,0.733333,0.266667,2.327102,4,0,17,13,4,0.764706,0.235294,2.361911,4,0,-1, abandoned,0,0,0
33229,1000108,2,46,37,9,0.804348,0.195652,1.531621,5,4,47,38,9,0.808511,0.191489,1.547641,5,4,1, merged,0,0,0.431614584745
33229,1000140,1,22,16,6,0.727273,0.272727,0.727273,6,0,23,17,6,0.73913,0.26087,0.73913,6,0,1, merged,0,0,0.427985355929
33237,1000063,2,2314,2067,247,0.893258,0.106742,1.809048,206,41,2315,2068,247,0.893305,0.106695,1.809315,206,41,-1, merged,0,0,0.345716089504
33244,1000063,2,2315,2068,247,0.893305,0.106695,1.809315,206,41,2317,2070,247,0.893397,0.106603,1.809627,206,41,-1, merged,0,0,0
33251,1000023,3,413,363,50,0.878935,0.121065,2.724209,47,3,414,364,50,0.879227,0.120773,2.725278,47,3,1, merged,0,0,0.00419736834213
33260,1000023,2,415,364,51,0.877108,0.122892,1.482372,48,3,417,365,52,0.8753,0.1247,1.478748,49,3,1, merged,1,1,0.103521364567
33261,1000014,2,1549,1315,234,0.848935,0.151065,1.629065,218,16,1550,1316,234,0.849032,0.150968,1.62952,218,16,1, merged,0,0,0.164440229649
33261,1000327,1,614,479,135,0.78013,0.21987,0.78013,104,31,615,480,135,0.780488,0.219512,0.780488,104,31,1, merged,0,0,0.194740980635
33266,1000105,1,439,332,107,0.756264,0.243736,0.756264,97,10,441,333,108,0.755102,0.244898,0.755102,98,10,1, abandoned,1,1,0.102714000882
33267,1000004,1,2231,1968,263,0.882116,0.117884,0.882116,206,57,2232,1969,263,0.882168,0.117832,0.882168,206,57,1, merged,0,0,0.364606825398
33267,1000011,2,488,454,34,0.930328,0.069672,1.812444,31,3,489,455,34,0.93047,0.06953,1.812639,31,3,1, merged,0,0,0.915505331002
33268,1000026,2,284,261,23,0.919014,0.080986,1.620313,21,2,285,262,23,0.919298,0.080702,1.621564,21,2,1, merged,0,0,0.0902604834596
33269,1000014,1,1550,1316,234,0.849032,0.150968,0.849032,218,16,1551,1317,234,0.84913,0.15087,0.84913,218,16,1, merged,0,0,0.49936461567
33271,1000014,2,1554,1320,234,0.849421,0.150579,1.690046,218,16,1555,1321,234,0.849518,0.150482,1.690391,218,16,1, merged,0,0,0.499620984781
33276,1000015,1,1477,1330,147,0.900474,0.099526,0.900474,135,12,1478,1331,147,0.900541,0.099459,0.900541,135,12,-1, abandoned,0,0,1.03932915883
33276,1000153,2,705,645,60,0.914894,0.085106,1.815368,46,14,706,646,60,0.915014,0.084986,1.815555,46,14,-1, abandoned,0,0,1.11947518568
33277,1000007,2,966,786,180,0.813665,0.186335,1.663182,161,19,968,787,181,0.813017,0.186983,1.661988,162,19,1, merged,1,1,1.23139269776
33277,1000014,1,1555,1321,234,0.849518,0.150482,0.849518,218,16,1556,1321,235,0.848972,0.151028,0.848972,219,16,1, merged,1,1,0.701376000195
33286,1000329,3,2273,1753,520,0.771227,0.228773,1.870434,463,57,2274,1754,520,0.771328,0.228672,1.784174,463,57,-1, merged,0,0,0.236967220043
33286,1000592,4,464,391,73,0.842672,0.157328,2.713106,47,26,465,392,73,0.843011,0.156989,2.627185,47,26,1, merged,0,0,0.202010818753
33290,1000329,1,2275,1755,520,0.771429,0.228571,0.771429,463,57,2276,1755,521,0.77109,0.22891,0.77109,464,57,1, merged,1,1,0.711399634644
33290,1000592,2,467,394,73,0.843683,0.156317,1.615112,47,26,468,395,73,0.844017,0.155983,1.615107,47,26,1, merged,0,0,0.608599517926
33303,1000004,1,2233,1970,263,0.882221,0.117779,0.882221,206,57,2234,1971,263,0.882274,0.117726,0.882274,206,57,1, merged,0,0,0.485433223008
33317,1000004,2,2234,1971,263,0.882274,0.117726,1.677728,206,57,2236,1973,263,0.882379,0.117621,1.675612,206,57,-1, merged,0,0,0.035014775661
33322,1000003,3,894,753,141,0.842282,0.157718,2.537678,128,13,895,754,141,0.842458,0.157542,2.537261,128,13,1, merged,0,0,0.946137095594
33322,1000004,1,2236,1973,263,0.882379,0.117621,0.882379,206,57,2237,1974,263,0.882432,0.117568,0.882432,206,57,-1, merged,0,0,0.562126489254
33322,1000007,2,968,787,181,0.813017,0.186983,1.695396,162,19,970,788,182,0.812371,0.187629,1.694803,163,19,1, merged,1,1,1.23187587734
33327,1000009,2,812,687,125,0.846059,0.153941,1.582493,111,14,814,688,126,0.845209,0.154791,1.575978,112,14,1, merged,1,1,1.28965990678
33327,1000534,1,129,95,34,0.736434,0.263566,0.736434,32,2,130,95,35,0.730769,0.269231,0.730769,33,2,1, merged,1,1,1.1329985119
33328,1000592,2,468,395,73,0.844017,0.155983,1.594017,47,26,469,396,73,0.84435,0.15565,1.595619,47,26,1, merged,0,0,0.19827170591
33329,1000592,2,469,396,73,0.84435,0.15565,1.595619,47,26,470,397,73,0.844681,0.155319,1.597206,47,26,1, merged,0,0,0.609763610858
33330,1000592,2,470,397,73,0.844681,0.155319,1.597206,47,26,471,398,73,0.845011,0.154989,1.598779,47,26,1, merged,0,0,0.198963658922
33335,1000130,1,262,219,43,0.835878,0.164122,0.835878,33,10,263,220,43,0.836502,0.163498,0.836502,33,10,1, merged,0,0,0.982273527551
33338,1000130,1,263,220,43,0.836502,0.163498,0.836502,33,10,264,221,43,0.837121,0.162879,0.837121,33,10,1, merged,0,0,0.984015863851
33340,1000105,2,441,333,108,0.755102,0.244898,1.583281,98,10,442,333,109,0.753394,0.246606,1.581004,99,10,1, abandoned,1,1,0
33340,1000121,1,1455,1205,250,0.828179,0.171821,0.828179,235,15,1456,1205,251,0.82761,0.17239,0.82761,236,15,1, abandoned,1,1,0
33340,1000329,3,2277,1756,521,0.77119,0.22881,2.354471,464,57,2278,1757,521,0.771291,0.228709,2.352294,464,57,-1, abandoned,0,0,0
33341,1000592,2,471,398,73,0.845011,0.154989,1.598779,47,26,472,399,73,0.845339,0.154661,1.597814,47,26,1, merged,0,0,0.203668773121
33342,1000329,2,2278,1757,521,0.771291,0.228709,1.545826,464,57,2280,1759,521,0.771491,0.228509,1.544578,464,57,-1, merged,0,0,0.397626690185
33343,1000329,2,2280,1759,521,0.771491,0.228509,1.544578,464,57,2283,1761,522,0.771353,0.228647,1.543007,465,57,1, merged,1,1,0.15250102919
33345,1000004,3,2238,1975,263,0.882484,0.117516,2.494508,206,57,2239,1976,263,0.882537,0.117463,2.495337,206,57,1, merged,0,0,0
33345,1000120,2,880,739,141,0.839773,0.160227,1.612024,127,14,881,740,141,0.839955,0.160045,1.612801,127,14,1, merged,0,0,0
33346,1000166,4,201,171,30,0.850746,0.149254,3.147421,28,2,202,172,30,0.851485,0.148515,3.147129,28,2,1, merged,0,0,0.0376998665678
33346,1000329,3,2283,1761,522,0.771353,0.228647,2.296675,465,57,2285,1762,523,0.771116,0.228884,2.295644,466,57,-1, merged,1,0,0.0763327534034
33352,1000004,3,2239,1976,263,0.882537,0.117463,2.504118,206,57,2240,1977,263,0.882589,0.117411,2.504854,206,57,1, merged,0,0,0.00506321376317
33352,1000014,1,1556,1321,235,0.848972,0.151028,0.848972,219,16,1557,1322,235,0.849069,0.150931,0.849069,219,16,1, merged,0,0,0.00257783655935
33352,1000120,4,881,740,141,0.839955,0.160045,3.344073,127,14,882,741,141,0.840136,0.159864,3.34499,127,14,1, merged,0,0,0.00673549409847
33353,1000105,1,443,334,109,0.75395,0.24605,0.75395,99,10,444,334,110,0.752252,0.247748,0.752252,100,10,1, abandoned,1,1,0
33353,1000329,2,2285,1762,523,0.771116,0.228884,1.525066,466,57,2287,1764,523,0.771316,0.228684,1.523568,466,57,-1, abandoned,0,0,0
33355,1000121,2,1456,1205,251,0.82761,0.17239,1.583707,236,15,1457,1206,251,0.827728,0.172272,1.58501,236,15,1, merged,0,0,0.638784492683
33363,1000004,1,2240,1977,263,0.882589,0.117411,0.882589,206,57,2241,1978,263,0.882642,0.117358,0.882642,206,57,-1, abandoned,0,0,0.0186906612754
33363,1000121,2,1457,1206,251,0.827728,0.172272,1.710317,236,15,1458,1207,251,0.827846,0.172154,1.710488,236,15,-1, abandoned,0,0,0.0184878755115
33377,1000014,2,1557,1322,235,0.849069,0.150931,1.488413,219,16,1558,1323,235,0.849166,0.150834,1.491442,219,16,1, merged,0,0,0
33378,1000023,2,417,365,52,0.8753,0.1247,1.792612,49,3,418,366,52,0.875598,0.124402,1.790547,49,3,1, merged,0,0,0.0208893105015
33381,1000023,1,418,366,52,0.875598,0.124402,0.875598,49,3,420,367,53,0.87381,0.12619,0.87381,50,3,1, merged,1,1,3.17474506303e-06
33381,1000063,2,2317,2070,247,0.893397,0.106603,1.768995,206,41,2318,2071,247,0.893443,0.106557,1.767252,206,41,1, merged,0,0,3.94133767152e-06
33416,1000328,2,728,526,202,0.722527,0.277473,1.496886,179,23,729,526,203,0.721536,0.278464,1.493915,180,23,1, abandoned,1,1,0.650946398944
33417,1000329,2,2289,1765,524,0.771079,0.228921,1.543458,467,57,2290,1766,524,0.771179,0.228821,1.541587,467,57,-1, abandoned,0,0,0.393497933197
33420,1000007,2,971,789,182,0.812564,0.187436,1.664416,163,19,972,790,182,0.812757,0.187243,1.665389,163,19,1, merged,0,0,0.0757887151972
33421,1000105,2,445,335,110,0.752809,0.247191,1.66884,100,10,446,336,110,0.753363,0.246637,1.67003,100,10,1, merged,0,0,0.00338207496903
33425,1000329,3,2290,1766,524,0.771179,0.228821,2.296395,467,57,2291,1767,524,0.771279,0.228721,2.295708,467,57,1, merged,0,0,0.393302169088
33426,1000329,2,2291,1767,524,0.771279,0.228721,1.539727,467,57,2292,1768,524,0.771379,0.228621,1.540414,467,57,1, merged,0,0,0.393526874381
33430,1000004,2,2242,1979,263,0.882694,0.117306,1.71054,206,57,2243,1980,263,0.882746,0.117254,1.710711,206,57,1, merged,0,0,0.480678898688
33430,1000121,1,1458,1207,251,0.827846,0.172154,0.827846,236,15,1459,1208,251,0.827964,0.172036,0.827964,236,15,1, merged,0,0,0.59630995868
33435,1000004,3,2243,1980,263,0.882746,0.117254,0.882746,206,57,2245,1982,263,0.882851,0.117149,1.382851,206,57,-1, merged,0,0,0.015014406627
33436,1000014,1,1559,1324,235,0.849262,0.150738,0.849262,219,16,1560,1325,235,0.849359,0.150641,0.849359,219,16,1, merged,0,0,0.312599553731
33436,1000015,2,1489,1340,149,0.899933,0.100067,1.749195,137,12,1490,1341,149,0.9,0.1,1.749359,137,12,1, merged,0,0,0.468467259064
33441,1000014,1,1562,1327,235,0.849552,0.150448,0.849552,219,16,1564,1328,236,0.849105,0.150895,0.849105,220,16,1, merged,1,1,0.0555214346057
33441,1000015,2,1490,1341,149,0.9,0.1,1.749552,137,12,1492,1342,150,0.899464,0.100536,1.748569,138,12,1, merged,1,1,0.0517958141048
33452,1000130,2,264,221,43,0.837121,0.162879,1.514974,33,10,265,222,43,0.837736,0.162264,1.517736,33,10,-1, abandoned,0,0,0
33459,1000329,2,2292,1768,524,0.771379,0.228621,1.603637,467,57,2293,1769,524,0.771478,0.228522,1.604812,467,57,1, merged,0,0,0.513752166893
33462,1000329,1,2293,1769,524,0.771478,0.228522,0.771478,467,57,2294,1770,524,0.771578,0.228422,0.771578,467,57,1, merged,0,0,0.270506758292
33463,1000329,1,2294,1770,524,0.771578,0.228422,0.771578,467,57,2295,1771,524,0.771678,0.228322,0.771678,467,57,1, merged,0,0,0.541819848738
33464,1000592,2,472,399,73,0.845339,0.154661,1.345339,47,26,473,400,73,0.845666,0.154334,1.512333,47,26,1, merged,0,0,0.164819202795
33471,1000329,1,2296,1772,524,0.771777,0.228223,0.771777,467,57,2299,1775,524,0.772075,0.227925,0.772075,467,57,-1, merged,0,0,0.789099817876
33476,1000329,1,2302,1778,524,0.772372,0.227628,0.772372,467,57,2303,1779,524,0.772471,0.227529,0.772471,467,57,1, merged,0,0,0.420235695776
33481,1000003,1,896,755,141,0.842634,0.157366,0.842634,128,13,898,756,142,0.841871,0.158129,0.841871,129,13,1, merged,1,1,0.27475921746
33481,1000004,2,2247,1984,263,0.882955,0.117045,1.725589,206,57,2249,1986,263,0.883059,0.116941,1.72493,206,57,-1, merged,0,0,0.205972101321
33486,1000328,2,729,526,203,0.721536,0.278464,1.494106,180,23,730,527,203,0.721918,0.278082,1.494586,180,23,1, merged,0,0,0.71831847589
33486,1000329,1,2304,1780,524,0.772569,0.227431,0.772569,467,57,2305,1781,524,0.772668,0.227332,0.772668,467,57,1, merged,0,0,0.76924578423
33487,1000329,2,2305,1781,524,0.772668,0.227332,1.528649,467,57,2308,1784,524,0.772964,0.227036,1.530106,467,57,-1, merged,0,0,0.0432721617271
33491,1000004,1,2250,1987,263,0.883111,0.116889,0.883111,206,57,2254,1990,264,0.882875,0.117125,0.882875,206,58,-1, merged,1,0,0.00128262826283
33491,1000091,2,420,320,100,0.761905,0.238095,1.645016,85,15,421,321,100,0.76247,0.23753,1.645345,85,15,1, merged,0,0,0
33491,1000130,3,265,222,43,0.837736,0.162264,2.482752,33,10,266,223,43,0.838346,0.161654,2.483691,33,10,1, merged,0,0,0
33492,1000015,2,1499,1349,150,0.899933,0.100067,1.815545,138,12,1501,1350,151,0.8994,0.1006,1.813726,139,12,1, merged,1,1,0.216830886275
33492,1000153,1,711,651,60,0.915612,0.084388,0.915612,46,14,712,651,61,0.914326,0.085674,0.914326,47,14,1, merged,1,1,0.220959517461
33493,1000070,4,881,773,108,0.877412,0.122588,3.439326,91,17,882,774,108,0.877551,0.122449,3.449175,91,17,1, merged,0,0,0.0160536588048
33493,1000130,5,266,223,43,0.838346,0.161654,4.277672,33,10,267,224,43,0.838951,0.161049,4.288126,33,10,1, merged,0,0,0.00230282095567
33494,1000070,2,882,774,108,0.877551,0.122449,1.877551,91,17,883,775,108,0.87769,0.12231,1.87769,91,17,1, merged,0,0,0.00788886315682
33496,1000026,2,289,265,24,0.916955,0.083045,1.831281,22,2,290,266,24,0.917241,0.082759,1.831687,22,2,1, merged,0,0,0.163583744578
33496,1000153,1,712,651,61,0.914326,0.085674,0.914326,47,14,713,652,61,0.914446,0.085554,0.914446,47,14,1, merged,0,0,0.372216324412
33504,1000004,1,2254,1990,264,0.882875,0.117125,0.882875,206,58,2255,1991,264,0.882927,0.117073,0.882927,206,58,-1, abandoned,0,0,0.025061312455
33504,1000120,2,883,742,141,0.840317,0.159683,1.723192,127,14,884,743,141,0.840498,0.159502,1.723425,127,14,-1, abandoned,0,0,0.0716009144026
33510,1000004,2,2255,1991,264,0.882927,0.117073,1.486375,206,58,2256,1992,264,0.882979,0.117021,1.489816,206,58,1, merged,0,0,0.0148038156947
33513,1000004,3,2256,1992,264,0.882979,0.117021,2.246959,206,58,2257,1993,264,0.883031,0.116969,2.251494,206,58,1, merged,0,0,0.023376619458
33516,1000108,1,47,38,9,0.808511,0.191489,0.808511,5,4,48,38,10,0.791667,0.208333,0.791667,6,4,1, merged,1,1,0.217418801832
33516,1000121,3,1462,1211,251,0.828317,0.171683,2.475779,236,15,1465,1214,251,0.828669,0.171331,2.459888,236,15,-1, merged,0,0,0.26182551133
33516,1000130,2,267,224,43,0.838951,0.161049,1.647462,33,10,268,225,43,0.839552,0.160448,1.631219,33,10,-1, merged,0,0,0.371701422358
33517,1000063,2,2318,2071,247,0.893443,0.106557,1.551337,206,41,2319,2072,247,0.893489,0.106511,1.568489,206,41,1, merged,0,0,1.64073279813e-09
33519,1000124,2,620,575,45,0.927419,0.072581,1.722195,39,6,621,576,45,0.927536,0.072464,1.723075,39,6,1, merged,0,0,0.00147913348826
33526,1000329,3,2311,1785,526,0.772393,0.227607,2.382562,469,57,2313,1787,526,0.77259,0.22741,2.130923,469,57,-1, merged,0,0,0.787507145898
33543,1000592,1,473,400,73,0.845666,0.154334,0.845666,47,26,474,401,73,0.845992,0.154008,0.845992,47,26,-1, merged,0,0,0.296503666467
33544,1000043,2,359,294,65,0.818942,0.181058,0.818942,56,9,360,295,65,0.819444,0.180556,1.819444,56,9,1, merged,0,0,0.699174119732
33548,1000070,3,884,776,108,0.877828,0.122172,2.462945,91,17,885,777,108,0.877966,0.122034,2.463739,91,17,1, merged,0,0,0.583658668676
33548,1000105,2,451,341,110,0.756098,0.243902,1.585117,100,10,452,342,110,0.756637,0.243363,1.585773,100,10,1, merged,0,0,0.587343308678
33548,1000121,1,1468,1217,251,0.829019,0.170981,0.829019,236,15,1469,1218,251,0.829135,0.170865,0.829135,236,15,1, merged,0,0,0.470468985393
33551,1000004,2,2257,1993,264,0.883031,0.116969,1.775713,206,58,2259,1995,264,0.883134,0.116866,1.778372,206,58,-1, abandoned,0,0,0.146292719113
33551,1000329,3,2313,1787,526,0.77259,0.22741,2.548303,469,57,2314,1788,526,0.772688,0.227312,2.55106,469,57,-1, abandoned,0,0,0.176098855193
33554,1000003,1,898,756,142,0.841871,0.158129,0.841871,129,13,900,758,142,0.842222,0.157778,0.842222,129,13,-1, merged,0,0,0.111355050903
33560,1000004,1,2259,1995,264,0.883134,0.116866,0.883134,206,58,2260,1996,264,0.883186,0.116814,0.883186,206,58,1, merged,0,0,0.415815656079
33560,1000120,2,884,743,141,0.840498,0.159502,1.723632,127,14,885,744,141,0.840678,0.159322,1.723864,127,14,1, merged,0,0,0.54176860234
33577,1000023,3,420,367,53,0.87381,0.12619,1.715424,50,3,421,368,53,0.874109,0.125891,2.428952,50,3,-1, abandoned,0,0,0.00416334228414
33579,1000009,2,827,698,129,0.844015,0.155985,0.844015,115,14,828,699,129,0.844203,0.155797,1.844203,115,14,1, merged,0,0,1.17291164003
33586,1000015,2,1504,1353,151,0.899601,0.100399,1.816842,139,12,1505,1353,152,0.899003,0.100997,1.813387,140,12,1, abandoned,1,1,0
33586,1000026,1,290,266,24,0.917241,0.082759,0.917241,22,2,292,267,25,0.914384,0.085616,0.914384,23,2,-1, abandoned,1,0,0
33589,1000328,2,731,528,203,0.722298,0.277702,1.495183,180,23,732,529,203,0.722678,0.277322,1.495522,180,23,-1, abandoned,0,0,0
33589,1000329,1,2316,1790,526,0.772884,0.227116,0.772884,469,57,2320,1793,527,0.772845,0.227155,0.772845,470,57,-1, abandoned,1,0,0
33594,1000014,2,1569,1333,236,0.849586,0.150414,1.553766,220,16,1570,1334,236,0.849682,0.150318,1.55481,220,16,1, merged,0,0,0.541861858577
33596,1000009,2,830,701,129,0.844578,0.155422,1.577403,115,14,831,702,129,0.844765,0.155235,1.581607,115,14,1, merged,0,0,0.195409857915
33596,1000534,1,131,96,35,0.732824,0.267176,0.732824,33,2,133,98,35,0.736842,0.263158,0.736842,33,2,-1, merged,0,0,0.180572338295
33597,1000014,1,1570,1334,236,0.849682,0.150318,0.849682,220,16,1571,1335,236,0.849777,0.150223,0.849777,220,16,-1, abandoned,0,0,0
33601,1000004,1,2260,1996,264,0.883186,0.116814,0.883186,206,58,2261,1997,264,0.883238,0.116762,0.883238,206,58,1, merged,0,0,0.000179646097189
33601,1000121,2,1473,1222,251,0.829599,0.170401,1.712785,236,15,1474,1223,251,0.829715,0.170285,1.712953,236,15,1, merged,0,0,0.000523697302959
33604,1000014,1,1571,1335,236,0.849777,0.150223,0.849777,220,16,1573,1336,237,0.849332,0.150668,0.849332,221,16,-1, abandoned,1,0,0.101525195597
33606,1000329,1,2323,1796,527,0.773138,0.226862,0.773138,470,57,2327,1800,527,0.773528,0.226472,0.773528,470,57,-1, merged,0,0,0.0173036839096
33606,1002169,2,18,13,5,0.722222,0.277778,1.49536,5,0,20,15,5,0.75,0.25,1.523528,5,0,-1, merged,0,0,0
33611,1000592,2,477,402,75,0.842767,0.157233,1.634434,47,28,478,403,75,0.843096,0.156904,1.637617,47,28,1, merged,0,0,0.606745561016
33612,1000121,2,1474,1223,251,0.829715,0.170285,1.496382,236,15,1475,1224,251,0.829831,0.170169,1.579831,236,15,1, merged,0,0,0.591767632846
33633,1000329,2,2327,1800,527,0.773528,0.226472,1.542564,470,57,2328,1800,528,0.773196,0.226804,1.540873,470,58,-1, merged,1,1,0.228289040354
33634,1000328,1,733,530,203,0.723056,0.276944,0.723056,180,23,734,531,203,0.723433,0.276567,0.723433,180,23,1, merged,0,0,0
33634,1000329,2,2328,1800,528,0.773196,0.226804,1.496252,470,58,2329,1801,528,0.773293,0.226707,1.496727,470,58,1, merged,0,0,0
33637,1000009,2,832,703,129,0.844952,0.155048,1.77193,115,14,833,704,129,0.845138,0.154862,1.770239,115,14,1, merged,0,0,1.2254002391
33637,1000011,1,493,457,36,0.926978,0.073022,0.926978,33,3,494,457,37,0.925101,0.074899,0.925101,34,3,1, merged,1,1,1.03532169961
33639,1000011,3,494,457,37,0.925101,0.074899,2.738596,34,3,495,458,37,0.925253,0.074747,2.736997,34,3,1, merged,0,0,0.0584144137278
33639,1000015,1,1512,1359,153,0.89881,0.10119,0.89881,141,12,1513,1359,154,0.898215,0.101785,0.898215,142,12,1, merged,1,1,0
33639,1000153,2,715,654,61,0.914685,0.085315,1.813495,47,14,717,655,62,0.913529,0.086471,1.811744,48,14,-1, merged,1,0,0.0617934207185
33643,1000004,2,2262,1998,264,0.883289,0.116711,1.748674,206,58,2263,1999,264,0.883341,0.116659,1.743996,206,58,-1, abandoned,0,0,0
33643,1000012,1,364,315,49,0.865385,0.134615,0.865385,48,1,366,315,51,0.860656,0.139344,0.860656,50,1,1, abandoned,1,1,0
33651,1000004,2,2263,1999,264,0.883341,0.116659,1.726437,206,58,2265,2000,265,0.883002,0.116998,1.724998,207,58,1, merged,1,1,0.0596755927101
33651,1000592,1,478,403,75,0.843096,0.156904,0.843096,47,28,481,405,76,0.841996,0.158004,0.841996,48,28,1, merged,1,1,0.0735875148163
33659,1000004,2,2265,2000,265,0.883002,0.116998,1.697477,207,58,2266,2001,265,0.883054,0.116946,1.697718,207,58,1, merged,0,0,0.433131111935
33659,1000007,1,981,799,182,0.814475,0.185525,0.814475,163,19,982,800,182,0.814664,0.185336,0.814664,163,19,1, merged,0,0,0.710002676731
33660,1000004,1,2266,2001,265,0.883054,0.116946,0.883054,207,58,2268,2002,266,0.882716,0.117284,0.882716,207,59,-1, merged,1,0,0.430459598345
33660,1000007,2,982,800,182,0.814664,0.185336,1.697718,163,19,983,801,182,0.814852,0.185148,1.697569,163,19,1, merged,0,0,0.703335635063
33666,1000329,2,2335,1803,532,0.772163,0.227837,1.380496,474,58,2336,1804,532,0.77226,0.22774,1.383831,474,58,1, merged,0,0,0.787856128268
33669,1000329,1,2338,1804,534,0.7716,0.2284,0.7716,476,58,2341,1805,536,0.771038,0.228962,0.771038,478,58,1, merged,1,1,0.0378639862118
33669,1002169,2,20,15,5,0.75,0.25,1.5216,5,0,23,17,6,0.73913,0.26087,1.510168,6,0,-1, merged,1,0,0
33670,1000329,1,2341,1805,536,0.771038,0.228962,0.771038,478,58,2344,1806,538,0.770478,0.229522,0.770478,480,58,1, merged,1,1,0.0505921644147
33670,1002169,2,23,17,6,0.73913,0.26087,1.510168,6,0,24,18,6,0.75,0.25,1.520478,6,0,-1, merged,0,0,0
33672,1000124,1,628,583,45,0.928344,0.071656,0.928344,39,6,629,583,46,0.926868,0.073132,0.926868,40,6,1, abandoned,1,1,0
33672,1000329,2,2347,1807,540,0.769919,0.230081,1.698263,482,58,2349,1807,542,0.769264,0.230736,1.696132,484,58,1, abandoned,1,1,0
33673,1000124,1,629,583,46,0.926868,0.073132,0.926868,40,6,630,583,47,0.925397,0.074603,0.925397,41,6,1, merged,1,1,0.433182465845
33673,1000329,2,2349,1807,542,0.769264,0.230736,1.696132,484,58,2352,1808,544,0.768707,0.231293,1.694104,486,58,1, merged,1,1,0.722661049317
33674,1000124,1,630,583,47,0.925397,0.074603,0.925397,41,6,631,583,48,0.92393,0.07607,0.92393,42,6,1, abandoned,1,1,0
33674,1000329,2,2352,1808,544,0.768707,0.231293,1.694104,486,58,2354,1808,546,0.768054,0.231946,1.691985,488,58,1, abandoned,1,1,0
33678,1000121,3,1477,1226,251,0.830061,0.169939,2.498378,236,15,1478,1227,251,0.830176,0.169824,2.465431,236,15,1, merged,0,0,0.138061541209
33684,1000015,2,1515,1361,154,0.89835,0.10165,1.635192,142,12,1516,1362,154,0.898417,0.101583,1.63175,142,12,1, merged,0,0,0.676544340283
33684,1000534,1,133,98,35,0.736842,0.263158,0.736842,33,2,135,99,36,0.733333,0.266667,0.733333,34,2,1, merged,1,1,0.712881106363
33688,1000121,2,1478,1227,251,0.830176,0.169824,1.594065,236,15,1479,1228,251,0.830291,0.169709,1.595268,236,15,1, merged,0,0,0.133694049236
33700,1000534,1,135,99,36,0.733333,0.266667,0.733333,34,2,136,100,36,0.735294,0.264706,0.735294,34,2,1, merged,0,0,0
33702,1000004,1,2268,2002,266,0.882716,0.117284,0.882716,207,59,2271,2005,266,0.882871,0.117129,0.882871,207,59,-1, merged,0,0,0.0791912493764
33708,1000011,2,496,459,37,0.925403,0.074597,1.823954,34,3,497,460,37,0.925553,0.074447,1.824171,34,3,1, merged,0,0,0.00191817656059
33708,1000015,1,1518,1364,154,0.898551,0.101449,0.898551,142,12,1519,1365,154,0.898618,0.101382,0.898618,142,12,1, merged,0,0,0.00191070898094
33709,1000014,2,1575,1338,237,0.849524,0.150476,1.331005,221,16,1577,1340,237,0.849715,0.150285,1.316381,221,16,-1, merged,0,0,0.32943065362
33719,1000534,1,136,100,36,0.735294,0.264706,0.735294,34,2,137,101,36,0.737226,0.262774,0.737226,34,2,-1, merged,0,0,0.566046944477
33720,1000534,1,137,101,36,0.737226,0.262774,0.737226,34,2,138,102,36,0.73913,0.26087,0.73913,34,2,1, merged,0,0,0.699673947543
33726,1000007,1,989,807,182,0.815976,0.184024,0.815976,163,19,990,808,182,0.816162,0.183838,0.816162,163,19,1, merged,0,0,0
33726,1000120,2,886,745,141,0.840858,0.159142,1.656834,127,14,887,746,141,0.841037,0.158963,1.657199,127,14,1, merged,0,0,0.165516252812
33727,1000007,1,990,808,182,0.816162,0.183838,0.816162,163,19,992,809,183,0.815524,0.184476,0.815524,163,20,-1, merged,1,1,8.41498989809e-05
33727,1000120,2,887,746,141,0.841037,0.158963,1.657199,127,14,888,747,141,0.841216,0.158784,1.65674,127,14,1, merged,0,0,0.0523313327239
33728,1000004,2,2272,2006,266,0.882923,0.117077,1.698447,207,59,2273,2007,266,0.882974,0.117026,1.698684,207,59,1, merged,0,0,0.0090124921953
33728,1000007,1,992,809,183,0.815524,0.184476,0.815524,163,20,993,810,183,0.81571,0.18429,0.81571,163,20,1, merged,0,0,0.000231332389533
33732,1000007,1,995,812,183,0.81608,0.18392,0.81608,163,20,997,813,184,0.815446,0.184554,0.815446,164,20,1, merged,1,1,0.00184729064039
33732,1000120,2,889,748,141,0.841395,0.158605,1.657475,127,14,890,749,141,0.841573,0.158427,1.657019,127,14,1, merged,0,0,0.145124890447
33735,1000007,1,998,814,184,0.815631,0.184369,0.815631,164,20,1000,815,185,0.815,0.185,0.815,165,20,1, merged,1,1,0.00226636821489
33735,1000120,2,891,750,141,0.841751,0.158249,1.657382,127,14,892,751,141,0.841928,0.158072,1.656928,127,14,1, merged,0,0,0.145087918817
33736,1000007,1,1000,815,185,0.815,0.185,0.815,165,20,1002,816,186,0.814371,0.185629,0.814371,166,20,1, merged,1,1,0.00271374216652
33736,1000120,2,892,751,141,0.841928,0.158072,1.656928,127,14,893,752,141,0.842105,0.157895,1.656477,127,14,1, merged,0,0,0.146267873541
33737,1000004,2,2273,2007,266,0.882974,0.117026,1.725079,207,59,2274,2008,266,0.883026,0.116974,1.725307,207,59,1, merged,0,0,0.00553177360359
33737,1000120,1,893,752,141,0.842105,0.157895,0.842105,127,14,894,753,141,0.842282,0.157718,0.842282,127,14,1, merged,0,0,0.0240657621298
33738,1000007,1,1002,816,186,0.814371,0.185629,0.814371,166,20,1003,817,186,0.814556,0.185444,0.814556,166,20,1, merged,0,0,0.000498872406263
33738,1000120,2,894,753,141,0.842282,0.157718,1.656653,127,14,895,754,141,0.842458,0.157542,1.657014,127,14,1, merged,0,0,0.0263765540524
33739,1000130,1,270,227,43,0.840741,0.159259,0.840741,33,10,272,228,44,0.838235,0.161765,0.838235,34,10,-1, merged,1,0,0.257416497964
33739,1000329,2,2356,1810,546,0.768251,0.231749,1.608992,488,58,2359,1812,547,0.768122,0.231878,1.606357,489,58,-1, merged,1,0,0.361826001749
33747,1000014,2,1577,1340,237,0.849715,0.150285,1.727681,221,16,1578,1341,237,0.84981,0.15019,1.727914,221,16,1, merged,0,0,0.68408815415
33747,1000070,1,885,777,108,0.877966,0.122034,0.877966,91,17,886,778,108,0.878104,0.121896,0.878104,91,17,1, merged,0,0,0.79784176041
33753,1000004,1,2275,2009,266,0.883077,0.116923,0.883077,207,59,2277,2010,267,0.88274,0.11726,0.88274,208,59,1, merged,1,1,0.0293286098685
33753,1000592,3,481,405,76,0.841996,0.158004,2.325073,48,28,482,406,76,0.842324,0.157676,2.391731,48,28,1, merged,0,0,0.0287855614208
33754,1000014,2,1579,1342,237,0.849905,0.150095,1.563083,221,16,1580,1343,237,0.85,0.15,1.557692,221,16,1, merged,0,0,0.0544530822764
33756,1000003,2,900,758,142,0.842222,0.157778,1.697892,129,13,903,760,143,0.841639,0.158361,1.695174,130,13,-1, merged,1,0,0.00650222654561
33756,1000012,3,366,315,51,0.860656,0.139344,2.558548,50,1,367,316,51,0.861035,0.138965,2.55621,50,1,1, merged,0,0,0.00096281295441
33764,1000004,3,2277,2010,267,0.88274,0.11726,2.514538,208,59,2278,2011,267,0.882792,0.117208,2.522052,208,59,1, merged,0,0,0.000756800071228
33764,1000592,2,482,406,76,0.842324,0.157676,1.631797,48,28,483,407,76,0.84265,0.15735,1.63926,48,28,-1, merged,0,0,0
33773,1000007,1,1003,817,186,0.814556,0.185444,0.814556,166,20,1004,818,186,0.814741,0.185259,0.814741,166,20,1, merged,0,0,0.70578931114
33773,1000011,2,497,460,37,0.925553,0.074447,1.74011,34,3,498,461,37,0.925703,0.074297,1.740444,34,3,1, merged,0,0,0.59163108684
33776,1000004,2,2278,2011,267,0.882792,0.117208,1.697901,208,59,2279,2012,267,0.882843,0.117157,1.698136,208,59,1, merged,0,0,0.436409047656
33776,1000007,1,1006,820,186,0.815109,0.184891,0.815109,166,20,1007,821,186,0.815293,0.184707,0.815293,166,20,1, merged,0,0,0.716972933563
33777,1000004,2,2279,2012,267,0.882843,0.117157,1.698136,208,59,2280,2013,267,0.882895,0.117105,1.698554,208,59,-1, abandoned,0,0,0.282590559218
33777,1000007,1,1007,821,186,0.815293,0.184707,0.815293,166,20,1009,823,186,0.815659,0.184341,0.815659,166,20,-1, abandoned,0,0,0.649404796675
33783,1000004,2,2280,2013,267,0.882895,0.117105,1.697054,208,59,2282,2015,267,0.882997,0.117003,1.69654,208,59,1, merged,0,0,0.216306955057
33783,1000007,1,1017,828,189,0.814159,0.185841,0.814159,168,21,1019,829,190,0.813543,0.186457,0.813543,169,21,1, merged,1,1,0.353889734836
33787,1000004,2,2282,2015,267,0.882997,0.117003,1.694521,208,59,2283,2016,267,0.883049,0.116951,1.694756,208,59,1, merged,0,0,0
33787,1000007,1,1024,831,193,0.811523,0.188477,0.811523,172,21,1025,832,193,0.811707,0.188293,0.811707,172,21,1, merged,0,0,0
33790,1000004,2,2283,2016,267,0.883049,0.116951,1.693544,208,59,2284,2017,267,0.8831,0.1169,1.692993,208,59,1, merged,0,0,0.145200099308
33790,1000007,1,1029,834,195,0.810496,0.189504,0.810496,174,21,1031,835,196,0.809893,0.190107,0.809893,175,21,1, merged,1,1,0.238445231189
33793,1000004,2,2284,2017,267,0.8831,0.1169,1.691795,208,59,2285,2018,267,0.883151,0.116849,1.690473,208,59,1, merged,0,0,0.1091192159
33793,1000007,1,1035,837,198,0.808696,0.191304,0.808696,177,21,1038,838,200,0.807322,0.192678,0.807322,179,21,1, merged,1,1,0.179319782847
33797,1000004,2,2285,2018,267,0.883151,0.116849,1.688707,208,59,2286,2019,267,0.883202,0.116798,1.688173,208,59,1, merged,0,0,0
33797,1000007,1,1044,841,203,0.805556,0.194444,0.805556,182,21,1046,842,204,0.804971,0.195029,0.804971,183,21,1, merged,1,1,0
33806,1000091,2,421,321,100,0.76247,0.23753,1.486655,85,15,422,321,101,0.760664,0.239336,1.484241,86,15,1, abandoned,1,1,0.0107648761267
33806,1000121,5,1481,1230,251,0.83052,0.16948,3.928045,236,15,1482,1231,251,0.830634,0.169366,3.924103,236,15,-1, abandoned,0,0,0.00877126043575
33806,1000328,1,736,533,203,0.724185,0.275815,0.724185,180,23,738,534,204,0.723577,0.276423,0.723577,181,23,1, abandoned,1,1,0.0150121569296
33806,1000329,4,2360,1813,547,0.76822,0.23178,3.097526,489,58,2361,1814,547,0.768319,0.231681,3.093468,489,58,-1, abandoned,0,0,0.00891440704053
33806,1000592,3,483,407,76,0.84265,0.15735,2.329305,48,28,484,407,77,0.840909,0.159091,2.32515,49,28,1, abandoned,1,1,0
33817,1000121,2,1482,1231,251,0.830634,0.169366,1.676788,236,15,1483,1232,251,0.830748,0.169252,1.677374,236,15,1, merged,0,0,0
33817,1000199,1,325,275,50,0.846154,0.153846,0.846154,46,4,326,276,50,0.846626,0.153374,0.846626,46,4,1, merged,0,0,0
33822,1000328,1,738,534,204,0.723577,0.276423,0.723577,181,23,740,536,204,0.724324,0.275676,0.724324,181,23,-1, merged,0,0,0.182192624463
33823,1000091,2,422,321,101,0.760664,0.239336,1.406333,86,15,424,323,101,0.761792,0.238208,1.405203,86,15,-1, merged,0,0,0.207913151023
33823,1000328,3,740,536,204,0.724324,0.275676,2.130657,181,23,741,537,204,0.724696,0.275304,2.1299,181,23,1, merged,0,0,0.182629183322
33824,1000007,3,1052,845,207,0.803232,0.196768,2.356433,186,21,1054,847,207,0.803605,0.196395,2.36041,186,21,-1, abandoned,0,0,0
33824,1000009,1,835,706,129,0.845509,0.154491,0.845509,115,14,837,707,130,0.844683,0.155317,0.844683,116,14,-1, abandoned,1,0,0
33830,1000015,2,1521,1367,154,0.898751,0.101249,1.637881,142,12,1522,1368,154,0.898817,0.101183,1.634532,142,12,1, merged,0,0,0.470266644395
33830,1000534,1,138,102,36,0.73913,0.26087,0.73913,34,2,140,103,37,0.735714,0.264286,0.735714,35,2,1, merged,1,1,0.477637324985
33832,1000014,2,1580,1343,237,0.85,0.15,1.562121,221,16,1581,1344,237,0.850095,0.149905,1.564381,221,16,1, merged,0,0,0.217027456367
33833,1000007,2,1054,847,207,0.803605,0.196395,1.6537,186,21,1055,848,207,0.803791,0.196209,1.653981,186,21,1, merged,0,0,0
33833,1000014,1,1581,1344,237,0.850095,0.149905,0.850095,221,16,1582,1345,237,0.85019,0.14981,0.85019,221,16,1, merged,0,0,0.00756712774614
33836,1000012,1,368,317,51,0.861413,0.138587,0.861413,50,1,369,317,52,0.859079,0.140921,0.859079,51,1,1, merged,1,1,0.154179803951
33842,1000121,2,1483,1232,251,0.830748,0.169252,1.830748,236,15,1484,1233,251,0.830863,0.169137,1.830863,236,15,1, merged,0,0,0.571561994228
33845,1000015,2,1523,1369,154,0.898884,0.101116,1.634598,142,12,1524,1370,154,0.89895,0.10105,1.636539,142,12,1, merged,0,0,0.0264698260713
33845,1000534,1,140,103,37,0.735714,0.264286,0.735714,35,2,141,104,37,0.737589,0.262411,0.737589,35,2,1, merged,0,0,0.0204682642455
33851,1000003,1,903,760,143,0.841639,0.158361,0.841639,130,13,905,761,144,0.840884,0.159116,0.840884,131,13,-1, merged,1,0,0.80667282341
33851,1000014,2,1582,1345,237,0.85019,0.14981,1.691829,221,16,1585,1347,238,0.849842,0.150158,1.690726,222,16,1, merged,1,1,0.685665015447
33853,1000328,1,741,537,204,0.724696,0.275304,0.724696,181,23,742,538,204,0.725067,0.274933,0.725067,181,23,1, merged,0,0,0.252907759722
33853,1000592,2,488,411,77,0.842213,0.157787,1.566909,49,28,489,412,77,0.842536,0.157464,1.567603,49,28,1, merged,0,0,0.198972741004
33854,1000014,1,1585,1347,238,0.849842,0.150158,0.849842,222,16,1586,1348,238,0.849937,0.150063,0.849937,222,16,-1, merged,0,0,0.299070142668
33854,1000121,2,1484,1233,251,0.830863,0.169137,1.680705,236,15,1485,1234,251,0.830976,0.169024,1.680913,236,15,1, merged,0,0,0.277632440232
33863,1000004,2,2287,2020,267,0.883253,0.116747,1.725789,208,59,2289,2022,267,0.883355,0.116645,1.726532,208,59,-1, merged,0,0,0
33863,1000592,1,489,412,77,0.842536,0.157464,0.842536,49,28,491,414,77,0.843177,0.156823,0.843177,49,28,-1, merged,0,0,0
33883,1000004,3,2311,2044,267,0.884466,0.115534,2.653248,208,59,2312,2045,267,0.884516,0.115484,2.653637,208,59,1, merged,0,0,0.00291395420929
33883,1000023,2,425,372,53,0.875294,0.124706,1.768783,50,3,426,373,53,0.875587,0.124413,1.769121,50,3,1, merged,0,0,0.000210401723878
33883,1000063,1,2319,2072,247,0.893489,0.106511,0.893489,206,41,2320,2073,247,0.893534,0.106466,0.893534,206,41,1, merged,0,0,0.000114601532257
33903,1000166,1,208,178,30,0.855769,0.144231,0.855769,28,2,209,178,31,0.851675,0.148325,0.851675,29,2,1, merged,1,1,0.990204127628
33905,1000328,2,743,539,204,0.725437,0.274563,1.371591,181,23,744,540,204,0.725806,0.274194,1.374661,181,23,1, merged,0,0,0.369373317955
33911,1000124,2,632,584,48,0.924051,0.075949,1.767228,42,6,633,585,48,0.924171,0.075829,1.764252,42,6,1, merged,0,0,0.122562892622
33911,1000592,1,491,414,77,0.843177,0.156823,0.843177,49,28,494,415,79,0.840081,0.159919,0.840081,49,30,-1, merged,1,1,0.148096252951
33923,1000023,1,429,376,53,0.876457,0.123543,0.876457,50,3,430,377,53,0.876744,0.123256,0.876744,50,3,1, merged,0,0,0.235991577566
33924,1000011,3,498,461,37,0.925703,0.074297,2.553758,34,3,501,464,37,0.926148,0.073852,2.556455,34,3,-1, merged,0,0,0.198990984525
33924,1000153,2,719,657,62,0.913769,0.086231,1.628055,48,14,720,658,62,0.913889,0.086111,1.630307,48,14,-1, merged,0,0,0.181631801555
33927,1000004,1,2323,2056,267,0.885062,0.114938,0.885062,208,59,2325,2058,267,0.885161,0.114839,0.885161,208,59,-1, abandoned,0,0,0
33927,1000153,2,720,658,62,0.913889,0.086111,1.798951,48,14,721,659,62,0.914008,0.085992,1.79917,48,14,-1, abandoned,0,0,0
33936,1000014,1,1587,1349,238,0.850032,0.149968,0.850032,222,16,1588,1349,239,0.849496,0.150504,0.849496,223,16,1, abandoned,1,1,0.514163412545
33936,1000121,2,1487,1236,251,0.831204,0.168796,1.681235,236,15,1488,1236,252,0.830645,0.169355,1.680141,237,15,1, abandoned,1,1,0.5970592219
33946,1000592,2,494,415,79,0.840081,0.159919,0.840081,49,30,495,416,79,0.840404,0.159596,1.840404,49,30,1, merged,0,0,0.13166344294
33950,1000329,2,2365,1817,548,0.768288,0.231712,1.533264,489,59,2366,1818,548,0.768385,0.231615,1.530943,489,59,1, merged,0,0,0.727556133627
33974,1000121,1,1491,1238,253,0.830315,0.169685,0.830315,238,15,1492,1239,253,0.830429,0.169571,0.830429,238,15,1, merged,0,0,0.0355932975984
33974,1000130,2,274,230,44,0.839416,0.160584,1.669731,34,10,275,231,44,0.84,0.16,1.670429,34,10,1, merged,0,0,0.0412740603383
33983,1000120,2,895,754,141,0.842458,0.157542,1.610844,127,14,896,755,141,0.842634,0.157366,1.610695,127,14,1, merged,0,0,0.00121914050594
33983,1000329,1,2366,1818,548,0.768385,0.231615,0.768385,489,59,2367,1818,549,0.768061,0.231939,0.768061,489,60,-1, merged,1,1,0
33984,1000007,1,1060,853,207,0.804717,0.195283,0.804717,186,21,1063,855,208,0.804327,0.195673,0.804327,186,22,-1, merged,1,0,0.00540106359406
33984,1000120,2,896,755,141,0.842634,0.157366,1.647351,127,14,897,756,141,0.842809,0.157191,1.647137,127,14,1, merged,0,0,0.165632889353
33985,1000004,3,2331,2064,267,0.885457,0.114543,2.532594,208,59,2332,2065,267,0.885506,0.114494,2.530739,208,59,1, merged,0,0,0.000935929334051
33985,1000007,1,1063,855,208,0.804327,0.195673,0.804327,186,22,1067,857,210,0.803187,0.196813,0.803187,188,22,-1, merged,1,0,9.770102563e-05
33985,1000120,2,897,756,141,0.842809,0.157191,1.647137,127,14,899,757,142,0.842047,0.157953,1.645233,128,14,1, merged,1,1,0.00411726488668
33986,1000004,1,2332,2065,267,0.885506,0.114494,0.885506,208,59,2336,2067,269,0.884846,0.115154,0.884846,209,60,1, merged,1,1,0.00519658449184
33986,1000120,4,899,757,142,0.842047,0.157953,3.326043,128,14,901,757,144,0.840178,0.159822,3.322157,130,14,1, merged,1,1,0.00593747971844
33986,1000121,3,1492,1239,253,0.830429,0.169571,2.483996,238,15,1496,1240,256,0.828877,0.171123,2.48198,241,15,1, merged,1,1,0.0112807421376
33986,1000329,2,2367,1818,549,0.768061,0.231939,1.653567,489,60,2369,1820,549,0.768257,0.231743,1.653103,489,60,-1, merged,0,0,0
33986,1002169,5,24,18,6,0.75,0.25,4.076043,6,0,25,19,6,0.76,0.24,4.082157,6,0,1, merged,0,0,0
33987,1000007,1,1067,857,210,0.803187,0.196813,0.803187,188,22,1068,858,210,0.803371,0.196629,0.803371,188,22,1, merged,0,0,0.00433112425753
33987,1000120,2,901,757,144,0.840178,0.159822,1.643364,130,14,902,758,144,0.840355,0.159645,1.643726,130,14,1, merged,0,0,0.0903973884418
33992,1000063,1,2321,2074,247,0.89358,0.10642,0.89358,206,41,2322,2075,247,0.893626,0.106374,0.893626,206,41,1, merged,0,0,0.176034395992
33995,1000023,1,430,377,53,0.876744,0.123256,0.876744,50,3,431,378,53,0.87703,0.12297,0.87703,50,3,1, merged,0,0,0.00397974870094
33996,1000007,2,1068,858,210,0.803371,0.196629,1.717498,188,22,1069,859,210,0.803555,0.196445,1.717801,188,22,-1, abandoned,0,0,1.19929346256
33996,1000153,1,722,660,62,0.914127,0.085873,0.914127,48,14,723,661,62,0.914246,0.085754,0.914246,48,14,-1, abandoned,0,0,0
33996,1000534,3,141,104,37,0.737589,0.262411,2.455087,35,2,142,105,37,0.739437,0.260563,2.457238,35,2,-1, abandoned,0,0,1.08652089211
34000,1000130,1,276,232,44,0.84058,0.15942,0.84058,34,10,277,232,45,0.837545,0.162455,0.837545,35,10,1, merged,1,1,0.634710047954
34002,1000014,1,1592,1353,239,0.849874,0.150126,0.849874,223,16,1593,1353,240,0.849341,0.150659,0.849341,224,16,1, abandoned,1,1,0
34002,1000132,2,252,223,29,0.884921,0.115079,1.734795,22,7,253,223,30,0.881423,0.118577,1.730764,23,7,1, abandoned,1,1,0.0312613525042
34005,1000592,2,495,416,79,0.840404,0.159596,1.673737,49,30,496,417,79,0.840726,0.159274,1.697869,49,30,1, merged,0,0,0.594205459532
34007,1000329,1,2370,1821,549,0.768354,0.231646,0.768354,489,60,2371,1822,549,0.768452,0.231548,0.768452,489,60,-1, merged,0,0,0.00603602753938
34015,1000015,2,1530,1376,154,0.899346,0.100654,1.638783,142,12,1531,1377,154,0.899412,0.100588,1.633678,142,12,1, merged,0,0,1.09468373693
34015,1000534,1,142,105,37,0.739437,0.260563,0.739437,35,2,143,105,38,0.734266,0.265734,0.734266,36,2,1, merged,1,1,1.12070368345
34019,1000004,1,2340,2071,269,0.885043,0.114957,0.885043,209,60,2343,2074,269,0.88519,0.11481,0.88519,209,60,-1, merged,0,0,0.0177746514947
34019,1000011,2,501,464,37,0.926148,0.073852,1.81119,34,3,502,465,37,0.926295,0.073705,1.811485,34,3,-1, merged,0,0,0.0314995189751
34026,1000121,2,1496,1240,256,0.828877,0.171123,1.597329,241,15,1497,1241,256,0.828991,0.171009,1.597541,241,15,1, merged,0,0,0.596544538786
34026,1000329,1,2371,1822,549,0.768452,0.231548,0.768452,489,60,2372,1823,549,0.76855,0.23145,0.76855,489,60,1, merged,0,0,0.717585288293
34031,1000007,2,1071,861,210,0.803922,0.196078,1.648975,188,22,1073,863,210,0.804287,0.195713,1.648335,188,22,-1, merged,0,0,1.22151706607
34031,1000009,1,839,709,130,0.845054,0.154946,0.845054,116,14,840,709,131,0.844048,0.155952,0.844048,117,14,1, merged,1,1,1.1960640676
34036,1000004,2,2351,2080,271,0.88473,0.11527,1.689199,211,60,2352,2081,271,0.884779,0.115221,1.68943,211,60,1, merged,0,0,0.327105670298
34036,1000007,1,1074,864,210,0.804469,0.195531,0.804469,188,22,1075,865,210,0.804651,0.195349,0.804651,188,22,1, merged,0,0,0.451476248234
34044,1000592,1,496,417,79,0.840726,0.159274,0.840726,49,30,498,419,79,0.841365,0.158635,0.841365,49,30,-1, abandoned,0,0,0.0407360917939
34045,1000063,2,2326,2079,247,0.893809,0.106191,1.360476,206,41,2327,2080,247,0.893855,0.106145,1.377726,206,41,1, merged,0,0,0.0321041428595
34046,1000329,1,2373,1824,549,0.768647,0.231353,0.768647,489,60,2374,1824,550,0.768324,0.231676,0.768324,489,61,-1, merged,1,1,0.39405488298
34050,1000005,3,237,182,55,0.767932,0.232068,2.300578,50,5,238,183,55,0.768908,0.231092,2.309196,50,5,1, merged,0,0,0
34050,1000014,1,1597,1357,240,0.849718,0.150282,0.849718,224,16,1598,1358,240,0.849812,0.150188,0.849812,224,16,1, merged,0,0,0
34052,1000009,3,840,709,131,0.844048,0.155952,2.49256,117,14,841,710,131,0.844233,0.155767,2.496529,117,14,-1, abandoned,0,0,0.107895043097
34052,1000153,2,723,661,62,0.914246,0.085754,1.648512,48,14,724,662,62,0.914365,0.085635,1.652296,48,14,-1, abandoned,0,0,0.101435058189
34052,1000534,1,143,105,38,0.734266,0.265734,0.734266,36,2,145,107,38,0.737931,0.262069,0.737931,36,2,-1, abandoned,0,0,0
34056,1000009,1,845,713,132,0.843787,0.156213,0.843787,118,14,846,714,132,0.843972,0.156028,0.843972,118,14,1, merged,0,0,0.235343397416
34056,1000026,2,292,267,25,0.914384,0.085616,1.758171,23,2,293,268,25,0.914676,0.085324,1.758647,23,2,1, merged,0,0,0.0976559737629
34057,1000105,2,452,342,110,0.756637,0.243363,1.676345,100,10,453,343,110,0.757174,0.242826,1.677464,100,10,1, merged,0,0,0.717687613766
34061,1000054,2,128,112,16,0.875,0.125,1.643324,12,4,129,113,16,0.875969,0.124031,1.644488,12,4,-1, abandoned,0,0,0
34061,1000329,1,2374,1824,550,0.768324,0.231676,0.768324,489,61,2376,1826,550,0.768519,0.231481,0.768519,489,61,-1, abandoned,0,0,0
34061,1002169,3,25,19,6,0.76,0.24,2.403324,6,0,26,20,6,0.769231,0.230769,2.413718,6,0,-1, abandoned,0,0,0
34062,1000014,2,1598,1358,240,0.849812,0.150188,1.747248,224,16,1599,1359,240,0.849906,0.150094,1.748211,224,16,1, merged,0,0,0
34071,1000328,2,744,540,204,0.725806,0.274194,1.392473,181,23,745,541,204,0.726174,0.273826,1.426174,181,23,1, merged,0,0,0.38380579672
34077,1000121,2,1497,1241,256,0.828991,0.171009,1.681372,241,15,1498,1241,257,0.828438,0.171562,1.676779,242,15,1, merged,1,1,0.0355775758228
34077,1000130,3,282,237,45,0.840426,0.159574,2.521798,35,10,285,239,46,0.838596,0.161404,2.515376,36,10,-1, merged,1,0,0.0419207104671
34077,1000166,1,210,179,31,0.852381,0.147619,0.852381,29,2,211,179,32,0.848341,0.151659,0.848341,30,2,1, merged,1,1,0.034102176238
34080,1000592,2,499,420,79,0.841683,0.158317,1.698826,49,30,500,421,79,0.842,0.158,1.717,49,30,1, merged,0,0,0.596490842491
34081,1000166,1,211,179,32,0.848341,0.151659,0.848341,30,2,212,180,32,0.849057,0.150943,0.849057,30,2,1, merged,0,0,0.417434002779
34085,1000109,3,364,306,58,0.840659,0.159341,2.489246,55,3,365,307,58,0.841096,0.158904,2.497535,55,3,1, merged,0,0,0
34085,1000199,4,327,277,50,0.847095,0.152905,3.336341,46,4,328,277,51,0.844512,0.155488,3.342047,46,5,-1, merged,1,1,0
34087,1000004,1,2354,2083,271,0.884877,0.115123,0.884877,211,60,2357,2086,271,0.885023,0.114977,0.885023,211,60,-1, abandoned,0,0,0.418425524528
34087,1000091,2,424,323,101,0.761792,0.238208,1.646669,86,15,425,324,101,0.762353,0.237647,1.647376,86,15,-1, abandoned,0,0,0.424676928924
34088,1000004,1,2357,2086,271,0.885023,0.114977,0.885023,211,60,2358,2087,271,0.885072,0.114928,0.885072,211,60,-1, merged,0,0,0.417769834767
34089,1000328,3,745,541,204,0.726174,0.273826,2.49479,181,23,746,542,204,0.726542,0.273458,2.495255,181,23,1, merged,0,0,0.181953883437
34089,1000329,1,2377,1827,550,0.768616,0.231384,0.768616,489,61,2378,1828,550,0.768713,0.231287,0.768713,489,61,1, merged,0,0,0.114161014488
34091,1000534,2,145,107,38,0.737931,0.262069,1.619181,36,2,146,108,38,0.739726,0.260274,1.621714,36,2,1, merged,0,0,0.17505577716
34092,1000329,3,2378,1828,550,0.768713,0.231287,2.463159,489,61,2379,1829,550,0.76881,0.23119,2.465013,489,61,1, merged,0,0,0.539964641983
34093,1000014,1,1599,1359,240,0.849906,0.150094,0.849906,224,16,1602,1360,242,0.848939,0.151061,0.848939,225,17,1, merged,1,1,0.577203521579
34093,1000120,2,902,758,144,0.840355,0.159645,1.690261,130,14,904,759,145,0.839602,0.160398,1.688541,130,15,1, merged,1,0,0.408212828279
34099,1000004,1,2359,2088,271,0.885121,0.114879,0.885121,211,60,2360,2089,271,0.885169,0.114831,0.885169,211,60,1, merged,0,0,0.555580375282
34107,1000009,2,847,715,132,0.844156,0.155844,1.743699,118,14,849,717,132,0.844523,0.155477,1.74348,118,14,-1, merged,0,0,0.122917641542
34107,1000015,1,1533,1379,154,0.899543,0.100457,0.899543,142,12,1534,1379,155,0.898957,0.101043,0.898957,143,12,1, merged,1,1,0.115773252785
34108,1000009,2,849,717,132,0.844523,0.155477,1.74348,118,14,850,718,132,0.844706,0.155294,1.743077,118,14,1, merged,0,0,0.0890063209057
34108,1000015,1,1534,1379,155,0.898957,0.101043,0.898957,143,12,1535,1379,156,0.898371,0.101629,0.898371,144,12,1, merged,1,1,0.0806673900323
34112,1000121,2,1498,1241,257,0.828438,0.171562,1.554979,242,15,1500,1242,258,0.828,0.172,1.554908,243,15,-1, abandoned,1,0,0.0445891567516
34112,1000132,3,254,224,30,0.88189,0.11811,2.436869,23,7,255,225,30,0.882353,0.117647,2.437261,23,7,-1, abandoned,0,0,0.0665716496726
34112,1000328,1,746,542,204,0.726542,0.273458,0.726542,181,23,747,543,204,0.726908,0.273092,0.726908,181,23,-1, abandoned,0,0,0.0705143015595
34116,1000015,1,1536,1380,156,0.898438,0.101562,0.898438,144,12,1537,1380,157,0.897853,0.102147,0.897853,145,12,1, merged,1,1,0.0300194425874
34116,1000026,2,293,268,25,0.914676,0.085324,1.813113,23,2,296,270,26,0.912162,0.087838,1.810015,24,2,-1, merged,1,0,0.0144392118473
34118,1000121,1,1500,1242,258,0.828,0.172,0.828,243,15,1502,1243,259,0.827563,0.172437,0.827563,244,15,1, merged,1,1,0.0446749016492
34118,1000328,2,747,543,204,0.726908,0.273092,1.554908,181,23,749,544,205,0.726302,0.273698,1.553865,182,23,1, merged,1,1,0.0708161457272
34126,1000004,1,2368,2097,271,0.885557,0.114443,0.885557,211,60,2370,2098,272,0.885232,0.114768,0.885232,211,61,-1, merged,1,0,0.414824772376
34126,1000329,2,2380,1830,550,0.768908,0.231092,1.654465,489,61,2381,1831,550,0.769005,0.230995,1.654237,489,61,1, merged,0,0,0.482337181744
34131,1000329,1,2381,1831,550,0.769005,0.230995,0.769005,489,61,2382,1831,551,0.768682,0.231318,0.768682,490,61,1, abandoned,1,1,0.0713587614247
34134,1000054,3,129,113,16,0.875969,0.124031,2.408217,12,4,130,114,16,0.876923,0.123077,2.410667,12,4,1, merged,0,0,0.546582201823
34134,1000329,1,2382,1831,551,0.768682,0.231318,0.768682,490,61,2383,1831,552,0.768359,0.231641,0.768359,490,62,-1, merged,1,1,0
34139,1000015,1,1540,1383,157,0.898052,0.101948,0.898052,145,12,1542,1384,158,0.897536,0.102464,0.897536,146,12,1, merged,1,1,0.56468095093
34139,1002169,2,26,20,6,0.769231,0.230769,1.667283,6,0,27,21,6,0.777778,0.222222,1.675313,6,0,1, merged,0,0,0
34141,1000012,2,369,317,52,0.859079,0.140921,1.718234,51,1,370,318,52,0.859459,0.140541,1.7146,51,1,1, merged,0,0,0.151423006598
34142,1000012,2,370,318,52,0.859459,0.140541,1.7146,51,1,371,319,52,0.859838,0.140162,1.711001,51,1,1, merged,0,0,0.871585513638
34143,1000012,2,371,319,52,0.859838,0.140162,1.711001,51,1,372,320,52,0.860215,0.139785,1.707437,51,1,1, merged,0,0,0.8533500139
34146,1000012,2,373,321,52,0.86059,0.13941,1.707812,51,1,374,322,52,0.860963,0.139037,1.704281,51,1,1, merged,0,0,0.154781746032
34147,1000012,2,374,322,52,0.860963,0.139037,1.704281,51,1,375,323,52,0.861333,0.138667,1.700783,51,1,1, merged,0,0,0.837775926697
34148,1000012,2,375,323,52,0.861333,0.138667,1.700783,51,1,376,324,52,0.861702,0.138298,1.701885,51,1,1, merged,0,0,0.15645692082
34150,1000009,2,850,718,132,0.844706,0.155294,1.584432,118,14,851,719,132,0.844888,0.155112,1.581375,118,14,1, merged,0,0,1.2688957583
34150,1000534,1,146,108,38,0.739726,0.260274,0.739726,36,2,148,109,39,0.736486,0.263514,0.736486,37,2,1, merged,1,1,1.13653796654
34151,1000012,2,376,324,52,0.861702,0.138298,1.701885,51,1,377,325,52,0.862069,0.137931,1.702978,51,1,1, merged,0,0,0.158056397757
34156,1000004,4,2373,2101,272,0.885377,0.114623,2.983435,211,61,2374,2102,272,0.885425,0.114575,2.992833,211,61,1, merged,0,0,0.00481381621758
34156,1000329,5,2383,1831,552,0.768359,0.231641,3.751794,490,62,2384,1832,552,0.768456,0.231544,3.761289,490,62,1, merged,0,0,0.00183777890936
34164,1000003,2,906,762,144,0.84106,0.15894,1.739365,131,13,907,762,145,0.840132,0.159868,1.731799,132,13,1, abandoned,1,1,0.137820721454
34164,1000014,3,1608,1365,243,0.848881,0.151119,2.588245,225,18,1609,1366,243,0.848975,0.151025,2.580773,225,18,-1, abandoned,0,0,0.15143663496
34171,1000023,1,433,380,53,0.877598,0.122402,0.877598,50,3,434,380,54,0.875576,0.124424,0.875576,51,3,1, abandoned,1,1,0.478596688724
34171,1000140,2,24,18,6,0.75,0.25,1.627598,6,0,25,18,7,0.72,0.28,1.595576,7,0,1, abandoned,1,1,0.00624865330748
34172,1000012,2,377,325,52,0.862069,0.137931,1.722069,51,1,378,326,52,0.862434,0.137566,1.705571,51,1,1, merged,0,0,0.159654544014
34173,1000014,1,1609,1366,243,0.848975,0.151025,0.848975,225,18,1610,1367,243,0.849068,0.150932,0.849068,225,18,1, merged,0,0,0.200596517003
34173,1000070,2,887,779,108,0.878241,0.121759,1.727216,91,17,888,780,108,0.878378,0.121622,1.727447,91,17,1, merged,0,0,0.243481481499
34174,1000054,3,130,114,16,0.876923,0.123077,2.454486,12,4,132,116,16,0.878788,0.121212,2.483578,12,4,-1, merged,0,0,0.816989565277
34174,1000121,2,1502,1243,259,0.827563,0.172437,1.577563,244,15,1503,1243,260,0.827013,0.172987,1.60479,245,15,1, merged,1,1,0.335437148434
34185,1000329,1,2386,1834,552,0.76865,0.23135,0.76865,490,62,2387,1835,552,0.768747,0.231253,0.768747,490,62,1, merged,0,0,0.491360387782
34186,1000329,2,2387,1835,552,0.768747,0.231253,1.768747,490,62,2388,1836,552,0.768844,0.231156,1.768844,490,62,1, merged,0,0,0.0186213759347
34198,1000329,2,2390,1838,552,0.769038,0.230962,1.546815,490,62,2391,1839,552,0.769134,0.230866,1.519134,490,62,1, merged,0,0,0.125795131778
34198,1002169,1,27,21,6,0.777778,0.222222,0.777778,6,0,28,21,7,0.75,0.25,0.75,6,1,-1, merged,1,1,0
34199,1000130,1,287,241,46,0.839721,0.160279,0.839721,36,10,288,242,46,0.840278,0.159722,0.840278,36,10,1, merged,0,0,0.534159856162
34199,1000132,3,255,225,30,0.882353,0.117647,2.579217,23,7,256,226,30,0.882812,0.117188,2.589757,23,7,1, merged,0,0,0.692934936351
34204,1000007,2,1078,868,210,0.805195,0.194805,1.649821,188,22,1079,869,210,0.805375,0.194625,1.650183,188,22,1, merged,0,0,0.130073952026
34204,1000009,1,856,723,133,0.844626,0.155374,0.844626,119,14,857,724,133,0.844807,0.155193,0.844807,119,14,1, merged,0,0,0.127163694778
34206,1000009,1,858,725,133,0.844988,0.155012,0.844988,119,14,859,726,133,0.845169,0.154831,0.845169,119,14,1, merged,0,0,1.30901698296
34206,1000014,2,1611,1368,243,0.849162,0.150838,1.69415,225,18,1612,1369,243,0.849256,0.150744,1.694424,225,18,1, merged,0,0,0.711308863301
34211,1000004,5,2376,2104,272,0.885522,0.114478,3.651466,211,61,2377,2105,272,0.88557,0.11443,3.647449,211,61,1, merged,0,0,0.0048661895669
34213,1000329,1,2391,1839,552,0.769134,0.230866,0.769134,490,62,2394,1840,554,0.768588,0.231412,0.768588,492,62,1, merged,1,1,0.0203984830503
34213,1002169,3,28,21,7,0.75,0.25,2.20961,6,1,29,22,7,0.758621,0.241379,2.222861,6,1,1, merged,0,0,0
34218,1000140,2,25,18,7,0.72,0.28,1.72,7,0,28,20,8,0.714286,0.285714,1.680952,8,0,-1, merged,1,0,0.0242966751918
34219,1000130,2,288,242,46,0.840278,0.159722,1.598898,36,10,289,243,46,0.84083,0.15917,1.607497,36,10,1, merged,0,0,0.641539776935
34219,1002169,1,29,22,7,0.758621,0.241379,0.758621,6,1,30,23,7,0.766667,0.233333,0.766667,6,1,1, merged,0,0,0
34220,1000329,3,2394,1840,554,0.768588,0.231412,2.393588,492,62,2395,1841,554,0.768685,0.231315,2.415744,492,62,1, merged,0,0,0.72100631515
34222,1002169,1,30,23,7,0.766667,0.233333,0.766667,6,1,33,24,9,0.727273,0.272727,0.727273,8,1,1, merged,1,1,0
34227,1000121,2,1507,1246,261,0.826808,0.173192,1.675865,246,15,1508,1247,261,0.826923,0.173077,1.676688,246,15,1, merged,0,0,0.498831741095
34227,1000166,1,212,180,32,0.849057,0.150943,0.849057,30,2,213,181,32,0.849765,0.150235,0.849765,30,2,1, merged,0,0,0.960881218847
34233,1000329,2,2396,1842,554,0.768781,0.231219,1.496054,492,62,2397,1843,554,0.768878,0.231122,1.504172,492,62,1, merged,0,0,0.0133965950321
34233,1002169,1,33,24,9,0.727273,0.272727,0.727273,8,1,34,25,9,0.735294,0.264706,0.735294,8,1,1, merged,0,0,0
34238,1000014,1,1612,1369,243,0.849256,0.150744,0.849256,225,18,1613,1370,243,0.849349,0.150651,0.849349,225,18,-1, merged,0,0,0.229492386652
34242,1000329,1,2398,1844,554,0.768974,0.231026,0.768974,492,62,2399,1845,554,0.76907,0.23093,0.76907,492,62,-1, merged,0,0,0.255959562326
34245,1002169,1,34,25,9,0.735294,0.264706,0.735294,8,1,41,27,14,0.658537,0.341463,0.658537,13,1,1, merged,1,1,0
34247,1000004,1,2380,2108,272,0.885714,0.114286,0.885714,211,61,2381,2108,273,0.885342,0.114658,0.885342,212,61,1, merged,1,1,0
34247,1000153,2,726,664,62,0.914601,0.085399,1.800315,48,14,729,667,62,0.914952,0.085048,1.800294,48,14,-1, merged,0,0,0
34250,1002169,1,41,27,14,0.658537,0.341463,0.658537,13,1,47,28,19,0.595745,0.404255,0.595745,18,1,1, merged,1,1,0
34251,1000023,2,434,380,54,0.875576,0.124424,1.589862,51,3,436,382,54,0.876147,0.123853,1.594897,51,3,-1, merged,0,0,0.405860465456
34251,1000140,1,28,20,8,0.714286,0.285714,0.714286,8,0,32,23,9,0.71875,0.28125,0.71875,9,0,1, merged,1,1,0.0185303514377
34251,1002169,4,47,28,19,0.595745,0.404255,3.152273,18,1,48,29,19,0.604167,0.395833,3.136563,18,1,1, merged,0,0,0
34253,1000007,2,1081,871,210,0.805735,0.194265,1.684523,188,22,1082,872,210,0.805915,0.194085,1.685225,188,22,-1, abandoned,0,0,0.0451040241547
34254,1000153,2,730,668,62,0.915068,0.084932,1.651555,48,14,731,669,62,0.915185,0.084815,1.648518,48,14,1, merged,0,0,0.0189174564585
34254,1000534,1,148,109,39,0.736486,0.263514,0.736486,37,2,150,110,40,0.733333,0.266667,0.733333,38,2,1, merged,1,1,0.0201425877448
34255,1000004,1,2381,2108,273,0.885342,0.114658,0.885342,212,61,2382,2108,274,0.884971,0.115029,0.884971,213,61,1, merged,1,1,0.00122955811189
34255,1000014,2,1616,1373,243,0.849629,0.150371,1.734971,225,18,1617,1374,243,0.849722,0.150278,1.734692,225,18,-1, merged,0,0,0
34255,1000121,4,1508,1247,261,0.826923,0.173077,3.422654,246,15,1510,1249,261,0.827152,0.172848,3.42043,246,15,-1, merged,0,0,0.00138974448557
34262,1000007,2,1082,872,210,0.805915,0.194085,1.651801,188,22,1083,873,210,0.806094,0.193906,1.652159,188,22,1, merged,0,0,0.124148779041
34262,1000009,1,863,730,133,0.845886,0.154114,0.845886,119,14,864,731,133,0.846065,0.153935,0.846065,119,14,1, merged,0,0,0.125487910093
34262,1000011,3,506,469,37,0.926877,0.073123,2.578679,34,3,507,470,37,0.927022,0.072978,2.579181,34,3,1, merged,0,0,0.119161701528
34263,1000023,2,436,382,54,0.876147,0.123853,1.645313,51,3,437,383,54,0.87643,0.12357,1.645789,51,3,-1, abandoned,0,0,0.0285085427793
34263,1000329,1,2400,1846,554,0.769167,0.230833,0.769167,492,62,2402,1848,554,0.769359,0.230641,0.769359,492,62,-1, abandoned,0,0,0.0220894342977
34263,1002169,3,48,29,19,0.604167,0.395833,2.24948,18,1,52,29,23,0.557692,0.442308,2.203481,22,1,1, abandoned,1,1,0
34265,1000132,2,256,226,30,0.882812,0.117188,1.440505,23,7,257,227,30,0.883268,0.116732,1.449306,23,7,1, merged,0,0,0.6431959345
34265,1002169,1,52,29,23,0.557692,0.442308,0.557692,22,1,53,30,23,0.566038,0.433962,0.566038,22,1,1, merged,0,0,0
34267,1000003,1,907,762,145,0.840132,0.159868,0.840132,132,13,909,762,147,0.838284,0.161716,0.838284,132,15,-1, merged,1,1,0.566547361369
34267,1000329,2,2402,1848,554,0.769359,0.230641,1.609491,492,62,2403,1849,554,0.769455,0.230545,1.607739,492,62,1, merged,0,0,0.719644251573
34276,1000023,2,437,383,54,0.87643,0.12357,1.761676,51,3,438,384,54,0.876712,0.123288,1.755745,51,3,1, merged,0,0,0.0714784735328
34277,1002169,1,53,30,23,0.566038,0.433962,0.566038,22,1,55,31,24,0.563636,0.436364,0.563636,23,1,1, merged,1,1,0
34281,1000120,2,910,764,146,0.83956,0.16044,1.172894,130,16,911,765,146,0.839737,0.160263,1.339737,130,16,1, merged,0,0,0.232842876774
34282,1000014,2,1617,1374,243,0.849722,0.150278,1.616005,225,18,1618,1375,243,0.849815,0.150185,1.614073,225,18,1, merged,0,0,0.100732983384
34282,1000070,3,888,780,108,0.878378,0.121622,2.494384,91,17,889,781,108,0.878515,0.121485,2.492588,91,17,1, merged,0,0,0.124080748489
34290,1000166,1,214,182,32,0.850467,0.149533,0.850467,30,2,216,182,34,0.842593,0.157407,0.842593,32,2,1, merged,1,1,0.128522582443
34290,1002169,2,55,31,24,0.563636,0.436364,1.414104,23,1,57,32,25,0.561404,0.438596,1.403996,24,1,1, merged,1,1,0
34294,1000091,3,425,324,101,0.762353,0.237647,2.093211,86,15,426,325,101,0.762911,0.237089,2.091464,86,15,-1, merged,0,0,0
34294,1000329,2,2403,1849,554,0.769455,0.230545,1.330858,492,62,2405,1850,555,0.769231,0.230769,1.328553,493,62,1, merged,1,1,0.724532402026
34294,1002169,1,57,32,25,0.561404,0.438596,0.561404,24,1,59,33,26,0.559322,0.440678,0.559322,25,1,1, merged,1,1,0
34295,1000023,1,438,384,54,0.876712,0.123288,0.876712,51,3,439,385,54,0.876993,0.123007,0.876993,51,3,1, merged,0,0,0.404485143526
34296,1000121,2,1511,1250,261,0.827267,0.172733,1.553568,246,15,1512,1251,261,0.827381,0.172619,1.554048,246,15,1, merged,0,0,0.538519787156
34296,1000328,1,749,544,205,0.726302,0.273698,0.726302,182,23,750,545,205,0.726667,0.273333,0.726667,182,23,1, merged,0,0,0.416982999174
34300,1000004,2,2384,2110,274,0.885067,0.114933,1.691161,213,61,2385,2111,274,0.885115,0.114885,1.691388,213,61,1, merged,0,0,0.434865598417
34300,1000007,1,1083,873,210,0.806094,0.193906,0.806094,188,22,1084,874,210,0.806273,0.193727,0.806273,188,22,1, merged,0,0,0.712027721887
34304,1002169,2,59,33,26,0.559322,0.440678,1.159322,25,1,63,34,29,0.539683,0.460317,1.130287,28,1,1, merged,1,1,0
34305,1000009,1,865,732,133,0.846243,0.153757,0.846243,119,14,866,732,134,0.845266,0.154734,0.845266,120,14,1, merged,1,1,0
34305,1000153,2,731,669,62,0.915185,0.084815,1.761427,48,14,734,671,63,0.914169,0.085831,1.759435,49,14,1, merged,1,1,0.952829294925
34306,1000014,2,1619,1376,243,0.849907,0.150093,1.484236,225,18,1620,1377,243,0.85,0.15,1.487037,225,18,1, merged,0,0,0.525239765245
34307,1000011,1,507,470,37,0.927022,0.072978,0.927022,34,3,508,471,37,0.927165,0.072835,0.927165,34,3,1, merged,0,0,0.61306390442
34307,1000120,2,911,765,146,0.839737,0.160263,1.766758,130,16,912,766,146,0.839912,0.160088,1.767078,130,16,1, merged,0,0,0.527929326842
34311,1000199,3,328,277,51,0.844512,0.155488,2.474794,46,5,330,279,51,0.845455,0.154545,2.46139,46,5,-1, merged,0,0,0
34312,1000023,2,439,385,54,0.876993,0.123007,1.604266,51,3,440,386,54,0.877273,0.122727,1.583155,51,3,1, merged,0,0,0.404934584749
34312,1000140,1,33,24,9,0.727273,0.272727,0.727273,9,0,34,24,10,0.705882,0.294118,0.705882,9,1,-1, merged,1,1,0.0301958307012
34313,1000054,3,135,118,17,0.874074,0.125926,2.608974,12,5,136,119,17,0.875,0.125,2.608389,12,5,1, merged,0,0,0.407266308897
34313,1000121,4,1512,1251,261,0.827381,0.172619,3.436355,246,15,1513,1252,261,0.827495,0.172505,3.435884,246,15,1, merged,0,0,0.167883429632
34313,1000166,1,216,182,34,0.842593,0.157407,0.842593,32,2,218,183,35,0.83945,0.16055,0.83945,33,2,1, merged,1,1,0.206964357746
34315,1000026,2,298,272,26,0.912752,0.087248,1.826921,24,2,299,273,26,0.913043,0.086957,1.827446,24,2,1, merged,0,0,0.466936299292
34315,1000153,1,734,671,63,0.914169,0.085831,0.914169,49,14,736,673,63,0.914402,0.085598,0.914402,49,14,-1, merged,0,0,0.948505940912
34321,1000023,1,440,386,54,0.877273,0.122727,0.877273,51,3,441,387,54,0.877551,0.122449,0.877551,51,3,1, merged,0,0,0.404735600213
34322,1002169,1,63,34,29,0.539683,0.460317,0.539683,28,1,65,35,30,0.538462,0.461538,0.538462,29,1,1, merged,1,1,0
34323,1000004,3,2388,2114,274,0.88526,0.11474,1.846798,213,61,2389,2115,274,0.885308,0.114692,1.83817,213,61,1, merged,0,0,0.0241470735853
34323,1002169,2,65,35,30,0.538462,0.461538,0.961538,29,1,66,36,30,0.545455,0.454545,0.952862,29,1,1, merged,0,0,0
34325,1002169,1,66,36,30,0.545455,0.454545,0.545455,29,1,68,37,31,0.544118,0.455882,0.544118,30,1,1, merged,1,1,0
34327,1000023,2,441,387,54,0.877551,0.122449,1.824919,51,3,442,388,54,0.877828,0.122172,1.826546,51,3,1, merged,0,0,0.404703093222
34337,1000005,2,239,184,55,0.769874,0.230126,1.313992,50,5,241,186,55,0.771784,0.228216,1.308016,50,5,-1, merged,0,0,0.1525930519
34337,1002169,1,68,37,31,0.544118,0.455882,0.544118,30,1,69,37,32,0.536232,0.463768,0.536232,31,1,1, merged,1,1,0
34338,1000166,1,218,183,35,0.83945,0.16055,0.83945,33,2,220,184,36,0.836364,0.163636,0.836364,34,2,1, merged,1,1,0.460250544662
34338,1002169,2,69,37,32,0.536232,0.463768,1.375681,31,1,70,37,33,0.528571,0.471429,1.364935,31,2,-1, merged,1,1,0
34342,1000011,1,508,471,37,0.927165,0.072835,0.927165,34,3,509,472,37,0.927308,0.072692,0.927308,34,3,1, merged,0,0,0.0343347803501
34342,1000026,2,299,273,26,0.913043,0.086957,1.840209,24,2,300,274,26,0.913333,0.086667,1.840642,24,2,1, merged,0,0,0.0677888510405
34347,1000009,1,868,734,134,0.845622,0.154378,0.845622,120,14,869,735,134,0.8458,0.1542,0.8458,120,14,1, merged,0,0,0.54938430039
34347,1000011,2,509,472,37,0.927308,0.072692,1.772931,34,3,510,473,37,0.927451,0.072549,1.773251,34,3,1, merged,0,0,0.438316426279
34347,1000014,3,1621,1378,243,0.850093,0.149907,2.623023,225,18,1622,1379,243,0.850185,0.149815,2.623436,225,18,1, merged,0,0,0.309115277529
34350,1000004,2,2390,2116,274,0.885356,0.114644,1.452022,213,61,2392,2118,274,0.885452,0.114548,1.445891,213,61,-1, merged,0,0,0.0554164274481
34352,1000091,2,426,325,101,0.762911,0.237089,1.712911,86,15,428,326,102,0.761682,0.238318,1.712902,87,15,1, merged,1,1,0.43415117804
34353,1000054,2,137,120,17,0.875912,0.124088,1.404484,12,5,138,121,17,0.876812,0.123188,1.418478,12,5,1, merged,0,0,0.542163252638
34353,1002169,1,70,37,33,0.528571,0.471429,0.528571,31,2,72,39,33,0.541667,0.458333,0.541667,31,2,-1, merged,0,0,0
34359,1000004,2,2393,2119,274,0.885499,0.114501,1.427166,213,61,2394,2120,274,0.885547,0.114453,1.419794,213,61,-1, abandoned,0,0,0.010390915047
34359,1002169,1,72,39,33,0.541667,0.458333,0.541667,31,2,73,39,34,0.534247,0.465753,0.534247,32,2,1, abandoned,1,1,0
34360,1000327,2,615,480,135,0.780488,0.219512,1.314734,104,31,616,481,135,0.780844,0.219156,1.321385,104,31,1, merged,0,0,0.470642850535
34360,1002169,1,73,39,34,0.534247,0.465753,0.534247,32,2,74,40,34,0.540541,0.459459,0.540541,32,2,1, merged,0,0,0
34363,1000007,2,1092,881,211,0.806777,0.193223,1.656962,188,23,1093,882,211,0.806953,0.193047,1.656614,188,23,-1, abandoned,0,0,0.644939888966
34363,1000014,1,1622,1379,243,0.850185,0.149815,0.850185,225,18,1623,1379,244,0.849661,0.150339,0.849661,226,18,1, abandoned,1,1,0.357756492876
34367,1000004,2,2394,2120,274,0.885547,0.114453,1.692117,213,61,2395,2121,274,0.885595,0.114405,1.691606,213,61,1, merged,0,0,0.0377716506865
34367,1000007,1,1096,884,212,0.806569,0.193431,0.806569,189,23,1098,885,213,0.806011,0.193989,0.806011,190,23,1, merged,1,1,0.0585084209819
34368,1000004,2,2395,2121,274,0.885595,0.114405,1.691606,213,61,2396,2122,274,0.885643,0.114357,1.69183,213,61,1, merged,0,0,0.0275228061778
34368,1000007,1,1098,885,213,0.806011,0.193989,0.806011,190,23,1099,886,213,0.806187,0.193813,0.806187,190,23,1, merged,0,0,0.00517894330361
34371,1000004,2,2396,2122,274,0.885643,0.114357,1.692182,213,61,2398,2124,274,0.885738,0.114262,1.692453,213,61,1, merged,0,0,0.0231480626212
34371,1000007,1,1101,888,213,0.80654,0.19346,0.80654,190,23,1102,889,213,0.806715,0.193285,0.806715,190,23,1, merged,0,0,0.0364456186383
34372,1000004,3,2398,2124,274,0.885738,0.114262,2.570557,213,61,2399,2125,274,0.885786,0.114214,2.568802,213,61,1, merged,0,0,0.110989302426
34372,1000007,2,1102,889,213,0.806715,0.193285,1.684819,190,23,1103,890,213,0.80689,0.19311,1.683016,190,23,1, merged,0,0,0.0229462360705
34372,1000023,1,443,389,54,0.878104,0.121896,0.878104,51,3,444,389,55,0.876126,0.123874,0.876126,52,3,1, merged,1,1,0.406423640047
34373,1000004,2,2399,2125,274,0.885786,0.114214,1.725873,213,61,2400,2126,274,0.885833,0.114167,1.725178,213,61,1, merged,0,0,0.106561673692
34373,1000120,1,913,767,146,0.840088,0.159912,0.840088,130,16,915,768,147,0.839344,0.160656,0.839344,131,16,1, merged,1,1,0.0982291923234
34374,1000004,2,2400,2126,274,0.885833,0.114167,1.692724,213,61,2401,2127,274,0.885881,0.114119,1.692216,213,61,1, merged,0,0,0.0269088646337
34374,1000007,1,1103,890,213,0.80689,0.19311,0.80689,190,23,1105,891,214,0.806335,0.193665,0.806335,190,24,-1, merged,1,1,0.00538669991623
34376,1000004,2,2401,2127,274,0.885881,0.114119,1.692391,213,61,2402,2128,274,0.885928,0.114072,1.691885,213,61,1, merged,0,0,0.213461587905
34376,1000007,1,1106,892,214,0.80651,0.19349,0.80651,190,24,1108,893,215,0.805957,0.194043,0.805957,190,25,-1, merged,1,1,0.32519596554
34380,1000014,1,1623,1379,244,0.849661,0.150339,0.849661,226,18,1626,1380,246,0.848708,0.151292,0.848708,227,19,1, merged,1,1,0.00235282338807
34381,1000120,2,917,770,147,0.839695,0.160305,1.380235,131,16,918,771,147,0.839869,0.160131,1.386536,131,16,1, merged,0,0,0.154746557281
34381,1002169,1,74,40,34,0.540541,0.459459,0.540541,32,2,75,41,34,0.546667,0.453333,0.546667,32,2,1, merged,0,0,0
34383,1000120,2,919,772,147,0.840044,0.159956,1.38671,131,16,920,772,148,0.83913,0.16087,1.378604,132,16,1, abandoned,1,1,0.419590043924
34383,1002169,1,75,41,34,0.546667,0.453333,0.546667,32,2,76,41,35,0.539474,0.460526,0.539474,33,2,1, abandoned,1,1,0
34384,1000004,3,2402,2128,274,0.885928,0.114072,2.264533,213,61,2403,2129,274,0.885976,0.114024,2.270736,213,61,1, merged,0,0,0
34384,1000120,2,920,772,148,0.83913,0.16087,1.378604,132,16,921,773,148,0.839305,0.160695,1.38476,132,16,1, merged,0,0,0
34384,1002169,1,76,41,35,0.539474,0.460526,0.539474,33,2,77,42,35,0.545455,0.454545,0.545455,33,2,1, merged,0,0,0
34385,1000120,3,921,773,148,0.839305,0.160695,2.128349,132,16,922,774,148,0.839479,0.160521,2.140761,132,16,1, merged,0,0,0.0100995316159
34385,1000140,2,39,29,10,0.74359,0.25641,1.289044,9,1,40,30,10,0.75,0.25,1.301282,9,1,1, merged,0,0,0
34385,1000329,4,2409,1854,555,0.769614,0.230386,2.897963,493,62,2410,1855,555,0.76971,0.23029,2.910471,493,62,1, merged,0,0,0.00885434285656
34385,1002169,1,77,42,35,0.545455,0.454545,0.545455,33,2,78,43,35,0.551282,0.448718,0.551282,33,2,1, merged,0,0,0
34386,1000120,2,922,774,148,0.839479,0.160521,1.390761,132,16,923,775,148,0.839653,0.160347,1.396615,132,16,1, merged,0,0,0.155150717003
34386,1002169,1,78,43,35,0.551282,0.448718,0.551282,33,2,79,44,35,0.556962,0.443038,0.556962,33,2,1, merged,0,0,0
34387,1000120,3,923,775,148,0.839653,0.160347,2.146615,132,16,924,776,148,0.839827,0.160173,2.158424,132,16,1, merged,0,0,0.181833570175
34387,1000140,2,40,30,10,0.75,0.25,1.306962,9,1,41,31,10,0.756098,0.243902,1.318598,9,1,1, merged,0,0,0.000313873195229
34387,1002169,1,79,44,35,0.556962,0.443038,0.556962,33,2,80,45,35,0.5625,0.4375,0.5625,33,2,1, merged,0,0,0
34388,1000120,2,924,776,148,0.839827,0.160173,1.402327,132,16,925,777,148,0.84,0.16,1.407901,132,16,1, merged,0,0,0.0802381436737
34388,1002169,1,80,45,35,0.5625,0.4375,0.5625,33,2,81,46,35,0.567901,0.432099,0.567901,33,2,1, merged,0,0,0
34392,1000004,2,2403,2129,274,0.885976,0.114024,1.726493,213,61,2404,2130,274,0.886023,0.113977,1.726712,213,61,1, merged,0,0,0.0140851869071
34392,1000120,1,928,780,148,0.840517,0.159483,0.840517,132,16,929,781,148,0.840689,0.159311,0.840689,132,16,1, merged,0,0,0.0197597625634
34393,1000120,2,929,781,148,0.840689,0.159311,1.40859,132,16,930,782,148,0.84086,0.15914,1.414031,132,16,1, merged,0,0,0.0267734208447
34393,1002169,1,81,46,35,0.567901,0.432099,0.567901,33,2,82,47,35,0.573171,0.426829,0.573171,33,2,1, merged,0,0,0
34394,1000329,1,2410,1855,555,0.76971,0.23029,0.76971,493,62,2411,1856,555,0.769805,0.230195,0.769805,493,62,-1, merged,0,0,0.513077887737
34394,1002169,2,82,47,35,0.573171,0.426829,1.34288,33,2,87,48,39,0.551724,0.448276,1.321529,37,2,1, merged,1,1,0
34395,1000004,3,2404,2130,274,0.886023,0.113977,2.278608,213,61,2405,2131,274,0.886071,0.113929,2.28392,213,61,1, merged,0,0,0.0189099173651
34395,1000120,2,930,782,148,0.84086,0.15914,1.392584,132,16,931,783,148,0.841031,0.158969,1.397849,132,16,1, merged,0,0,0.0271971122612
34395,1002169,1,87,48,39,0.551724,0.448276,0.551724,37,2,88,49,39,0.556818,0.443182,0.556818,37,2,1, merged,0,0,0
34397,1000004,3,2405,2131,274,0.886071,0.113929,2.284091,213,61,2406,2132,274,0.886118,0.113882,2.289288,213,61,1, merged,0,0,0
34397,1000120,2,932,784,148,0.841202,0.158798,1.39802,132,16,933,785,148,0.841372,0.158628,1.40317,132,16,1, merged,0,0,0
34397,1002169,1,88,49,39,0.556818,0.443182,0.556818,37,2,89,50,39,0.561798,0.438202,0.561798,37,2,1, merged,0,0,0
34404,1000153,2,736,673,63,0.914402,0.085598,1.805443,49,14,738,675,63,0.914634,0.085366,1.805938,49,14,-1, merged,0,0,1.08996886085
34405,1000007,2,1108,893,215,0.805957,0.194043,1.71929,190,25,1109,894,215,0.806132,0.193868,1.719753,190,25,1, merged,0,0,0
34405,1000026,1,300,274,26,0.913333,0.086667,0.913333,24,2,301,275,26,0.913621,0.086379,0.913621,24,2,1, merged,0,0,0
34406,1000004,2,2406,2132,274,0.886118,0.113882,1.447916,213,61,2407,2133,274,0.886165,0.113835,1.435616,213,61,-1, abandoned,0,0,0.0410192506016
34406,1002169,1,89,50,39,0.561798,0.438202,0.561798,37,2,91,50,41,0.549451,0.450549,0.549451,39,2,1, abandoned,1,1,0
34407,1002169,1,91,50,41,0.549451,0.450549,0.549451,39,2,92,51,41,0.554348,0.445652,0.554348,39,2,1, merged,0,0,0
34410,1000005,2,241,186,55,0.771784,0.228216,1.326132,50,5,242,187,55,0.772727,0.227273,1.331867,50,5,1, merged,0,0,0.463335334134
34410,1000329,3,2411,1856,555,0.769805,0.230195,2.095937,493,62,2412,1857,555,0.7699,0.2301,2.101768,493,62,1, merged,0,0,0.788102226906
34410,1002169,1,92,51,41,0.554348,0.445652,0.554348,39,2,93,52,41,0.55914,0.44086,0.55914,39,2,1, merged,0,0,0
34411,1002169,1,93,52,41,0.55914,0.44086,0.55914,39,2,96,53,43,0.552083,0.447917,0.552083,41,2,1, merged,1,1,0
34412,1000327,2,617,482,135,0.781199,0.218801,1.333283,104,31,618,483,135,0.781553,0.218447,1.338254,104,31,1, merged,0,0,0.671190084157
34412,1002169,1,96,53,43,0.552083,0.447917,0.552083,41,2,97,54,43,0.556701,0.443299,0.556701,41,2,1, merged,0,0,0
34414,1000023,2,444,389,55,0.876126,0.123874,1.432827,52,3,445,390,55,0.876404,0.123596,1.437629,52,3,1, merged,0,0,0.411364959233
34414,1002169,1,97,54,43,0.556701,0.443299,0.556701,41,2,98,55,43,0.561224,0.438776,0.561224,41,2,1, merged,0,0,0
34421,1002169,1,98,55,43,0.561224,0.438776,0.561224,41,2,99,56,43,0.565657,0.434343,0.565657,41,2,1, merged,0,0,0
34423,1000007,2,1109,894,215,0.806132,0.193868,1.647761,190,25,1110,895,215,0.806306,0.193694,1.644144,190,25,1, merged,0,0,0.647417365783
34424,1000070,3,889,781,108,0.878515,0.121485,2.0156,91,17,890,782,108,0.878652,0.121348,1.992734,91,17,-1, abandoned,0,0,0.0429387821888
34424,1002169,1,99,56,43,0.565657,0.434343,0.565657,41,2,102,58,44,0.568627,0.431373,0.568627,42,2,-1, abandoned,1,0,0
34425,1000105,1,454,344,110,0.757709,0.242291,0.757709,100,10,455,345,110,0.758242,0.241758,0.758242,100,10,1, merged,0,0,0.618631034386
34426,1000105,1,455,345,110,0.758242,0.241758,0.758242,100,10,456,346,110,0.758772,0.241228,0.758772,100,10,1, merged,0,0,0.629823747681
34427,1000105,1,456,346,110,0.758772,0.241228,0.758772,100,10,457,347,110,0.7593,0.2407,0.7593,100,10,1, merged,0,0,0.315273863301
34431,1000011,2,512,475,37,0.927734,0.072266,1.842714,34,3,513,476,37,0.927875,0.072125,1.843198,34,3,-1, merged,0,0,0.206815834594
34431,1000153,1,741,678,63,0.91498,0.08502,0.91498,49,14,744,681,63,0.915323,0.084677,0.915323,49,14,-1, merged,0,0,0.236648664487
34432,1000121,3,1513,1252,261,0.827495,0.172505,2.255772,246,15,1514,1253,261,0.827609,0.172391,2.260425,246,15,1, merged,0,0,0.261199781592
34432,1002169,1,102,58,44,0.568627,0.431373,0.568627,42,2,103,59,44,0.572816,0.427184,0.572816,42,2,1, merged,0,0,0
34433,1002169,1,103,59,44,0.572816,0.427184,0.572816,42,2,104,60,44,0.576923,0.423077,0.576923,42,2,1, merged,0,0,0
34434,1000121,2,1514,1253,261,0.827609,0.172391,1.404532,246,15,1515,1254,261,0.827723,0.172277,1.408675,246,15,1, merged,0,0,0.0642028437134
34434,1002169,1,104,60,44,0.576923,0.423077,0.576923,42,2,105,61,44,0.580952,0.419048,0.580952,42,2,1, merged,0,0,0
34436,1000011,1,513,476,37,0.927875,0.072125,0.927875,34,3,514,477,37,0.928016,0.071984,0.928016,34,3,1, merged,0,0,0.78552881224
34439,1000023,1,446,391,55,0.876682,0.123318,0.876682,52,3,447,392,55,0.876957,0.123043,0.876957,52,3,1, merged,0,0,0.0368453149028
34441,1000023,1,447,392,55,0.876957,0.123043,0.876957,52,3,448,393,55,0.877232,0.122768,0.877232,52,3,1, merged,0,0,0.101410249003
34441,1000110,4,46,40,6,0.869565,0.130435,3.642868,5,1,47,41,6,0.87234,0.12766,3.648562,5,1,1, merged,0,0,0.00668344062085
34442,1000023,1,448,393,55,0.877232,0.122768,0.877232,52,3,450,394,56,0.875556,0.124444,0.875556,53,3,1, merged,1,1,0.0368859011523
34442,1000110,4,47,41,6,0.87234,0.12766,3.648562,5,1,48,42,6,0.875,0.125,3.652057,5,1,1, merged,0,0,0.00325188057008
34443,1000023,4,450,394,56,0.875556,0.124444,2.879272,53,3,451,395,56,0.875831,0.124169,2.695925,53,3,1, merged,0,0,0.396711116246
34443,1000140,2,41,31,10,0.756098,0.243902,1.33705,9,1,44,33,11,0.75,0.25,1.320093,10,1,-1, merged,1,0,0.0531936742658
34443,1002169,1,105,61,44,0.580952,0.419048,0.580952,42,2,107,61,46,0.570093,0.429907,0.570093,44,2,1, merged,1,1,0
34446,1000132,2,258,228,30,0.883721,0.116279,1.453814,23,7,259,229,30,0.88417,0.11583,1.443803,23,7,-1, abandoned,0,0,0.091697080292
34446,1002169,1,107,61,46,0.570093,0.429907,0.570093,44,2,109,61,48,0.559633,0.440367,0.559633,46,2,1, abandoned,1,1,0
34451,1000003,3,910,763,147,0.838462,0.161538,2.608062,132,15,911,764,147,0.838639,0.161361,2.608583,132,15,1, merged,0,0,0.0274940810171
34451,1000004,1,2407,2133,274,0.886165,0.113835,0.886165,213,61,2408,2133,275,0.885797,0.114203,0.885797,214,61,1, merged,1,1,0.0201777296113
34452,1000329,2,2413,1858,555,0.769996,0.230004,1.329629,493,62,2415,1860,555,0.770186,0.229814,1.328745,493,62,-1, merged,0,0,0.789109306794
34452,1002169,1,109,61,48,0.559633,0.440367,0.559633,46,2,111,62,49,0.558559,0.441441,0.558559,47,2,1, merged,1,1,0
34453,1000329,2,2415,1860,555,0.770186,0.229814,1.328745,493,62,2417,1862,555,0.770376,0.229624,1.327899,493,62,-1, merged,0,0,0.520557333368
34453,1002169,1,111,62,49,0.558559,0.441441,0.558559,47,2,113,63,50,0.557522,0.442478,0.557522,48,2,1, merged,1,1,0
34454,1000328,1,750,545,205,0.726667,0.273333,0.726667,182,23,752,547,205,0.727394,0.272606,0.727394,182,23,-1, merged,0,0,0.215995945735
34454,1002169,2,113,63,50,0.557522,0.442478,1.284189,48,2,115,64,51,0.556522,0.443478,1.283915,49,2,1, merged,1,1,0
34456,1002169,1,115,64,51,0.556522,0.443478,0.556522,49,2,116,65,51,0.560345,0.439655,0.560345,49,2,1, merged,0,0,0
34457,1002169,1,116,65,51,0.560345,0.439655,0.560345,49,2,117,66,51,0.564103,0.435897,0.564103,49,2,1, merged,0,0,0
34458,1000110,2,48,42,6,0.875,0.125,1.439103,5,1,51,44,7,0.862745,0.137255,1.421078,6,1,-1, merged,1,0,0.0332034909904
34458,1000140,4,44,33,11,0.75,0.25,3.020353,10,1,45,34,11,0.755556,0.244444,3.008932,10,1,1, merged,0,0,0.0382765963098
34458,1002169,1,117,66,51,0.564103,0.435897,0.564103,49,2,120,67,53,0.558333,0.441667,0.558333,51,2,1, merged,1,1,0
34459,1000015,2,1547,1389,158,0.897867,0.102133,1.813189,146,12,1548,1390,158,0.897933,0.102067,1.813369,146,12,1, merged,0,0,0.210539274107
34459,1000153,1,744,681,63,0.915323,0.084677,0.915323,49,14,745,682,63,0.915436,0.084564,0.915436,49,14,1, merged,0,0,0.224198659574
34465,1000121,2,1515,1254,261,0.827723,0.172277,1.386056,246,15,1516,1255,261,0.827836,0.172164,1.38982,246,15,1, merged,0,0,0.263421707096
34465,1002169,1,120,67,53,0.558333,0.441667,0.558333,51,2,121,68,53,0.561983,0.438017,0.561983,51,2,1, merged,0,0,0
34467,1000004,1,2409,2134,275,0.885845,0.114155,0.885845,214,61,2410,2135,275,0.885892,0.114108,0.885892,214,61,-1, merged,0,0,0.110805691805
34474,1000023,1,451,395,56,0.875831,0.124169,0.875831,53,3,452,396,56,0.876106,0.123894,0.876106,53,3,1, merged,0,0,0.0170204163867
34474,1000063,2,2328,2081,247,0.8939,0.1061,1.769732,206,41,2329,2082,247,0.893946,0.106054,1.770052,206,41,1, merged,0,0,0.0123814953823
34476,1000329,1,2417,1862,555,0.770376,0.229624,0.770376,493,62,2418,1863,555,0.770471,0.229529,0.770471,493,62,-1, abandoned,0,0,0.0873742162184
34476,1002169,2,121,68,53,0.561983,0.438017,1.33236,51,2,124,68,56,0.548387,0.451613,1.318859,54,2,1, abandoned,1,1,0
34478,1000023,1,452,396,56,0.876106,0.123894,0.876106,53,3,453,396,57,0.874172,0.125828,0.874172,54,3,1, merged,1,1,0.00368171857243
34478,1000054,2,141,124,17,0.879433,0.120567,1.755539,12,5,142,125,17,0.880282,0.119718,1.754454,12,5,1, merged,0,0,0.0020818571058
34479,1000121,2,1516,1255,261,0.827836,0.172164,1.555592,246,15,1517,1256,261,0.82795,0.17205,1.556067,246,15,1, merged,0,0,0.599004352279
34479,1000328,1,753,548,205,0.727756,0.272244,0.727756,182,23,754,549,205,0.728117,0.271883,0.728117,182,23,1, merged,0,0,0.641130394047
34480,1000004,2,2410,2135,275,0.885892,0.114108,1.434279,214,61,2411,2136,275,0.885939,0.114061,1.433558,214,61,-1, merged,0,0,0.475670055121
34480,1000121,3,1517,1256,261,0.82795,0.17205,2.262229,246,15,1518,1257,261,0.828063,0.171937,2.261622,246,15,1, merged,0,0,0.599223757197
34480,1002169,1,124,68,56,0.548387,0.451613,0.548387,54,2,126,69,57,0.547619,0.452381,0.547619,55,2,1, merged,1,1,0
34481,1000121,2,1518,1257,261,0.828063,0.171937,1.55618,246,15,1519,1258,261,0.828176,0.171824,1.556653,246,15,1, merged,0,0,0.59944313381
34481,1000328,1,754,549,205,0.728117,0.271883,0.728117,182,23,755,550,205,0.728477,0.271523,0.728477,182,23,1, merged,0,0,0.642666579552
34482,1000132,3,259,229,30,0.88417,0.11583,2.20226,23,7,260,230,30,0.884615,0.115385,2.206363,23,7,1, merged,0,0,0.299788979435
34482,1000329,2,2418,1863,555,0.770471,0.229529,1.318091,493,62,2419,1864,555,0.770566,0.229434,1.321747,493,62,1, merged,0,0,0.260429845936
34482,1002169,1,126,69,57,0.547619,0.452381,0.547619,55,2,127,70,57,0.551181,0.448819,0.551181,55,2,1, merged,0,0,0
34483,1000023,1,453,396,57,0.874172,0.125828,0.874172,54,3,456,399,57,0.875,0.125,0.875,54,3,-1, merged,0,0,0.0175877164676
34483,1000329,3,2419,1864,555,0.770566,0.229434,2.19592,493,62,2421,1865,556,0.770343,0.229657,2.183804,494,62,1, merged,1,1,0.0524347754688
34483,1002169,2,127,70,57,0.551181,0.448819,1.425353,55,2,130,70,60,0.538462,0.461538,1.413462,58,2,1, merged,1,1,0
34497,1000023,1,456,399,57,0.875,0.125,0.875,54,3,457,400,57,0.875274,0.124726,0.875274,54,3,1, merged,0,0,0.00275993971637
34497,1000063,2,2329,2082,247,0.893946,0.106054,1.768946,206,41,2330,2083,247,0.893991,0.106009,1.769265,206,41,1, merged,0,0,0.00243848249183
34498,1000023,1,457,400,57,0.875274,0.124726,0.875274,54,3,458,401,57,0.875546,0.124454,0.875546,54,3,1, merged,0,0,0.00560420195432
34498,1000063,2,2330,2083,247,0.893991,0.106009,1.769265,206,41,2331,2084,247,0.894037,0.105963,1.769583,206,41,1, merged,0,0,0.00491775313855
34502,1000329,2,2423,1866,557,0.77012,0.22988,1.304471,495,62,2425,1868,557,0.770309,0.229691,1.30016,495,62,-1, merged,0,0,0.744685544775
34502,1002169,1,131,70,61,0.534351,0.465649,0.534351,59,2,134,71,63,0.529851,0.470149,0.529851,61,2,1, merged,1,1,0
34503,1002169,1,134,71,63,0.529851,0.470149,0.529851,61,2,136,72,64,0.529412,0.470588,0.529412,62,2,1, merged,1,1,0
34505,1000327,2,618,483,135,0.781553,0.218447,1.310965,104,31,620,485,135,0.782258,0.217742,1.315105,104,31,1, merged,0,0,0.682002090274
34505,1002169,1,136,72,64,0.529412,0.470588,0.529412,62,2,137,73,64,0.532847,0.467153,0.532847,62,2,1, merged,0,0,0
34506,1000014,3,1628,1382,246,0.848894,0.151106,2.102329,227,19,1629,1383,246,0.848987,0.151013,2.103989,227,19,1, merged,0,0,0.0254139105355
34506,1002169,1,137,73,64,0.532847,0.467153,0.532847,62,2,139,74,65,0.532374,0.467626,0.532374,63,2,1, merged,1,1,0
34508,1000014,3,1629,1383,246,0.848987,0.151013,2.136917,227,19,1630,1384,246,0.84908,0.15092,2.145664,227,19,1, merged,0,0,0.159585658622
34508,1000140,2,45,34,11,0.755556,0.244444,1.28793,10,1,46,35,11,0.76087,0.23913,1.296584,10,1,1, merged,0,0,0.0537568723274
34508,1002169,1,139,74,65,0.532374,0.467626,0.532374,63,2,140,75,65,0.535714,0.464286,0.535714,63,2,1, merged,0,0,0
34509,1000004,2,2411,2136,275,0.885939,0.114061,0.885939,214,61,2414,2139,275,0.886081,0.113919,1.886081,214,61,-1, merged,0,0,0.551220566285
34509,1000007,3,1114,899,215,0.807002,0.192998,1.692941,190,25,1115,900,215,0.807175,0.192825,2.693256,190,25,1, merged,0,0,1.22647911467
34511,1000004,2,2414,2139,275,0.886081,0.113919,1.722445,214,61,2416,2141,275,0.886175,0.113825,1.70476,214,61,-1, merged,0,0,0.0530177092259
34511,1000166,1,220,184,36,0.836364,0.163636,0.836364,34,2,226,185,41,0.818584,0.181416,0.818584,39,2,1, merged,1,1,0.168114522099
34513,1002169,1,140,75,65,0.535714,0.464286,0.535714,63,2,141,76,65,0.539007,0.460993,0.539007,63,2,1, merged,0,0,0
34516,1000121,3,1520,1259,261,0.828289,0.171711,2.292028,246,15,1521,1260,261,0.828402,0.171598,2.29579,246,15,1, merged,0,0,0.143562773659
34516,1002169,1,141,76,65,0.539007,0.460993,0.539007,63,2,142,77,65,0.542254,0.457746,0.542254,63,2,1, merged,0,0,0
34520,1002169,1,142,77,65,0.542254,0.457746,0.542254,63,2,143,78,65,0.545455,0.454545,0.545455,63,2,1, merged,0,0,0
34521,1000004,2,2418,2143,275,0.88627,0.11373,1.814285,214,61,2419,2144,275,0.886317,0.113683,1.814611,214,61,-1, merged,0,0,0.277488820344
34521,1000011,1,514,477,37,0.928016,0.071984,0.928016,34,3,516,479,37,0.928295,0.071705,0.928295,34,3,-1, merged,0,0,0.499147562393
34521,1000120,3,936,788,148,0.84188,0.15812,2.656166,132,16,938,789,149,0.841151,0.158849,2.655763,133,16,1, merged,1,1,0.219908855879
34522,1000121,2,1521,1260,261,0.828402,0.171598,1.373857,246,15,1522,1260,262,0.827858,0.172142,1.372686,247,15,1, merged,1,1,0.287329208559
34522,1002169,1,143,78,65,0.545455,0.454545,0.545455,63,2,145,79,66,0.544828,0.455172,0.544828,64,2,1, merged,1,1,0
34523,1000014,2,1630,1384,246,0.84908,0.15092,1.393907,227,19,1631,1385,246,0.849172,0.150828,1.397117,227,19,1, merged,0,0,0.172903953997
34523,1002169,1,145,79,66,0.544828,0.455172,0.544828,64,2,146,80,66,0.547945,0.452055,0.547945,64,2,1, merged,0,0,0
34524,1000004,2,2419,2144,275,0.886317,0.113683,1.434262,214,61,2420,2145,275,0.886364,0.113636,1.437384,214,61,1, merged,0,0,0.0294954808913
34524,1002169,1,146,80,66,0.547945,0.452055,0.547945,64,2,147,81,66,0.55102,0.44898,0.55102,64,2,1, merged,0,0,0
34525,1000026,2,302,276,26,0.913907,0.086093,1.67762,24,2,303,277,26,0.914191,0.085809,1.674696,24,2,1, merged,0,0,0.0111815754339
34527,1000054,2,142,125,17,0.880282,0.119718,1.698866,12,5,143,126,17,0.881119,0.118881,1.700502,12,5,1, merged,0,0,0.0462222607617
34527,1000166,1,226,185,41,0.818584,0.181416,0.818584,39,2,227,186,41,0.819383,0.180617,0.819383,39,2,1, merged,0,0,0.0320152515625
34528,1000014,2,1631,1385,246,0.849172,0.150828,1.400193,227,19,1632,1386,246,0.849265,0.150735,1.403319,227,19,1, merged,0,0,0.182147252674
34528,1000140,3,46,35,11,0.76087,0.23913,2.161062,10,1,47,36,11,0.765957,0.234043,2.169276,10,1,1, merged,0,0,0.0553386211104
34528,1002169,1,147,81,66,0.55102,0.44898,0.55102,64,2,148,82,66,0.554054,0.445946,0.554054,64,2,1, merged,0,0,0
34529,1002169,2,148,82,66,0.554054,0.445946,1.510576,64,2,150,83,67,0.553333,0.446667,1.49673,65,2,1, merged,1,1,0
34530,1002169,2,150,83,67,0.553333,0.446667,1.49673,65,2,151,84,67,0.556291,0.443709,1.50366,65,2,1, merged,0,0,0
34531,1000328,2,755,550,205,0.728477,0.271523,1.284768,182,23,756,551,205,0.728836,0.271164,1.284392,182,23,1, merged,0,0,0.216757126425
34531,1002169,1,151,84,67,0.556291,0.443709,0.556291,65,2,153,85,68,0.555556,0.444444,0.555556,66,2,1, merged,1,1,0
34532,1000328,2,756,551,205,0.728836,0.271164,1.284392,182,23,758,552,206,0.728232,0.271768,1.28018,183,23,1, merged,1,1,0.118936062286
34532,1002169,1,153,85,68,0.555556,0.444444,0.555556,66,2,154,85,69,0.551948,0.448052,0.551948,67,2,1, merged,1,1,0
34533,1000328,2,758,552,206,0.728232,0.271768,1.28018,183,23,760,553,207,0.727632,0.272368,1.278914,184,23,1, merged,1,1,0.21789135364
34533,1002169,1,154,85,69,0.551948,0.448052,0.551948,67,2,156,86,70,0.551282,0.448718,0.551282,68,2,1, merged,1,1,0
34539,1000004,2,2421,2146,275,0.886411,0.113589,1.727562,214,61,2422,2147,275,0.886457,0.113543,1.726883,214,61,1, merged,0,0,0.410580131433
34539,1000120,1,938,789,149,0.841151,0.158849,0.841151,133,16,940,790,150,0.840426,0.159574,0.840426,133,17,-1, merged,1,0,0.356520577231
34540,1000004,4,2422,2147,275,0.886457,0.113543,3.048569,214,61,2423,2148,275,0.886504,0.113496,3.046927,214,61,1, merged,0,0,0.147427785777
34540,1000120,3,940,790,150,0.840426,0.159574,2.162112,133,17,942,791,151,0.839703,0.160297,2.160422,133,18,-1, merged,1,0,0.122332703974
34540,1000329,2,2426,1869,557,0.770404,0.229596,1.321686,495,62,2427,1869,558,0.770087,0.229913,1.320719,496,62,1, merged,1,1,0.189616659161
34540,1002169,1,156,86,70,0.551282,0.448718,0.551282,68,2,158,87,71,0.550633,0.449367,0.550633,69,2,1, merged,1,1,0
34543,1000004,2,2423,2148,275,0.886504,0.113496,1.437137,214,61,2424,2149,275,0.886551,0.113449,1.433135,214,61,1, merged,0,0,0.0430917626243
34543,1002169,1,158,87,71,0.550633,0.449367,0.550633,69,2,161,88,73,0.546584,0.453416,0.546584,71,2,1, merged,1,1,0
34544,1000026,2,303,277,26,0.914191,0.085809,1.647525,24,2,304,278,26,0.914474,0.085526,1.649573,24,2,1, merged,0,0,0.0124626121635
34544,1000534,1,150,110,40,0.733333,0.266667,0.733333,38,2,151,111,40,0.735099,0.264901,0.735099,38,2,-1, merged,0,0,0.00291141657121
34545,1000329,2,2427,1869,558,0.770087,0.229913,1.31667,496,62,2428,1870,558,0.770181,0.229819,1.310059,496,62,-1, abandoned,0,0,0.787774596477
34545,1002169,1,161,88,73,0.546584,0.453416,0.546584,71,2,163,88,75,0.539877,0.460123,0.539877,73,2,1, abandoned,1,1,0
34551,1000004,2,2424,2149,275,0.886551,0.113449,1.423137,214,61,2425,2150,275,0.886598,0.113402,1.419931,214,61,-1, abandoned,0,0,0.00470024086791
34551,1002169,1,164,88,76,0.536585,0.463415,0.536585,74,2,165,88,77,0.533333,0.466667,0.533333,75,2,1, abandoned,1,1,0
34553,1000014,2,1633,1387,246,0.849357,0.150643,1.38269,227,19,1634,1388,246,0.849449,0.150551,1.385594,227,19,1, merged,0,0,0.585127064894
34553,1002169,1,165,88,77,0.533333,0.466667,0.533333,75,2,166,89,77,0.536145,0.463855,0.536145,75,2,1, merged,0,0,0
34555,1000328,2,760,553,207,0.727632,0.272368,1.263776,184,23,762,554,208,0.727034,0.272966,1.262748,185,23,1, merged,1,1,0.18303015489
34555,1002169,1,166,89,77,0.536145,0.463855,0.536145,75,2,168,90,78,0.535714,0.464286,0.535714,76,2,1, merged,1,1,0
34557,1002169,1,168,90,78,0.535714,0.464286,0.535714,76,2,169,90,79,0.532544,0.467456,0.532544,77,2,1, abandoned,1,1,0
34561,1000023,1,460,402,58,0.873913,0.126087,0.873913,55,3,461,403,58,0.874187,0.125813,0.874187,55,3,1, merged,0,0,0.00561392361806
34561,1000063,2,2331,2084,247,0.894037,0.105963,1.76795,206,41,2332,2085,247,0.894082,0.105918,1.768269,206,41,1, merged,0,0,0.00488408430018
34565,1000329,2,2428,1870,558,0.770181,0.229819,1.302726,496,62,2429,1871,558,0.770276,0.229724,1.299688,496,62,-1, abandoned,0,0,0.422859542351
34565,1002169,1,169,90,79,0.532544,0.467456,0.532544,77,2,170,90,80,0.529412,0.470588,0.529412,78,2,1, abandoned,1,1,0
34569,1000004,3,2425,2150,275,0.886598,0.113402,2.670598,214,61,2427,2152,275,0.886691,0.113309,2.419637,214,61,-1, merged,0,0,0.0296252276255
34570,1000004,2,2427,2152,275,0.886691,0.113309,1.660354,214,61,2428,2153,275,0.886738,0.113262,1.661328,214,61,1, merged,0,0,0.000419929880252
34570,1000005,1,243,188,55,0.773663,0.226337,0.773663,50,5,244,189,55,0.77459,0.22541,0.77459,50,5,1, merged,0,0,0.00116654183601
34570,1000121,3,1522,1260,262,0.827858,0.172142,2.488212,247,15,1523,1261,262,0.827971,0.172029,2.489299,247,15,1, merged,0,0,0.000397912391156
34572,1000014,1,1634,1388,246,0.849449,0.150551,0.849449,227,19,1636,1390,246,0.849633,0.150367,0.849633,227,19,-1, merged,0,0,0.166071418994
34572,1000015,2,1560,1399,161,0.896795,0.103205,1.746244,149,12,1561,1400,161,0.896861,0.103139,1.746494,149,12,1, merged,0,0,0.202464782363
34575,1002169,1,170,90,80,0.529412,0.470588,0.529412,78,2,173,91,82,0.526012,0.473988,0.526012,80,2,1, merged,1,1,0
34592,1000592,2,500,421,79,0.842,0.158,1.368012,49,30,501,422,79,0.842315,0.157685,1.371051,49,30,1, merged,0,0,0.640879715918
34592,1002169,1,173,91,82,0.526012,0.473988,0.526012,80,2,174,92,82,0.528736,0.471264,0.528736,80,2,1, merged,0,0,0
34595,1000140,2,47,36,11,0.765957,0.234043,1.294693,10,1,48,37,11,0.770833,0.229167,1.296548,10,1,-1, abandoned,0,0,0.0626513317191
34595,1002169,1,174,92,82,0.528736,0.471264,0.528736,80,2,175,92,83,0.525714,0.474286,0.525714,81,2,1, abandoned,1,1,0
34596,1000004,2,2428,2153,275,0.886738,0.113262,1.412452,214,61,2429,2154,275,0.886785,0.113215,1.415194,214,61,1, merged,0,0,0.426697524376
34596,1000166,3,227,186,41,0.819383,0.180617,2.231836,39,2,228,187,41,0.820175,0.179825,2.235369,39,2,1, merged,0,0,0.961075129534
34596,1002169,1,175,92,83,0.525714,0.474286,0.525714,81,2,176,93,83,0.528409,0.471591,0.528409,81,2,1, merged,0,0,0
34597,1000004,2,2429,2154,275,0.886785,0.113215,1.415194,214,61,2431,2156,275,0.886878,0.113122,1.406431,214,61,-1, abandoned,0,0,0.124550404168
34597,1000121,3,1523,1261,262,0.827971,0.172029,2.243165,247,15,1524,1262,262,0.828084,0.171916,2.234515,247,15,-1, abandoned,0,0,0.158802280316
34597,1002169,1,176,93,83,0.528409,0.471591,0.528409,81,2,179,93,86,0.519553,0.480447,0.519553,84,2,1, abandoned,1,1,0
34598,1000130,2,289,243,46,0.84083,0.15917,1.360384,36,10,290,244,46,0.841379,0.158621,1.363602,36,10,1, merged,0,0,0.24224533413
34598,1002169,1,179,93,86,0.519553,0.480447,0.519553,84,2,180,94,86,0.522222,0.477778,0.522222,84,2,1, merged,0,0,0
34599,1000166,2,228,187,41,0.820175,0.179825,1.342398,39,2,229,188,41,0.820961,0.179039,1.345823,39,2,1, merged,0,0,0.878489751888
34599,1002169,1,180,94,86,0.522222,0.477778,0.522222,84,2,181,95,86,0.524862,0.475138,0.524862,84,2,1, merged,0,0,0
34601,1000091,3,428,326,102,0.761682,0.238318,2.056914,87,15,429,327,102,0.762238,0.237762,2.060175,87,15,1, merged,0,0,0.437190895087
34601,1000329,2,2430,1872,558,0.77037,0.22963,1.295232,496,62,2431,1873,558,0.770465,0.229535,1.297937,496,62,1, merged,0,0,0.451773889085
34601,1002169,1,181,95,86,0.524862,0.475138,0.524862,84,2,182,96,86,0.527473,0.472527,0.527473,84,2,1, merged,0,0,0
34605,1000091,1,429,327,102,0.762238,0.237762,0.762238,87,15,430,328,102,0.762791,0.237209,0.762791,87,15,1, merged,0,0,0
34605,1000329,2,2434,1874,560,0.769926,0.230074,1.532164,496,64,2435,1875,560,0.770021,0.229979,1.532811,496,64,1, merged,0,0,0
34606,1000091,2,430,328,102,0.762791,0.237209,1.532811,87,15,431,329,102,0.763341,0.236659,1.53355,87,15,1, merged,0,0,0.146760403582
34606,1000329,1,2435,1875,560,0.770021,0.229979,0.770021,496,64,2437,1877,560,0.770209,0.229791,0.770209,496,64,-1, merged,0,0,0.150923332141
34611,1000015,2,1562,1401,161,0.896927,0.103073,1.633769,149,12,1563,1402,161,0.896993,0.103007,1.635555,149,12,1, merged,0,0,0.666935635475
34611,1000534,1,152,112,40,0.736842,0.263158,0.736842,38,2,153,113,40,0.738562,0.261438,0.738562,38,2,1, merged,0,0,0.70459651036
34612,1002169,1,182,96,86,0.527473,0.472527,0.527473,84,2,184,97,87,0.527174,0.472826,0.527174,85,2,1, merged,1,1,0
34613,1000121,2,1524,1262,262,0.828084,0.171916,1.598293,247,15,1525,1263,262,0.828197,0.171803,1.5985,247,15,1, merged,0,0,4.96532458936e-10
34613,1000329,1,2437,1877,560,0.770209,0.229791,0.770209,496,64,2438,1878,560,0.770304,0.229696,0.770304,496,64,1, merged,0,0,1.79380529668e-45
34614,1002169,1,184,97,87,0.527174,0.472826,0.527174,85,2,185,98,87,0.52973,0.47027,0.52973,85,2,1, merged,0,0,0
34617,1000120,2,959,808,151,0.842544,0.157456,1.565172,133,18,960,809,151,0.842708,0.157292,1.567346,133,18,1, merged,0,0,0.037916023287
34618,1000120,3,960,809,151,0.842708,0.157292,2.142742,133,18,961,810,151,0.842872,0.157128,2.145528,133,18,1, merged,0,0,0.0339425494975
34618,1000329,2,2438,1878,560,0.770304,0.229696,1.300033,496,64,2439,1879,560,0.770398,0.229602,1.302656,496,64,1, merged,0,0,0.0419944476505
34618,1002169,1,185,98,87,0.52973,0.47027,0.52973,85,2,186,99,87,0.532258,0.467742,0.532258,85,2,1, merged,0,0,0
34619,1000004,2,2431,2156,275,0.886878,0.113122,1.657276,214,61,2432,2157,275,0.886924,0.113076,1.657416,214,61,1, merged,0,0,0.158109594805
34619,1000329,1,2439,1879,560,0.770398,0.229602,0.770398,496,64,2440,1880,560,0.770492,0.229508,0.770492,496,64,1, merged,0,0,0.241959402236
34621,1000004,2,2432,2157,275,0.886924,0.113076,1.419182,214,61,2433,2158,275,0.886971,0.113029,1.42173,214,61,1, merged,0,0,0
34621,1002169,1,186,99,87,0.532258,0.467742,0.532258,85,2,187,100,87,0.534759,0.465241,0.534759,85,2,1, merged,0,0,0
34622,1000054,2,143,126,17,0.881119,0.118881,1.70208,12,5,144,127,17,0.881944,0.118056,1.703684,12,5,1, merged,0,0,0.0504157744468
34622,1000166,1,229,188,41,0.820961,0.179039,0.820961,39,2,230,189,41,0.821739,0.178261,0.821739,39,2,1, merged,0,0,0.0351739684407
34625,1000130,3,290,244,46,0.841379,0.158621,2.242805,36,10,291,245,46,0.841924,0.158076,2.258669,36,10,1, merged,0,0,0.259781598903
34625,1002169,1,187,100,87,0.534759,0.465241,0.534759,85,2,189,101,88,0.534392,0.465608,0.534392,86,2,1, merged,1,1,0
34626,1000009,1,879,743,136,0.845279,0.154721,0.845279,122,14,880,743,137,0.844318,0.155682,0.844318,123,14,1, merged,1,1,0.0863463639403
34626,1000534,2,153,113,40,0.738562,0.261438,1.583841,38,2,155,114,41,0.735484,0.264516,1.579802,39,2,1, merged,1,1,0.0793918580256
34627,1000004,2,2433,2158,275,0.886971,0.113029,1.421362,214,61,2434,2159,275,0.887017,0.112983,1.423859,214,61,1, merged,0,0,0
34627,1002169,1,189,101,88,0.534392,0.465608,0.534392,86,2,190,102,88,0.536842,0.463158,0.536842,86,2,1, merged,0,0,0
34630,1000054,2,144,127,17,0.881944,0.118056,1.703684,12,5,145,128,17,0.882759,0.117241,1.705269,12,5,1, merged,0,0,0.708375169831
34630,1000166,1,230,189,41,0.821739,0.178261,0.821739,39,2,231,190,41,0.822511,0.177489,0.822511,39,2,1, merged,0,0,0.426289873689
34637,1002169,1,198,103,95,0.520202,0.479798,0.520202,93,2,199,104,95,0.522613,0.477387,0.522613,93,2,1, merged,0,0,0
34640,1002169,1,199,104,95,0.522613,0.477387,0.522613,93,2,200,104,96,0.52,0.48,0.52,94,2,1, abandoned,1,1,0
34642,1000121,2,1525,1263,262,0.828197,0.171803,1.348197,247,15,1526,1264,262,0.828309,0.171691,1.353062,247,15,1, merged,0,0,0.571657697535
34642,1002169,1,200,104,96,0.52,0.48,0.52,94,2,202,106,96,0.524752,0.475248,0.524752,94,2,-1, merged,0,0,0
34644,1000004,1,2434,2159,275,0.887017,0.112983,0.887017,214,61,2435,2160,275,0.887064,0.112936,0.887064,214,61,1, merged,0,0,0.552506354396
34644,1000009,2,883,746,137,0.844847,0.155153,1.731864,123,14,884,747,137,0.845023,0.154977,1.732086,123,14,1, merged,0,0,1.20531220641
34644,1000153,3,753,688,65,0.913679,0.086321,2.645543,51,14,754,689,65,0.913793,0.086207,2.645879,51,14,1, merged,0,0,1.11924270788
34646,1000329,3,2440,1880,560,0.770492,0.229508,2.137839,496,64,2441,1881,560,0.770586,0.229414,2.141443,496,64,1, merged,0,0,0.743886460825
34648,1000023,1,464,406,58,0.875,0.125,0.875,55,3,465,407,58,0.875269,0.124731,0.875269,55,3,1, merged,0,0,0.000516669180872
34648,1000063,2,2332,2085,247,0.894082,0.105918,1.769082,206,41,2333,2086,247,0.894128,0.105872,1.769397,206,41,1, merged,0,0,0.00133309012419
34649,1000023,1,465,407,58,0.875269,0.124731,0.875269,55,3,466,408,58,0.875536,0.124464,0.875536,55,3,1, merged,0,0,0.000592084174005
34649,1000063,2,2333,2086,247,0.894128,0.105872,1.769397,206,41,2334,2087,247,0.894173,0.105827,1.76971,206,41,1, merged,0,0,0.00136955900504
34651,1000329,2,2441,1881,560,0.770586,0.229414,1.295338,496,64,2444,1884,560,0.770867,0.229133,1.290475,496,64,-1, merged,0,0,0.513653134526
34651,1002169,1,202,106,96,0.524752,0.475248,0.524752,94,2,204,106,98,0.519608,0.480392,0.519608,96,2,1, merged,1,1,0
34655,1000023,1,466,408,58,0.875536,0.124464,0.875536,55,3,467,409,58,0.875803,0.124197,0.875803,55,3,1, merged,0,0,0.00339837481302
34655,1000063,2,2334,2087,247,0.894173,0.105827,1.76971,206,41,2335,2088,247,0.894218,0.105782,1.770021,206,41,1, merged,0,0,0.00294529980275
34660,1000009,2,884,747,137,0.845023,0.154977,1.845023,123,14,885,748,137,0.845198,0.154802,1.845198,123,14,1, merged,0,0,0.597618045896
34661,1000004,3,2435,2160,275,0.887064,0.112936,2.156671,214,61,2436,2161,275,0.88711,0.11289,2.186839,214,61,1, merged,0,0,0.0436540016168
34661,1002169,1,204,106,98,0.519608,0.480392,0.519608,96,2,205,107,98,0.521951,0.478049,0.521951,96,2,1, merged,0,0,0
34663,1000004,2,2436,2161,275,0.88711,0.11289,1.664888,214,61,2437,2162,275,0.887156,0.112844,1.614429,214,61,1, merged,0,0,0.0438223281144
34664,1000004,2,2437,2162,275,0.887156,0.112844,1.614429,214,61,2439,2164,275,0.887249,0.112751,1.502633,214,61,-1, merged,0,0,0.069437708289
34666,1000009,3,885,748,137,0.845198,0.154802,2.544831,123,14,886,749,137,0.845372,0.154628,2.547557,123,14,1, merged,0,0,1.08296140653
34666,1000014,1,1636,1390,246,0.849633,0.150367,0.849633,227,19,1637,1391,246,0.849725,0.150275,0.849725,227,19,-1, merged,0,0,0.623725515323
34667,1000014,2,1637,1391,246,0.849725,0.150275,1.371676,227,19,1638,1392,246,0.849817,0.150183,1.374089,227,19,1, merged,0,0,0.575483356588
34667,1002169,1,205,107,98,0.521951,0.478049,0.521951,96,2,206,108,98,0.524272,0.475728,0.524272,96,2,1, merged,0,0,0
34670,1000329,2,2444,1884,560,0.770867,0.229133,1.295139,496,64,2445,1885,560,0.770961,0.229039,1.295,496,64,1, merged,0,0,0.0952988608149
34670,1002169,1,206,108,98,0.524272,0.475728,0.524272,96,2,208,109,99,0.524038,0.475962,0.524038,97,2,1, merged,1,1,0
34671,1000014,2,1639,1392,247,0.849298,0.150702,1.373337,228,19,1640,1393,247,0.84939,0.15061,1.370921,228,19,-1, abandoned,0,0,0.593047884758
34671,1002169,1,208,109,99,0.524038,0.475962,0.524038,97,2,209,109,100,0.521531,0.478469,0.521531,98,2,1, abandoned,1,1,0
34677,1000014,1,1640,1393,247,0.84939,0.15061,0.84939,228,19,1643,1396,247,0.849665,0.150335,0.849665,228,19,-1, merged,0,0,0.166353600848
34677,1000015,2,1564,1403,161,0.897059,0.102941,1.746449,149,12,1565,1404,161,0.897125,0.102875,1.74679,149,12,1, merged,0,0,0.202595527102
34678,1000054,2,145,128,17,0.882759,0.117241,1.40429,12,5,146,129,17,0.883562,0.116438,1.407371,12,5,1, merged,0,0,0.0293037903917
34678,1002169,1,209,109,100,0.521531,0.478469,0.521531,98,2,210,110,100,0.52381,0.47619,0.52381,98,2,1, merged,0,0,0
34679,1002169,1,210,110,100,0.52381,0.47619,0.52381,98,2,211,111,100,0.526066,0.473934,0.526066,98,2,1, merged,0,0,0
34680,1000014,1,1643,1396,247,0.849665,0.150335,0.849665,228,19,1645,1398,247,0.849848,0.150152,0.849848,228,19,-1, merged,0,0,0.345435430356
34680,1002169,2,211,111,100,0.526066,0.473934,1.375732,98,2,212,112,100,0.528302,0.471698,1.37815,98,2,1, merged,0,0,0
34687,1000121,2,1526,1264,262,0.828309,0.171691,1.356611,247,15,1527,1265,262,0.828422,0.171578,1.356459,247,15,1, merged,0,0,0
34687,1002169,1,212,112,100,0.528302,0.471698,0.528302,98,2,214,113,101,0.528037,0.471963,0.528037,99,2,1, merged,1,1,0
34692,1000011,1,518,481,37,0.928571,0.071429,0.928571,34,3,519,482,37,0.928709,0.071291,0.928709,34,3,1, merged,0,0,0.0123813735644
34692,1000120,2,965,814,151,0.843523,0.156477,1.772095,133,18,966,815,151,0.843685,0.156315,1.772394,133,18,1, merged,0,0,0.019652123806
34693,1000329,2,2445,1885,560,0.770961,0.229039,1.282273,496,64,2446,1886,560,0.771055,0.228945,1.284568,496,64,1, merged,0,0,0.357822872954
34693,1002169,1,221,113,108,0.511312,0.488688,0.511312,106,2,222,114,108,0.513514,0.486486,0.513514,106,2,1, merged,0,0,0
34694,1000054,3,146,129,17,0.883562,0.116438,2.160416,12,5,147,130,17,0.884354,0.115646,2.161635,12,5,1, merged,0,0,0.277571849762
34694,1000091,2,431,329,102,0.763341,0.236659,1.276855,87,15,432,330,102,0.763889,0.236111,1.277282,87,15,-1, merged,0,0,0.297440293588
34694,1002169,1,222,114,108,0.513514,0.486486,0.513514,106,2,224,115,109,0.513393,0.486607,0.513393,107,2,1, merged,1,1,0
34699,1000054,2,147,130,17,0.884354,0.115646,1.397747,12,5,149,131,18,0.879195,0.120805,1.39475,12,6,-1, merged,1,1,0.624944374137
34699,1002169,1,224,115,109,0.513393,0.486607,0.513393,107,2,225,116,109,0.515556,0.484444,0.515556,107,2,1, merged,0,0,0
34700,1000329,2,2446,1886,560,0.771055,0.228945,1.28661,496,64,2447,1887,560,0.771148,0.228852,1.288847,496,64,1, merged,0,0,0.252145568576
34700,1002169,1,225,116,109,0.515556,0.484444,0.515556,107,2,226,117,109,0.517699,0.482301,0.517699,107,2,1, merged,0,0,0
34701,1002169,1,226,117,109,0.517699,0.482301,0.517699,107,2,227,118,109,0.519824,0.480176,0.519824,107,2,1, merged,0,0,0
34703,1000130,2,293,247,46,0.843003,0.156997,1.362827,36,10,294,248,46,0.843537,0.156463,1.365467,36,10,1, merged,0,0,0.501319344848
34703,1002169,1,227,118,109,0.519824,0.480176,0.519824,107,2,228,119,109,0.52193,0.47807,0.52193,107,2,1, merged,0,0,0
34707,1000121,2,1527,1265,262,0.828422,0.171578,1.350352,247,15,1528,1266,262,0.828534,0.171466,1.352551,247,15,1, merged,0,0,0.326238214584
34707,1002169,1,228,119,109,0.52193,0.47807,0.52193,107,2,229,120,109,0.524017,0.475983,0.524017,107,2,1, merged,0,0,0
34708,1000121,3,1528,1266,262,0.828534,0.171466,2.079586,247,15,1529,1267,262,0.828646,0.171354,2.082125,247,15,1, merged,0,0,0.326474287183
34708,1000328,2,762,554,208,0.727034,0.272966,1.251052,185,23,763,555,208,0.727392,0.272608,1.253479,185,23,1, merged,0,0,0.608937799926
34708,1002169,1,229,120,109,0.524017,0.475983,0.524017,107,2,230,121,109,0.526087,0.473913,0.526087,107,2,1, merged,0,0,0
34710,1002169,1,231,121,110,0.52381,0.47619,0.52381,108,2,232,121,111,0.521552,0.478448,0.521552,109,2,1, abandoned,1,1,0
34711,1000004,2,2443,2168,275,0.887433,0.112567,1.759012,214,61,2444,2169,275,0.88748,0.11252,1.759328,214,61,1, merged,0,0,0.00483946417181
34711,1000023,1,475,414,61,0.871579,0.128421,0.871579,58,3,476,415,61,0.871849,0.128151,0.871849,58,3,1, merged,0,0,0.000283480908575
34712,1000004,4,2444,2169,275,0.88748,0.11252,3.123195,214,61,2445,2170,275,0.887526,0.112474,3.121586,214,61,-1, abandoned,0,0,0.00500935533254
34712,1000023,3,476,415,61,0.871849,0.128151,2.235716,58,3,477,416,61,0.872117,0.127883,2.23406,58,3,-1, abandoned,0,0,0.000358877551662
34712,1000592,2,501,422,79,0.842315,0.157685,1.363867,49,30,502,423,79,0.842629,0.157371,1.361943,49,30,-1, abandoned,0,0,0
34712,1002169,1,232,121,111,0.521552,0.478448,0.521552,109,2,233,121,112,0.519313,0.480687,0.519313,110,2,1, abandoned,1,1,0
34713,1000004,2,2445,2170,275,0.887526,0.112474,1.406839,214,61,2446,2171,275,0.887572,0.112428,1.408939,214,61,1, merged,0,0,0.473375672298
34713,1002169,1,233,121,112,0.519313,0.480687,0.519313,110,2,234,122,112,0.521368,0.478632,0.521368,110,2,1, merged,0,0,0
34715,1000014,2,1646,1399,247,0.849939,0.150061,1.371307,228,19,1647,1400,247,0.85003,0.14997,1.373435,228,19,1, merged,0,0,0
34715,1002169,1,234,122,112,0.521368,0.478632,0.521368,110,2,235,123,112,0.523404,0.476596,0.523404,110,2,1, merged,0,0,0
34717,1000014,3,1648,1401,247,0.850121,0.149879,2.144674,228,19,1649,1402,247,0.850212,0.149788,2.146878,228,19,1, merged,0,0,0.544434094195
34717,1000329,2,2447,1887,560,0.771148,0.228852,1.294553,496,64,2448,1888,560,0.771242,0.228758,1.296666,496,64,1, merged,0,0,0.763335772329
34717,1002169,1,235,123,112,0.523404,0.476596,0.523404,110,2,236,124,112,0.525424,0.474576,0.525424,110,2,1, merged,0,0,0
34718,1000014,3,1649,1402,247,0.850212,0.149788,2.146878,228,19,1650,1403,247,0.850303,0.149697,2.149064,228,19,1, merged,0,0,0
34718,1000329,2,2448,1888,560,0.771242,0.228758,1.296666,496,64,2449,1889,560,0.771335,0.228665,1.298761,496,64,1, merged,0,0,0
34718,1002169,1,236,124,112,0.525424,0.474576,0.525424,110,2,237,125,112,0.527426,0.472574,0.527426,110,2,1, merged,0,0,0
34719,1002169,1,237,125,112,0.527426,0.472574,0.527426,110,2,238,126,112,0.529412,0.470588,0.529412,110,2,1, merged,0,0,0
34723,1000004,2,2447,2172,275,0.887617,0.112383,1.417029,214,61,2448,2173,275,0.887663,0.112337,1.41486,214,61,-1, merged,0,0,0.037133286775
34723,1000140,3,48,37,11,0.770833,0.229167,2.187863,10,1,49,38,11,0.77551,0.22449,2.19037,10,1,1, merged,0,0,0.021804662376
34723,1002169,1,238,126,112,0.529412,0.470588,0.529412,110,2,239,126,113,0.527197,0.472803,0.527197,111,2,1, merged,1,1,0
34725,1000014,2,1650,1403,247,0.850303,0.149697,1.3775,228,19,1651,1404,247,0.850394,0.149606,1.37956,228,19,1, merged,0,0,0.522860555729
34725,1002169,1,239,126,113,0.527197,0.472803,0.527197,111,2,240,127,113,0.529167,0.470833,0.529167,111,2,1, merged,0,0,0
34726,1000004,2,2448,2173,275,0.887663,0.112337,1.695356,214,61,2449,2174,275,0.887709,0.112291,1.695573,214,61,1, merged,0,0,0
34726,1000007,1,1118,903,215,0.807692,0.192308,0.807692,190,25,1119,904,215,0.807864,0.192136,0.807864,190,25,1, merged,0,0,0
34727,1000004,2,2449,2174,275,0.887709,0.112291,1.695573,214,61,2450,2175,275,0.887755,0.112245,1.695791,214,61,1, merged,0,0,0
34727,1000007,1,1119,904,215,0.807864,0.192136,0.807864,190,25,1120,905,215,0.808036,0.191964,0.808036,190,25,1, merged,0,0,0
34728,1000199,3,330,279,51,0.845455,0.154545,1.959091,46,5,331,280,51,0.845921,0.154079,2.072008,46,5,-1, abandoned,0,0,0
34729,1000109,4,365,307,58,0.841096,0.158904,2.883509,55,3,367,308,59,0.839237,0.160763,2.80965,56,3,1, abandoned,1,1,0
34729,1000199,3,331,280,51,0.845921,0.154079,2.042413,46,5,332,280,52,0.843373,0.156627,1.970413,47,5,1, abandoned,1,1,0
34730,1000109,2,367,308,59,0.839237,0.160763,1.682611,56,3,368,309,59,0.839674,0.160326,1.680515,56,3,-1, abandoned,0,0,0
34730,1000199,1,332,280,52,0.843373,0.156627,0.843373,47,5,333,280,53,0.840841,0.159159,0.840841,48,5,1, abandoned,1,1,0
34731,1000054,2,149,131,18,0.879195,0.120805,1.408361,12,6,150,132,18,0.88,0.12,1.41112,12,6,1, merged,0,0,0.544850880456
34731,1002169,1,240,127,113,0.529167,0.470833,0.529167,111,2,241,128,113,0.53112,0.46888,0.53112,111,2,1, merged,0,0,0
34732,1000054,2,150,132,18,0.88,0.12,1.41112,12,6,151,133,18,0.880795,0.119205,1.413853,12,6,1, merged,0,0,0.545294814099
34732,1002169,1,241,128,113,0.53112,0.46888,0.53112,111,2,242,129,113,0.533058,0.466942,0.533058,111,2,1, merged,0,0,0
34733,1000054,2,151,133,18,0.880795,0.119205,1.413853,12,6,152,134,18,0.881579,0.118421,1.416558,12,6,1, merged,0,0,0.545738516646
34733,1002169,1,242,129,113,0.533058,0.466942,0.533058,111,2,243,130,113,0.534979,0.465021,0.534979,111,2,1, merged,0,0,0
34734,1000140,3,49,38,11,0.77551,0.22449,2.262103,10,1,50,39,11,0.78,0.22,2.252181,10,1,-1, merged,0,0,0.140433919947
34734,1002169,1,243,130,113,0.534979,0.465021,0.534979,111,2,244,130,114,0.532787,0.467213,0.532787,112,2,1, merged,1,1,0
34735,1000054,2,152,134,18,0.881579,0.118421,1.414366,12,6,153,135,18,0.882353,0.117647,1.417047,12,6,1, merged,0,0,0.546181988278
34735,1002169,1,244,130,114,0.532787,0.467213,0.532787,112,2,245,131,114,0.534694,0.465306,0.534694,112,2,1, merged,0,0,0
34736,1000121,2,1529,1267,262,0.828646,0.171354,1.578646,247,15,1530,1268,262,0.828758,0.171242,1.628758,247,15,1, merged,0,0,0.00140811890161
34739,1000023,2,477,416,61,0.872117,0.127883,1.691562,58,3,478,417,61,0.872385,0.127615,1.694303,58,3,1, merged,0,0,0.000593712303981
34739,1000121,3,1530,1268,262,0.828758,0.171242,2.52032,247,15,1531,1269,262,0.82887,0.17113,2.523173,247,15,1, merged,0,0,0.00470011348793
34742,1000329,2,2449,1889,560,0.771335,0.228665,1.306029,496,64,2451,1890,561,0.771114,0.228886,1.307699,496,65,-1, merged,1,1,0.0209168793292
34742,1002169,1,245,131,114,0.534694,0.465306,0.534694,112,2,246,132,114,0.536585,0.463415,0.536585,112,2,1, merged,0,0,0
34743,1000004,2,2450,2175,275,0.887755,0.112245,1.42434,214,61,2451,2175,276,0.887393,0.112607,1.421806,215,61,1, abandoned,1,1,0.0707633901378
34743,1002169,1,246,132,114,0.536585,0.463415,0.536585,112,2,247,132,115,0.534413,0.465587,0.534413,113,2,1, abandoned,1,1,0
34744,1000004,3,2451,2175,276,0.887393,0.112607,2.265491,215,61,2452,2176,276,0.887439,0.112561,2.267576,215,61,1, merged,0,0,0
34744,1000120,2,966,815,151,0.843685,0.156315,1.378098,133,18,967,816,151,0.843847,0.156153,1.380137,133,18,1, merged,0,0,0
34744,1002169,1,247,132,115,0.534413,0.465587,0.534413,113,2,248,133,115,0.53629,0.46371,0.53629,113,2,1, merged,0,0,0
34745,1000004,3,2452,2176,276,0.887439,0.112561,2.267576,215,61,2453,2177,276,0.887485,0.112515,2.269646,215,61,1, merged,0,0,0
34745,1000120,2,967,816,151,0.843847,0.156153,1.380137,133,18,968,817,151,0.844008,0.155992,1.382161,133,18,1, merged,0,0,0
34745,1002169,1,248,133,115,0.53629,0.46371,0.53629,113,2,249,134,115,0.538153,0.461847,0.538153,113,2,1, merged,0,0,0
34746,1000004,3,2453,2177,276,0.887485,0.112515,2.269646,215,61,2454,2178,276,0.887531,0.112469,2.2717,215,61,1, merged,0,0,0
34746,1000120,2,968,817,151,0.844008,0.155992,1.382161,133,18,969,818,151,0.844169,0.155831,1.384169,133,18,1, merged,0,0,0
34746,1002169,1,249,134,115,0.538153,0.461847,0.538153,113,2,250,135,115,0.54,0.46,0.54,113,2,1, merged,0,0,0
34747,1000120,2,969,818,151,0.844169,0.155831,1.384169,133,18,970,819,151,0.84433,0.15567,1.386163,133,18,1, merged,0,0,0
34747,1002169,1,250,135,115,0.54,0.46,0.54,113,2,251,136,115,0.541833,0.458167,0.541833,113,2,1, merged,0,0,0
34748,1000004,3,2454,2178,276,0.887531,0.112469,2.273693,215,61,2455,2179,276,0.887576,0.112424,2.27088,215,61,1, merged,0,0,0
34748,1000120,2,970,819,151,0.84433,0.15567,1.386163,133,18,972,820,152,0.843621,0.156379,1.383304,134,18,1, merged,1,1,0
34748,1002169,1,251,136,115,0.541833,0.458167,0.541833,113,2,252,136,116,0.539683,0.460317,0.539683,114,2,1, merged,1,1,0
34749,1000109,4,368,309,59,0.839674,0.160326,2.738486,56,3,370,311,59,0.840541,0.159459,2.738816,56,3,-1, merged,0,0,0
34749,1000199,3,333,280,53,0.840841,0.159159,1.898812,48,5,334,280,54,0.838323,0.161677,1.898275,49,5,1, merged,1,1,0
34750,1000005,2,245,190,55,0.77551,0.22449,1.55551,50,5,246,191,55,0.776423,0.223577,1.560736,50,5,1, merged,0,0,0.165170747891
34752,1000015,2,1571,1410,161,0.897518,0.102482,0.897518,149,12,1572,1411,161,0.897583,0.102417,1.897583,149,12,1, merged,0,0,1.02120796592
34754,1000120,2,972,820,152,0.843621,0.156379,1.383304,134,18,973,821,152,0.843782,0.156218,1.385284,134,18,1, merged,0,0,0.025001455863
34754,1002169,1,252,136,116,0.539683,0.460317,0.539683,114,2,253,137,116,0.541502,0.458498,0.541502,114,2,1, merged,0,0,0
34755,1000120,2,973,821,152,0.843782,0.156218,1.385284,134,18,974,822,152,0.843943,0.156057,1.38725,134,18,1, merged,0,0,0.161975495442
34755,1002169,1,253,137,116,0.541502,0.458498,0.541502,114,2,254,138,116,0.543307,0.456693,0.543307,114,2,1, merged,0,0,0
34756,1000120,2,974,822,152,0.843943,0.156057,1.38725,134,18,975,823,152,0.844103,0.155897,1.389201,134,18,1, merged,0,0,0.146825191854
34756,1002169,1,254,138,116,0.543307,0.456693,0.543307,114,2,255,139,116,0.545098,0.454902,0.545098,114,2,1, merged,0,0,0
34762,1000005,1,246,191,55,0.776423,0.223577,0.776423,50,5,247,192,55,0.777328,0.222672,0.777328,50,5,1, merged,0,0,0.000206313183412
34762,1000023,2,480,419,61,0.872917,0.127083,1.649339,58,3,481,420,61,0.873181,0.126819,1.650509,58,3,1, merged,0,0,0.00184274248802
34766,1000070,2,890,782,108,0.878652,0.121348,1.811985,91,17,891,783,108,0.878788,0.121212,1.819964,91,17,1, merged,0,0,0.778767154831
34768,1000054,2,153,135,18,0.882353,0.117647,1.427451,12,6,154,136,18,0.883117,0.116883,1.427864,12,6,1, merged,0,0,0.54059356573
34768,1002169,1,255,139,116,0.545098,0.454902,0.545098,114,2,257,140,117,0.544747,0.455253,0.544747,115,2,1, merged,1,1,0
34769,1000054,2,154,136,18,0.883117,0.116883,1.427864,12,6,155,137,18,0.883871,0.116129,1.430383,12,6,1, merged,0,0,0.351735401358
34769,1002169,1,257,140,117,0.544747,0.455253,0.544747,115,2,258,141,117,0.546512,0.453488,0.546512,115,2,1, merged,0,0,0
34774,1000007,2,1123,907,216,0.807658,0.192342,1.653031,191,25,1124,908,216,0.807829,0.192171,1.653376,191,25,1, merged,0,0,0.202808490989
34774,1000009,1,886,749,137,0.845372,0.154628,0.845372,123,14,887,750,137,0.845547,0.154453,0.845547,123,14,1, merged,0,0,0.201622166783
34776,1000054,3,155,137,18,0.883871,0.116129,2.259253,12,6,156,138,18,0.884615,0.115385,2.265321,12,6,1, merged,0,0,0.0165025539766
34776,1000121,2,1531,1269,262,0.82887,0.17113,1.375382,247,15,1532,1270,262,0.828982,0.171018,1.380706,247,15,1, merged,0,0,0.0146987719387
34776,1002169,1,258,141,117,0.546512,0.453488,0.546512,115,2,261,144,117,0.551724,0.448276,0.551724,115,2,-1, merged,0,0,0
34777,1000014,1,1652,1405,247,0.850484,0.149516,0.850484,228,19,1653,1406,247,0.850575,0.149425,0.850575,228,19,1, merged,0,0,0.101028383911
34777,1000070,2,892,784,108,0.878924,0.121076,1.729408,91,17,893,785,108,0.879059,0.120941,1.729634,91,17,1, merged,0,0,0.122391202175
34778,1000007,1,1124,908,216,0.807829,0.192171,0.807829,191,25,1125,908,217,0.807111,0.192889,0.807111,192,25,1, abandoned,1,1,0.202542076689
34778,1000012,2,391,338,53,0.86445,0.13555,1.672279,52,1,392,339,53,0.864796,0.135204,1.671907,52,1,-1, abandoned,0,0,0.154249535476
34779,1000121,3,1532,1270,262,0.828982,0.171018,2.435873,247,15,1534,1271,263,0.828553,0.171447,2.433728,248,15,1, merged,1,1,0.527743443721
34788,1000329,2,2457,1895,562,0.771266,0.228734,1.32299,496,66,2458,1896,562,0.771359,0.228641,1.324794,496,66,1, merged,0,0,0.538992161813
34788,1002169,1,261,144,117,0.551724,0.448276,0.551724,115,2,262,145,117,0.553435,0.446565,0.553435,115,2,1, merged,0,0,0
34819,1000004,1,2456,2180,276,0.887622,0.112378,0.887622,215,61,2457,2181,276,0.887668,0.112332,0.887668,215,61,-1, merged,0,0,0.00171770294342
34819,1000091,2,434,332,102,0.764977,0.235023,1.652599,87,15,436,334,102,0.766055,0.233945,1.653723,87,15,-1, merged,0,0,0.0045197740113
34820,1000004,1,2457,2181,276,0.887668,0.112332,0.887668,215,61,2458,2182,276,0.887714,0.112286,0.887714,215,61,-1, abandoned,0,0,0.00188727257305
34820,1000091,2,436,334,102,0.766055,0.233945,1.653723,87,15,437,335,102,0.76659,0.23341,1.654304,87,15,-1, abandoned,0,0,0.00564812199944
34823,1000003,2,911,764,147,0.838639,0.161361,1.683061,132,15,913,764,149,0.836802,0.163198,1.679659,134,15,1, merged,1,1,0.00446333687566
34823,1000004,3,2458,2182,276,0.887714,0.112286,2.570774,215,61,2461,2185,276,0.88785,0.11215,2.567509,215,61,-1, merged,0,0,0.0698199344188
34823,1000120,1,977,825,152,0.844422,0.155578,0.844422,134,18,980,826,154,0.842857,0.157143,0.842857,136,18,1, merged,1,1,0.211091049781
34827,1000004,2,2461,2185,276,0.88785,0.11215,1.563907,215,61,2462,2186,276,0.887896,0.112104,1.550396,215,61,1, merged,0,0,0.0302534904146
34828,1000005,1,247,192,55,0.777328,0.222672,0.777328,50,5,248,192,56,0.774194,0.225806,0.774194,51,5,1, merged,1,1,0.433928265394
34828,1000130,4,294,248,46,0.843537,0.156463,3.353008,36,10,295,249,46,0.844068,0.155932,3.326595,36,10,1, merged,0,0,0.555892208735
34830,1000329,1,2459,1897,562,0.771452,0.228548,0.771452,496,66,2460,1898,562,0.771545,0.228455,0.771545,496,66,1, merged,0,0,0.412991694856
34831,1000121,3,1534,1271,263,0.828553,0.171447,2.154814,248,15,1535,1272,263,0.828664,0.171336,2.156878,248,15,1, merged,0,0,0.0535069345584
34831,1000328,4,764,556,208,0.727749,0.272251,2.882563,185,23,765,557,208,0.728105,0.271895,2.884983,185,23,1, merged,0,0,0.0549751993849
34831,1000329,2,2460,1898,562,0.771545,0.228455,1.326262,496,66,2463,1901,562,0.771823,0.228177,1.328214,496,66,-1, merged,0,0,0.0644694606668
34831,1002169,1,265,147,118,0.554717,0.445283,0.554717,116,2,266,148,118,0.556391,0.443609,0.556391,116,2,-1, merged,0,0,0
34832,1000004,1,2462,2186,276,0.887896,0.112104,0.887896,215,61,2463,2187,276,0.887942,0.112058,0.887942,215,61,1, merged,0,0,0.0243232602305
34832,1000005,3,248,192,56,0.774194,0.225806,2.328756,51,5,249,193,56,0.7751,0.2249,2.377328,51,5,1, merged,0,0,0.00359804653708
34833,1000121,1,1535,1272,263,0.828664,0.171336,0.828664,248,15,1536,1273,263,0.828776,0.171224,0.828776,248,15,1, merged,0,0,0.0524161051541
34835,1000004,2,2464,2188,276,0.887987,0.112013,1.583639,215,61,2469,2192,277,0.887809,0.112191,1.589936,216,61,-1, merged,1,0,0.0206107377795
34835,1000005,4,249,193,56,0.7751,0.2249,3.10874,51,5,250,193,57,0.772,0.228,3.028603,52,5,1, merged,1,1,0.0110807809854
34841,1000329,2,2463,1901,562,0.771823,0.228177,1.543823,496,66,2466,1904,562,0.772101,0.227899,1.545009,496,66,-1, merged,0,0,0.255747295352
34846,1000023,2,483,422,61,0.873706,0.126294,1.582039,58,3,484,423,61,0.873967,0.126033,1.588253,58,3,1, merged,0,0,0.0079123992406
34847,1000023,1,484,423,61,0.873967,0.126033,0.873967,58,3,485,424,61,0.874227,0.125773,0.874227,58,3,1, merged,0,0,0.0057475955728
34847,1000063,2,2335,2088,247,0.894218,0.105782,1.768185,206,41,2336,2089,247,0.894264,0.105736,1.768491,206,41,1, merged,0,0,0.00494942407554
34848,1000004,2,2471,2194,277,0.8879,0.1121,1.660808,216,61,2472,2195,277,0.887945,0.112055,1.661755,216,61,1, merged,0,0,0.0675510723065
34848,1000005,1,251,194,57,0.772908,0.227092,0.772908,52,5,252,195,57,0.77381,0.22619,0.77381,52,5,1, merged,0,0,0.012905982906
34849,1000070,2,893,785,108,0.879059,0.120941,1.43545,91,17,894,786,108,0.879195,0.120805,1.440533,91,17,1, merged,0,0,0.128117192254
34849,1002169,1,266,148,118,0.556391,0.443609,0.556391,116,2,269,151,118,0.561338,0.438662,0.561338,116,2,-1, merged,0,0,0
34855,1000023,2,485,424,61,0.874227,0.125773,1.654227,58,3,486,425,61,0.874486,0.125514,1.658799,58,3,1, merged,0,0,0.411641910696
34855,1000140,1,50,39,11,0.78,0.22,0.78,10,1,51,40,11,0.784314,0.215686,0.784314,10,1,-1, merged,0,0,0.420145716376
34857,1000004,1,2474,2197,277,0.888036,0.111964,0.888036,216,61,2476,2199,277,0.888126,0.111874,0.888126,216,61,-1, merged,0,0,0.00690531570538
34857,1000120,2,982,828,154,0.843177,0.156823,1.731213,136,18,983,829,154,0.843337,0.156663,1.731463,136,18,1, merged,0,0,0.00868088484968
34858,1000004,2,2476,2199,277,0.888126,0.111874,1.525163,216,61,2477,2200,277,0.888171,0.111829,1.527877,216,61,1, merged,0,0,0.0173776234835
34867,1000026,2,304,278,26,0.914474,0.085526,1.78114,24,2,305,279,26,0.914754,0.085246,1.789754,24,2,1, merged,0,0,0.412423509607
34872,1000003,1,913,764,149,0.836802,0.163198,0.836802,134,15,915,766,149,0.837158,0.162842,0.837158,134,15,-1, merged,0,0,0.0917310076149
34872,1000004,2,2478,2201,277,0.888216,0.111784,1.725018,216,61,2479,2201,278,0.887858,0.112142,1.725016,217,61,1, merged,1,1,0.0675280770694
34872,1000121,3,1536,1273,263,0.828776,0.171224,2.553794,248,15,1539,1274,265,0.82781,0.17219,2.552827,250,15,-1, merged,1,0,0.0771576833538
34874,1000004,2,2479,2201,278,0.887858,0.112142,1.801357,217,61,2481,2203,278,0.887948,0.112052,1.801561,217,61,-1, merged,0,0,0.0203427059384
34874,1000153,1,763,697,66,0.913499,0.086501,0.913499,52,14,764,698,66,0.913613,0.086387,0.913613,52,14,-1, merged,0,0,0.0283428599523
34879,1000120,3,983,829,154,0.843337,0.156663,2.453676,136,18,985,831,154,0.843655,0.156345,2.449699,136,18,-1, merged,0,0,0.371811649987
34880,1000004,1,2482,2204,278,0.887994,0.112006,0.887994,217,61,2483,2205,278,0.888039,0.111961,0.888039,217,61,-1, merged,0,0,0.106642845582
34880,1000005,2,252,195,57,0.77381,0.22619,1.661803,52,5,253,196,57,0.774704,0.225296,1.662742,52,5,1, merged,0,0,0.107548529522
34882,1000120,2,985,831,154,0.843655,0.156345,1.545782,136,18,986,832,154,0.843813,0.156187,1.531313,136,18,1, merged,0,0,0.171115223924
34883,1000120,2,986,832,154,0.843813,0.156187,1.531313,136,18,987,833,154,0.843972,0.156028,1.517441,136,18,1, merged,0,0,0.172097241051
34884,1000120,2,987,833,154,0.843972,0.156028,1.517441,136,18,988,834,154,0.84413,0.15587,1.50413,136,18,1, merged,0,0,0.173078754579
34893,1000011,2,519,482,37,0.928709,0.071291,1.772839,34,3,520,483,37,0.928846,0.071154,1.773133,34,3,1, merged,0,0,0.596534387038
34893,1000120,1,988,834,154,0.84413,0.15587,0.84413,136,18,989,835,154,0.844287,0.155713,0.844287,136,18,1, merged,0,0,0.391353865309
34896,1000140,1,51,40,11,0.784314,0.215686,0.784314,10,1,53,42,11,0.792453,0.207547,0.792453,10,1,-1, merged,0,0,0.421090605301
34897,1000329,2,2466,1904,562,0.772101,0.227899,1.654454,496,66,2467,1905,562,0.772193,0.227807,1.661082,496,66,1, merged,0,0,0.00106116322781
34898,1000004,2,2485,2207,278,0.888129,0.111871,1.73273,217,61,2486,2208,278,0.888174,0.111826,1.731924,217,61,1, merged,0,0,0.0157297827369
34898,1000120,1,991,837,154,0.844601,0.155399,0.844601,136,18,992,837,155,0.84375,0.15625,0.84375,137,18,1, merged,1,1,0.0616632374324
34899,1000070,1,894,786,108,0.879195,0.120805,0.879195,91,17,895,786,109,0.878212,0.121788,0.878212,92,17,1, merged,1,1,0.0398289181523
34902,1000121,1,1541,1276,265,0.828034,0.171966,0.828034,250,15,1542,1277,265,0.828145,0.171855,0.828145,250,15,1, merged,0,0,0.0186687190251
34903,1000329,3,2467,1905,562,0.772193,0.227807,2.405526,496,66,2468,1906,562,0.772285,0.227715,2.273308,496,66,1, merged,0,0,0.0301242212286
34905,1000121,1,1542,1277,265,0.828145,0.171855,0.828145,250,15,1543,1278,265,0.828257,0.171743,0.828257,250,15,1, merged,0,0,0.000422294339865
34906,1000023,1,487,426,61,0.874743,0.125257,0.874743,58,3,488,427,61,0.875,0.125,0.875,58,3,-1, merged,0,0,0.0411667188604
34907,1000015,2,1574,1413,161,0.897713,0.102287,1.897713,149,12,1575,1414,161,0.897778,0.102222,1.897778,149,12,1, merged,0,0,0.44843031315
34910,1000011,2,520,483,37,0.928846,0.071154,1.826624,34,3,521,484,37,0.928983,0.071017,1.82689,34,3,1, merged,0,0,0
34910,1000015,1,1575,1414,161,0.897778,0.102222,0.897778,149,12,1577,1416,161,0.897907,0.102093,0.897907,149,12,1, merged,0,0,0
34912,1000121,2,1543,1278,265,0.828257,0.171743,1.600542,250,15,1545,1280,265,0.828479,0.171521,1.600856,250,15,-1, merged,0,0,0.292689949789
34912,1000329,1,2468,1906,562,0.772285,0.227715,0.772285,496,66,2469,1907,562,0.772377,0.227623,0.772377,496,66,-1, merged,0,0,0.354467142561
34919,1000121,1,1545,1280,265,0.828479,0.171521,0.828479,250,15,1546,1281,265,0.82859,0.17141,0.82859,250,15,1, merged,0,0,0.00327421982705
34920,1000014,3,1658,1411,247,0.851025,0.148975,2.396778,228,19,1659,1412,247,0.851115,0.148885,2.383217,228,19,1, merged,0,0,0.00377078878024
34920,1000121,4,1546,1281,265,0.82859,0.17141,3.225368,250,15,1547,1282,265,0.828701,0.171299,3.211917,250,15,1, merged,0,0,0.00160572980772
34926,1000004,4,2488,2210,278,0.888264,0.111736,3.424091,217,61,2489,2211,278,0.888309,0.111691,3.410103,217,61,-1, merged,0,0,0.110999550632
34926,1000054,3,156,138,18,0.884615,0.115385,2.535827,12,6,160,142,18,0.8875,0.1125,2.521794,12,6,-1, merged,0,0,0.267457904008
34926,1000070,6,895,786,109,0.878212,0.121788,5.07468,92,17,896,787,109,0.878348,0.121652,5.061013,92,17,1, merged,0,0,0.128271904965
34926,1000121,2,1547,1282,265,0.828701,0.171299,1.651212,250,15,1550,1284,266,0.828387,0.171613,1.634294,251,15,1, merged,1,1,0.110924542222
34926,1000166,1,231,190,41,0.822511,0.177489,0.822511,39,2,237,191,46,0.805907,0.194093,0.805907,44,2,1, merged,1,1,0.145092583316
34926,1000329,5,2469,1907,562,0.772377,0.227623,4.196468,496,66,2471,1909,562,0.772562,0.227438,4.182665,496,66,-1, merged,0,0,0.111832275625
34928,1000120,2,992,837,155,0.84375,0.15625,1.626008,137,18,993,838,155,0.843907,0.156093,1.626516,137,18,1, merged,0,0,0.190374686632
34928,1000327,1,620,485,135,0.782258,0.217742,0.782258,104,31,621,486,135,0.782609,0.217391,0.782609,104,31,-1, merged,0,0,0.30151081388
34936,1000026,1,306,280,26,0.915033,0.084967,0.915033,24,2,307,281,26,0.915309,0.084691,0.915309,24,2,1, merged,0,0,0.0135931870292
34936,1000153,2,764,698,66,0.913613,0.086387,1.828645,52,14,765,699,66,0.913725,0.086275,1.829035,52,14,1, merged,0,0,0.00297804142946
34937,1000329,1,2475,1912,563,0.772525,0.227475,0.772525,497,66,2476,1913,563,0.772617,0.227383,0.772617,497,66,1, merged,0,0,0.511336719062
34939,1000328,2,766,558,208,0.72846,0.27154,1.501077,185,23,767,558,209,0.72751,0.27249,1.499815,186,23,1, abandoned,1,1,0.426869280197
34939,1000329,1,2476,1913,563,0.772617,0.227383,0.772617,497,66,2477,1913,564,0.772305,0.227695,0.772305,498,66,1, abandoned,1,1,0.513922392709
34951,1000109,2,370,311,59,0.840541,0.159459,1.684448,56,3,371,312,59,0.84097,0.15903,1.685035,56,3,1, merged,0,0,0.00243178833723
34951,1000120,1,993,838,155,0.843907,0.156093,0.843907,137,18,994,839,155,0.844064,0.155936,0.844064,137,18,1, merged,0,0,0.00132024156613
34983,1000534,1,161,119,42,0.73913,0.26087,0.73913,40,2,164,121,43,0.737805,0.262195,0.737805,41,2,-1, merged,1,0,1.11085381222
34988,1002169,2,269,151,118,0.561338,0.438662,1.413797,116,2,270,152,118,0.562963,0.437037,1.422338,116,2,-1, abandoned,0,0,0
34990,1000004,2,2492,2213,279,0.888042,0.111958,1.503426,217,62,2493,2214,279,0.888087,0.111913,1.530944,217,62,1, merged,0,0,0.0439584991552
34991,1000004,2,2493,2214,279,0.888087,0.111913,1.530944,217,62,2495,2216,279,0.888176,0.111824,1.488176,217,62,-1, merged,0,0,0
34996,1000054,2,161,143,18,0.888199,0.111801,1.716697,12,6,165,144,21,0.872727,0.127273,1.700691,15,6,1, abandoned,1,1,0.035682111631
34996,1000121,1,1551,1285,266,0.828498,0.171502,0.828498,251,15,1552,1285,267,0.827964,0.172036,0.827964,252,15,1, abandoned,1,1,0.0310318775625
35013,1000004,2,2495,2216,279,0.888176,0.111824,1.817159,217,62,2497,2218,279,0.888266,0.111734,1.815469,217,62,-1, merged,0,0,0.0244156043661
35013,1000011,1,521,484,37,0.928983,0.071017,0.928983,34,3,522,484,38,0.927203,0.072797,0.927203,35,3,1, merged,1,1,0.00466639256545
35019,1000009,1,893,753,140,0.843225,0.156775,0.843225,124,16,894,753,141,0.842282,0.157718,0.842282,125,16,1, merged,1,1,0.0210430640745
35019,1000109,4,371,312,59,0.84097,0.15903,2.962051,56,3,373,314,59,0.841823,0.158177,2.986072,56,3,-1, merged,0,0,0.00476630817417
35019,1000534,3,165,122,43,0.739394,0.260606,2.121081,41,2,167,122,45,0.730539,0.269461,2.144249,43,2,1, merged,1,1,0.0207169055828
35020,1000007,1,1133,916,217,0.808473,0.191527,0.808473,192,25,1135,917,218,0.80793,0.19207,0.80793,193,25,1, merged,1,1,1.21657374051
35020,1000009,2,894,753,141,0.842282,0.157718,1.650755,125,16,896,755,141,0.842634,0.157366,1.650563,125,16,-1, merged,0,0,1.21040736907
35032,1000012,1,401,348,53,0.86783,0.13217,0.86783,52,1,402,349,53,0.868159,0.131841,0.868159,52,1,-1, merged,0,0,0.8469665985
35035,1000007,2,1135,917,218,0.80793,0.19207,1.721655,193,25,1136,918,218,0.808099,0.191901,1.721937,193,25,1, merged,0,0,0.429663605718
35035,1000153,1,765,699,66,0.913725,0.086275,0.913725,52,14,766,700,66,0.913838,0.086162,0.913838,52,14,1, merged,0,0,0.373899602714
35040,1000070,2,896,787,109,0.878348,0.121652,1.423803,92,17,898,789,109,0.878619,0.121381,1.400358,92,17,-1, merged,0,0,0.800235277994
35044,1000015,2,1590,1429,161,0.898742,0.101258,1.667973,149,12,1591,1430,161,0.898806,0.101194,1.639547,149,12,1, merged,0,0,0.667621673632
35045,1000054,2,165,144,21,0.872727,0.127273,1.43569,15,6,168,146,22,0.869048,0.130952,1.43632,16,6,-1, merged,1,0,0.0129582942592
35045,1000166,3,237,191,46,0.805907,0.194093,2.241597,44,2,238,191,47,0.802521,0.197479,2.238841,45,2,1, merged,1,1,0.00966580236244
35045,1002169,1,270,152,118,0.562963,0.437037,0.562963,116,2,275,156,119,0.567273,0.432727,0.567273,117,2,-1, merged,1,0,0
35046,1000023,1,493,432,61,0.876268,0.123732,0.876268,58,3,494,433,61,0.876518,0.123482,0.876518,58,3,1, merged,0,0,0.00050828566057
35046,1000063,2,2336,2089,247,0.894264,0.105736,1.770531,206,41,2337,2090,247,0.894309,0.105691,1.770827,206,41,1, merged,0,0,0.000759747756193
35047,1000005,1,254,197,57,0.775591,0.224409,0.775591,52,5,255,198,57,0.776471,0.223529,0.776471,52,5,1, merged,0,0,0.00316843273703
35047,1000023,3,494,433,61,0.876518,0.123482,2.546418,58,3,495,434,61,0.876768,0.123232,2.547592,58,3,1, merged,0,0,0.00029177018448
35047,1000063,2,2337,2090,247,0.894309,0.105691,1.669899,206,41,2338,2091,247,0.894354,0.105646,1.670825,206,41,1, merged,0,0,0.00039810678251
35048,1000023,1,495,434,61,0.876768,0.123232,0.876768,58,3,497,436,61,0.877264,0.122736,0.877264,58,3,-1, merged,0,0,2.20887453414e-11
35048,1000121,3,1554,1287,267,0.828185,0.171815,2.364953,252,15,1555,1288,267,0.828296,0.171704,2.359406,252,15,1, merged,0,0,0.000996958497572
35048,1000329,4,2479,1915,564,0.772489,0.227511,3.137442,498,66,2480,1916,564,0.772581,0.227419,3.131986,498,66,1, merged,0,0,0.000900454727813
35049,1000132,3,261,231,30,0.885057,0.114943,2.499222,23,7,262,232,30,0.885496,0.114504,2.500066,23,7,1, merged,0,0,0.117481384214
35049,1000329,1,2480,1916,564,0.772581,0.227419,0.772581,498,66,2481,1917,564,0.772672,0.227328,0.772672,498,66,1, merged,0,0,0.117976972675
35049,1000592,2,505,425,80,0.841584,0.158416,1.614165,49,31,506,426,80,0.841897,0.158103,1.61457,49,31,1, merged,0,0,0.0967929795501
35050,1000329,1,2481,1917,564,0.772672,0.227328,0.772672,498,66,2482,1918,564,0.772764,0.227236,0.772764,498,66,1, merged,0,0,0.515317981611
35054,1000120,1,999,844,155,0.844845,0.155155,0.844845,137,18,1000,844,156,0.844,0.156,0.844,138,18,1, merged,1,1,0.00396517594825
35054,1000329,2,2482,1918,564,0.772764,0.227236,1.617609,498,66,2485,1920,565,0.772636,0.227364,1.616636,499,66,1, merged,1,1,0.000359574743481
35061,1000063,1,2339,2092,247,0.894399,0.105601,0.894399,206,41,2340,2093,247,0.894444,0.105556,0.894444,206,41,1, merged,0,0,0.00781317876791
35061,1000120,2,1006,850,156,0.84493,0.15507,1.73933,138,18,1007,851,156,0.845084,0.154916,1.739529,138,18,1, merged,0,0,0.21798757764
35065,1000004,3,2497,2218,279,0.888266,0.111734,2.506446,217,62,2500,2221,279,0.8884,0.1116,2.505368,217,62,-1, merged,0,0,0
35065,1000120,2,1010,854,156,0.845545,0.154455,1.61818,138,18,1012,855,157,0.844862,0.155138,1.616968,139,18,1, merged,1,1,0
35065,1000329,1,2485,1920,565,0.772636,0.227364,0.772636,499,66,2488,1921,567,0.772106,0.227894,0.772106,500,67,1, merged,1,1,0
35071,1000120,1,1018,860,158,0.844794,0.155206,0.844794,139,19,1019,861,158,0.844946,0.155054,0.844946,139,19,1, merged,0,0,0.00537987923869
35071,1000329,2,2488,1921,567,0.772106,0.227894,1.6169,500,67,2489,1922,567,0.772198,0.227802,1.617144,500,67,1, merged,0,0,0.0072916657257
35072,1000004,3,2500,2221,279,0.8884,0.1116,2.505544,217,62,2501,2222,279,0.888445,0.111555,2.505832,217,62,1, merged,0,0,0.142477630282
35072,1000120,2,1019,861,158,0.844946,0.155054,1.617144,139,19,1020,862,158,0.845098,0.154902,1.617387,139,19,1, merged,0,0,0.133853877311
35072,1000329,1,2489,1922,567,0.772198,0.227802,0.772198,500,67,2490,1923,567,0.772289,0.227711,0.772289,500,67,1, merged,0,0,0.174050422201
35073,1000004,2,2501,2222,279,0.888445,0.111555,1.733543,217,62,2502,2223,279,0.888489,0.111511,1.733739,217,62,1, merged,0,0,0.0358707973684
35073,1000120,1,1020,862,158,0.845098,0.154902,0.845098,139,19,1021,863,158,0.84525,0.15475,0.84525,139,19,1, merged,0,0,0.106944357539
35076,1000063,2,2340,2093,247,0.894444,0.105556,1.655808,206,41,2344,2095,249,0.893771,0.106229,1.651234,208,41,-1, merged,1,0,0.283845062099
35079,1000023,1,497,436,61,0.877264,0.122736,0.877264,58,3,498,437,61,0.87751,0.12249,0.87751,58,3,-1, merged,0,0,0
35082,1000023,1,499,438,61,0.877756,0.122244,0.877756,58,3,501,440,61,0.878244,0.121756,0.878244,58,3,-1, merged,0,0,0.100331188406
35083,1000327,2,621,486,135,0.782609,0.217391,1.549425,104,31,622,487,135,0.782958,0.217042,1.550815,104,31,1, merged,0,0,0.0400467886578
35084,1000327,2,622,487,135,0.782958,0.217042,1.550815,104,31,623,488,135,0.783307,0.216693,1.552195,104,31,1, merged,0,0,0.075352845171
35087,1000023,2,501,440,61,0.878244,0.121756,1.53209,58,3,502,441,61,0.878486,0.121514,1.538863,58,3,1, merged,0,0,0.000658442290654
35089,1000023,2,502,441,61,0.878486,0.121514,1.592772,58,3,503,442,61,0.878728,0.121272,1.604218,58,3,-1, abandoned,0,0,2.1536318575e-06
35090,1000054,2,168,146,22,0.869048,0.130952,1.43632,16,6,170,147,23,0.864706,0.135294,1.433051,17,6,-1, merged,1,0,0.00998927503667
35090,1000166,3,238,191,47,0.802521,0.197479,2.238841,45,2,239,192,47,0.803347,0.196653,2.236398,45,2,1, merged,0,0,0.00655276701862
35090,1002169,1,275,156,119,0.567273,0.432727,0.567273,117,2,278,158,120,0.568345,0.431655,0.568345,118,2,-1, merged,1,0,0
35100,1000009,2,896,755,141,0.842634,0.157366,1.573173,125,16,897,756,141,0.842809,0.157191,1.574952,125,16,1, merged,0,0,0.404118022405
35100,1000534,1,167,122,45,0.730539,0.269461,0.730539,43,2,168,123,45,0.732143,0.267857,0.732143,43,2,1, merged,0,0,0.370031644833
35107,1000004,2,2504,2225,279,0.888578,0.111422,1.739818,217,62,2505,2226,279,0.888623,0.111377,1.732885,217,62,-1, merged,0,0,0.0244764108051
35107,1000011,3,522,484,38,0.927203,0.072797,2.667021,35,3,523,485,38,0.927342,0.072658,2.660227,35,3,1, merged,0,0,0.0334948822863
35107,1000015,4,1595,1434,161,0.89906,0.10094,3.566081,149,12,1596,1435,161,0.899123,0.100877,3.55935,149,12,1, merged,0,0,0.0314594111652
35108,1000070,2,898,789,109,0.878619,0.121381,1.434175,92,17,899,790,109,0.878754,0.121246,1.457702,92,17,1, merged,0,0,0.160211971816
35109,1000063,2,2344,2095,249,0.893771,0.106229,1.619262,208,41,2345,2096,249,0.893817,0.106183,1.624586,208,41,1, merged,0,0,0.00580854304722
35122,1000329,1,2493,1926,567,0.772563,0.227437,0.772563,500,67,2495,1927,568,0.772345,0.227655,0.772345,500,68,-1, merged,1,1,0.270165456235
35124,1000110,3,51,44,7,0.862745,0.137255,2.406338,6,1,52,45,7,0.865385,0.134615,2.40695,6,1,1, merged,0,0,0.0230504100921
35124,1000592,4,506,426,80,0.841897,0.158103,3.248235,49,31,507,427,80,0.842209,0.157791,3.249159,49,31,1, merged,0,0,0.0254963585433
35144,1000120,2,1022,864,158,0.845401,0.154599,1.617436,139,19,1023,865,158,0.845552,0.154448,1.617679,139,19,1, merged,0,0,0
35144,1000329,1,2496,1927,569,0.772035,0.227965,0.772035,501,68,2497,1928,569,0.772127,0.227873,0.772127,501,68,1, merged,0,0,0
35149,1000121,3,1555,1288,267,0.828296,0.171704,2.331192,252,15,1557,1290,267,0.828516,0.171484,2.342113,252,15,-1, merged,0,0,4.2093319034e-06
35149,1000329,2,2497,1928,569,0.772127,0.227873,1.502896,501,68,2498,1929,569,0.772218,0.227782,1.513597,501,68,-1, merged,0,0,2.04681267883e-06
35154,1000070,1,901,792,109,0.879023,0.120977,0.879023,92,17,903,793,110,0.878184,0.121816,0.878184,93,17,1, merged,1,1,0.0413442925577
35154,1000140,3,54,43,11,0.796296,0.203704,2.605875,10,1,55,44,11,0.8,0.2,2.610616,10,1,-1, merged,0,0,0.0712391839131
35169,1000004,4,2505,2226,279,0.888623,0.111377,2.980813,217,62,2507,2228,279,0.888712,0.111288,2.856879,217,62,-1, merged,0,0,0.156169986112
35171,1000108,2,59,49,10,0.830508,0.169492,1.695893,6,4,60,49,11,0.816667,0.183333,1.655952,7,4,1, merged,1,1,0.154214483658
35171,1000110,1,52,45,7,0.865385,0.134615,0.865385,6,1,56,47,9,0.839286,0.160714,0.839286,8,1,1, merged,1,1,0.109750896388
35172,1000004,2,2507,2228,279,0.888712,0.111288,1.661021,217,62,2508,2229,279,0.888756,0.111244,1.661156,217,62,1, merged,0,0,0
35172,1000329,1,2499,1930,569,0.772309,0.227691,0.772309,501,68,2500,1931,569,0.7724,0.2276,0.7724,501,68,1, merged,0,0,0
35174,1000063,1,2345,2096,249,0.893817,0.106183,0.893817,208,41,2346,2096,250,0.893436,0.106564,0.893436,209,41,1, merged,1,1,0.121570507013
35175,1000063,1,2346,2096,250,0.893436,0.106564,0.893436,209,41,2347,2096,251,0.893055,0.106945,0.893055,210,41,1, merged,1,1,0.182375322283
35177,1000130,1,297,250,47,0.841751,0.158249,0.841751,37,10,298,251,47,0.842282,0.157718,0.842282,37,10,-1, merged,0,0,0
35177,1000166,3,239,192,47,0.803347,0.196653,2.213443,45,2,241,193,48,0.80083,0.19917,2.213004,45,3,1, merged,1,0,0
35177,1002169,2,278,158,120,0.568345,0.431655,1.410096,118,2,279,159,120,0.569892,0.430108,1.412174,118,2,-1, merged,0,0,0
35178,1000014,2,1660,1413,247,0.851205,0.148795,1.646258,228,19,1662,1415,247,0.851384,0.148616,1.644366,228,19,-1, merged,0,0,0.689518520617
35183,1000004,3,2510,2231,279,0.888845,0.111155,2.543169,217,62,2511,2232,279,0.888889,0.111111,2.541847,217,62,1, merged,0,0,0
35183,1000007,1,1140,922,218,0.808772,0.191228,0.808772,193,25,1142,923,219,0.808231,0.191769,0.808231,194,25,1, merged,1,1,0
35183,1000120,2,1023,865,158,0.845552,0.154448,1.654324,139,19,1024,865,159,0.844727,0.155273,1.652958,140,19,1, merged,1,1,0
35187,1000121,2,1558,1291,267,0.828626,0.171374,1.570006,252,15,1559,1292,267,0.828736,0.171264,1.574499,252,15,1, merged,0,0,3.0247995725e-05
35189,1000023,3,505,444,61,0.879208,0.120792,2.457944,58,3,506,445,61,0.879447,0.120553,2.450338,58,3,1, merged,0,0,2.06312295176e-05
35189,1000121,2,1559,1292,267,0.828736,0.171264,1.578736,252,15,1561,1294,267,0.828956,0.171044,1.570891,252,15,-1, merged,0,0,3.30162930196e-05
35190,1000023,3,506,445,61,0.879447,0.120553,2.450338,58,3,508,447,61,0.879921,0.120079,2.442941,58,3,-1, merged,0,0,0.000206736825344
35190,1000121,2,1561,1294,267,0.828956,0.171044,1.570891,252,15,1564,1296,268,0.828645,0.171355,1.56302,253,15,1, merged,1,1,0.000130894871071
35191,1000023,3,508,447,61,0.879921,0.120079,2.442941,58,3,509,448,61,0.880157,0.119843,2.451335,58,3,1, merged,0,0,0.000285317283638
35191,1000121,2,1564,1296,268,0.828645,0.171355,1.56302,253,15,1565,1297,268,0.828754,0.171246,1.571178,253,15,1, merged,0,0,0.000413900771959
35195,1000023,3,509,448,61,0.880157,0.119843,2.451335,58,3,510,449,61,0.880392,0.119608,2.459256,58,3,1, merged,0,0,0.000721598821073
35195,1000121,2,1565,1297,268,0.828754,0.171246,1.571178,253,15,1566,1298,268,0.828863,0.171137,1.578863,253,15,1, merged,0,0,0.000492663234619
35197,1000007,2,1142,923,219,0.808231,0.191769,1.540374,194,25,1143,923,220,0.807524,0.192476,1.535335,195,25,1, merged,1,1,0.23813841183
35197,1000534,1,168,123,45,0.732143,0.267857,0.732143,43,2,169,123,46,0.727811,0.272189,0.727811,44,2,1, merged,1,1,0.219962075129
35206,1000120,2,1024,865,159,0.844727,0.155273,1.844727,140,19,1025,866,159,0.844878,0.155122,1.844878,140,19,1, merged,0,0,0
35207,1000015,2,1601,1440,161,0.899438,0.100562,1.813612,149,12,1602,1441,161,0.899501,0.100499,1.813898,149,12,1, merged,0,0,0.129784743734
35207,1000153,1,769,703,66,0.914174,0.085826,0.914174,52,14,771,705,66,0.914397,0.085603,0.914397,52,14,-1, merged,0,0,0.138908213753
35215,1000121,2,1566,1298,268,0.828863,0.171137,1.432522,253,15,1568,1300,268,0.829082,0.170918,1.435142,253,15,1, merged,0,0,0.0226756253773
35216,1000108,1,60,49,11,0.816667,0.183333,0.816667,7,4,61,49,12,0.803279,0.196721,0.803279,8,4,1, abandoned,1,1,0.109914407989
35216,1002169,2,279,159,120,0.569892,0.430108,1.386559,118,2,280,159,121,0.567857,0.432143,1.371136,119,2,1, abandoned,1,1,0
35218,1000023,3,510,449,61,0.880392,0.119608,2.459474,58,3,511,450,61,0.880626,0.119374,2.463021,58,3,1, merged,0,0,0.00033819426764
35218,1000121,2,1568,1300,268,0.829082,0.170918,1.579082,253,15,1571,1302,269,0.828771,0.171229,1.582395,254,15,1, merged,1,1,0.000384664399799
35219,1000023,3,511,450,61,0.880626,0.119374,2.463021,58,3,512,451,61,0.880859,0.119141,2.466883,58,3,1, merged,0,0,0.00460466194114
35219,1000121,2,1571,1302,269,0.828771,0.171229,1.582395,254,15,1572,1303,269,0.82888,0.17112,1.586023,254,15,1, merged,0,0,0.0029404948776
35220,1000012,1,407,354,53,0.869779,0.130221,0.869779,52,1,408,355,53,0.870098,0.129902,0.870098,52,1,1, merged,0,0,0.758734821778
35221,1000004,2,2515,2236,279,0.889066,0.110934,1.410805,217,62,2518,2239,279,0.889198,0.110802,1.430864,217,62,-1, merged,0,0,0.0363792313639
35222,1000004,2,2518,2239,279,0.889198,0.110802,1.661961,217,62,2520,2241,279,0.889286,0.110714,1.661741,217,62,-1, merged,0,0,0.0574256543861
35222,1000329,1,2504,1935,569,0.772764,0.227236,0.772764,501,68,2505,1935,570,0.772455,0.227545,0.772455,502,68,1, merged,1,1,0.0718180482069
35223,1000120,2,1025,866,159,0.844878,0.155122,1.729493,140,19,1026,867,159,0.845029,0.154971,1.730525,140,19,1, merged,0,0,0.372187958375
35224,1000023,1,512,451,61,0.880859,0.119141,0.880859,58,3,513,452,61,0.881092,0.118908,0.881092,58,3,1, merged,0,0,0.00594434574961
35224,1000121,2,1572,1303,269,0.82888,0.17112,1.70974,254,15,1573,1304,269,0.828989,0.171011,1.710081,254,15,1, merged,0,0,0.00378760946765
35225,1000023,2,513,452,61,0.881092,0.118908,1.638234,58,3,516,455,61,0.881783,0.118217,1.645672,58,3,-1, merged,0,0,0.0359232075345
35227,1000023,2,516,455,61,0.881783,0.118217,1.645672,58,3,517,456,61,0.882012,0.117988,1.649135,58,3,1, merged,0,0,0.000192880596845
35227,1000121,3,1573,1304,269,0.828989,0.171011,2.474661,254,15,1574,1305,269,0.829098,0.170902,2.478233,254,15,1, merged,0,0,0.000307955179376
35228,1000004,2,2520,2241,279,0.889286,0.110714,1.771297,217,62,2521,2242,279,0.88933,0.11067,1.771569,217,62,1, merged,0,0,0.0628476868788
35228,1000023,1,517,456,61,0.882012,0.117988,0.882012,58,3,518,457,61,0.882239,0.117761,0.882239,58,3,1, merged,0,0,0.17943692588
35233,1000063,2,2348,2097,251,0.893101,0.106899,1.660224,210,41,2349,2098,251,0.893146,0.106854,1.663416,210,41,1, merged,0,0,0.175493814766
35236,1000140,1,55,44,11,0.8,0.2,0.8,10,1,57,46,11,0.807018,0.192982,0.807018,10,1,-1, abandoned,0,0,0
35236,1000329,2,2505,1935,570,0.772455,0.227545,1.572455,502,68,2506,1936,570,0.772546,0.227454,1.579563,502,68,-1, abandoned,0,0,0.0259331508764
35238,1000140,1,57,46,11,0.807018,0.192982,0.807018,10,1,58,47,11,0.810345,0.189655,0.810345,10,1,-1, merged,0,0,0.0919858882896
35246,1000054,1,170,147,23,0.864706,0.135294,0.864706,17,6,171,148,23,0.865497,0.134503,0.865497,17,6,1, merged,0,0,0.106391122733
35246,1000166,3,242,194,48,0.801653,0.198347,2.234216,45,3,243,195,48,0.802469,0.197531,2.237361,45,3,1, merged,0,0,0.0777062304239
35246,1002169,2,280,159,121,0.567857,0.432143,1.432563,119,2,281,160,121,0.569395,0.430605,1.434892,119,2,1, merged,0,0,0
35248,1000011,1,526,488,38,0.927757,0.072243,0.927757,35,3,527,489,38,0.927894,0.072106,0.927894,35,3,1, merged,0,0,0.61335856647
35248,1000120,2,1026,867,159,0.845029,0.154971,1.772786,140,19,1027,868,159,0.84518,0.15482,1.773074,140,19,1, merged,0,0,0.46286268264
35250,1000011,1,528,490,38,0.92803,0.07197,0.92803,35,3,529,491,38,0.928166,0.071834,0.928166,35,3,1, merged,0,0,0.615254599658
35250,1000120,2,1027,868,159,0.84518,0.15482,1.77321,140,19,1028,869,159,0.845331,0.154669,1.773497,140,19,1, merged,0,0,0.468660209847
35255,1000011,1,533,495,38,0.928705,0.071295,0.928705,35,3,534,496,38,0.928839,0.071161,0.928839,35,3,1, merged,0,0,0.00703113991286
35255,1000120,2,1028,869,159,0.845331,0.154669,1.774036,140,19,1029,870,159,0.845481,0.154519,1.77432,140,19,1, merged,0,0,0.0195707451516
35256,1000011,1,534,496,38,0.928839,0.071161,0.928839,35,3,535,497,38,0.928972,0.071028,0.928972,35,3,1, merged,0,0,0.61806707458
35256,1000120,2,1029,870,159,0.845481,0.154519,1.77432,140,19,1030,871,159,0.845631,0.154369,1.774603,140,19,1, merged,0,0,0.47296135615
35258,1000043,2,368,303,65,0.82337,0.17663,1.365036,56,9,369,304,65,0.823848,0.176152,1.383848,56,9,1, merged,0,0,0.542276971985
35259,1000043,2,369,304,65,0.823848,0.176152,1.383848,56,9,370,305,65,0.824324,0.175676,1.401247,56,9,1, merged,0,0,0.535373298374
35259,1000070,3,904,794,110,0.878319,0.121681,2.262167,93,17,905,795,110,0.878453,0.121547,2.2797,93,17,1, merged,0,0,0.607819018846
35262,1000328,1,767,558,209,0.72751,0.27249,0.72751,186,23,768,559,209,0.727865,0.272135,0.727865,186,23,1, merged,0,0,0.265974554379
35264,1000005,3,257,200,57,0.77821,0.22179,2.272911,52,5,258,201,57,0.77907,0.22093,2.26879,52,5,1, merged,0,0,0.448999787941
35267,1000328,2,769,560,209,0.728218,0.271782,1.500855,186,23,770,561,209,0.728571,0.271429,1.501389,186,23,1, merged,0,0,0.626851941408
35267,1000329,1,2507,1937,570,0.772637,0.227363,0.772637,502,68,2509,1939,570,0.772818,0.227182,0.772818,502,68,-1, merged,0,0,0.633874605854
35269,1000328,2,770,561,209,0.728571,0.271429,1.501661,186,23,773,562,211,0.727038,0.272962,1.500307,188,23,1, abandoned,1,1,0.313990268419
35269,1000329,1,2512,1942,570,0.773089,0.226911,0.773089,502,68,2514,1944,570,0.77327,0.22673,0.77327,502,68,-1, abandoned,0,0,0.317082407791
35269,1002169,3,281,160,121,0.569395,0.430605,2.071056,119,2,283,162,121,0.572438,0.427562,2.072745,119,2,-1, abandoned,0,0,0
35276,1000063,2,2349,2098,251,0.893146,0.106854,1.644036,210,41,2351,2099,252,0.892812,0.107188,1.641928,211,41,-1, merged,1,0,0.323805552323
35279,1000011,1,536,498,38,0.929104,0.070896,0.929104,35,3,537,499,38,0.929236,0.070764,0.929236,35,3,1, merged,0,0,0.874818013842
35279,1000015,2,1602,1441,161,0.899501,0.100499,1.828605,149,12,1603,1442,161,0.899563,0.100437,1.8288,149,12,1, merged,0,0,0.894888306674
35282,1000534,1,169,123,46,0.727811,0.272189,0.727811,44,2,171,125,46,0.730994,0.269006,0.730994,44,2,1, merged,0,0,1.10949087057
35288,1000054,3,172,149,23,0.866279,0.133721,2.2317,17,6,173,150,23,0.867052,0.132948,2.231181,17,6,-1, abandoned,0,0,0.0613372310996
35288,1002169,1,283,162,121,0.572438,0.427562,0.572438,119,2,284,162,122,0.570423,0.429577,0.570423,120,2,1, abandoned,1,1,0
35290,1000327,1,624,488,136,0.782051,0.217949,0.782051,105,31,625,489,136,0.7824,0.2176,0.7824,105,31,-1, merged,0,0,0.349017935737
35290,1000329,3,2514,1944,570,0.77327,0.22673,2.271537,502,68,2515,1945,570,0.77336,0.22664,2.273881,502,68,1, merged,0,0,0.344000210421
35295,1000014,2,1662,1415,247,0.851384,0.148616,1.73688,228,19,1663,1416,247,0.851473,0.148527,1.738691,228,19,1, merged,0,0,0.58612220617
35297,1000014,3,1663,1416,247,0.851473,0.148527,2.738691,228,19,1666,1417,249,0.85054,0.14946,2.599614,230,19,1, merged,1,1,0.586113668229
35298,1000023,1,520,459,61,0.882692,0.117308,0.882692,58,3,522,461,61,0.883142,0.116858,0.883142,58,3,-1, merged,0,0,0.0299248495364
35298,1000121,2,1575,1306,269,0.829206,0.170794,1.711899,254,15,1576,1307,269,0.829315,0.170685,1.712456,254,15,1, merged,0,0,0.0191532745696
35299,1000015,1,1603,1442,161,0.899563,0.100437,0.899563,149,12,1604,1442,162,0.899002,0.100998,0.899002,150,12,1, merged,1,1,0.00279967532162
35299,1000534,2,171,125,46,0.730994,0.269006,1.630557,44,2,173,126,47,0.728324,0.271676,1.627326,45,2,1, merged,1,1,0.00204450061687
35300,1000023,1,522,461,61,0.883142,0.116858,0.883142,58,3,523,462,61,0.883365,0.116635,0.883365,58,3,1, merged,0,0,0.00881753157395
35300,1000121,2,1576,1307,269,0.829315,0.170685,1.712456,254,15,1577,1308,269,0.829423,0.170577,1.712788,254,15,1, merged,0,0,0.00627946099011
35301,1000023,1,523,462,61,0.883365,0.116635,0.883365,58,3,524,463,61,0.883588,0.116412,0.883588,58,3,1, merged,0,0,0
35301,1000121,2,1577,1308,269,0.829423,0.170577,1.712788,254,15,1578,1309,269,0.829531,0.170469,1.713119,254,15,1, merged,0,0,0
35302,1000011,2,537,499,38,0.929236,0.070764,1.843744,35,3,538,500,38,0.929368,0.070632,1.843986,35,3,1, merged,0,0,0.0162876254181
35302,1000120,3,1030,871,159,0.845631,0.154369,2.689375,140,19,1031,872,159,0.845781,0.154219,2.689767,140,19,1, merged,0,0,0.108113936974
35302,1000153,1,772,706,66,0.914508,0.085492,0.914508,52,14,773,707,66,0.914618,0.085382,0.914618,52,14,1, merged,0,0,0.037750640041
35303,1000011,2,538,500,38,0.929368,0.070632,1.775149,35,3,539,501,38,0.929499,0.070501,1.775727,35,3,1, merged,0,0,0.00928008218412
35303,1000120,1,1031,872,159,0.845781,0.154219,0.845781,140,19,1034,875,159,0.846228,0.153772,0.846228,140,19,-1, merged,0,0,0.0583857752921
35304,1000121,1,1578,1309,269,0.829531,0.170469,0.829531,254,15,1580,1311,269,0.829747,0.170253,0.829747,254,15,-1, merged,0,0,0.183108094914
35309,1000011,1,539,501,38,0.929499,0.070501,0.929499,35,3,540,501,39,0.927778,0.072222,0.927778,36,3,1, merged,1,1,0.622285961017
35309,1000120,2,1034,875,159,0.846228,0.153772,1.775727,140,19,1035,876,159,0.846377,0.153623,1.774155,140,19,1, merged,0,0,0.47374879692
35318,1000121,3,1582,1313,269,0.829962,0.170038,1.600232,254,15,1583,1314,269,0.830069,0.169931,2.106385,254,15,1, merged,0,0,0.0232059820797
35322,1000109,1,375,316,59,0.842667,0.157333,0.842667,56,3,376,317,59,0.843085,0.156915,0.843085,56,3,1, merged,0,0,0
35324,1000328,1,775,564,211,0.727742,0.272258,0.727742,188,23,776,565,211,0.728093,0.271907,0.728093,188,23,1, merged,0,0,0.149866356954
35324,1000329,2,2516,1946,570,0.77345,0.22655,1.501192,502,68,2517,1947,570,0.77354,0.22646,1.501633,502,68,1, merged,0,0,0.0850287771356
35341,1000011,2,541,502,39,0.927911,0.072089,1.774436,36,3,542,503,39,0.928044,0.071956,1.774717,36,3,1, merged,0,0,0.309988291858
35341,1000120,1,1036,877,159,0.846525,0.153475,0.846525,140,19,1037,878,159,0.846673,0.153327,0.846673,140,19,-1, merged,0,0,0.239703126825
35348,1000120,2,1037,878,159,0.846673,0.153327,1.574997,140,19,1039,880,159,0.846968,0.153032,1.576853,140,19,-1, merged,0,0,0.0567352288387
35348,1000534,1,173,126,47,0.728324,0.271676,0.728324,45,2,174,127,47,0.729885,0.270115,0.729885,45,2,-1, merged,0,0,0.0195653621388
35353,1000140,2,58,47,11,0.810345,0.189655,1.593291,10,1,59,48,11,0.813559,0.186441,1.599819,10,1,1, merged,0,0,0.0194225437148
35353,1000329,3,2517,1947,570,0.77354,0.22646,2.36683,502,68,2518,1948,570,0.77363,0.22637,2.373449,502,68,1, merged,0,0,0.0610120126682
35354,1000140,1,59,48,11,0.813559,0.186441,0.813559,10,1,61,50,11,0.819672,0.180328,0.819672,10,1,1, merged,0,0,0.106725985457
35354,1000329,2,2518,1948,570,0.77363,0.22637,1.587189,502,68,2519,1949,570,0.77372,0.22628,1.593392,502,68,1, merged,0,0,0.670874297963
35355,1000166,2,264,216,48,0.818182,0.181818,1.611888,45,3,265,217,48,0.818868,0.181132,1.607062,45,3,1, merged,0,0,0.923476802683
35356,1000063,3,2352,2100,252,0.892857,0.107143,2.562378,211,41,2353,2101,252,0.892903,0.107097,2.565575,211,41,1, merged,0,0,0.32362107986
35357,1000063,3,2353,2101,252,0.892903,0.107097,2.565575,211,41,2354,2102,252,0.892948,0.107052,2.566282,211,41,1, merged,0,0,0.323654567854
35362,1000063,3,2354,2102,252,0.892948,0.107052,2.566282,211,41,2355,2103,252,0.892994,0.107006,2.489485,211,41,-1, merged,0,0,0.323688055237
35362,1000592,4,508,428,80,0.84252,0.15748,3.408801,49,31,509,429,80,0.842829,0.157171,3.332314,49,31,1, merged,0,0,0.603747481771
35368,1000004,1,2524,2245,279,0.889461,0.110539,0.889461,217,62,2525,2246,279,0.889505,0.110495,0.889505,217,62,-1, merged,0,0,0
35368,1000120,3,1040,881,159,0.847115,0.152885,2.389059,140,19,1041,882,159,0.847262,0.152738,2.39411,140,19,1, merged,0,0,0
35369,1000070,3,905,795,110,0.878453,0.121547,2.228587,93,17,906,796,110,0.878587,0.121413,2.202646,93,17,1, merged,0,0,0.804107880053
35379,1000003,3,918,769,149,0.837691,0.162309,2.219627,134,15,919,770,149,0.837867,0.162133,2.21274,134,15,-1, merged,0,0,0
35379,1000329,2,2521,1950,571,0.773503,0.226497,1.381936,503,68,2523,1952,571,0.773682,0.226318,1.374873,503,68,-1, merged,0,0,0
35382,1000327,2,626,490,136,0.782748,0.217252,0.782748,105,31,627,491,136,0.783094,0.216906,1.783094,105,31,1, merged,0,0,0
35387,1000120,2,1043,883,160,0.846596,0.153404,1.506974,141,19,1044,884,160,0.846743,0.153257,1.51341,141,19,1, merged,0,0,0.364806565466
35394,1000004,3,2525,2246,279,0.889505,0.110495,2.50993,217,62,2527,2248,279,0.889592,0.110408,2.509048,217,62,-1, merged,0,0,0
35394,1000120,2,1044,884,160,0.846743,0.153257,1.620425,141,19,1046,885,161,0.84608,0.15392,1.619456,142,19,1, merged,1,1,0
35394,1000329,1,2523,1952,571,0.773682,0.226318,0.773682,503,68,2524,1952,572,0.773376,0.226624,0.773376,504,68,1, merged,1,1,0
35400,1000015,2,1608,1446,162,0.899254,0.100746,1.783504,150,12,1609,1447,162,0.899316,0.100684,1.783786,150,12,1, merged,0,0,0.562542462325
35400,1000023,1,527,466,61,0.88425,0.11575,0.88425,58,3,528,467,61,0.88447,0.11553,0.88447,58,3,1, merged,0,0,0.24152813644
35414,1000120,2,1048,887,161,0.846374,0.153626,1.61975,142,19,1049,888,161,0.84652,0.15348,1.619986,142,19,1, merged,0,0,0.0412173496286
35414,1000329,1,2524,1952,572,0.773376,0.226624,0.773376,504,68,2525,1953,572,0.773465,0.226535,0.773465,504,68,1, merged,0,0,0.0231594438635
35416,1000023,2,528,467,61,0.88447,0.11553,1.657935,58,3,529,468,61,0.884688,0.115312,1.658243,58,3,1, merged,0,0,0.117808563751
35416,1000329,1,2525,1953,572,0.773465,0.226535,0.773465,504,68,2526,1954,572,0.773555,0.226445,0.773555,504,68,1, merged,0,0,0.221473405103
35421,1000023,1,529,468,61,0.884688,0.115312,0.884688,58,3,530,469,61,0.884906,0.115094,0.884906,58,3,1, merged,0,0,0.000811100489557
35421,1000121,2,1585,1316,269,0.830284,0.169716,1.714972,254,15,1586,1317,269,0.830391,0.169609,1.715297,254,15,1, merged,0,0,0.00464459438255
35424,1000121,2,1587,1318,269,0.830498,0.169502,1.600926,254,15,1588,1319,269,0.830605,0.169395,1.601922,254,15,1, merged,0,0,0.490447313014
35426,1000327,1,627,491,136,0.783094,0.216906,0.783094,105,31,628,492,136,0.783439,0.216561,0.783439,105,31,1, merged,0,0,0.569909598821
35429,1000023,2,531,470,61,0.885122,0.114878,1.778116,58,3,532,471,61,0.885338,0.114662,1.778377,58,3,1, merged,0,0,0.188888696255
35429,1000063,1,2355,2103,252,0.892994,0.107006,0.892994,211,41,2356,2104,252,0.893039,0.106961,0.893039,211,41,1, merged,0,0,0.176725586972
35431,1000329,2,2526,1954,572,0.773555,0.226445,1.549489,504,68,2527,1955,572,0.773645,0.226355,1.551422,504,68,1, merged,0,0,0.0866463118402
35440,1000023,2,532,471,61,0.885338,0.114662,1.661654,58,3,533,472,61,0.885553,0.114447,1.664774,58,3,1, merged,0,0,0.000147264622104
35440,1000121,3,1590,1321,269,0.830818,0.169182,2.492472,254,15,1591,1322,269,0.830924,0.169076,2.495698,254,15,1, merged,0,0,0.000224626891422
35441,1000121,2,1591,1322,269,0.830924,0.169076,1.610145,254,15,1592,1323,269,0.83103,0.16897,1.613081,254,15,1, merged,0,0,0.000183114722127
35442,1000023,2,533,472,61,0.885553,0.114447,1.667605,58,3,534,473,61,0.885768,0.114232,1.670578,58,3,1, merged,0,0,0.000189414891451
35442,1000121,3,1592,1323,269,0.83103,0.16897,2.498635,254,15,1593,1324,269,0.831136,0.168864,2.501714,254,15,1, merged,0,0,0.000129263451905
35443,1000023,2,534,473,61,0.885768,0.114232,1.670578,58,3,535,474,61,0.885981,0.114019,1.673481,58,3,1, merged,0,0,0.0177388861805
35443,1000121,3,1593,1324,269,0.831136,0.168864,2.501714,254,15,1594,1325,269,0.831242,0.168758,2.504723,254,15,1, merged,0,0,0.011439682087
35444,1000023,2,535,474,61,0.885981,0.114019,1.673481,58,3,536,475,61,0.886194,0.113806,1.676317,58,3,1, merged,0,0,0.000257918796472
35444,1000121,3,1594,1325,269,0.831242,0.168758,2.504723,254,15,1595,1326,269,0.831348,0.168652,2.507665,254,15,1, merged,0,0,0.00017581161258
35445,1000023,2,536,475,61,0.886194,0.113806,1.676317,58,3,537,476,61,0.886406,0.113594,1.679089,58,3,1, merged,0,0,0.00260963730936
35446,1000023,2,537,476,61,0.886406,0.113594,1.679089,58,3,538,477,61,0.886617,0.113383,1.681798,58,3,1, merged,0,0,2.66579229113e-05
35446,1000121,3,1595,1326,269,0.831348,0.168652,2.510437,254,15,1596,1327,269,0.831454,0.168546,2.513251,254,15,1, merged,0,0,4.224438874e-05
35447,1000023,2,538,477,61,0.886617,0.113383,1.681798,58,3,539,478,61,0.886827,0.113173,1.684447,58,3,1, merged,0,0,0.000578997227458
35447,1000121,3,1596,1327,269,0.831454,0.168546,2.513251,254,15,1597,1328,269,0.831559,0.168441,2.516006,254,15,1, merged,0,0,0.000412098283821
35448,1000023,3,539,478,61,0.886827,0.113173,2.285637,58,3,540,479,61,0.887037,0.112963,2.290587,58,3,1, merged,0,0,0.000590140650902
35449,1000121,2,1597,1328,269,0.831559,0.168441,1.631559,254,15,1598,1329,269,0.831665,0.168335,1.63399,254,15,1, merged,0,0,0.00129034225287
35450,1000023,2,540,479,61,0.887037,0.112963,1.689363,58,3,541,480,61,0.887246,0.112754,1.691844,58,3,1, merged,0,0,0.00132625535071
35450,1000121,3,1598,1329,269,0.831665,0.168335,2.521027,254,15,1599,1330,269,0.83177,0.16823,2.523613,254,15,1, merged,0,0,0.000847514343776
35451,1000023,2,541,480,61,0.887246,0.112754,1.691844,58,3,542,481,61,0.887454,0.112546,1.694272,58,3,1, merged,0,0,0.000330746475105
35451,1000121,3,1599,1330,269,0.83177,0.16823,2.523613,254,15,1600,1331,269,0.831875,0.168125,2.526147,254,15,1, merged,0,0,0.000216474375073
35452,1000121,2,1600,1331,269,0.831875,0.168125,1.638693,254,15,1601,1332,269,0.83198,0.16802,1.640969,254,15,1, merged,0,0,0.000400310898391
35455,1000023,2,543,482,61,0.887661,0.112339,1.69665,58,3,545,484,61,0.888073,0.111927,1.688073,58,3,-1, merged,0,0,0.00168373944711
35456,1000023,2,545,484,61,0.888073,0.111927,1.688073,58,3,546,485,61,0.888278,0.111722,1.690476,58,3,1, merged,0,0,0.000630561763671
35463,1000070,2,906,796,110,0.878587,0.121413,1.710672,93,17,907,797,110,0.878721,0.121279,1.710911,93,17,1, merged,0,0,0.388316621037
35463,1000121,1,1602,1333,269,0.832085,0.167915,0.832085,254,15,1603,1334,269,0.83219,0.16781,0.83219,254,15,1, merged,0,0,0.232740181006
35470,1000007,1,1144,924,220,0.807692,0.192308,0.807692,195,25,1145,925,220,0.80786,0.19214,0.80786,195,25,1, merged,0,0,0.397517887352
35474,1000130,1,301,254,47,0.843854,0.156146,0.843854,37,10,303,256,47,0.844884,0.155116,0.844884,37,10,-1, merged,0,0,0
35475,1000130,1,303,256,47,0.844884,0.155116,0.844884,37,10,305,258,47,0.845902,0.154098,0.845902,37,10,-1, merged,0,0,0
35482,1000592,2,513,433,80,0.844055,0.155945,1.417481,49,31,514,434,80,0.844358,0.155642,1.417275,49,31,1, merged,0,0,0.539649692838
35482,1002169,1,286,164,122,0.573427,0.426573,0.573427,120,2,288,165,123,0.572917,0.427083,0.572917,121,2,1, merged,1,1,0
35487,1000023,1,546,485,61,0.888278,0.111722,0.888278,58,3,548,486,62,0.886861,0.113139,0.886861,59,3,1, merged,1,1,0.356512111359
35490,1000070,1,907,797,110,0.878721,0.121279,0.878721,93,17,909,798,111,0.877888,0.122112,0.877888,94,17,1, merged,1,1,0.148831969575
35495,1000004,1,2529,2250,279,0.88968,0.11032,0.88968,217,62,2535,2254,281,0.889152,0.110848,0.889152,219,62,-1, merged,1,0,0
35495,1000121,2,1604,1335,269,0.832294,0.167706,1.721974,254,15,1606,1335,271,0.831258,0.168742,1.72041,256,15,1, merged,1,1,0
35496,1000023,2,548,486,62,0.886861,0.113139,1.689059,59,3,549,487,62,0.887067,0.112933,1.691415,59,3,1, merged,0,0,0.0122201622387
35496,1000121,3,1606,1335,271,0.831258,0.168742,2.520317,256,15,1608,1337,271,0.831468,0.168532,2.522883,256,15,1, merged,0,0,0.0158952433242
35502,1000327,1,628,492,136,0.783439,0.216561,0.783439,105,31,629,493,136,0.783784,0.216216,0.783784,105,31,1, merged,0,0,0.238599668
35505,1000004,2,2535,2254,281,0.889152,0.110848,1.672936,219,62,2536,2255,281,0.889196,0.110804,1.673323,219,62,1, merged,0,0,0.410473594486
35505,1000327,1,629,493,136,0.783784,0.216216,0.783784,105,31,630,494,136,0.784127,0.215873,0.784127,105,31,-1, merged,0,0,0.572849014979
35509,1000070,1,909,798,111,0.877888,0.122112,0.877888,94,17,910,799,111,0.878022,0.121978,0.878022,94,17,1, merged,0,0,0.803937221556
35510,1000130,2,305,258,47,0.845902,0.154098,1.66477,37,10,306,259,47,0.846405,0.153595,1.665954,37,10,1, merged,0,0,0.492045252884
35510,1000166,1,265,217,48,0.818868,0.181132,0.818868,45,3,266,218,48,0.819549,0.180451,0.819549,45,3,1, merged,0,0,0.935726118167
35513,1000054,3,177,153,24,0.864407,0.135593,2.419962,17,7,179,155,24,0.865922,0.134078,2.28735,17,7,-1, merged,0,0,0.0038371930175
35516,1000121,3,1608,1337,271,0.831468,0.168532,2.476128,256,15,1609,1338,271,0.831572,0.168428,2.472673,256,15,1, merged,0,0,6.14631072412e-05
35516,1000592,1,515,435,80,0.84466,0.15534,0.84466,49,31,516,435,81,0.843023,0.156977,0.843023,50,31,1, merged,1,1,9.46598733433e-05
35518,1000329,1,2531,1958,573,0.773607,0.226393,0.773607,505,68,2532,1959,573,0.773697,0.226303,0.773697,505,68,1, merged,0,0,0.615450290924
35518,1000592,2,516,435,81,0.843023,0.156977,1.616631,50,31,517,436,81,0.843327,0.156673,1.617024,50,31,1, merged,0,0,0.617489209007
35519,1000015,2,1612,1450,162,0.899504,0.100496,1.828075,150,12,1613,1450,163,0.898946,0.101054,1.830764,151,12,1, merged,1,1,0
35521,1000121,1,1610,1338,272,0.831056,0.168944,0.831056,257,15,1612,1339,273,0.830645,0.169355,0.830645,258,15,-1, merged,1,0,0.00215230874765
35522,1000012,1,417,362,55,0.868106,0.131894,0.868106,54,1,419,363,56,0.866348,0.133652,0.866348,54,2,-1, merged,1,0,0.162873353028
35524,1000327,3,630,494,136,0.784127,0.215873,2.04502,105,31,631,495,136,0.784469,0.215531,2.046531,105,31,1, merged,0,0,0.0621101313193
35528,1000023,2,549,487,62,0.887067,0.112933,1.717818,59,3,550,488,62,0.887273,0.112727,1.717613,59,3,-1, abandoned,0,0,0
35528,1000121,1,1613,1340,273,0.83075,0.16925,0.83075,258,15,1615,1341,274,0.830341,0.169659,0.830341,259,15,-1, abandoned,1,0,0
35532,1000007,2,1149,929,220,0.808529,0.191471,1.707475,195,25,1151,931,220,0.808862,0.191138,1.707251,195,25,-1, merged,0,0,1.10864441441
35532,1000015,1,1613,1450,163,0.898946,0.101054,0.898946,151,12,1614,1450,164,0.898389,0.101611,0.898389,152,12,1, merged,1,1,0.893256341713
35537,1000121,1,1615,1341,274,0.830341,0.169659,0.830341,259,15,1616,1342,274,0.830446,0.169554,0.830446,259,15,1, merged,0,0,0.0248259644581
35543,1000007,2,1153,932,221,0.808326,0.191674,1.721986,196,25,1154,933,221,0.808492,0.191508,1.722374,196,25,1, merged,0,0,0.357079738501
35543,1000153,1,776,709,67,0.91366,0.08634,0.91366,52,15,778,711,67,0.913882,0.086118,0.913882,52,15,-1, merged,0,0,0.346161258146
35557,1000043,1,371,306,65,0.824798,0.175202,0.824798,56,9,373,307,66,0.823056,0.176944,0.823056,57,9,1, merged,1,1,0.174924491505
35557,1000070,2,910,799,111,0.878022,0.121978,1.70282,94,17,912,801,111,0.878289,0.121711,1.701346,94,17,-1, merged,0,0,0.155798300253
35565,1000063,1,2358,2105,253,0.892706,0.107294,0.892706,212,41,2359,2106,253,0.892751,0.107249,0.892751,212,41,1, merged,0,0,0.00765384125366
35565,1000592,2,517,436,81,0.843327,0.156673,1.736033,50,31,518,437,81,0.843629,0.156371,1.736381,50,31,1, merged,0,0,0.127082575482
35570,1000063,1,2359,2106,253,0.892751,0.107249,0.892751,212,41,2360,2107,253,0.892797,0.107203,0.892797,212,41,1, merged,0,0,0.331417671216
35570,1000592,2,518,437,81,0.843629,0.156371,1.736381,50,31,519,438,81,0.843931,0.156069,1.736727,50,31,1, merged,0,0,0.401378354978
35571,1000592,2,519,438,81,0.843931,0.156069,1.443931,50,31,520,439,81,0.844231,0.155769,1.469231,50,31,1, merged,0,0,0.0786077789895
35572,1000023,1,552,490,62,0.887681,0.112319,0.887681,59,3,553,491,62,0.887884,0.112116,0.887884,59,3,1, merged,0,0,0.000470483683364
35572,1000063,2,2360,2107,253,0.892797,0.107203,1.780478,212,41,2361,2108,253,0.892842,0.107158,1.780726,212,41,1, merged,0,0,0.00192923704135
35573,1000592,1,520,439,81,0.844231,0.155769,0.844231,50,31,521,440,81,0.84453,0.15547,0.84453,50,31,1, merged,0,0,0.113396959345
35576,1000120,2,1050,889,161,0.846667,0.153333,1.626259,142,19,1051,889,162,0.845861,0.154139,1.624087,143,19,1, abandoned,1,1,0
35583,1000070,1,912,801,111,0.878289,0.121711,0.878289,94,17,913,802,111,0.878423,0.121577,0.878423,94,17,1, merged,0,0,0.428317920332
35583,1000132,2,263,233,30,0.885932,0.114068,1.764221,23,7,264,234,30,0.886364,0.113636,1.764786,23,7,1, merged,0,0,0.438289726897
35585,1000121,2,1619,1344,275,0.830142,0.169858,1.645932,260,15,1620,1345,275,0.830247,0.169753,1.648429,260,15,1, merged,0,0,0
35593,1000109,2,378,319,59,0.843915,0.156085,1.757797,56,3,379,319,60,0.841689,0.158311,1.755681,57,3,1, merged,1,1,0.0746000503546
35593,1000153,1,778,711,67,0.913882,0.086118,0.913882,52,15,779,712,67,0.913992,0.086008,0.913992,52,15,-1, merged,0,0,0.297696176733
35594,1000023,2,553,491,62,0.887884,0.112116,1.70878,59,3,554,492,62,0.888087,0.111913,1.709648,59,3,1, merged,0,0,0.0189646599353
35594,1000166,1,268,220,48,0.820896,0.179104,0.820896,45,3,269,221,48,0.821561,0.178439,0.821561,45,3,1, merged,0,0,0.135834929572
35609,1000023,1,557,495,62,0.888689,0.111311,0.888689,59,3,561,497,64,0.885918,0.114082,0.885918,61,3,1, merged,1,1,1.70622800747e-06
35609,1000121,2,1620,1345,275,0.830247,0.169753,1.718936,260,15,1621,1346,275,0.830352,0.169648,1.71627,260,15,1, merged,0,0,2.4805595079e-06
35610,1000005,2,261,204,57,0.781609,0.218391,1.667527,52,5,262,205,57,0.782443,0.217557,1.668564,52,5,1, merged,0,0,0.0646695197337
35610,1000023,1,561,497,64,0.885918,0.114082,0.885918,61,3,562,498,64,0.886121,0.113879,0.886121,61,3,1, merged,0,0,0.00013596501167
35611,1000108,1,64,52,12,0.8125,0.1875,0.8125,8,4,65,52,13,0.8,0.2,0.8,9,4,1, merged,1,1,0.0934591194969
35611,1000110,3,60,51,9,0.85,0.15,2.6225,8,1,61,52,9,0.852459,0.147541,2.593635,8,1,1, merged,0,0,0.248805031447
35614,1000012,1,421,365,56,0.866983,0.133017,0.866983,54,2,422,366,56,0.867299,0.132701,0.867299,54,2,-1, abandoned,0,0,0.890172925539
35615,1000329,2,2532,1959,573,0.773697,0.226303,1.540614,505,68,2533,1960,573,0.773786,0.226214,1.539955,505,68,1, merged,0,0,0.639289543125
35616,1000003,2,919,770,149,0.837867,0.162133,1.611653,134,15,920,771,149,0.838043,0.161957,1.612008,134,15,-1, abandoned,0,0,0
35616,1000329,1,2533,1960,573,0.773786,0.226214,0.773786,505,68,2535,1962,573,0.773964,0.226036,0.773964,505,68,-1, abandoned,0,0,0
35617,1000121,2,1621,1346,275,0.830352,0.169648,1.673863,260,15,1622,1346,276,0.82984,0.17016,1.671744,261,15,1, abandoned,1,1,0.0112544527449
35617,1000592,1,524,442,82,0.843511,0.156489,0.843511,51,31,525,442,83,0.841905,0.158095,0.841905,52,31,1, abandoned,1,1,0
35622,1000015,2,1614,1450,164,0.898389,0.101611,1.737195,152,12,1615,1451,164,0.898452,0.101548,1.737738,152,12,1, merged,0,0,0.507982927608
35622,1000199,1,335,281,54,0.838806,0.161194,0.838806,49,5,336,282,54,0.839286,0.160714,0.839286,49,5,1, merged,0,0,0.0740535812986
35628,1000120,2,1051,889,162,0.845861,0.154139,1.61203,143,19,1052,890,162,0.846008,0.153992,1.610859,143,19,1, merged,0,0,0.145004099201
35632,1000121,1,1624,1347,277,0.829433,0.170567,0.829433,262,15,1625,1348,277,0.829538,0.170462,0.829538,262,15,1, merged,0,0,0.00773881020913
35635,1000124,3,638,590,48,0.924765,0.075235,2.417105,42,6,640,592,48,0.925,0.075,2.420238,42,6,1, merged,0,0,0.232756418848
35635,1000166,2,279,231,48,0.827957,0.172043,1.492341,45,3,280,232,48,0.828571,0.171429,1.495238,45,3,1, merged,0,0,0.188420340828
35638,1000592,1,526,443,83,0.842205,0.157795,0.842205,52,31,527,444,83,0.842505,0.157495,0.842505,52,31,1, merged,0,0,0.00345381700218
35649,1000054,2,180,156,24,0.866667,0.133333,1.866667,17,7,181,157,24,0.867403,0.132597,1.685585,17,7,-1, merged,0,0,0.0271188329183
35651,1000329,4,2536,1963,573,0.774054,0.225946,2.310223,505,68,2537,1964,573,0.774143,0.225857,3.309306,505,68,1, merged,0,0,0
35652,1000327,3,631,495,136,0.784469,0.215531,2.558612,105,31,632,496,136,0.78481,0.21519,2.059042,105,31,1, merged,0,0,0
35652,1000329,2,2537,1964,573,0.774143,0.225857,1.774143,505,68,2538,1965,573,0.774232,0.225768,1.274232,505,68,-1, merged,0,0,0
35653,1000063,2,2361,2108,253,0.892842,0.107158,1.72238,212,41,2363,2110,253,0.892933,0.107067,1.721961,212,41,-1, merged,0,0,0.000351860614664
35653,1000121,1,1625,1348,277,0.829538,0.170462,0.829538,262,15,1626,1348,278,0.829028,0.170972,0.829028,263,15,1, merged,1,1,5.78726031097e-05
35654,1000011,2,544,505,39,0.928309,0.071691,1.821166,36,3,545,506,39,0.92844,0.07156,1.819177,36,3,-1, merged,0,0,0.758843425436
35654,1000015,3,1615,1451,164,0.898452,0.101548,2.719618,152,12,1616,1452,164,0.898515,0.101485,2.717692,152,12,1, merged,0,0,0.668829967408
35655,1000153,2,780,713,67,0.914103,0.085897,1.648566,52,15,782,714,68,0.913043,0.086957,1.643381,53,15,1, merged,1,1,0.559065478429
35655,1000534,1,177,130,47,0.734463,0.265537,0.734463,45,2,178,130,48,0.730337,0.269663,0.730337,46,2,1, merged,1,1,0.562451477809
35657,1000063,1,2363,2110,253,0.892933,0.107067,0.892933,212,41,2364,2111,253,0.892978,0.107022,0.892978,212,41,-1, merged,0,0,0.000313073236978
35657,1000121,3,1626,1348,278,0.829028,0.170972,2.526309,263,15,1627,1349,278,0.829133,0.170867,2.528563,263,15,1, merged,0,0,1.68431191724e-05
35661,1000005,2,263,205,58,0.779468,0.220532,1.528584,53,5,264,206,58,0.780303,0.219697,1.530303,53,5,1, merged,0,0,0.456319029513
35662,1002169,3,288,165,123,0.572917,0.427083,2.118702,121,2,289,166,123,0.574394,0.425606,2.12929,121,2,-1, merged,0,0,0
35667,1000166,1,280,232,48,0.828571,0.171429,0.828571,45,3,283,234,49,0.826855,0.173145,0.826855,46,3,-1, merged,1,0,0.0922830583433
35674,1000023,2,562,498,64,0.886121,0.113879,1.675595,61,3,563,499,64,0.886323,0.113677,1.648228,61,3,1, merged,0,0,0.155642707049
35676,1000121,2,1628,1350,278,0.829238,0.170762,1.63569,263,15,1629,1351,278,0.829343,0.170657,1.637854,263,15,1, merged,0,0,0.00202938297628
35679,1000023,1,563,499,64,0.886323,0.113677,0.886323,61,3,564,499,65,0.884752,0.115248,0.884752,62,3,1, merged,1,1,0.361052972645
35679,1000063,2,2365,2112,253,0.893023,0.106977,1.779347,212,41,2367,2114,253,0.893114,0.106886,1.777865,212,41,-1, merged,0,0,0.364943381209
35682,1000120,2,1054,891,163,0.845351,0.154649,1.503069,144,19,1055,892,163,0.845498,0.154502,1.505498,144,19,1, merged,0,0,0.162071906126
35683,1000014,2,1667,1418,249,0.85063,0.14937,1.599759,230,19,1669,1420,249,0.850809,0.149191,1.598214,230,19,-1, merged,0,0,0.546570679403
35689,1000023,1,564,499,65,0.884752,0.115248,0.884752,62,3,565,500,65,0.884956,0.115044,0.884956,62,3,1, merged,0,0,0.32874214684
35689,1000070,2,914,803,111,0.878556,0.121444,1.763308,94,17,915,804,111,0.878689,0.121311,1.763644,94,17,1, merged,0,0,0.194474167322
35690,1000108,2,65,52,13,0.8,0.2,1.652459,9,4,66,53,13,0.80303,0.19697,1.657869,9,4,1, merged,0,0,0.0799937136571
35690,1000110,1,61,52,9,0.852459,0.147541,0.852459,8,1,62,53,9,0.854839,0.145161,0.854839,8,1,1, merged,0,0,0.209798994975
35697,1000120,2,1055,892,163,0.845498,0.154502,1.758541,144,19,1056,893,163,0.845644,0.154356,1.758909,144,19,-1, abandoned,0,0,0.315651210365
35697,1000153,1,782,714,68,0.913043,0.086957,0.913043,53,15,784,716,68,0.913265,0.086735,0.913265,53,15,-1, abandoned,0,0,0.567629774675
35707,1000023,3,566,501,65,0.885159,0.114841,2.579417,62,3,567,502,65,0.885362,0.114638,2.580958,62,3,1, merged,0,0,0.227177244119
35707,1000054,2,181,157,24,0.867403,0.132597,1.694258,17,7,182,158,24,0.868132,0.131868,1.695597,17,7,1, merged,0,0,0.686209822104
35707,1000166,1,283,234,49,0.826855,0.173145,0.826855,46,3,284,235,49,0.827465,0.172535,0.827465,46,3,1, merged,0,0,0.401194934903
35712,1000015,1,1618,1454,164,0.89864,0.10136,0.89864,152,12,1621,1456,165,0.898211,0.101789,0.898211,153,12,1, merged,1,1,0
35712,1000329,2,2538,1965,573,0.774232,0.225768,1.672872,505,68,2540,1967,573,0.774409,0.225591,1.67262,505,68,-1, merged,0,0,0
35719,1000328,1,777,566,211,0.728443,0.271557,0.728443,188,23,778,567,211,0.728792,0.271208,0.728792,188,23,-1, abandoned,0,0,0.617457641632
35727,1000003,2,920,771,149,0.838043,0.161957,1.682199,134,15,921,772,149,0.838219,0.161781,1.677963,134,15,1, merged,0,0,0
35737,1000014,1,1673,1423,250,0.850568,0.149432,0.850568,231,19,1674,1424,250,0.850657,0.149343,0.850657,231,19,1, merged,0,0,0
35738,1000592,2,527,444,83,0.842505,0.157495,1.627661,52,31,529,446,83,0.8431,0.1569,1.626884,52,31,-1, merged,0,0,0.438683382345
35739,1000130,2,306,259,47,0.846405,0.153595,1.630189,37,10,307,259,48,0.843648,0.156352,1.624417,38,10,1, abandoned,1,1,0.0405245878367
35740,1000109,1,379,319,60,0.841689,0.158311,0.841689,57,3,380,320,60,0.842105,0.157895,0.842105,57,3,1, merged,0,0,0
35740,1000153,2,785,717,68,0.913376,0.086624,1.755064,53,15,786,718,68,0.913486,0.086514,1.755591,53,15,1, merged,0,0,0.00305096057587
35741,1000109,1,380,320,60,0.842105,0.157895,0.842105,57,3,383,321,62,0.83812,0.16188,0.83812,59,3,1, merged,1,1,1.60947663406e-05
35741,1000153,3,786,718,68,0.913486,0.086514,2.645591,53,15,787,719,68,0.913596,0.086404,2.637288,53,15,1, merged,0,0,5.87936577265e-05
35767,1000026,2,309,283,26,0.915858,0.084142,1.713935,24,2,310,284,26,0.916129,0.083871,1.712307,24,2,1, merged,0,0,0.0747646627578
35769,1000130,2,307,259,48,0.843648,0.156352,1.843648,38,10,308,260,48,0.844156,0.155844,1.844156,38,10,-1, abandoned,0,0,0.0307608900047
35770,1000023,1,569,504,65,0.885764,0.114236,0.885764,62,3,571,506,65,0.886165,0.113835,0.886165,62,3,-1, abandoned,0,0,0
35770,1000130,4,308,260,48,0.844156,0.155844,3.521729,38,10,309,261,48,0.84466,0.15534,3.523342,38,10,-1, abandoned,0,0,0.118758666138
35772,1000108,2,66,53,13,0.80303,0.19697,1.662405,9,4,67,54,13,0.80597,0.19403,1.654455,9,4,1, merged,0,0,0.230550685361
35772,1000110,1,64,55,9,0.859375,0.140625,0.859375,8,1,66,56,10,0.848485,0.151515,0.848485,8,2,-1, merged,1,1,0.295761937926
35775,1000592,6,529,446,83,0.8431,0.1569,4.147597,52,31,530,447,83,0.843396,0.156604,4.15049,52,31,1, merged,0,0,0.19403572718
35779,1000592,2,530,447,83,0.843396,0.156604,1.627487,52,31,531,448,83,0.843691,0.156309,1.622717,52,31,1, merged,0,0,0.040451635022
35780,1000592,2,531,448,83,0.843691,0.156309,1.622717,52,31,532,449,83,0.843985,0.156015,1.620937,52,31,1, merged,0,0,0.615102724507
35790,1002169,1,289,166,123,0.574394,0.425606,0.574394,121,2,290,167,123,0.575862,0.424138,0.575862,121,2,-1, merged,0,0,0
35794,1000023,1,572,507,65,0.886364,0.113636,0.886364,62,3,573,508,65,0.886562,0.113438,0.886562,62,3,1, merged,0,0,0.00510710891822
35794,1000063,2,2370,2117,253,0.893249,0.106751,1.779613,212,41,2371,2118,253,0.893294,0.106706,1.779856,212,41,1, merged,0,0,0.00706483768705
35795,1000023,1,573,508,65,0.886562,0.113438,0.886562,62,3,574,509,65,0.88676,0.11324,0.88676,62,3,1, merged,0,0,0.00515224283103
35795,1000063,2,2371,2118,253,0.893294,0.106706,1.779856,212,41,2372,2119,253,0.893339,0.106661,1.780099,212,41,1, merged,0,0,0.0071011569081
35796,1000023,2,574,509,65,0.88676,0.11324,1.79585,62,3,575,510,65,0.886957,0.113043,1.803623,62,3,1, merged,0,0,0.00453199721085
35796,1000063,3,2372,2119,253,0.893339,0.106661,2.689189,212,41,2373,2120,253,0.893384,0.106616,2.697007,212,41,1, merged,0,0,0.0051042661129
35799,1000023,1,575,510,65,0.886957,0.113043,0.886957,62,3,576,511,65,0.887153,0.112847,0.887153,62,3,1, merged,0,0,0.168296712219
35803,1000014,2,1674,1424,250,0.850657,0.149343,1.298933,231,19,1675,1425,250,0.850746,0.149254,1.317413,231,19,1, merged,0,0,0.505398151398
35805,1000009,1,904,762,142,0.84292,0.15708,0.84292,126,16,907,763,144,0.841235,0.158765,0.841235,128,16,1, merged,1,1,0.179405631848
35805,1000153,2,787,719,68,0.913596,0.086404,1.756516,53,15,788,720,68,0.913706,0.086294,1.75494,53,15,-1, merged,0,0,0.155889627068
35807,1000014,3,1676,1426,250,0.850835,0.149165,2.601533,231,19,1678,1427,251,0.850417,0.149583,2.579421,232,19,1, merged,1,1,0.0333733656922
35807,1000070,4,919,807,112,0.878128,0.121872,3.479661,95,17,921,809,112,0.878393,0.121607,3.457814,95,17,-1, merged,0,0,0.0417218610707
35807,1000120,2,1058,895,163,0.845936,0.154064,1.750698,144,19,1060,896,164,0.845283,0.154717,1.729004,145,19,1, merged,1,1,0.0113920722042
35814,1000011,2,548,509,39,0.928832,0.071168,1.72501,36,3,549,510,39,0.928962,0.071038,1.725787,36,3,1, merged,0,0,0.499974423522
35814,1000015,3,1624,1459,165,0.898399,0.101601,2.623409,153,12,1625,1460,165,0.898462,0.101538,2.624249,153,12,1, merged,0,0,0.542891463146
35817,1000120,2,1062,898,164,0.845574,0.154426,1.573352,145,19,1063,899,164,0.84572,0.15428,1.575001,145,19,1, merged,0,0,0.378973702583
35817,1000534,1,180,131,49,0.727778,0.272222,0.727778,47,2,181,132,49,0.729282,0.270718,0.729282,47,2,-1, merged,0,0,0.691460984617
35820,1000592,4,533,450,83,0.844278,0.155722,2.949336,52,31,534,451,83,0.844569,0.155431,2.94623,52,31,1, merged,0,0,0.313372401279
35820,1002169,1,291,168,123,0.57732,0.42268,0.57732,121,2,292,169,123,0.578767,0.421233,0.578767,121,2,-1, merged,0,0,0
35822,1000592,2,534,451,83,0.844569,0.155431,1.613522,52,31,535,452,83,0.84486,0.15514,1.611885,52,31,-1, merged,0,0,0.309074070854
35837,1000023,1,576,511,65,0.887153,0.112847,0.887153,62,3,577,511,66,0.885615,0.114385,0.885615,63,3,1, merged,1,1,0.000175103650064
35837,1000130,2,309,261,48,0.84466,0.15534,1.731813,38,10,310,262,48,0.845161,0.154839,1.730777,38,10,1, merged,0,0,0.0164338537387
35838,1000023,2,577,511,66,0.885615,0.114385,1.556347,63,3,578,512,66,0.885813,0.114187,1.560512,63,3,1, merged,0,0,0.328762664007
35839,1000592,2,537,453,84,0.843575,0.156425,1.676909,53,31,538,454,84,0.843866,0.156134,1.69002,53,31,1, merged,0,0,0.231942608623
35841,1000023,1,578,512,66,0.885813,0.114187,0.885813,63,3,580,514,66,0.886207,0.113793,0.886207,63,3,-1, abandoned,0,0,0
35845,1000015,1,1625,1460,165,0.898462,0.101538,0.898462,153,12,1626,1461,165,0.898524,0.101476,0.898524,153,12,1, merged,0,0,1.08480287579
35845,1000120,2,1066,902,164,0.846154,0.153846,1.744615,145,19,1067,903,164,0.846298,0.153702,1.744822,145,19,1, merged,0,0,0.437308041246
35846,1000070,2,921,809,112,0.878393,0.121607,1.775744,95,17,922,810,112,0.878525,0.121475,1.776215,95,17,1, merged,0,0,0.405306974973
35847,1000023,1,580,514,66,0.886207,0.113793,0.886207,63,3,582,514,68,0.883162,0.116838,0.883162,63,5,-1, merged,1,1,0
35847,1000070,2,922,810,112,0.878525,0.121475,1.764732,95,17,923,811,112,0.878657,0.121343,1.761818,95,17,1, merged,0,0,0.0397378556867
35857,1000023,2,582,514,68,0.883162,0.116838,1.711287,63,5,583,515,68,0.883362,0.116638,1.714131,63,5,1, merged,0,0,0.321659932465
35857,1000140,1,64,53,11,0.828125,0.171875,0.828125,10,1,65,54,11,0.830769,0.169231,0.830769,10,1,1, merged,0,0,0.437275403146
35858,1000070,3,923,811,112,0.878657,0.121343,2.305909,95,17,924,811,113,0.877706,0.122294,2.295602,96,17,1, merged,1,1,0.119301517639
35858,1000110,1,66,56,10,0.848485,0.151515,0.848485,8,2,68,57,11,0.838235,0.161765,0.838235,9,2,-1, merged,1,0,0.104519140573
35858,1002169,2,292,169,123,0.578767,0.421233,1.427252,121,2,295,171,124,0.579661,0.420339,1.417896,121,3,-1, merged,1,0,0
35860,1000005,2,266,206,60,0.774436,0.225564,1.494436,55,5,267,207,60,0.775281,0.224719,1.497135,55,5,1, merged,0,0,0.426598120764
35861,1000140,2,65,54,11,0.830769,0.169231,1.751224,10,1,66,55,11,0.833333,0.166667,1.754682,10,1,1, merged,0,0,0.438163819631
35863,1000070,2,924,811,113,0.877706,0.122294,1.646413,96,17,925,812,113,0.877838,0.122162,1.648108,96,17,1, merged,0,0,0.19957570334
35869,1000023,1,583,515,68,0.883362,0.116638,0.883362,63,5,584,516,68,0.883562,0.116438,0.883562,63,5,1, merged,0,0,0.321693953831
35871,1000003,3,921,772,149,0.838219,0.161781,2.627034,134,15,922,773,149,0.838395,0.161605,2.634781,134,15,-1, merged,0,0,0.110534330148
35871,1000153,2,789,721,68,0.913815,0.086185,1.788815,53,15,791,723,68,0.914033,0.085967,1.796386,53,15,-1, merged,0,0,0.139073471644
35880,1000014,3,1682,1430,252,0.850178,0.149822,2.304939,233,19,1684,1430,254,0.849169,0.150831,2.281879,235,19,1, merged,1,1,0.692358374586
35880,1000070,2,925,812,113,0.877838,0.122162,1.454761,96,17,928,814,114,0.877155,0.122845,1.432711,97,17,1, merged,1,1,0.791444233136
35882,1000199,1,336,282,54,0.839286,0.160714,0.839286,49,5,339,285,54,0.840708,0.159292,0.840708,49,5,-1, merged,0,0,0.0318527351319
35883,1000199,1,339,285,54,0.840708,0.159292,0.840708,49,5,341,287,54,0.841642,0.158358,0.841642,49,5,-1, merged,0,0,0.045521609538
35884,1000199,1,341,287,54,0.841642,0.158358,0.841642,49,5,343,289,54,0.842566,0.157434,0.842566,49,5,-1, merged,0,0,0.0115304353814
35891,1000110,1,68,57,11,0.838235,0.161765,0.838235,9,2,69,58,11,0.84058,0.15942,0.84058,9,2,1, merged,0,0,0.258200408998
35892,1000110,1,69,58,11,0.84058,0.15942,0.84058,9,2,70,59,11,0.842857,0.157143,0.842857,9,2,1, merged,0,0,0.260825163399
35893,1000014,1,1684,1430,254,0.849169,0.150831,0.849169,235,19,1688,1434,254,0.849526,0.150474,0.849526,235,19,-1, merged,0,0,0.34611819499
35893,1000070,3,928,814,114,0.877155,0.122845,2.726324,97,17,929,815,114,0.877287,0.122713,2.726813,97,17,1, merged,0,0,0.395495295118
35894,1000005,2,267,207,60,0.775281,0.224719,1.775281,55,5,268,208,60,0.776119,0.223881,1.776119,55,5,1, merged,0,0,0.246671933515
35905,1000004,3,2537,2256,281,0.889239,0.110761,2.493499,219,62,2538,2257,281,0.889283,0.110717,2.493735,219,62,1, merged,0,0,0.0360911823427
35905,1000121,2,1633,1355,278,0.829761,0.170239,1.604259,263,15,1634,1356,278,0.829865,0.170135,1.604452,263,15,1, merged,0,0,0.004099124278
35905,1000329,1,2541,1968,573,0.774498,0.225502,0.774498,505,68,2542,1969,573,0.774587,0.225413,0.774587,505,68,1, merged,0,0,0.0222997544812
35906,1000199,2,343,289,54,0.842566,0.157434,1.637787,49,5,345,291,54,0.843478,0.156522,1.639397,49,5,-1, merged,0,0,0.046679076694
35907,1000199,2,345,291,54,0.843478,0.156522,1.639397,49,5,347,293,54,0.84438,0.15562,1.640991,49,5,-1, merged,0,0,0.00565187331236
35910,1000109,3,383,321,62,0.83812,0.16188,2.479111,59,3,384,322,62,0.838542,0.161458,2.480667,59,3,1, merged,0,0,0.0582155422594
35910,1000199,2,347,293,54,0.84438,0.15562,1.640991,49,5,348,294,54,0.844828,0.155172,1.642125,49,5,1, merged,0,0,0.0599835461048
35921,1000121,2,1634,1356,278,0.829865,0.170135,1.604452,263,15,1635,1357,278,0.829969,0.170031,1.60434,263,15,1, merged,0,0,0.00125490424498
35921,1000329,1,2542,1969,573,0.774587,0.225413,0.774587,505,68,2544,1970,574,0.774371,0.225629,0.774371,505,69,-1, merged,1,1,0.000998636842254
35927,1000329,2,2544,1970,574,0.774371,0.225629,1.354371,505,69,2545,1971,574,0.77446,0.22554,1.358618,505,69,1, merged,0,0,0.0112433635054
35928,1000023,1,589,521,68,0.88455,0.11545,0.88455,63,5,590,522,68,0.884746,0.115254,0.884746,63,5,1, merged,0,0,0.00119564270326
35928,1000063,3,2373,2120,253,0.893384,0.106616,2.586445,212,41,2374,2121,253,0.893429,0.106571,2.588701,212,41,1, merged,0,0,0.00109910510273
35929,1000023,2,590,522,68,0.884746,0.115254,1.778175,63,5,591,523,68,0.884941,0.115059,1.778459,63,5,1, merged,0,0,0.00641816899186
35929,1000063,1,2374,2121,253,0.893429,0.106571,0.893429,212,41,2376,2123,253,0.893519,0.106481,0.893519,212,41,-1, merged,0,0,0.00909906322617
35930,1000003,2,922,773,149,0.838395,0.161605,1.597731,134,15,923,774,149,0.83857,0.16143,1.5989,134,15,1, merged,0,0,0.027781366134
35935,1000009,2,914,769,145,0.841357,0.158643,1.690883,129,16,915,769,146,0.840437,0.159563,1.690052,130,16,1, merged,1,1,0.321338852657
35935,1000014,1,1688,1434,254,0.849526,0.150474,0.849526,235,19,1689,1435,254,0.849615,0.150385,0.849615,235,19,-1, merged,0,0,0.256356189358
35935,1000109,3,384,322,62,0.838542,0.161458,2.529424,59,3,385,323,62,0.838961,0.161039,2.529013,59,3,1, merged,0,0,0.0754343751821
35936,1000070,2,929,815,114,0.877287,0.122713,1.641415,97,17,930,816,114,0.877419,0.122581,1.640256,97,17,-1, abandoned,0,0,0.00390775812595
35937,1000109,2,385,323,62,0.838961,0.161039,1.636258,59,3,387,325,62,0.839793,0.160207,1.637773,59,3,1, merged,0,0,0.146846393131
35938,1000109,3,387,325,62,0.839793,0.160207,2.415551,59,3,388,326,62,0.840206,0.159794,2.422648,59,3,1, merged,0,0,0
35939,1000109,2,388,326,62,0.840206,0.159794,1.638864,59,3,389,327,62,0.840617,0.159383,1.639948,59,3,1, merged,0,0,0
35941,1000023,1,591,523,68,0.884941,0.115059,0.884941,63,5,594,526,68,0.885522,0.114478,0.885522,63,5,-1, merged,0,0,0.159322762403
35947,1000003,1,923,774,149,0.83857,0.16143,0.83857,134,15,924,775,149,0.838745,0.161255,0.838745,134,15,1, merged,0,0,0.184189970197
35947,1000026,2,311,285,26,0.916399,0.083601,1.754969,24,2,312,286,26,0.916667,0.083333,1.755411,24,2,1, merged,0,0,0.40968600212
35950,1000007,2,1165,943,222,0.809442,0.190558,1.723475,196,26,1166,944,222,0.809605,0.190395,1.723747,196,26,1, merged,0,0,0.643842154106
35950,1000153,1,791,723,68,0.914033,0.085967,0.914033,53,15,792,724,68,0.914141,0.085859,0.914141,53,15,-1, merged,0,0,0.560519842889
35962,1000329,3,2545,1971,574,0.77446,0.22554,2.354121,505,69,2546,1972,574,0.774548,0.225452,1.855629,505,69,1, merged,0,0,0.340221311309
35962,1002169,1,295,171,124,0.579661,0.420339,0.579661,121,3,296,172,124,0.581081,0.418919,0.581081,121,3,-1, merged,0,0,0
35963,1000014,1,1689,1435,254,0.849615,0.150385,0.849615,235,19,1691,1436,255,0.849202,0.150798,0.849202,236,19,1, merged,1,1,0
35963,1000120,3,1067,903,164,0.846298,0.153702,2.470461,145,19,1068,903,165,0.845506,0.154494,2.46904,145,20,-1, merged,1,1,0
35963,1000329,2,2546,1972,574,0.774548,0.225452,1.624163,505,69,2548,1973,575,0.774333,0.225667,1.623534,505,70,-1, merged,1,0,0.245701807728
35964,1000329,1,2548,1973,575,0.774333,0.225667,0.774333,505,70,2550,1973,577,0.773725,0.226275,0.773725,507,70,1, abandoned,1,1,0.18587239192
35966,1000003,1,924,775,149,0.838745,0.161255,0.838745,134,15,925,776,149,0.838919,0.161081,0.838919,134,15,1, merged,0,0,0.00216214037792
35966,1000012,2,438,380,58,0.86758,0.13242,1.706324,56,2,439,381,58,0.867882,0.132118,1.7068,56,2,1, merged,0,0,0.00215947942049
35968,1000007,1,1167,945,222,0.809769,0.190231,0.809769,196,26,1169,947,222,0.810094,0.189906,0.810094,196,26,-1, merged,0,0,0.405692673133
35968,1000153,2,793,725,68,0.91425,0.08575,1.724018,53,15,794,726,68,0.914358,0.085642,1.724452,53,15,1, merged,0,0,0.372552134216
35981,1000070,1,930,816,114,0.877419,0.122581,0.877419,97,17,932,817,115,0.876609,0.123391,0.876609,98,17,1, merged,1,1,0
35983,1000005,2,269,209,60,0.776952,0.223048,1.653561,55,5,270,209,61,0.774074,0.225926,1.649744,55,6,-1, merged,1,1,0.441780019525
35983,1000070,1,932,817,115,0.876609,0.123391,0.876609,98,17,933,817,116,0.87567,0.12433,0.87567,98,18,-1, merged,1,1,0.768285267159
35984,1000003,1,928,778,150,0.838362,0.161638,0.838362,135,15,930,779,151,0.837634,0.162366,0.837634,136,15,-1, merged,1,0,0.105716032959
35995,1000063,3,2380,2126,254,0.893277,0.106723,2.248173,213,41,2383,2128,255,0.892992,0.107008,2.249386,213,42,-1, merged,1,1,0.283852291302
35995,1000091,4,441,339,102,0.768707,0.231293,3.01688,87,15,442,340,102,0.769231,0.230769,3.018617,87,15,1, merged,0,0,0.429343575419
35995,1000329,2,2551,1974,577,0.773814,0.226186,1.354895,507,70,2552,1975,577,0.773903,0.226097,1.356394,507,70,1, merged,0,0,0.454665379665
35995,1002169,1,296,172,124,0.581081,0.418919,0.581081,121,3,297,173,124,0.582492,0.417508,0.582492,121,3,-1, merged,0,0,0
35996,1000070,1,933,817,116,0.87567,0.12433,0.87567,98,18,934,818,116,0.875803,0.124197,0.875803,98,18,1, merged,0,0,0.019441883162
35998,1000329,2,2552,1975,577,0.773903,0.226097,1.544129,507,70,2553,1976,577,0.773991,0.226009,1.545696,507,70,1, merged,0,0,0.65938654136
36001,1000120,1,1068,903,165,0.845506,0.154494,0.845506,145,20,1070,905,165,0.845794,0.154206,0.845794,145,20,-1, merged,0,0,0.0656307597858
36004,1000110,1,73,62,11,0.849315,0.150685,0.849315,9,2,74,62,12,0.837838,0.162162,0.837838,10,2,1, merged,1,1,0.0965595720718
36006,1000043,1,374,308,66,0.823529,0.176471,0.823529,57,9,375,309,66,0.824,0.176,0.824,57,9,-1, merged,0,0,0
36025,1000004,1,2540,2258,282,0.888976,0.111024,0.888976,220,62,2543,2261,282,0.889107,0.110893,0.889107,220,62,-1, merged,0,0,0.0611721671986
36025,1000329,2,2553,1976,577,0.773991,0.226009,1.662968,507,70,2554,1977,577,0.77408,0.22592,1.663187,507,70,1, merged,0,0,0.0248328267477
36034,1000015,1,1628,1463,165,0.898649,0.101351,0.898649,153,12,1629,1464,165,0.898711,0.101289,0.898711,153,12,-1, merged,0,0,0.340006913834
36040,1000121,1,1635,1357,278,0.829969,0.170031,0.829969,263,15,1637,1358,279,0.829566,0.170434,0.829566,264,15,1, merged,1,1,0.091698614618
36040,1000327,2,633,497,136,0.78515,0.21485,1.615119,105,31,634,498,136,0.785489,0.214511,1.615055,105,31,1, merged,0,0,0.0781024637288
36042,1000012,3,439,381,58,0.867882,0.132118,2.601944,56,2,440,382,58,0.868182,0.131818,2.603009,56,2,1, merged,0,0,0.105299756748
36042,1000120,1,1070,905,165,0.845794,0.154206,0.845794,145,20,1071,906,165,0.845938,0.154062,0.845938,145,20,1, merged,0,0,0.0767678494813
36043,1000023,1,599,531,68,0.886477,0.113523,0.886477,63,5,600,531,69,0.885,0.115,0.885,64,5,1, merged,1,1,0
36045,1000014,1,1692,1437,255,0.849291,0.150709,0.849291,236,19,1693,1438,255,0.84938,0.15062,0.84938,236,19,1, merged,0,0,0.0246796175704
36046,1000014,1,1693,1438,255,0.84938,0.15062,0.84938,236,19,1694,1439,255,0.849469,0.150531,0.849469,236,19,1, merged,0,0,0.0166088858332
36047,1000012,2,440,382,58,0.868182,0.131818,1.452074,56,2,441,383,58,0.868481,0.131519,1.453765,56,2,1, merged,0,0,0.00603474696034
36047,1000014,3,1694,1439,255,0.849469,0.150531,2.301543,236,19,1695,1440,255,0.849558,0.150442,2.303323,236,19,1, merged,0,0,0.0327633310203
36047,1002169,1,298,174,124,0.583893,0.416107,0.583893,121,3,299,175,124,0.585284,0.414716,0.585284,121,3,-1, merged,0,0,0
36048,1000012,1,441,383,58,0.868481,0.131519,0.868481,56,2,443,384,59,0.866817,0.133183,0.866817,57,2,1, merged,1,1,0.0325179980918
36048,1000014,2,1695,1440,255,0.849558,0.150442,1.718038,236,19,1696,1441,255,0.849646,0.150354,1.716463,236,19,1, merged,0,0,0.164374523
36050,1000023,2,600,531,69,0.885,0.115,1.538846,64,5,601,532,69,0.885191,0.114809,1.541242,64,5,1, merged,0,0,0.267965093413
36053,1000121,1,1637,1358,279,0.829566,0.170434,0.829566,264,15,1638,1359,279,0.82967,0.17033,0.82967,264,15,1, merged,0,0,0.014877318124
36055,1000054,1,187,163,24,0.871658,0.128342,0.871658,17,7,189,165,24,0.873016,0.126984,0.873016,17,7,-1, merged,0,0,0.674151137941
36055,1002169,2,299,175,124,0.585284,0.414716,1.456942,121,3,300,176,124,0.586667,0.413333,1.459683,121,3,-1, merged,0,0,0
36070,1000328,2,779,568,211,0.72914,0.27086,1.477439,188,23,780,569,211,0.729487,0.270513,1.47864,188,23,1, merged,0,0,0.179769936609
36073,1000070,2,936,820,116,0.876068,0.123932,1.75288,98,18,937,821,116,0.876201,0.123799,1.753898,98,18,1, merged,0,0,0.861315100681
36076,1000014,1,1700,1445,255,0.85,0.15,0.85,236,19,1701,1446,255,0.850088,0.149912,0.850088,236,19,1, merged,0,0,0.146779040768
36076,1000043,2,381,315,66,0.826772,0.173228,1.676772,57,9,382,316,66,0.827225,0.172775,1.677313,57,9,1, merged,0,0,0.178716862842
36077,1000014,1,1701,1446,255,0.850088,0.149912,0.850088,236,19,1702,1447,255,0.850176,0.149824,0.850176,236,19,1, merged,0,0,0.121058660779
36077,1000043,2,382,316,66,0.827225,0.172775,1.677313,57,9,383,317,66,0.827676,0.172324,1.677853,57,9,1, merged,0,0,0.139405110459
36086,1000009,2,917,771,146,0.840785,0.159215,1.757452,130,16,918,772,146,0.840959,0.159041,1.757892,130,16,1, merged,0,0,0.60774842297
36086,1000026,1,312,286,26,0.916667,0.083333,0.916667,24,2,313,287,26,0.916933,0.083067,0.916933,24,2,1, merged,0,0,0.281118699462
36087,1000014,1,1702,1447,255,0.850176,0.149824,0.850176,236,19,1704,1448,256,0.849765,0.150235,0.849765,236,20,1, merged,1,0,0.0206366911459
36091,1000109,2,392,330,62,0.841837,0.158163,1.641168,59,3,393,331,62,0.842239,0.157761,1.642904,59,3,1, merged,0,0,0.0573522138833
36094,1000120,2,1071,906,165,0.845938,0.154062,1.720938,145,20,1072,907,165,0.846082,0.153918,1.746082,145,20,1, merged,0,0,0.000136595905829
36104,1000070,2,942,826,116,0.876858,0.123142,1.62601,98,18,943,827,116,0.876988,0.123012,1.624463,98,18,1, merged,0,0,0.400636340297
36105,1000023,3,601,532,69,0.885191,0.114809,2.426942,64,5,602,533,69,0.885382,0.114618,2.463452,64,5,1, merged,0,0,0.043459307431
36105,1000166,2,284,235,49,0.827465,0.172535,1.541751,46,3,285,236,49,0.82807,0.17193,1.57807,46,3,1, merged,0,0,0.225337238197
36109,1000012,2,449,389,60,0.86637,0.13363,1.717198,58,2,451,390,61,0.864745,0.135255,1.717204,59,2,1, merged,1,1,0.130839721385
36111,1000054,2,191,166,25,0.86911,0.13089,1.69718,17,8,192,167,25,0.869792,0.130208,1.698463,17,8,1, merged,0,0,0.385565481421
36111,1000166,1,285,236,49,0.82807,0.17193,0.82807,46,3,286,237,49,0.828671,0.171329,0.828671,46,3,1, merged,0,0,0.240369071792
36116,1000091,1,442,340,102,0.769231,0.230769,0.769231,87,15,443,341,102,0.769752,0.230248,0.769752,87,15,1, merged,0,0,0.430808584368
36123,1000007,2,1173,951,222,0.810742,0.189258,0.810742,196,26,1174,952,222,0.810903,0.189097,1.810903,196,26,1, merged,0,0,1.19360054281
36135,1000070,4,944,828,116,0.877119,0.122881,3.158331,98,18,946,829,117,0.876321,0.123679,3.11814,98,19,-1, merged,1,0,0.808239450703
36135,1000121,5,1638,1359,279,0.82967,0.17033,3.988002,264,15,1639,1360,279,0.829774,0.170226,3.947914,264,15,1, merged,0,0,0.392917390834
36137,1000004,1,2543,2261,282,0.889107,0.110893,0.889107,220,62,2544,2262,282,0.889151,0.110849,0.889151,220,62,1, merged,0,0,0.062530161446
36137,1000014,2,1704,1448,256,0.849765,0.150235,1.738873,236,20,1705,1449,256,0.849853,0.150147,1.739004,236,20,1, merged,0,0,0.00499886939949
36139,1000014,1,1705,1449,256,0.849853,0.150147,0.849853,236,20,1706,1450,256,0.849941,0.150059,0.849941,236,20,1, merged,0,0,0.00112042579822
36139,1000120,2,1073,908,165,0.846226,0.153774,1.696079,145,20,1074,909,165,0.846369,0.153631,1.69631,145,20,1, merged,0,0,0.0490943484903
36140,1000592,2,538,454,84,0.843866,0.156134,1.510533,53,31,539,455,84,0.844156,0.155844,1.516883,53,31,1, merged,0,0,0.61963064065
36143,1000023,1,602,533,69,0.885382,0.114618,0.885382,64,5,605,535,70,0.884298,0.115702,0.884298,65,5,1, merged,1,1,0.00131466580395
36143,1000063,3,2388,2133,255,0.893216,0.106784,2.591098,213,42,2389,2134,255,0.893261,0.106739,2.591991,213,42,1, merged,0,0,0.00153536031027
36144,1000023,2,605,535,70,0.884298,0.115702,1.698731,65,5,606,536,70,0.884488,0.115512,1.700815,65,5,1, merged,0,0,0.00392783822816
36144,1000063,3,2389,2134,255,0.893261,0.106739,2.591991,213,42,2391,2136,255,0.89335,0.10665,2.594165,213,42,1, merged,0,0,0.00555518006646
36145,1000023,2,606,536,70,0.884488,0.115512,1.700815,65,5,607,537,70,0.884679,0.115321,1.702861,65,5,1, merged,0,0,0.00529994637144
36147,1000014,1,1706,1450,256,0.849941,0.150059,0.849941,236,20,1707,1451,256,0.850029,0.149971,0.850029,236,20,1, merged,0,0,0.0648595641646
36147,1000070,3,946,829,117,0.876321,0.123679,2.572774,98,19,947,830,117,0.876452,0.123548,2.573136,98,19,1, merged,0,0,0.0295489891135
36147,1000120,2,1075,910,165,0.846512,0.153488,1.696453,145,20,1076,911,165,0.846654,0.153346,1.696684,145,20,1, merged,0,0,0.00805186972256
36159,1000329,2,2555,1978,577,0.774168,0.225832,1.563642,507,70,2556,1979,577,0.774257,0.225743,1.549257,507,70,1, merged,0,0,4.41918145711e-05
36160,1000011,1,558,519,39,0.930108,0.069892,0.930108,36,3,559,520,39,0.930233,0.069767,0.930233,36,3,1, merged,0,0,0.628183757809
36160,1000120,2,1076,911,165,0.846654,0.153346,1.776762,145,20,1077,912,165,0.846797,0.153203,1.777029,145,20,1, merged,0,0,0.446830339207
36161,1000011,1,559,520,39,0.930233,0.069767,0.930233,36,3,560,521,39,0.930357,0.069643,0.930357,36,3,1, merged,0,0,0.209581964672
36161,1000120,2,1077,912,165,0.846797,0.153203,1.777029,145,20,1078,913,165,0.846939,0.153061,1.777296,145,20,1, merged,0,0,0.149191635021
36162,1000011,1,560,521,39,0.930357,0.069643,0.930357,36,3,561,522,39,0.930481,0.069519,0.930481,36,3,1, merged,0,0,0.636760806895
36162,1000120,2,1078,913,165,0.846939,0.153061,1.777296,145,20,1079,914,165,0.847081,0.152919,1.777562,145,20,1, merged,0,0,0.480528473935
36163,1000329,2,2556,1979,577,0.774257,0.225743,1.521731,507,70,2557,1980,577,0.774345,0.225655,1.519311,507,70,-1, abandoned,0,0,0.0240959531828
36164,1000070,1,947,830,117,0.876452,0.123548,0.876452,98,19,948,831,117,0.876582,0.123418,0.876582,98,19,1, merged,0,0,0.00335842449549
36164,1000327,2,634,498,136,0.785489,0.214511,1.661941,105,31,635,499,136,0.785827,0.214173,1.662409,105,31,1, merged,0,0,0.00489580396825
36165,1000120,1,1079,914,165,0.847081,0.152919,0.847081,145,20,1082,917,165,0.847505,0.152495,0.847505,145,20,-1, merged,0,0,0.124870650425
36166,1000023,1,608,538,70,0.884868,0.115132,0.884868,65,5,609,539,70,0.885057,0.114943,0.885057,65,5,1, merged,0,0,0.00642898258162
36166,1000063,2,2391,2136,255,0.89335,0.10665,1.778218,213,42,2392,2137,255,0.893395,0.106605,1.778452,213,42,1, merged,0,0,0.00592073115046
36167,1000011,2,561,522,39,0.930481,0.069519,1.603209,36,3,562,523,39,0.930605,0.069395,1.591319,36,3,-1, abandoned,0,0,0.0221313020296
36174,1000007,1,1176,954,222,0.811224,0.188776,0.811224,196,26,1177,954,223,0.810535,0.189465,0.810535,197,26,1, merged,1,1,1.288438334
36174,1000009,2,918,772,146,0.840959,0.159041,1.652183,130,16,919,773,146,0.841132,0.158868,1.651667,130,16,1, merged,0,0,1.32105026997
36176,1000007,1,1179,956,223,0.810857,0.189143,0.810857,197,26,1180,956,224,0.810169,0.189831,0.810169,198,26,1, merged,1,1,1.29111476008
36176,1000009,2,919,773,146,0.841132,0.158868,1.651988,130,16,920,774,146,0.841304,0.158696,1.651474,130,16,1, merged,0,0,1.32482738564
36178,1000011,1,562,523,39,0.930605,0.069395,0.930605,36,3,563,524,39,0.930728,0.069272,0.930728,36,3,-1, merged,0,0,0.00692276713861
36178,1000120,2,1082,917,165,0.847505,0.152495,1.77811,145,20,1083,918,165,0.847645,0.152355,1.778374,145,20,1, merged,0,0,0.0178658790786
36180,1000120,2,1083,918,165,0.847645,0.152355,1.581341,145,20,1084,919,165,0.847786,0.152214,1.582921,145,20,-1, abandoned,0,0,0
36180,1000534,1,184,135,49,0.733696,0.266304,0.733696,47,2,185,136,49,0.735135,0.264865,0.735135,47,2,-1, abandoned,0,0,0
36181,1000011,1,563,524,39,0.930728,0.069272,0.930728,36,3,564,525,39,0.930851,0.069149,0.930851,36,3,-1, merged,0,0,0.0117474907084
36181,1000120,2,1084,919,165,0.847786,0.152214,1.778514,145,20,1086,921,165,0.848066,0.151934,1.778917,145,20,-1, merged,0,0,0.0404509169981
36181,1000534,3,185,136,49,0.735135,0.264865,2.513649,47,2,187,136,51,0.727273,0.272727,2.50619,47,4,-1, merged,1,1,0.0380768836757
36183,1000015,1,1638,1473,165,0.899267,0.100733,0.899267,153,12,1640,1475,165,0.89939,0.10061,0.89939,153,12,-1, merged,0,0,1.12725047909e-05
36183,1000153,2,796,728,68,0.914573,0.085427,1.81384,53,15,797,729,68,0.91468,0.08532,1.81407,53,15,1, merged,0,0,8.88611262448e-06
36185,1000009,3,920,774,146,0.841304,0.158696,2.149077,130,16,921,775,146,0.841477,0.158523,2.17481,130,16,1, merged,0,0,0
36186,1000009,2,921,775,146,0.841477,0.158523,1.508143,130,16,922,776,146,0.841649,0.158351,1.541649,130,16,1, merged,0,0,0.19223077448
36187,1000054,2,192,167,25,0.869792,0.130208,1.698463,17,8,193,168,25,0.870466,0.129534,1.699735,17,8,1, merged,0,0,0.385841315977
36187,1000166,1,286,237,49,0.828671,0.171329,0.828671,46,3,287,238,49,0.829268,0.170732,0.829268,46,3,1, merged,0,0,0.24117711621
36193,1000054,2,193,168,25,0.870466,0.129534,1.457133,17,8,194,169,25,0.871134,0.128866,1.464577,17,8,1, merged,0,0,0.513699021556
36193,1000130,4,313,263,50,0.840256,0.159744,3.097389,40,10,314,263,51,0.83758,0.16242,3.109849,40,11,-1, merged,1,1,0
36193,1002169,1,300,176,124,0.586667,0.413333,0.586667,121,3,305,181,124,0.593443,0.406557,0.593443,121,3,-1, merged,0,0,0
36197,1000007,2,1182,957,225,0.809645,0.190355,1.476311,199,26,1183,958,225,0.809806,0.190194,1.487772,199,26,-1, abandoned,0,0,0
36203,1000023,2,609,539,70,0.885057,0.114943,1.703239,65,5,610,540,70,0.885246,0.114754,1.707028,65,5,1, merged,0,0,0.00145259870863
36204,1000023,2,610,540,70,0.885246,0.114754,1.707028,65,5,611,541,70,0.885434,0.114566,1.708963,65,5,1, merged,0,0,0.00590603435398
36206,1000023,2,611,541,70,0.885434,0.114566,1.708963,65,5,613,543,70,0.885808,0.114192,1.71105,65,5,1, merged,0,0,0.00528324661468
36206,1000063,3,2392,2137,255,0.893395,0.106605,2.602358,213,42,2393,2138,255,0.893439,0.106561,2.604489,213,42,1, merged,0,0,0.00720989026302
36208,1000004,2,2544,2262,282,0.889151,0.110849,1.663496,220,62,2545,2263,282,0.889194,0.110806,1.663325,220,62,1, merged,0,0,0.0363425012063
36208,1000329,1,2557,1980,577,0.774345,0.225655,0.774345,507,70,2559,1981,578,0.774131,0.225869,0.774131,507,71,-1, merged,1,1,0.0226649741524
36217,1000043,2,389,323,66,0.830334,0.169666,1.242099,57,9,390,324,66,0.830769,0.169231,1.259341,57,9,1, merged,0,0,0.287592267641
36218,1000043,2,390,324,66,0.830769,0.169231,1.330769,57,9,391,325,66,0.831202,0.168798,1.497869,57,9,1, merged,0,0,0.869169254658
36220,1000121,3,1639,1360,279,0.829774,0.170226,1.488002,264,15,1640,1361,279,0.829878,0.170122,2.492378,264,15,-1, abandoned,0,0,0.41393769192
36222,1000023,3,613,543,70,0.885808,0.114192,2.538744,65,5,614,544,70,0.885993,0.114007,2.544804,65,5,1, merged,0,0,0.000265165192273
36222,1000054,1,196,171,25,0.872449,0.127551,0.872449,17,8,197,172,25,0.873096,0.126904,0.873096,17,8,1, merged,0,0,0
36224,1000004,2,2545,2263,282,0.889194,0.110806,1.355861,220,62,2546,2264,282,0.889238,0.110762,1.357988,220,62,1, merged,0,0,0.19435760829
36227,1000121,2,1640,1361,279,0.829878,0.170122,1.508039,264,15,1641,1362,279,0.829982,0.170018,1.515375,264,15,1, merged,0,0,0.0409537642168
36236,1000054,2,197,172,25,0.873096,0.126904,1.650874,17,8,198,173,25,0.873737,0.126263,1.673737,17,8,1, merged,0,0,0.674378295036
36241,1000009,2,922,776,146,0.841649,0.158351,1.641649,130,16,923,777,146,0.84182,0.15818,1.675153,130,16,1, merged,0,0,1.15059736715
36242,1000023,1,614,544,70,0.885993,0.114007,0.885993,65,5,616,546,70,0.886364,0.113636,0.886364,65,5,1, merged,0,0,0.0354081974466
36245,1000121,1,1641,1362,279,0.829982,0.170018,0.829982,264,15,1642,1363,279,0.830085,0.169915,0.830085,264,15,1, merged,0,0,0.459873528182
36245,1000328,2,780,569,211,0.729487,0.270513,1.559469,188,23,781,570,211,0.729834,0.270166,1.559919,188,23,1, merged,0,0,0.39176180882
36246,1000003,4,933,781,152,0.837085,0.162915,3.308985,137,15,935,783,152,0.837433,0.162567,3.305272,137,15,-1, abandoned,0,0,0.039962069777
36246,1000015,2,1643,1478,165,0.899574,0.100426,1.673793,153,12,1646,1478,168,0.897934,0.102066,1.672241,156,12,1, abandoned,1,1,0
36246,1000329,1,2560,1982,578,0.774219,0.225781,0.774219,507,71,2561,1983,578,0.774307,0.225693,0.774307,507,71,-1, abandoned,0,0,0.0211933854492
36249,1000007,5,1183,958,225,0.809806,0.190194,4.126912,199,26,1185,959,226,0.809283,0.190717,4.010673,200,26,1, merged,1,1,0.017258021998
36249,1000009,3,923,777,146,0.84182,0.15818,2.483773,130,16,924,778,146,0.841991,0.158009,2.487104,130,16,-1, merged,0,0,0.0269983466324
36249,1000153,1,797,729,68,0.91468,0.08532,0.91468,53,15,798,729,69,0.913534,0.086466,0.913534,54,15,1, merged,1,1,0.024018329864
36249,1000534,2,187,136,51,0.727273,0.272727,1.641953,47,4,190,139,51,0.731579,0.268421,1.645113,47,4,-1, merged,0,0,0.0210835751266
36250,1000023,1,617,547,70,0.886548,0.113452,0.886548,65,5,619,549,70,0.886914,0.113086,0.886914,65,5,1, merged,0,0,0.00532724149627
36250,1000063,4,2397,2142,255,0.893617,0.106383,3.605408,213,42,2398,2143,255,0.893661,0.106339,3.607499,213,42,1, merged,0,0,0.0072453195286
36253,1000023,2,621,551,70,0.887279,0.112721,1.716547,65,5,622,552,70,0.88746,0.11254,1.718785,65,5,1, merged,0,0,0.000304599451721
36254,1000023,2,622,552,70,0.88746,0.11254,1.718785,65,5,623,553,70,0.88764,0.11236,1.720974,65,5,1, merged,0,0,3.25587911092e-06
36259,1000014,1,1709,1453,256,0.850205,0.149795,0.850205,236,20,1712,1455,257,0.849883,0.150117,0.849883,237,20,-1, abandoned,1,0,0.251173828406
36259,1000120,2,1086,921,165,0.848066,0.151934,1.698271,145,20,1088,921,167,0.846507,0.153493,1.696391,147,20,1, abandoned,1,1,0.176230764897
36261,1000014,1,1712,1455,257,0.849883,0.150117,0.849883,237,20,1714,1457,257,0.850058,0.149942,0.850058,237,20,-1, merged,0,0,0.0651775348297
36263,1000120,1,1088,921,167,0.846507,0.153493,0.846507,147,20,1090,923,167,0.846789,0.153211,0.846789,147,20,-1, abandoned,0,0,0.00528599455002
36266,1000329,3,2561,1983,578,0.774307,0.225693,1.4597,507,71,2562,1984,578,0.774395,0.225605,1.963284,507,71,1, merged,0,0,0.307788028911
36270,1000023,4,623,553,70,0.88764,0.11236,1.804307,65,5,624,554,70,0.887821,0.112179,3.310897,65,5,1, merged,0,0,0.0887229836958
36278,1000011,1,568,529,39,0.931338,0.068662,0.931338,36,3,569,530,39,0.931459,0.068541,0.931459,36,3,1, merged,0,0,0.317563264058
36278,1000120,2,1090,923,167,0.846789,0.153211,1.778127,147,20,1091,924,167,0.846929,0.153071,1.778388,147,20,1, merged,0,0,0.233374984287
36283,1000015,3,1646,1478,168,0.897934,0.102066,2.43757,156,12,1647,1479,168,0.897996,0.102004,2.443245,156,12,1, merged,0,0,0.567823851224
36289,1000063,2,2400,2145,255,0.89375,0.10625,1.227083,213,42,2401,2146,255,0.893794,0.106206,1.393794,213,42,1, merged,0,0,0.00298899963306
36294,1000023,2,624,554,70,0.887821,0.112179,1.706002,65,5,626,555,71,0.886581,0.113419,1.636581,66,5,1, merged,1,1,1.14900838917e-05
36294,1000199,3,350,296,54,0.845714,0.154286,2.551717,49,5,351,296,55,0.843305,0.156695,2.479886,50,5,1, merged,1,1,2.19193742862e-17
36295,1000014,1,1714,1457,257,0.850058,0.149942,0.850058,237,20,1715,1458,257,0.850146,0.149854,0.850146,237,20,1, merged,0,0,0.332420486397
36295,1000043,2,392,326,66,0.831633,0.168367,1.681691,57,9,394,327,67,0.829949,0.170051,1.680095,57,10,-1, merged,1,1,0.440419051558
36297,1000054,3,198,173,25,0.873737,0.126263,2.580714,17,8,201,174,27,0.865672,0.134328,2.479308,19,8,1, merged,1,1,0.00668438271026
36301,1000132,2,272,241,31,0.886029,0.113971,1.660424,23,8,273,242,31,0.886447,0.113553,1.661106,23,8,1, merged,0,0,0.309995537827
36301,1000329,1,2562,1984,578,0.774395,0.225605,0.774395,507,71,2565,1987,578,0.774659,0.225341,0.774659,507,71,-1, merged,0,0,0.312037236145
36307,1000011,3,569,530,39,0.931459,0.068541,1.431459,36,3,570,531,39,0.931579,0.068421,2.598246,36,3,1, merged,0,0,0.493384468016
36312,1000015,1,1647,1479,168,0.897996,0.102004,0.897996,156,12,1648,1479,169,0.897451,0.102549,0.897451,157,12,1, abandoned,1,1,0.577967653983
36312,1000329,2,2566,1988,578,0.774747,0.225253,1.672743,507,71,2568,1990,578,0.774922,0.225078,1.672374,507,71,-1, abandoned,0,0,0.479986082362
36316,1000329,2,2568,1990,578,0.774922,0.225078,1.373853,507,71,2569,1991,578,0.77501,0.22499,1.378184,507,71,1, merged,0,0,0.503231770341
36317,1000327,2,636,500,136,0.786164,0.213836,1.389338,105,31,637,501,136,0.786499,0.213501,1.393829,105,31,1, merged,0,0,0.619007263923
36317,1000329,3,2569,1991,578,0.77501,0.22499,2.164348,507,71,2570,1992,578,0.775097,0.224903,2.168926,507,71,1, merged,0,0,0.503424397909
36325,1000026,5,315,289,26,0.91746,0.08254,3.51495,24,2,316,290,26,0.917722,0.082278,3.531236,24,2,1, merged,0,0,0
36325,1000054,1,201,174,27,0.865672,0.134328,0.865672,19,8,203,176,27,0.866995,0.133005,0.866995,19,8,-1, merged,0,0,0
36327,1000054,1,203,176,27,0.866995,0.133005,0.866995,19,8,204,177,27,0.867647,0.132353,0.867647,19,8,1, merged,0,0,0.766828223192
36327,1000132,2,275,244,31,0.887273,0.112727,1.754268,23,8,276,245,31,0.887681,0.112319,1.755328,23,8,1, merged,0,0,0.428900666506
36328,1000012,1,452,391,61,0.865044,0.134956,0.865044,59,2,454,392,62,0.863436,0.136564,0.863436,60,2,1, merged,1,1,0.0756297251647
36330,1000015,2,1648,1479,169,0.897451,0.102549,1.660717,157,12,1650,1481,169,0.897576,0.102424,1.661803,157,12,1, merged,0,0,0.0179463646053
36335,1000153,2,802,733,69,0.913965,0.086035,0.913965,54,15,803,734,69,0.914072,0.085928,1.914072,54,15,1, merged,0,0,0.559493982014
36339,1000153,2,803,734,69,0.914072,0.085928,1.580739,54,15,804,735,69,0.914179,0.085821,1.614179,54,15,1, merged,0,0,1.07994992903
36340,1000014,3,1716,1459,257,0.850233,0.149767,2.50536,237,20,1718,1460,258,0.849825,0.150175,2.50368,238,20,1, merged,1,1,0.607500644247
36340,1000070,1,954,836,118,0.87631,0.12369,0.87631,99,19,955,836,119,0.875393,0.124607,0.875393,100,19,1, merged,1,1,0.735701734958
36345,1000110,2,76,64,12,0.842105,0.157895,1.71167,10,2,77,65,12,0.844156,0.155844,1.69522,10,2,1, merged,0,0,0.628009481197
36348,1000011,3,570,531,39,0.931579,0.068421,2.431579,36,3,571,532,39,0.931699,0.068301,2.455508,36,3,1, merged,0,0,0.493353977458
36355,1002169,1,306,182,124,0.594771,0.405229,0.594771,121,3,307,183,124,0.596091,0.403909,0.596091,121,3,-1, merged,0,0,0
36359,1000063,1,2401,2146,255,0.893794,0.106206,0.893794,213,42,2402,2147,255,0.893838,0.106162,0.893838,213,42,1, merged,0,0,0.00650502402796
36363,1000023,1,627,556,71,0.886762,0.113238,0.886762,66,5,628,557,71,0.886943,0.113057,0.886943,66,5,1, merged,0,0,0.00222279726679
36369,1000110,2,78,66,12,0.846154,0.153846,1.681975,10,2,80,68,12,0.85,0.15,1.671918,10,2,-1, merged,0,0,0.0345738856443
36369,1000140,1,67,56,11,0.835821,0.164179,0.835821,10,1,73,60,13,0.821918,0.178082,0.821918,12,1,-1, merged,1,0,0.0253744924398
36372,1000023,1,629,558,71,0.887122,0.112878,0.887122,66,5,630,559,71,0.887302,0.112698,0.887302,66,5,1, merged,0,0,0.332399408659
36372,1000120,2,1092,925,167,0.84707,0.15293,1.734192,147,20,1093,926,167,0.84721,0.15279,1.734511,147,20,1, merged,0,0,0.139561383634
36373,1000153,2,804,735,69,0.914179,0.085821,1.798179,54,15,805,736,69,0.914286,0.085714,1.798748,54,15,1, merged,0,0,0.00127837629316
36375,1000153,2,805,736,69,0.914286,0.085714,1.580952,54,15,806,737,69,0.914392,0.085608,1.591811,54,15,1, merged,0,0,0
36378,1000014,1,1718,1460,258,0.849825,0.150175,0.849825,238,20,1719,1461,258,0.849913,0.150087,0.849913,238,20,1, merged,0,0,0.548643924339
36378,1000120,2,1093,926,167,0.84721,0.15279,1.697035,147,20,1094,927,167,0.847349,0.152651,1.697262,147,20,1, merged,0,0,0.363614139412
36391,1000014,1,1719,1461,258,0.849913,0.150087,0.849913,238,20,1720,1462,258,0.85,0.15,0.85,238,20,-1, merged,0,0,0.0819406701486
36393,1000007,2,1189,962,227,0.809083,0.190917,1.706907,201,26,1194,965,229,0.808208,0.191792,1.705489,203,26,1, merged,1,1,0.257709234612
36393,1000009,3,927,781,146,0.842503,0.157497,2.549409,130,16,928,782,146,0.842672,0.157328,2.548161,130,16,-1, merged,0,0,0.247148643496
36393,1000015,1,1654,1485,169,0.897823,0.102177,0.897823,157,12,1655,1485,170,0.897281,0.102719,0.897281,158,12,1, merged,1,1,0
36396,1000014,2,1720,1462,258,0.85,0.15,1.628462,238,20,1722,1464,258,0.850174,0.149826,1.631992,238,20,-1, merged,0,0,0.586867397852
36398,1000012,3,456,394,62,0.864035,0.135965,2.596571,60,2,458,395,63,0.862445,0.137555,2.594817,61,2,1, merged,1,1,0.0663815068978
36398,1000070,2,955,836,119,0.875393,0.124607,1.732536,100,19,956,836,120,0.874477,0.125523,1.732372,101,19,1, merged,1,1,0.0992962918862
36401,1000054,2,204,177,27,0.867647,0.132353,1.755328,19,8,205,178,27,0.868293,0.131707,1.756379,19,8,1, merged,0,0,0.385759753063
36401,1000132,1,276,245,31,0.887681,0.112319,0.887681,23,8,277,246,31,0.888087,0.111913,0.888087,23,8,1, merged,0,0,0.215863620911
36403,1000014,1,1725,1467,258,0.850435,0.149565,0.850435,238,20,1726,1468,258,0.850521,0.149479,0.850521,238,20,-1, abandoned,0,0,0
36403,1000153,2,806,737,69,0.914392,0.085608,1.764827,54,15,807,738,69,0.914498,0.085502,1.76502,54,15,-1, abandoned,0,0,0
36405,1000592,2,539,455,84,0.844156,0.155844,1.749419,53,31,542,457,85,0.843173,0.156827,1.739007,53,32,-1, merged,1,0,0
36408,1000007,2,1194,965,229,0.808208,0.191792,1.65088,203,26,1198,967,231,0.807179,0.192821,1.64821,205,26,-1, merged,1,0,0.18568003306
36408,1000009,1,928,782,146,0.842672,0.157328,0.842672,130,16,931,783,148,0.841031,0.158969,0.841031,132,16,-1, merged,1,0,0.172116537608
36411,1000007,1,1200,968,232,0.806667,0.193333,0.806667,206,26,1203,969,234,0.805486,0.194514,0.805486,208,26,1, merged,1,1,0.645416329059
36411,1000153,2,807,738,69,0.914498,0.085502,1.721165,54,15,809,739,70,0.913473,0.086527,1.71896,55,15,1, merged,1,1,0.559375190623
36412,1000007,2,1203,969,234,0.805486,0.194514,1.702767,208,26,1206,972,234,0.80597,0.19403,1.702709,208,26,-1, merged,0,0,0.430034946752
36412,1000015,1,1655,1485,170,0.897281,0.102719,0.897281,158,12,1656,1485,171,0.896739,0.103261,0.896739,159,12,1, merged,1,1,0
36412,1000153,3,809,739,70,0.913473,0.086527,2.616241,55,15,811,741,70,0.913687,0.086313,2.616396,55,15,-1, merged,0,0,0.372875099852
36413,1000014,1,1726,1468,258,0.850521,0.149479,0.850521,238,20,1729,1470,259,0.850202,0.149798,0.850202,239,20,1, merged,1,1,0
36413,1000153,3,811,741,70,0.913687,0.086313,2.442174,55,15,812,742,70,0.913793,0.086207,2.430662,55,15,1, merged,0,0,0
36415,1000140,2,73,60,13,0.821918,0.178082,1.636733,12,1,74,60,14,0.810811,0.189189,1.596525,13,1,1, abandoned,1,1,0.0846666666667
36418,1000023,2,633,562,71,0.887836,0.112164,1.663108,66,5,635,563,72,0.886614,0.113386,1.661672,67,5,1, merged,1,1,0.00172588165274
36418,1000121,4,1642,1363,279,0.830085,0.169915,3.493193,264,15,1643,1364,279,0.830189,0.169811,3.491861,264,15,1, merged,0,0,0.00246367176844
36418,1000329,1,2572,1994,578,0.775272,0.224728,0.775272,507,71,2574,1995,579,0.775058,0.224942,0.775058,508,71,1, merged,1,1,0.00298306379687
36419,1000054,1,206,179,27,0.868932,0.131068,0.868932,19,8,208,181,27,0.870192,0.129808,0.870192,19,8,-1, merged,0,0,0.383821601976
36419,1000132,2,277,246,31,0.888087,0.111913,1.757019,23,8,278,247,31,0.888489,0.111511,1.758682,23,8,1, merged,0,0,0.217182050972
36420,1000054,1,208,181,27,0.870192,0.129808,0.870192,19,8,209,182,27,0.870813,0.129187,0.870813,19,8,1, merged,0,0,0.772594077461
36420,1000132,2,278,247,31,0.888489,0.111511,1.758682,23,8,279,248,31,0.888889,0.111111,1.759702,23,8,1, merged,0,0,0.438486736977
36428,1000023,2,635,563,72,0.886614,0.113386,1.886614,67,5,636,564,72,0.886792,0.113208,1.886792,67,5,1, merged,0,0,0.000706338846808
36431,1000121,2,1643,1364,279,0.830189,0.169811,1.427591,264,15,1644,1365,279,0.830292,0.169708,1.431578,264,15,-1, abandoned,0,0,0
36431,1002169,1,308,184,124,0.597403,0.402597,0.597403,121,3,311,187,124,0.601286,0.398714,0.601286,121,3,-1, abandoned,0,0,0
36434,1000014,1,1729,1470,259,0.850202,0.149798,0.850202,239,20,1732,1473,259,0.850462,0.149538,0.850462,239,20,-1, merged,0,0,0
36434,1000023,2,636,564,72,0.886792,0.113208,1.736995,67,5,638,565,73,0.88558,0.11442,1.736042,68,5,1, merged,1,1,0
36435,1000026,4,316,290,26,0.917722,0.082278,3.532821,24,2,317,291,26,0.917981,0.082019,3.534383,24,2,1, merged,0,0,0.297352055348
36435,1000054,1,211,184,27,0.872038,0.127962,0.872038,19,8,212,185,27,0.872642,0.127358,0.872642,19,8,1, merged,0,0,0.280633900542
36435,1000153,3,812,742,70,0.913793,0.086207,2.615099,55,15,813,743,70,0.913899,0.086101,2.616402,55,15,1, merged,0,0,0.144824895303
36435,1000166,2,287,238,49,0.829268,0.170732,1.701306,46,3,288,239,49,0.829861,0.170139,1.702503,46,3,1, merged,0,0,0.152386620378
36437,1000109,4,393,331,62,0.842239,0.157761,2.886208,59,3,394,332,62,0.84264,0.15736,2.94226,59,3,1, merged,0,0,0
36437,1000199,2,351,296,55,0.843305,0.156695,1.243305,50,5,352,297,55,0.84375,0.15625,1.298295,50,5,1, merged,0,0,0
36441,1000199,2,352,297,55,0.84375,0.15625,1.298295,50,5,353,298,55,0.844193,0.155807,1.344193,50,5,1, merged,0,0,0
36463,1000130,2,314,263,51,0.83758,0.16242,1.667441,40,11,316,264,52,0.835443,0.164557,1.662433,41,11,1, merged,1,1,0.24624707118
36463,1000166,1,288,239,49,0.829861,0.170139,0.829861,46,3,289,239,50,0.82699,0.17301,0.82699,47,3,1, merged,1,1,0.189916325897
36467,1000026,1,317,291,26,0.917981,0.082019,0.917981,24,2,318,292,26,0.918239,0.081761,0.918239,24,2,1, merged,0,0,0.287850586514
36478,1000014,2,1732,1473,259,0.850462,0.149538,1.69795,239,20,1733,1474,259,0.850548,0.149452,1.698176,239,20,-1, abandoned,0,0,0.20408269167
36478,1000120,1,1095,928,167,0.847489,0.152511,0.847489,147,20,1096,929,167,0.847628,0.152372,0.847628,147,20,-1, abandoned,0,0,0.142897310575
36481,1000063,1,2404,2149,255,0.893927,0.106073,0.893927,213,42,2405,2150,255,0.893971,0.106029,0.893971,213,42,1, merged,0,0,0.00248444304919
36481,1000592,3,542,457,85,0.843173,0.156827,2.583254,53,32,543,458,85,0.843462,0.156538,2.594576,53,32,1, merged,0,0,0.00306296419259
36482,1000023,2,640,567,73,0.885938,0.114062,1.779908,68,5,641,568,73,0.886115,0.113885,1.78013,68,5,1, merged,0,0,0.00521053376152
36482,1000063,1,2405,2150,255,0.893971,0.106029,0.893971,213,42,2406,2151,255,0.894015,0.105985,0.894015,213,42,1, merged,0,0,0.00716832765544
36483,1000063,1,2406,2151,255,0.894015,0.105985,0.894015,213,42,2407,2152,255,0.894059,0.105941,0.894059,213,42,1, merged,0,0,0.0309203182207
36484,1000063,2,2407,2152,255,0.894059,0.105941,1.680558,213,42,2408,2153,255,0.894103,0.105897,1.680937,213,42,1, merged,0,0,0.162930262711
36484,1000327,1,637,501,136,0.786499,0.213501,0.786499,105,31,638,502,136,0.786834,0.213166,0.786834,105,31,1, merged,0,0,0.0709934007826
36485,1002169,2,311,187,124,0.601286,0.398714,1.383104,121,3,312,188,124,0.602564,0.397436,1.379673,121,3,-1, abandoned,0,0,0
36489,1000063,3,2408,2153,255,0.894103,0.105897,2.724292,213,42,2409,2154,255,0.894147,0.105853,2.725923,213,42,1, merged,0,0,0.0109522469141
36494,1000023,1,641,568,73,0.886115,0.113885,0.886115,68,5,642,569,73,0.886293,0.113707,0.886293,68,5,1, merged,0,0,0.00130974794613
36494,1000063,3,2409,2154,255,0.894147,0.105853,2.612038,213,42,2410,2155,255,0.894191,0.105809,2.613817,213,42,1, merged,0,0,0.00184179860504
36495,1000023,1,642,569,73,0.886293,0.113707,0.886293,68,5,643,570,73,0.88647,0.11353,0.88647,68,5,1, merged,0,0,0.00776111997449
36495,1000063,3,2410,2155,255,0.894191,0.105809,2.613817,213,42,2411,2156,255,0.894235,0.105765,2.615567,213,42,1, merged,0,0,0.0118151124693
36496,1000023,1,643,570,73,0.88647,0.11353,0.88647,68,5,644,571,73,0.886646,0.113354,0.886646,68,5,1, merged,0,0,0.0022112103597
36496,1000063,3,2411,2156,255,0.894235,0.105765,2.615567,213,42,2412,2157,255,0.894279,0.105721,2.617288,213,42,1, merged,0,0,0.00309250755896
36497,1000534,2,190,139,51,0.731579,0.268421,1.615637,47,4,191,140,51,0.732984,0.267016,1.6176,47,4,-1, abandoned,0,0,0.957615380023
36507,1000023,1,644,571,73,0.886646,0.113354,0.886646,68,5,645,572,73,0.886822,0.113178,0.886822,68,5,1, merged,0,0,0.00247196938237
36509,1000012,1,462,399,63,0.863636,0.136364,0.863636,61,2,463,400,63,0.863931,0.136069,0.863931,61,2,1, merged,0,0,0.404451677431
36510,1000121,3,1644,1365,279,0.830292,0.169708,2.352192,264,15,1646,1367,279,0.830498,0.169502,2.34848,264,15,-1, merged,0,0,0.503144745842
36510,1000329,2,2576,1997,579,0.775233,0.224767,1.5219,508,71,2578,1999,579,0.775407,0.224593,1.517982,508,71,-1, merged,0,0,0.679940912742
36515,1000070,1,958,838,120,0.874739,0.125261,0.874739,101,19,959,839,120,0.87487,0.12513,0.87487,101,19,1, merged,0,0,0.0553270930769
36521,1000110,2,80,68,12,0.85,0.15,1.660811,10,2,82,69,13,0.841463,0.158537,1.657253,11,2,1, merged,1,1,0.330679432436
36521,1000140,1,74,60,14,0.810811,0.189189,0.810811,13,1,76,62,14,0.815789,0.184211,0.815789,13,1,-1, merged,0,0,0.237179078542
36528,1000063,2,2412,2157,255,0.894279,0.105721,1.730642,213,42,2413,2158,255,0.894322,0.105678,1.73216,213,42,1, merged,0,0,0.00200307351083
36531,1000121,2,1646,1367,279,0.830498,0.169502,1.390498,264,15,1647,1368,279,0.830601,0.169399,1.407524,264,15,1, merged,0,0,0.049058121598
36531,1000329,3,2578,1999,579,0.775407,0.224593,2.165905,508,71,2579,2000,579,0.775494,0.224506,2.183019,508,71,1, merged,0,0,0.052164611766
36534,1000014,1,1733,1474,259,0.850548,0.149452,0.850548,239,20,1737,1476,261,0.849741,0.150259,0.849741,241,20,1, merged,1,1,0.0780239945876
36536,1000012,3,463,400,63,0.863931,0.136069,2.425401,61,2,464,401,63,0.864224,0.135776,2.425168,61,2,1, merged,0,0,0.0501153825871
36542,1000063,2,2413,2158,255,0.894322,0.105678,1.73216,213,42,2414,2159,255,0.894366,0.105634,1.733652,213,42,1, merged,0,0,0.00628321889648
36545,1000026,2,320,294,26,0.91875,0.08125,1.864205,24,2,321,295,26,0.919003,0.080997,1.865432,24,2,1, merged,0,0,0.423401283592
36551,1000108,2,69,56,13,0.811594,0.188406,1.627384,9,4,70,57,13,0.814286,0.185714,1.632468,9,4,1, merged,0,0,0.247268534349
36551,1000140,1,76,62,14,0.815789,0.184211,0.815789,13,1,77,63,14,0.818182,0.181818,0.818182,13,1,1, merged,0,0,0.238647984835
36558,1000054,1,216,189,27,0.875,0.125,0.875,19,8,219,192,27,0.876712,0.123288,0.876712,19,8,-1, merged,0,0,0.384486426124
36558,1000132,2,279,248,31,0.888889,0.111111,1.763889,23,8,280,249,31,0.889286,0.110714,1.765998,23,8,1, merged,0,0,0.234657116678
36562,1000026,2,321,295,26,0.919003,0.080997,1.8321,24,2,322,296,26,0.919255,0.080745,1.832564,24,2,1, merged,0,0,0.422217201472
36562,1000153,1,817,746,71,0.913097,0.086903,0.913097,56,15,819,748,71,0.913309,0.086691,0.913309,56,15,-1, merged,0,0,0.217842984757
36566,1000132,2,281,250,31,0.88968,0.11032,1.665174,23,8,282,251,31,0.890071,0.109929,1.665652,23,8,1, merged,0,0,0.309365246018
36566,1000329,1,2579,2000,579,0.775494,0.224506,0.775494,508,71,2580,2001,579,0.775581,0.224419,0.775581,508,71,1, merged,0,0,0.311996774089
36569,1000109,1,394,332,62,0.84264,0.15736,0.84264,59,3,395,333,62,0.843038,0.156962,0.843038,59,3,1, merged,0,0,0.00979823383168
36569,1000153,3,819,748,71,0.913309,0.086691,2.641324,56,15,820,749,71,0.913415,0.086585,2.642279,56,15,1, merged,0,0,0.0666429346858
36572,1000070,2,961,841,120,0.87513,0.12487,1.57513,101,19,962,842,120,0.87526,0.12474,1.589546,101,19,1, merged,0,0,0.0942512880822
36574,1000109,1,395,333,62,0.843038,0.156962,0.843038,59,3,396,334,62,0.843434,0.156566,0.843434,59,3,1, merged,0,0,0.293837236811
36574,1000199,2,353,298,55,0.844193,0.155807,1.687231,50,5,354,299,55,0.844633,0.155367,1.688067,50,5,1, merged,0,0,0.301171272146
36575,1000121,1,1647,1368,279,0.830601,0.169399,0.830601,264,15,1649,1369,280,0.8302,0.1698,0.8302,265,15,-1, merged,1,0,0.0614681141245
36590,1000005,2,272,211,61,0.775735,0.224265,1.6617,55,6,274,213,61,0.777372,0.222628,1.655633,55,6,-1, merged,0,0,0.0142479926389
36591,1000005,2,274,213,61,0.777372,0.222628,1.655633,55,6,276,213,63,0.771739,0.228261,1.642429,57,6,1, abandoned,1,1,0
36591,1000130,3,316,264,52,0.835443,0.164557,2.491076,41,11,317,264,53,0.832808,0.167192,2.475236,42,11,1, abandoned,1,1,0
36592,1000329,1,2580,2001,579,0.775581,0.224419,0.775581,508,71,2581,2002,579,0.775668,0.224332,0.775668,508,71,1, merged,0,0,0.00395778364116
36597,1000329,1,2581,2002,579,0.775668,0.224332,0.775668,508,71,2582,2003,579,0.775755,0.224245,0.775755,508,71,1, merged,0,0,0.00417743088001
36599,1000327,1,639,503,136,0.787167,0.212833,0.787167,105,31,640,504,136,0.7875,0.2125,0.7875,105,31,-1, merged,0,0,0.701385165326
36599,1000329,3,2582,2003,579,0.775755,0.224245,2.340031,508,71,2588,2009,579,0.776275,0.223725,2.342218,508,71,-1, merged,0,0,0.677353841577
36600,1000120,2,1104,934,170,0.846014,0.153986,1.448579,149,21,1105,935,170,0.846154,0.153846,1.449988,149,21,1, merged,0,0,0.38635286044
36600,1000130,3,317,264,53,0.832808,0.167192,2.281386,42,11,318,265,53,0.833333,0.166667,2.283321,42,11,1, merged,0,0,0.496919410993
36600,1002169,1,312,188,124,0.602564,0.397436,0.602564,121,3,313,189,124,0.603834,0.396166,0.603834,121,3,-1, merged,0,0,0
36602,1000063,1,2414,2159,255,0.894366,0.105634,0.894366,213,42,2415,2160,255,0.89441,0.10559,0.89441,213,42,-1, merged,0,0,0.324041102437
36602,1000329,2,2588,2009,579,0.776275,0.223725,1.670641,508,71,2590,2011,579,0.776448,0.223552,1.670858,508,71,-1, merged,0,0,0.238885552022
36605,1000023,1,646,573,73,0.886997,0.113003,0.886997,68,5,647,574,73,0.887172,0.112828,0.887172,68,5,1, merged,0,0,0.317223704128
36608,1000023,2,647,574,73,0.887172,0.112828,1.726457,68,5,648,575,73,0.887346,0.112654,1.728054,68,5,1, merged,0,0,0.00282824571277
36609,1000023,2,648,575,73,0.887346,0.112654,1.728054,68,5,649,576,73,0.887519,0.112481,1.729625,68,5,1, merged,0,0,0.00789430137498
36610,1000023,1,649,576,73,0.887519,0.112481,0.887519,68,5,650,577,73,0.887692,0.112308,0.887692,68,5,1, merged,0,0,0.00793909961652
36610,1000063,3,2416,2161,255,0.894454,0.105546,2.624078,213,42,2417,2162,255,0.894497,0.105503,2.625668,213,42,1, merged,0,0,0.0119586475039
36611,1000023,2,650,577,73,0.887692,0.112308,1.731171,68,5,651,578,73,0.887865,0.112135,1.732692,68,5,1, merged,0,0,0.00798389685265
36612,1000023,1,651,578,73,0.887865,0.112135,0.887865,68,5,652,579,73,0.888037,0.111963,0.888037,68,5,1, merged,0,0,0.000116781579367
36612,1000063,2,2417,2162,255,0.894497,0.105503,1.782362,213,42,2418,2163,255,0.894541,0.105459,1.782578,213,42,1, merged,0,0,0.000130923083804
36613,1000063,1,2418,2163,255,0.894541,0.105459,0.894541,213,42,2420,2165,255,0.894628,0.105372,0.894628,213,42,-1, merged,0,0,0.00634841467759
36616,1000120,2,1105,935,170,0.846154,0.153846,1.56044,149,21,1106,936,170,0.846293,0.153707,1.566293,149,21,1, merged,0,0,0.0661323049627
36617,1000592,2,543,458,85,0.843462,0.156538,1.563462,53,32,544,459,85,0.84375,0.15625,1.574519,53,32,1, merged,0,0,0.150461570379
36620,1000004,2,2546,2264,282,0.889238,0.110762,1.735531,220,62,2548,2266,282,0.889325,0.110675,1.734853,220,62,-1, merged,0,0,0
36620,1000120,1,1106,936,170,0.846293,0.153707,0.846293,149,21,1107,936,171,0.845528,0.154472,0.845528,150,21,1, merged,1,1,0
36621,1000004,2,2548,2266,282,0.889325,0.110675,1.734853,220,62,2550,2268,282,0.889412,0.110588,1.735219,220,62,-1, merged,0,0,0.400499984725
36621,1000120,1,1107,936,171,0.845528,0.154472,0.845528,150,21,1109,938,171,0.845807,0.154193,0.845807,150,21,-1, merged,0,0,0.386494889381
36626,1000329,2,2590,2011,579,0.776448,0.223552,1.555552,508,71,2591,2012,579,0.776534,0.223466,1.553982,508,71,-1, abandoned,0,0,0
36633,1000023,1,652,579,73,0.888037,0.111963,0.888037,68,5,653,580,73,0.888208,0.111792,0.888208,68,5,1, merged,0,0,0.00261951722438
36634,1000014,1,1738,1477,261,0.849827,0.150173,0.849827,241,20,1739,1478,261,0.849914,0.150086,0.849914,241,20,1, merged,0,0,0.0510627515144
36634,1000070,2,962,842,120,0.87526,0.12474,1.725087,101,19,963,843,120,0.875389,0.124611,1.725303,101,19,1, merged,0,0,0.0618698656963
36642,1000023,2,653,580,73,0.888208,0.111792,1.888208,68,5,654,581,73,0.888379,0.111621,1.763379,68,5,1, merged,0,0,1.2273640058e-06
36642,1000121,4,1653,1372,281,0.830006,0.169994,3.566699,265,16,1654,1373,281,0.830109,0.169891,3.443488,265,16,1, merged,0,0,5.00504762104e-06
36643,1000329,2,2591,2012,579,0.776534,0.223466,1.626534,508,71,2592,2012,580,0.776235,0.223765,1.630603,509,71,1, merged,1,1,0.00461614551849
36645,1000023,2,654,581,73,0.888379,0.111621,1.742748,68,5,655,582,73,0.88855,0.11145,1.736169,68,5,1, merged,0,0,0.00265099769332
36654,1000153,1,830,758,72,0.913253,0.086747,0.913253,57,15,832,759,73,0.91226,0.08774,0.91226,58,15,1, merged,1,1,0
36656,1000009,3,945,791,154,0.837037,0.162963,2.406356,138,16,946,792,154,0.837209,0.162791,2.408703,138,16,1, merged,0,0,0.627481360671
36656,1000109,1,397,335,62,0.843829,0.156171,0.843829,59,3,398,336,62,0.844221,0.155779,0.844221,59,3,1, merged,0,0,0.151920335387
36658,1000109,2,398,336,62,0.844221,0.155779,1.571494,59,3,399,337,62,0.844612,0.155388,1.573644,59,3,1, merged,0,0,0.151969715394
36659,1000009,2,946,792,154,0.837209,0.162791,0.837209,138,16,947,793,154,0.837381,0.162619,1.837381,138,16,1, merged,0,0,0.477680029859
36661,1000014,2,1739,1478,261,0.849914,0.150086,1.349914,241,20,1740,1479,261,0.85,0.15,1.516667,241,20,1, merged,0,0,0.0584486403382
36662,1000120,2,1110,939,171,0.845946,0.154054,1.7303,150,21,1111,940,171,0.846085,0.153915,1.73122,150,21,1, merged,0,0,0
36676,1000109,2,399,337,62,0.844612,0.155388,1.72492,59,3,400,338,62,0.845,0.155,1.725769,59,3,1, merged,0,0,0.000236767066701
36679,1000004,2,2550,2268,282,0.889412,0.110588,1.703697,220,62,2551,2269,282,0.889455,0.110545,1.706357,220,62,1, merged,0,0,0.0366986497255
36679,1000108,1,70,57,13,0.814286,0.185714,0.814286,9,4,71,58,13,0.816901,0.183099,0.816901,9,4,1, merged,0,0,0.000305390135899
36683,1000026,1,322,296,26,0.919255,0.080745,0.919255,24,2,323,297,26,0.919505,0.080495,0.919505,24,2,-1, abandoned,0,0,0.599159093283
36683,1000153,2,832,759,73,0.91226,0.08774,1.831514,58,15,833,760,73,0.912365,0.087635,1.83187,58,15,-1, abandoned,0,0,0.0334432406971
36687,1000009,2,948,794,154,0.837553,0.162447,1.566585,138,16,949,795,154,0.837724,0.162276,1.568493,138,16,1, merged,0,0,0.125560327768
36690,1000009,2,949,795,154,0.837724,0.162276,1.568493,138,16,950,796,154,0.837895,0.162105,1.578635,138,16,1, merged,0,0,1.14783951849
36692,1000004,1,2551,2269,282,0.889455,0.110545,0.889455,220,62,2552,2269,283,0.889107,0.110893,0.889107,221,62,1, merged,1,1,0.0244606251696
36695,1000153,2,833,760,73,0.912365,0.087635,1.739355,58,15,834,761,73,0.91247,0.08753,1.736608,58,15,1, merged,0,0,0.3012530224
36695,1000166,1,289,239,50,0.82699,0.17301,0.82699,47,3,290,239,51,0.824138,0.175862,0.824138,48,3,1, merged,1,1,0.361487696774
36697,1000153,2,834,761,73,0.91247,0.08753,1.643239,58,15,835,762,73,0.912575,0.087425,1.638689,58,15,-1, abandoned,0,0,0.372504541615
36698,1000014,3,1741,1480,261,0.850086,0.149914,2.515613,241,20,1742,1481,261,0.850172,0.149828,2.50574,241,20,1, merged,0,0,0
36701,1000007,2,1206,972,234,0.80597,0.19403,1.532085,208,26,1207,973,234,0.806131,0.193869,1.52765,208,26,-1, abandoned,0,0,1.29249822134
36702,1000592,2,545,460,85,0.844037,0.155963,1.621485,53,32,546,461,85,0.844322,0.155678,1.622429,53,32,1, merged,0,0,0.158151197255
36710,1000007,1,1207,973,234,0.806131,0.193869,0.806131,208,26,1208,974,234,0.806291,0.193709,0.806291,208,26,-1, abandoned,0,0,1.21705596931
36717,1000004,1,2552,2269,283,0.889107,0.110893,0.889107,221,62,2554,2271,283,0.889193,0.110807,0.889193,221,62,1, merged,0,0,0.0610721809271
36724,1000140,2,77,63,14,0.818182,0.181818,1.741259,13,1,78,64,14,0.820513,0.179487,1.695513,13,1,1, merged,0,0,0.0880690161527
36737,1000070,2,964,843,121,0.874481,0.125519,1.488695,102,19,965,843,122,0.873575,0.126425,1.484686,103,19,1, abandoned,1,1,0
36739,1000014,1,1742,1481,261,0.850172,0.149828,0.850172,241,20,1744,1481,263,0.849197,0.150803,0.849197,242,21,1, merged,1,1,0
36739,1000070,4,965,843,122,0.873575,0.126425,3.341688,103,19,967,845,122,0.873837,0.126163,3.339348,103,19,-1, merged,0,0,0.149178038836
36739,1000121,3,1654,1373,281,0.830109,0.169891,2.468113,265,16,1656,1374,282,0.82971,0.17029,2.465512,266,16,1, merged,1,1,0
36739,1000327,2,641,505,136,0.787832,0.212168,1.638004,105,31,642,505,137,0.786604,0.213396,1.635802,106,31,1, merged,1,1,0
36742,1000023,2,655,582,73,0.88855,0.11145,1.696242,68,5,656,583,73,0.88872,0.11128,1.70004,68,5,1, merged,0,0,0.00286880198829
36743,1000023,2,656,583,73,0.88872,0.11128,1.740571,68,5,657,584,73,0.888889,0.111111,1.746032,68,5,1, merged,0,0,0.000555442714872
36744,1000012,1,469,405,64,0.863539,0.136461,0.863539,62,2,470,406,64,0.86383,0.13617,0.86383,62,2,1, merged,0,0,0.0327579202313
36744,1000026,2,323,297,26,0.919505,0.080495,1.783044,24,2,324,298,26,0.919753,0.080247,1.783583,24,2,1, merged,0,0,0.0908422284781
36745,1000012,2,470,406,64,0.86383,0.13617,1.710053,62,2,471,407,64,0.864119,0.135881,1.708823,62,2,1, merged,0,0,0.77581032413
36745,1000120,1,1112,941,171,0.846223,0.153777,0.846223,150,21,1114,941,173,0.844704,0.155296,0.844704,152,21,1, merged,1,1,0.311840903245
36747,1000043,2,397,330,67,0.831234,0.168766,1.259806,57,10,398,331,67,0.831658,0.168342,1.276103,57,10,1, merged,0,0,0.865520375701
36748,1000023,1,657,584,73,0.888889,0.111111,0.888889,68,5,659,586,73,0.889226,0.110774,0.889226,68,5,1, merged,0,0,0.00299168261858
36757,1000043,1,398,331,67,0.831658,0.168342,0.831658,57,10,399,331,68,0.829574,0.170426,0.829574,58,10,1, merged,1,1,0.0921125826263
36757,1000121,2,1656,1374,282,0.82971,0.17029,1.661368,266,16,1660,1376,284,0.828916,0.171084,1.65849,268,16,-1, merged,1,0,0.0661844990239
36759,1000007,2,1213,979,234,0.80709,0.19291,1.660031,208,26,1214,980,234,0.807249,0.192751,1.664392,208,26,1, merged,0,0,0.715095547023
36763,1000043,1,399,331,68,0.829574,0.170426,0.829574,58,10,400,331,69,0.8275,0.1725,0.8275,59,10,1, abandoned,1,1,0.864623871236
36764,1000023,1,659,586,73,0.889226,0.110774,0.889226,68,5,662,587,75,0.886707,0.113293,0.886707,70,5,1, merged,1,1,0.0030587115912
36770,1000329,2,2601,2021,580,0.777009,0.222991,1.555115,509,71,2602,2022,580,0.777095,0.222905,1.555856,509,71,1, merged,0,0,0
36774,1000014,2,1744,1481,263,0.849197,0.150803,1.668642,242,21,1750,1485,265,0.848571,0.151429,1.666753,244,21,-1, merged,1,0,0.0814473893913
36774,1000043,6,400,331,69,0.8275,0.1725,4.668553,59,10,401,332,69,0.82793,0.17207,4.65451,59,10,1, merged,0,0,0.0944510018657
36774,1000108,1,72,59,13,0.819444,0.180556,0.819444,9,4,77,63,14,0.818182,0.181818,0.818182,10,4,-1, merged,1,0,0.0725701381043
36774,1000110,5,85,72,13,0.847059,0.152941,3.841053,11,2,89,74,15,0.831461,0.168539,3.82658,13,2,1, merged,1,1,0.0990771254269
36774,1002169,4,313,189,124,0.603834,0.396166,2.993995,121,3,314,190,124,0.605096,0.394904,2.995119,121,3,-1, merged,0,0,0
36775,1000004,2,2554,2271,283,0.889193,0.110807,1.709706,221,62,2555,2272,283,0.889237,0.110763,1.701737,221,62,-1, abandoned,0,0,0.491497395132
36775,1000140,1,78,64,14,0.820513,0.179487,0.820513,13,1,80,65,15,0.8125,0.1875,0.8125,14,1,1, abandoned,1,1,0.118152632544
36778,1000023,1,662,587,75,0.886707,0.113293,0.886707,70,5,663,588,75,0.886878,0.113122,0.886878,70,5,1, merged,0,0,0.000109078430131
36779,1000120,1,1116,943,173,0.844982,0.155018,0.844982,152,21,1117,943,174,0.844226,0.155774,0.844226,153,21,1, merged,1,1,0.449003106167
36781,1000014,2,1750,1485,265,0.848571,0.151429,1.627332,244,21,1753,1487,266,0.84826,0.15174,1.628319,245,21,1, merged,1,1,0.300528220841
36789,1000007,2,1218,983,235,0.807061,0.192939,1.645126,208,27,1219,984,235,0.807219,0.192781,1.645454,208,27,1, merged,0,0,0.0813083465108
36789,1000009,1,951,797,154,0.838065,0.161935,0.838065,138,16,952,798,154,0.838235,0.161765,0.838235,138,16,-1, merged,0,0,0.0770020681718
36789,1000153,3,836,763,73,0.912679,0.087321,2.557805,58,15,837,764,73,0.912784,0.087216,2.558238,58,15,1, merged,0,0,0.0720819546787
36791,1000007,1,1219,984,235,0.807219,0.192781,0.807219,208,27,1221,985,236,0.806716,0.193284,0.806716,209,27,1, merged,1,1,1.29469959307
36791,1000009,2,952,798,154,0.838235,0.161765,1.645454,138,16,953,799,154,0.838405,0.161595,1.645121,138,16,1, merged,0,0,1.23718260973
36801,1000091,3,443,341,102,0.769752,0.230248,2.483639,87,15,444,342,102,0.77027,0.22973,2.486589,87,15,1, merged,0,0,0.018224819143
36801,1000592,2,546,461,85,0.844322,0.155678,1.713888,53,32,548,463,85,0.844891,0.155109,1.716319,53,32,1, merged,0,0,0.000527426160338
36802,1000329,1,2603,2023,580,0.77718,0.22282,0.77718,509,71,2605,2025,580,0.777351,0.222649,0.777351,509,71,-1, merged,0,0,0
36804,1000015,2,1663,1492,171,0.897174,0.102826,1.831956,159,12,1664,1493,171,0.897236,0.102764,1.815603,159,12,1, merged,0,0,0.147266743591
36806,1000132,4,283,252,31,0.890459,0.109541,1.670518,23,8,284,253,31,0.890845,0.109155,1.669271,23,8,1, merged,0,0,0.621110982792
36812,1000328,1,781,570,211,0.729834,0.270166,0.729834,188,23,782,571,211,0.730179,0.269821,0.730179,188,23,1, merged,0,0,0.164352567039
36812,1000592,2,548,463,85,0.844891,0.155109,1.574724,53,32,549,464,85,0.845173,0.154827,1.575352,53,32,1, merged,0,0,0.101099973783
36815,1000014,2,1755,1489,266,0.848433,0.151567,1.707588,245,21,1756,1490,266,0.848519,0.151481,1.70963,245,21,1, merged,0,0,0.690662766162
36816,1000014,3,1756,1490,266,0.848519,0.151481,2.597048,245,21,1757,1491,266,0.848606,0.151394,2.599777,245,21,1, merged,0,0,0.690980147693
36820,1000153,1,837,764,73,0.912784,0.087216,0.912784,58,15,838,764,74,0.911695,0.088305,0.911695,59,15,1, merged,1,1,0
36821,1000110,2,90,75,15,0.833333,0.166667,1.645833,13,2,91,76,15,0.835165,0.164835,1.652238,13,2,1, merged,0,0,0
36821,1000140,1,80,65,15,0.8125,0.1875,0.8125,14,1,82,67,15,0.817073,0.182927,0.817073,14,1,-1, merged,0,0,0
36828,1000014,1,1758,1492,266,0.848692,0.151308,0.848692,245,21,1760,1493,267,0.848295,0.151705,0.848295,246,21,1, merged,1,1,0.165470141657
36830,1000329,5,2607,2027,580,0.777522,0.222478,3.720348,509,71,2608,2028,580,0.777607,0.222393,3.726756,509,71,1, merged,0,0,0.24389055776
36833,1000121,2,1661,1377,284,0.829019,0.170981,1.557625,268,16,1662,1378,284,0.829122,0.170878,1.55839,268,16,1, merged,0,0,0.417887034452
36840,1000063,2,2426,2169,257,0.894064,0.105936,1.740218,214,43,2427,2170,257,0.894108,0.105892,1.741566,214,43,1, merged,0,0,0.00989892566151
36849,1000063,2,2427,2170,257,0.894108,0.105892,1.741566,214,43,2428,2171,257,0.894152,0.105848,1.742891,214,43,1, merged,0,0,0.000297681109489
36851,1000023,2,663,588,75,0.886878,0.113122,1.701693,70,5,664,589,75,0.887048,0.112952,1.70523,70,5,1, merged,0,0,0.00338170467005
36852,1000023,2,664,589,75,0.887048,0.112952,1.753715,70,5,665,590,75,0.887218,0.112782,1.758186,70,5,1, merged,0,0,0.00168185807176
36854,1000023,1,665,590,75,0.887218,0.112782,0.887218,70,5,666,591,75,0.887387,0.112613,0.887387,70,5,1, merged,0,0,0.00688660015706
36854,1000063,2,2428,2171,257,0.894152,0.105848,1.78137,214,43,2429,2172,257,0.894195,0.105805,1.781583,214,43,1, merged,0,0,0.00654334514485
36858,1000014,3,1761,1494,267,0.848382,0.151618,2.521483,246,21,1762,1494,268,0.8479,0.1521,2.492578,247,21,1, abandoned,1,1,0.0461945364465
36858,1000023,2,666,591,75,0.887387,0.112613,1.673102,70,5,667,591,76,0.886057,0.113943,1.644678,71,5,1, abandoned,1,1,0.0609910286197
36859,1000003,2,937,784,153,0.836713,0.163287,1.575275,138,15,938,785,153,0.836887,0.163113,1.576301,138,15,1, merged,0,0,0.548756420469
36859,1000014,3,1762,1494,268,0.8479,0.1521,2.423175,247,21,1763,1495,268,0.847986,0.152014,2.424287,247,21,1, merged,0,0,0.546179163302
36860,1000063,2,2429,2172,257,0.894195,0.105805,1.742935,214,43,2430,2173,257,0.894239,0.105761,1.744239,214,43,1, merged,0,0,0.00618012403591
36863,1000014,2,1763,1495,268,0.847986,0.152014,1.461052,247,21,1764,1496,268,0.848073,0.151927,1.464988,247,21,1, merged,0,0,0.0403977050174
36863,1000043,4,402,333,69,0.828358,0.171642,3.163507,59,10,403,334,69,0.828784,0.171216,3.167999,59,10,1, merged,0,0,0.0465606170358
36863,1000070,3,969,847,122,0.874097,0.125903,2.335149,103,19,970,848,122,0.874227,0.125773,2.339215,103,19,1, merged,0,0,0.0487892561752
36868,1000108,2,77,63,14,0.818182,0.181818,1.484848,10,4,78,64,14,0.820513,0.179487,1.570513,10,4,1, merged,0,0,0.138949605343
36874,1000054,2,223,196,27,0.878924,0.121076,1.703062,19,8,224,197,27,0.879464,0.120536,1.70077,19,8,-1, abandoned,0,0,0
36874,1000166,1,290,239,51,0.824138,0.175862,0.824138,48,3,291,239,52,0.821306,0.178694,0.821306,49,3,1, abandoned,1,1,0
36882,1000109,1,400,338,62,0.845,0.155,0.845,59,3,401,339,62,0.845387,0.154613,0.845387,59,3,1, merged,0,0,0.0237669887181
36886,1000054,2,225,198,27,0.88,0.12,1.701306,19,8,226,199,27,0.880531,0.119469,1.702449,19,8,1, merged,0,0,0.104817832303
36886,1000166,1,291,239,52,0.821306,0.178694,0.821306,49,3,292,240,52,0.821918,0.178082,0.821918,49,3,1, merged,0,0,0.0781029411501
36887,1000026,3,324,298,26,0.919753,0.080247,2.637504,24,2,325,299,26,0.92,0.08,2.625711,24,2,1, merged,0,0,0.064580154432
36887,1000054,4,226,199,27,0.880531,0.119469,3.518035,19,8,227,200,27,0.881057,0.118943,3.506768,19,8,1, merged,0,0,0.0550408682655
36887,1000166,1,292,240,52,0.821918,0.178082,0.821918,49,3,293,240,53,0.819113,0.180887,0.819113,50,3,1, merged,1,1,0.0345781960294
36889,1000009,1,953,799,154,0.838405,0.161595,0.838405,138,16,954,799,155,0.837526,0.162474,0.837526,139,16,1, abandoned,1,1,0
36889,1000153,2,838,764,74,0.911695,0.088305,1.7501,59,15,839,765,74,0.9118,0.0882,1.749326,59,15,-1, abandoned,0,0,0
36897,1000014,2,1764,1496,268,0.848073,0.151927,1.722299,247,21,1765,1497,268,0.848159,0.151841,1.722515,247,21,1, merged,0,0,0.503757013517
36897,1000070,1,970,848,122,0.874227,0.125773,0.874227,103,19,971,849,122,0.874356,0.125644,0.874356,103,19,1, merged,0,0,0.606196204689
36907,1000015,2,1667,1496,171,0.897421,0.102579,1.779773,159,12,1668,1496,172,0.896882,0.103118,1.730216,160,12,1, merged,1,1,0.147375171505
36908,1000015,2,1668,1496,172,0.896882,0.103118,1.730216,160,12,1670,1497,173,0.896407,0.103593,1.685881,161,12,1, merged,1,1,0.205461881191
36912,1000063,1,2430,2173,257,0.894239,0.105761,0.894239,214,43,2432,2175,257,0.894326,0.105674,0.894326,214,43,-1, merged,0,0,0.00656372522993
36915,1000054,2,235,207,28,0.880851,0.119149,1.699964,20,8,236,208,28,0.881356,0.118644,1.701084,20,8,1, merged,0,0,0.224944578834
36915,1000166,1,293,240,53,0.819113,0.180887,0.819113,50,3,294,241,53,0.819728,0.180272,0.819728,50,3,1, merged,0,0,0.153408711463
36916,1000110,2,91,76,15,0.835165,0.164835,1.61359,13,2,92,77,15,0.836957,0.163043,1.616026,13,2,1, merged,0,0,0.686484520046
36922,1000054,1,238,210,28,0.882353,0.117647,0.882353,20,8,239,211,28,0.882845,0.117155,0.882845,20,8,1, merged,0,0,0
36922,1000166,2,294,241,53,0.819728,0.180272,1.702081,50,3,295,242,53,0.820339,0.179661,1.703184,50,3,1, merged,0,0,0
36932,1000132,2,286,255,31,0.891608,0.108392,1.670978,23,8,287,256,31,0.891986,0.108014,1.670395,23,8,1, merged,0,0,0.983867325065
36935,1000011,2,589,547,42,0.928693,0.071307,1.773058,39,3,590,548,42,0.928814,0.071186,1.773318,39,3,1, merged,0,0,0.110446363246
36935,1000120,1,1118,944,174,0.844365,0.155635,0.844365,153,21,1119,945,174,0.844504,0.155496,0.844504,153,21,-1, merged,0,0,0.086598844982
36956,1000004,2,2556,2273,283,0.88928,0.11072,1.734062,221,62,2557,2274,283,0.889323,0.110677,1.734243,221,62,1, merged,0,0,0.00480930110683
36956,1000120,1,1121,947,174,0.844781,0.155219,0.844781,153,21,1122,948,174,0.84492,0.15508,0.84492,153,21,-1, merged,0,0,0.0168133750998
36959,1000130,2,320,267,53,0.834375,0.165625,1.67983,42,11,321,268,53,0.834891,0.165109,1.680905,42,11,1, merged,0,0,0.256212240571
36959,1000592,1,550,465,85,0.845455,0.154545,0.845455,53,32,552,467,85,0.846014,0.153986,0.846014,53,32,-1, merged,0,0,0.324553271336
36971,1000120,2,1122,948,174,0.84492,0.15508,1.84492,153,21,1124,949,175,0.844306,0.155694,1.344306,154,21,1, merged,1,1,0.0012542917408
36972,1000063,2,2432,2175,257,0.894326,0.105674,1.745565,214,43,2433,2176,257,0.894369,0.105631,1.746828,214,43,1, merged,0,0,0.00782690542435
36973,1000063,2,2433,2176,257,0.894369,0.105631,1.746828,214,43,2434,2177,257,0.894412,0.105588,1.748071,214,43,1, merged,0,0,0.00393156044319
36974,1000063,2,2434,2177,257,0.894412,0.105588,1.748071,214,43,2435,2178,257,0.894456,0.105544,1.749295,214,43,1, merged,0,0,0.00791731830846
36976,1000023,2,668,592,76,0.886228,0.113772,1.780683,71,5,669,592,77,0.884903,0.115097,1.779035,72,5,1, merged,1,1,0.000391512019419
36976,1000063,1,2435,2178,257,0.894456,0.105544,0.894456,214,43,2437,2179,258,0.894132,0.105868,0.894132,215,43,1, merged,1,1,0.000317187004395
36978,1000329,3,2608,2028,580,0.777607,0.222393,2.457369,509,71,2609,2029,580,0.777693,0.222307,2.461758,509,71,1, merged,0,0,0.00483118309086
36979,1000004,1,2562,2278,284,0.889149,0.110851,0.889149,222,62,2563,2279,284,0.889192,0.110808,0.889192,222,62,-1, abandoned,0,0,0.169605704991
36986,1000023,1,669,592,77,0.884903,0.115097,0.884903,72,5,670,593,77,0.885075,0.114925,0.885075,72,5,-1, merged,0,0,0.00447208581751
36992,1000023,1,670,593,77,0.885075,0.114925,0.885075,72,5,671,594,77,0.885246,0.114754,0.885246,72,5,-1, merged,0,0,0.000451285807656
36992,1000063,2,2437,2179,258,0.894132,0.105868,1.779207,215,43,2439,2181,258,0.894219,0.105781,1.779465,215,43,-1, merged,0,0,0.000559106146978
36993,1000110,1,92,77,15,0.836957,0.163043,0.836957,13,2,93,78,15,0.83871,0.16129,0.83871,13,2,1, merged,0,0,0.680571829152
36993,1000140,2,83,68,15,0.819277,0.180723,1.656234,14,1,84,69,15,0.821429,0.178571,1.660138,14,1,1, merged,0,0,0.485777987207
36997,1000023,1,671,594,77,0.885246,0.114754,0.885246,72,5,672,595,77,0.885417,0.114583,0.885417,72,5,1, merged,0,0,0.000480833743347
36997,1000063,2,2439,2181,258,0.894219,0.105781,1.779465,215,43,2440,2182,258,0.894262,0.105738,1.779679,215,43,1, merged,0,0,0.000389580973952
36999,1000140,3,84,69,15,0.821429,0.178571,2.472548,14,1,85,70,15,0.823529,0.176471,2.424837,14,1,-1, abandoned,0,0,0.140957349442
37005,1000054,2,240,212,28,0.883333,0.116667,1.704279,20,8,241,213,28,0.883817,0.116183,1.701999,20,8,-1, abandoned,0,0,0
37005,1000166,1,296,243,53,0.820946,0.179054,0.820946,50,3,297,243,54,0.818182,0.181818,0.818182,51,3,1, abandoned,1,1,0
37006,1000004,1,2568,2283,285,0.889019,0.110981,0.889019,223,62,2570,2285,285,0.889105,0.110895,0.889105,223,62,-1, merged,0,0,0.00508214029409
37012,1000329,2,2609,2029,580,0.777693,0.222307,1.557974,509,71,2610,2029,581,0.777395,0.222605,1.556106,510,71,1, abandoned,1,1,0
37023,1000130,2,321,268,53,0.834891,0.165109,1.650327,42,11,322,269,53,0.835404,0.164596,1.651457,42,11,1, merged,0,0,0
37023,1000166,1,298,243,55,0.815436,0.184564,0.815436,52,3,299,244,55,0.816054,0.183946,0.816054,52,3,1, merged,0,0,0
37024,1000130,2,322,269,53,0.835404,0.164596,1.651457,42,11,323,270,53,0.835913,0.164087,1.65258,42,11,1, merged,0,0,0
37024,1000166,1,299,244,55,0.816054,0.183946,0.816054,52,3,300,245,55,0.816667,0.183333,0.816667,52,3,1, merged,0,0,0
37025,1000130,2,323,270,53,0.835913,0.164087,1.65258,42,11,324,271,53,0.83642,0.16358,1.653696,42,11,1, merged,0,0,0
37025,1000166,1,300,245,55,0.816667,0.183333,0.816667,52,3,301,246,55,0.817276,0.182724,0.817276,52,3,1, merged,0,0,0
37026,1000130,2,324,271,53,0.83642,0.16358,1.653696,42,11,325,272,53,0.836923,0.163077,1.654804,42,11,1, merged,0,0,0
37026,1000166,1,301,246,55,0.817276,0.182724,0.817276,52,3,302,247,55,0.817881,0.182119,0.817881,52,3,1, merged,0,0,0
37030,1000004,1,2570,2285,285,0.889105,0.110895,0.889105,223,62,2571,2286,285,0.889148,0.110852,0.889148,223,62,1, merged,0,0,0.0111076306922
37035,1000003,3,938,785,153,0.836887,0.163113,1.305637,138,15,939,786,153,0.837061,0.162939,2.018013,138,15,1, merged,0,0,0.0885780253876
37042,1000003,2,939,786,153,0.837061,0.162939,1.595681,138,15,941,787,154,0.836344,0.163656,1.569678,139,15,1, merged,1,1,0.0921199514344
37057,1000121,1,1670,1385,285,0.829341,0.170659,0.829341,269,16,1671,1386,285,0.829443,0.170557,0.829443,269,16,-1, abandoned,0,0,0.153695174449
37057,1000329,2,2611,2030,581,0.77748,0.22252,1.606821,510,71,2612,2031,581,0.777565,0.222435,1.607009,510,71,-1, abandoned,0,0,0.172360015895
37071,1000108,2,78,64,14,0.820513,0.179487,1.264957,10,4,79,64,15,0.810127,0.189873,1.242559,11,4,1, abandoned,1,1,0
37074,1000120,2,1127,952,175,0.84472,0.15528,1.513432,154,21,1128,953,175,0.844858,0.155142,1.51559,154,21,1, merged,0,0,0.0209084354722
37084,1002169,1,315,191,124,0.606349,0.393651,0.606349,121,3,316,192,124,0.607595,0.392405,0.607595,121,3,-1, merged,0,0,0
37085,1000592,8,552,467,85,0.846014,0.153986,6.209294,53,32,553,468,85,0.846293,0.153707,5.683534,53,32,1, merged,0,0,0
37085,1002169,1,316,192,124,0.607595,0.392405,0.607595,121,3,318,194,124,0.610063,0.389937,0.610063,121,3,-1, merged,0,0,0
37086,1000592,5,553,468,85,0.846293,0.153707,3.499503,53,32,554,469,85,0.84657,0.15343,3.676305,53,32,1, merged,0,0,0
37091,1000004,2,2573,2287,286,0.888846,0.111154,1.666581,223,63,2574,2288,286,0.888889,0.111111,1.666709,223,63,1, merged,0,0,0
37091,1000329,1,2614,2033,581,0.777735,0.222265,0.777735,510,71,2615,2034,581,0.77782,0.22218,0.77782,510,71,1, merged,0,0,0
37092,1000063,2,2440,2182,258,0.894262,0.105738,1.677824,215,43,2441,2183,258,0.894306,0.105694,1.678459,215,43,1, merged,0,0,0.1061984828
37100,1000592,3,554,469,85,0.84657,0.15343,2.228846,53,32,556,471,85,0.847122,0.152878,2.214958,53,32,-1, merged,0,0,0
37104,1000004,1,2575,2289,286,0.888932,0.111068,0.888932,223,63,2577,2290,287,0.88863,0.11137,0.88863,223,64,-1, merged,1,1,0.065385112405
37104,1000121,2,1674,1389,285,0.829749,0.170251,1.718681,269,16,1675,1390,285,0.829851,0.170149,1.718481,269,16,1, merged,0,0,0.0677932682186
37112,1000328,3,785,573,212,0.729936,0.270064,2.292274,189,23,787,575,212,0.730623,0.269377,2.279301,189,23,1, merged,0,0,0.681284396847
37114,1000130,2,325,272,53,0.836923,0.163077,1.711923,42,11,326,272,54,0.834356,0.165644,1.657885,42,12,-1, merged,1,1,0
37118,1000121,3,1676,1391,285,0.829952,0.170048,2.532538,269,16,1677,1392,285,0.830054,0.169946,2.549451,269,16,1, merged,0,0,0.0469638428423
37119,1000063,1,2441,2183,258,0.894306,0.105694,0.894306,215,43,2442,2184,258,0.894349,0.105651,0.894349,215,43,1, merged,0,0,0.175014938709
37127,1000121,1,1677,1392,285,0.830054,0.169946,0.830054,269,16,1678,1393,285,0.830155,0.169845,0.830155,269,16,1, merged,0,0,0.463126881385
37127,1000132,2,292,261,31,0.893836,0.106164,1.723889,23,8,293,262,31,0.894198,0.105802,1.724353,23,8,1, merged,0,0,1.01659820478
37130,1000121,3,1678,1393,285,0.830155,0.169845,2.511415,269,16,1680,1394,286,0.829762,0.170238,2.51309,270,16,1, merged,1,1,0.0524656960976
37130,1000132,1,293,262,31,0.894198,0.105802,0.894198,23,8,294,263,31,0.894558,0.105442,0.894558,23,8,-1, merged,0,0,0
37131,1000023,2,673,596,77,0.885587,0.114413,1.740426,72,5,674,597,77,0.885757,0.114243,1.741757,72,5,1, merged,0,0,0.00644830627286
37132,1000004,1,2577,2290,287,0.88863,0.11137,0.88863,223,64,2578,2291,287,0.888673,0.111327,0.888673,223,64,-1, abandoned,0,0,0.0152252731692
37132,1000120,2,1134,959,175,0.845679,0.154321,1.734309,154,21,1135,960,175,0.845815,0.154185,1.734488,154,21,-1, abandoned,0,0,0.0975869362311
37133,1000004,1,2578,2291,287,0.888673,0.111327,0.888673,223,64,2579,2292,287,0.888717,0.111283,0.888717,223,64,-1, abandoned,0,0,0.0153554817999
37133,1000120,2,1135,960,175,0.845815,0.154185,1.734488,154,21,1136,961,175,0.845951,0.154049,1.734667,154,21,-1, abandoned,0,0,0.0982885567028
37136,1000023,2,674,597,77,0.885757,0.114243,1.741757,72,5,675,598,77,0.885926,0.114074,1.743069,72,5,1, merged,0,0,0.00926386883153
37138,1000063,2,2443,2185,258,0.894392,0.105608,1.751535,215,43,2444,2186,258,0.894435,0.105565,1.752703,215,43,1, merged,0,0,0.00659358904034
37139,1000023,2,675,598,77,0.885926,0.114074,1.744194,72,5,676,599,77,0.886095,0.113905,1.74547,72,5,1, merged,0,0,0.00699342743388
37144,1000003,2,941,787,154,0.836344,0.163656,1.666106,139,15,942,788,154,0.836518,0.163482,1.666381,139,15,1, merged,0,0,0.0331716827405
37144,1000121,1,1680,1394,286,0.829762,0.170238,0.829762,270,16,1681,1395,286,0.829863,0.170137,0.829863,270,16,1, merged,0,0,0.051135392059
37146,1000003,1,942,788,154,0.836518,0.163482,0.836518,139,15,943,789,154,0.836691,0.163309,0.836691,139,15,1, merged,0,0,0.0720112327614
37146,1000121,2,1681,1395,286,0.829863,0.170137,1.666381,270,16,1682,1396,286,0.829964,0.170036,1.666656,270,16,1, merged,0,0,0.0776293280732
37147,1000054,1,247,219,28,0.88664,0.11336,0.88664,20,8,250,222,28,0.888,0.112,0.888,20,8,-1, merged,0,0,0.771570996181
37147,1000166,3,302,247,55,0.817881,0.182119,2.583308,52,3,303,247,56,0.815182,0.184818,2.573182,53,3,1, merged,1,1,0.499213230572
37151,1000005,2,289,225,64,0.778547,0.221453,1.673105,58,6,290,226,64,0.77931,0.22069,1.674226,58,6,-1, abandoned,0,0,0.0695739647019
37151,1000132,1,294,263,31,0.894558,0.105442,0.894558,23,8,295,264,31,0.894915,0.105085,0.894915,23,8,-1, abandoned,0,0,0.0912904964879
37152,1000011,2,596,554,42,0.92953,0.07047,1.662514,39,3,599,554,45,0.924875,0.075125,1.647952,41,4,1, merged,1,1,0.67717814964
37152,1000534,1,191,140,51,0.732984,0.267016,0.732984,47,4,195,141,54,0.723077,0.276923,0.723077,50,4,1, merged,1,1,0.61773927811
37157,1000153,3,840,766,74,0.911905,0.088095,2.553349,59,15,845,770,75,0.911243,0.088757,2.516437,60,15,-1, merged,1,0,1.11031842428
37157,1000534,2,195,141,54,0.723077,0.276923,1.641444,50,4,217,155,62,0.714286,0.285714,1.605195,58,4,-1, merged,1,0,1.12566808561
37158,1000023,1,676,599,77,0.886095,0.113905,0.886095,72,5,677,600,77,0.886263,0.113737,0.886263,72,5,1, merged,0,0,0.00167876157111
37163,1000043,3,403,334,69,0.828784,0.171216,2.616942,59,10,404,335,69,0.829208,0.170792,2.627909,59,10,1, merged,0,0,0.661021915937
37167,1000014,1,1766,1498,268,0.848245,0.151755,0.848245,247,21,1768,1500,268,0.848416,0.151584,0.848416,247,21,-1, merged,0,0,0.202255102398
37167,1000070,3,973,851,122,0.874615,0.125385,2.722859,103,19,974,852,122,0.874743,0.125257,2.72316,103,19,1, merged,0,0,0.243901746397
37168,1000005,1,290,226,64,0.77931,0.22069,0.77931,58,6,291,227,64,0.780069,0.219931,0.780069,58,6,1, merged,0,0,0.200213558549
37168,1000070,2,974,852,122,0.874743,0.125257,1.654054,103,19,975,853,122,0.874872,0.125128,1.654941,103,19,1, merged,0,0,0.391085374777
37170,1000014,1,1768,1500,268,0.848416,0.151584,0.848416,247,21,1769,1500,269,0.847937,0.152063,0.847937,248,21,1, merged,1,1,0.547365300476
37172,1000108,1,79,64,15,0.810127,0.189873,0.810127,11,4,80,65,15,0.8125,0.1875,0.8125,11,4,1, merged,0,0,0.250255082627
37172,1000110,2,94,79,15,0.840426,0.159574,1.650552,13,2,95,80,15,0.842105,0.157895,1.654605,13,2,1, merged,0,0,0.342243375358
37173,1000007,2,1249,1003,246,0.803042,0.196958,1.703042,219,27,1250,1004,246,0.8032,0.1968,1.707962,219,27,1, merged,0,0,1.21902108558
37186,1000014,1,1769,1500,269,0.847937,0.152063,0.847937,248,21,1770,1501,269,0.848023,0.151977,0.848023,248,21,1, merged,0,0,0.0720665179798
37197,1000054,3,253,224,29,0.885375,0.114625,2.214188,21,8,256,227,29,0.886719,0.113281,2.194974,21,8,-1, abandoned,0,0,0
37197,1002169,1,318,194,124,0.610063,0.389937,0.610063,121,3,319,195,124,0.611285,0.388715,0.611285,121,3,-1, abandoned,0,0,0
37205,1000054,2,256,227,29,0.886719,0.113281,1.758006,21,8,257,228,29,0.88716,0.11284,1.759709,21,8,1, merged,0,0,0.740898404785
37206,1000004,2,2580,2292,288,0.888372,0.111628,1.745515,224,64,2581,2293,288,0.888415,0.111585,1.688415,224,64,-1, abandoned,0,0,0.0525191138992
37209,1000003,2,943,789,154,0.836691,0.163309,1.726302,139,15,945,790,155,0.835979,0.164021,1.717229,140,15,-1, merged,1,0,0.76353907496
37216,1000004,2,2581,2293,288,0.888415,0.111585,1.735175,224,64,2582,2294,288,0.888459,0.111541,1.735353,224,64,1, merged,0,0,0.031541849965
37216,1000120,1,1142,967,175,0.84676,0.15324,0.84676,154,21,1143,968,175,0.846894,0.153106,0.846894,154,21,1, merged,0,0,0.0812866646914
37218,1000120,2,1144,969,175,0.847028,0.152972,1.458313,154,21,1145,970,175,0.847162,0.152838,1.459662,154,21,1, merged,0,0,0.149090615684
37218,1002169,1,319,195,124,0.611285,0.388715,0.611285,121,3,320,196,124,0.6125,0.3875,0.6125,121,3,-1, merged,0,0,0
37224,1000327,1,642,505,137,0.786604,0.213396,0.786604,106,31,643,505,138,0.785381,0.214619,0.785381,107,31,1, merged,1,1,0.575886335293
37227,1000043,1,404,335,69,0.829208,0.170792,0.829208,59,10,405,336,69,0.82963,0.17037,0.82963,59,10,1, merged,0,0,0
37228,1000091,2,444,342,102,0.77027,0.22973,1.633907,87,15,445,343,102,0.770787,0.229213,1.60412,87,15,1, merged,0,0,0.218550236281
37229,1000012,2,480,415,65,0.864583,0.135417,1.630621,63,2,481,416,65,0.864865,0.135135,1.631782,63,2,1, merged,0,0,0.4022088154
37238,1000023,2,677,600,77,0.886263,0.113737,1.886263,72,5,678,601,77,0.886431,0.113569,1.886431,72,5,1, merged,0,0,0.000134066228717
37239,1000004,3,2585,2296,289,0.888201,0.111799,2.514215,225,64,2586,2297,289,0.888244,0.111756,2.514429,225,64,1, merged,0,0,0.0493860222077
37239,1000014,2,1771,1502,269,0.848108,0.151892,1.626014,248,21,1772,1503,269,0.848194,0.151806,1.626184,248,21,1, merged,0,0,0.0278599108788
37239,1000329,1,2616,2035,581,0.777905,0.222095,0.777905,510,71,2617,2036,581,0.77799,0.22201,0.77799,510,71,1, merged,0,0,0.0661110372184
37242,1000004,2,2588,2299,289,0.888331,0.111669,1.718396,225,64,2598,2307,291,0.887991,0.112009,1.71619,227,64,-1, merged,1,0,0.0114185415169
37242,1000121,1,1683,1397,286,0.830065,0.169935,0.830065,270,16,1688,1398,290,0.828199,0.171801,0.828199,274,16,1, merged,1,1,0.00991927107917
37243,1000004,2,2598,2307,291,0.887991,0.112009,1.71619,227,64,2600,2309,291,0.888077,0.111923,1.715398,227,64,-1, merged,0,0,0.105130764524
37243,1000121,1,1688,1398,290,0.828199,0.171801,0.828199,274,16,1691,1399,292,0.827321,0.172679,0.827321,276,16,1, merged,1,1,0.10753640136
37244,1000004,3,2600,2309,291,0.888077,0.111923,2.493388,227,64,2601,2310,291,0.88812,0.11188,2.492539,227,64,-1, abandoned,0,0,0
37244,1000121,1,1691,1399,292,0.827321,0.172679,0.827321,276,16,1693,1399,294,0.826344,0.173656,0.826344,278,16,1, abandoned,1,1,0
37244,1000329,2,2617,2036,581,0.77799,0.22201,1.605311,510,71,2618,2037,581,0.778075,0.221925,1.604419,510,71,-1, abandoned,0,0,0
37249,1000023,2,678,601,77,0.886431,0.113569,1.745806,72,5,679,602,77,0.886598,0.113402,1.747063,72,5,1, merged,0,0,0.00649670478077
37252,1000004,2,2601,2310,291,0.88812,0.11188,1.714464,227,64,2602,2311,291,0.888163,0.111837,1.714122,227,64,-1, merged,0,0,0
37252,1000121,1,1693,1399,294,0.826344,0.173656,0.826344,278,16,1695,1400,295,0.825959,0.174041,0.825959,279,16,1, merged,1,1,0
37253,1000004,2,2602,2311,291,0.888163,0.111837,1.714122,227,64,2605,2314,291,0.888292,0.111708,1.713763,227,64,-1, abandoned,0,0,0.0371506920867
37253,1000121,1,1695,1400,295,0.825959,0.174041,0.825959,279,16,1696,1400,296,0.825472,0.174528,0.825472,280,16,1, abandoned,1,1,0.00431309496465
37256,1000004,2,2605,2314,291,0.888292,0.111708,1.713866,227,64,2608,2317,291,0.88842,0.11158,1.713509,227,64,-1, merged,0,0,0
37256,1000121,1,1697,1401,296,0.825575,0.174425,0.825575,280,16,1698,1401,297,0.825088,0.174912,0.825088,281,16,1, merged,1,1,0
37256,1000592,3,556,471,85,0.847122,0.152878,2.560989,53,32,558,473,85,0.84767,0.15233,2.561179,53,32,-1, merged,0,0,0
37257,1000023,2,679,602,77,0.886598,0.113402,1.750598,72,5,680,603,77,0.886765,0.113235,1.751844,72,5,1, merged,0,0,0.00303013378312
37259,1000063,2,2444,2186,258,0.894435,0.105565,1.7549,215,43,2446,2187,259,0.894113,0.105887,1.755651,215,44,-1, merged,1,1,0.0125660692997
37262,1000011,1,608,560,48,0.921053,0.078947,0.921053,44,4,609,561,48,0.921182,0.078818,0.921182,44,4,1, merged,0,0,0.00722629851923
37262,1000120,2,1147,972,175,0.847428,0.152572,1.768481,154,21,1148,973,175,0.847561,0.152439,1.768743,154,21,1, merged,0,0,0.0130560881608
37263,1000110,1,95,80,15,0.842105,0.157895,0.842105,13,2,97,81,16,0.835052,0.164948,0.835052,14,2,1, merged,1,1,0.183478747223
37263,1000140,2,85,70,15,0.823529,0.176471,1.665635,14,1,87,71,16,0.816092,0.183908,1.651144,15,1,1, merged,1,1,0.171249065455
37263,1002169,3,320,196,124,0.6125,0.3875,2.278135,121,3,321,197,124,0.613707,0.386293,2.264851,121,3,-1, merged,0,0,0
37264,1000063,2,2446,2187,259,0.894113,0.105887,1.755651,215,44,2448,2189,259,0.894199,0.105801,1.751342,215,44,-1, merged,0,0,0.00998055071946
37269,1000023,1,680,603,77,0.886765,0.113235,0.886765,72,5,681,604,77,0.886931,0.113069,0.886931,72,5,-1, abandoned,0,0,0.326728017646
37269,1000140,2,87,71,16,0.816092,0.183908,1.702857,15,1,89,73,16,0.820225,0.179775,1.707156,15,1,-1, abandoned,0,0,0.0895030425963
37272,1000063,2,2448,2189,259,0.894199,0.105801,1.719391,215,44,2450,2190,260,0.893878,0.106122,1.718583,216,44,1, merged,1,1,0.0022217704415
37272,1000121,1,1699,1402,297,0.825191,0.174809,0.825191,281,16,1700,1402,298,0.824706,0.175294,0.824706,282,16,1, merged,1,1,4.18209780232e-05
37280,1000110,2,97,81,16,0.835052,0.164948,1.659757,14,2,98,82,16,0.836735,0.163265,1.661647,14,2,1, merged,0,0,0.0242306536873
37280,1000121,1,1700,1402,298,0.824706,0.175294,0.824706,282,16,1702,1404,298,0.824912,0.175088,0.824912,282,16,-1, merged,0,0,0.0207017622003
37290,1000004,2,2611,2319,292,0.888165,0.111835,1.713077,227,65,2612,2320,292,0.888208,0.111792,1.711669,227,65,-1, merged,0,0,0.000236483696409
37290,1000014,3,1772,1503,269,0.848194,0.151806,2.561271,248,21,1776,1506,270,0.847973,0.152027,2.559642,249,21,-1, merged,1,0,0.000127554103629
37290,1000120,4,1150,975,175,0.847826,0.152174,3.409098,154,21,1151,975,176,0.847089,0.152911,3.406731,155,21,1, merged,1,1,0.000345835439608
37290,1000121,1,1702,1404,298,0.824912,0.175088,0.824912,282,16,1705,1404,301,0.82346,0.17654,0.82346,285,16,1, merged,1,1,0.000205285310347
37291,1000140,1,89,73,16,0.820225,0.179775,0.820225,15,1,92,74,18,0.804348,0.195652,0.804348,17,1,1, merged,1,1,0.09148504815
37293,1000091,2,445,343,102,0.770787,0.229213,1.60412,87,15,446,344,102,0.7713,0.2287,1.6113,87,15,1, merged,0,0,0.218799187768
37295,1000140,1,92,74,18,0.804348,0.195652,0.804348,17,1,93,75,18,0.806452,0.193548,0.806452,17,1,1, merged,0,0,0.0863221884498
37295,1000329,2,2620,2039,581,0.778244,0.221756,1.582592,510,71,2621,2040,581,0.778329,0.221671,1.58478,510,71,1, merged,0,0,0.249106572862
37296,1000004,2,2612,2320,292,0.888208,0.111792,1.888208,227,65,2614,2322,292,0.888294,0.111706,1.821627,227,65,-1, merged,0,0,0.508877274555
37299,1000063,2,2450,2190,260,0.893878,0.106122,1.75102,216,44,2451,2191,260,0.893921,0.106079,1.75213,216,44,1, merged,0,0,0.00624185802065
37307,1000004,2,2614,2322,292,0.888294,0.111706,1.688294,227,65,2615,2323,292,0.888337,0.111663,1.700837,227,65,1, merged,0,0,0.0524171628268
37307,1000592,4,558,473,85,0.84767,0.15233,3.390131,53,32,559,474,85,0.847943,0.152057,3.405922,53,32,1, merged,0,0,0.126870629371
37312,1000054,1,259,230,29,0.888031,0.111969,0.888031,21,8,260,231,29,0.888462,0.111538,0.888462,21,8,1, merged,0,0,0.25437654646
37312,1000132,2,295,264,31,0.894915,0.105085,1.782946,23,8,296,265,31,0.89527,0.10473,1.783732,23,8,1, merged,0,0,0.313419949951
37313,1000054,2,260,231,29,0.888462,0.111538,1.728462,21,8,261,232,29,0.888889,0.111111,1.735043,21,8,1, merged,0,0,0.523796034689
37321,1000012,2,481,416,65,0.864865,0.135135,1.631782,63,2,485,419,66,0.863918,0.136082,1.632574,64,2,1, merged,1,1,0.198767111621
37322,1000014,1,1779,1509,270,0.848229,0.151771,0.848229,249,21,1780,1510,270,0.848315,0.151685,0.848315,249,21,1, merged,0,0,0.0567824590774
37322,1000070,2,976,854,122,0.875,0.125,1.723229,103,19,977,855,122,0.875128,0.124872,1.723443,103,19,1, merged,0,0,0.0547704770477
37325,1000023,2,681,604,77,0.886931,0.113069,1.66526,72,5,682,604,78,0.88563,0.11437,1.663747,73,5,1, merged,1,1,0.358452672058
37325,1000329,1,2621,2040,581,0.778329,0.221671,0.778329,510,71,2623,2041,582,0.778117,0.221883,0.778117,511,71,-1, merged,1,0,0.343707334105
37331,1000012,2,485,419,66,0.863918,0.136082,1.632574,64,2,486,420,66,0.864198,0.135802,1.633714,64,2,1, merged,0,0,0.198498824006
37332,1000140,2,100,82,18,0.82,0.18,1.714231,17,1,101,83,18,0.821782,0.178218,1.71702,17,1,1, merged,0,0,0.101445621113
37334,1000108,1,82,67,15,0.817073,0.182927,0.817073,11,4,83,68,15,0.819277,0.180723,0.819277,11,4,1, merged,0,0,0.479458230867
37335,1000003,2,945,790,155,0.835979,0.164021,1.605496,140,15,946,791,155,0.836152,0.163848,1.606523,140,15,1, merged,0,0,0.320337518927
37337,1000534,1,218,156,62,0.715596,0.284404,0.715596,58,4,219,157,62,0.716895,0.283105,0.716895,58,4,1, merged,0,0,0.550342633399
37339,1000070,1,977,855,122,0.875128,0.124872,0.875128,103,19,978,856,122,0.875256,0.124744,0.875256,103,19,1, merged,0,0,0.302456820365
37341,1000004,1,2615,2323,292,0.888337,0.111663,0.888337,227,65,2616,2324,292,0.888379,0.111621,0.888379,227,65,-1, merged,0,0,0.047093331403
37341,1000153,2,849,774,75,0.911661,0.088339,1.799997,60,15,852,776,76,0.910798,0.089202,1.799177,61,15,1, merged,1,1,0.100453290687
37349,1000023,2,683,605,78,0.885798,0.114202,1.70758,73,5,684,606,78,0.885965,0.114035,1.709494,73,5,1, merged,0,0,0.357690036613
37349,1000140,1,101,83,18,0.821782,0.178218,0.821782,17,1,102,84,18,0.823529,0.176471,0.823529,17,1,1, merged,0,0,0.102350965575
37351,1000003,2,946,791,155,0.836152,0.163848,1.732704,140,15,947,792,155,0.836325,0.163675,1.732938,140,15,1, merged,0,0,0.108208648902
37351,1000015,1,1682,1508,174,0.896552,0.103448,0.896552,162,12,1683,1509,174,0.896613,0.103387,0.896613,162,12,1, merged,0,0,0.121208395069
37354,1000003,1,947,792,155,0.836325,0.163675,0.836325,140,15,949,794,155,0.83667,0.16333,0.83667,140,15,1, merged,0,0,0.0624766572308
37357,1000009,2,963,807,156,0.838006,0.161994,1.748804,140,16,964,808,156,0.838174,0.161826,1.749077,140,16,1, merged,0,0,0
37357,1000015,3,1684,1510,174,0.896675,0.103325,2.645479,162,12,1685,1511,174,0.896736,0.103264,2.645813,162,12,1, merged,0,0,0
37357,1000153,1,852,776,76,0.910798,0.089202,0.910798,61,15,853,777,76,0.910903,0.089097,0.910903,61,15,1, merged,0,0,0
37364,1000328,3,788,576,212,0.730964,0.269036,2.369358,189,23,789,577,212,0.731305,0.268695,2.367199,189,23,1, merged,0,0,0.0236699633672
37364,1000592,2,559,474,85,0.847943,0.152057,1.638394,53,32,562,476,86,0.846975,0.153025,1.635893,54,32,1, merged,1,1,0.0143355201399
37365,1000592,2,562,476,86,0.846975,0.153025,1.635893,54,32,563,477,86,0.847247,0.152753,1.637273,54,32,1, merged,0,0,0.0270168391824
37366,1000014,1,1780,1510,270,0.848315,0.151685,0.848315,249,21,1781,1511,270,0.8484,0.1516,0.8484,249,21,1, merged,0,0,0.00311355557676
37367,1000329,2,2623,2041,582,0.778117,0.221883,1.568693,511,71,2624,2042,582,0.778201,0.221799,1.569868,511,71,1, merged,0,0,0.0498111709608
37369,1000014,1,1781,1511,270,0.8484,0.1516,0.8484,249,21,1782,1512,270,0.848485,0.151515,0.848485,249,21,1, merged,0,0,0.160109177529
37377,1000003,2,950,795,155,0.836842,0.163158,1.377383,140,15,951,796,155,0.837014,0.162986,1.389645,140,15,1, merged,0,0,0.176340144735
37378,1000063,1,2452,2192,260,0.893964,0.106036,0.893964,216,44,2453,2193,260,0.894007,0.105993,0.894007,216,44,1, merged,0,0,0.00645126753805
37384,1000108,1,83,68,15,0.819277,0.180723,0.819277,11,4,84,69,15,0.821429,0.178571,0.821429,11,4,1, merged,0,0,0.0325388360466
37384,1000110,2,99,83,16,0.838384,0.161616,1.657661,14,2,100,84,16,0.84,0.16,1.661429,14,2,1, merged,0,0,0.0348639415295
37386,1000108,1,84,69,15,0.821429,0.178571,0.821429,11,4,85,69,16,0.811765,0.188235,0.811765,12,4,1, merged,1,1,0.0380331820548
37386,1000130,2,328,274,54,0.835366,0.164634,1.656794,42,12,329,275,54,0.835866,0.164134,1.647631,42,12,1, merged,0,0,0.118989476558
37387,1000110,2,100,84,16,0.84,0.16,1.663529,14,2,101,85,16,0.841584,0.158416,1.651108,14,2,1, merged,0,0,0.160710665755
37387,1000140,1,102,84,18,0.823529,0.176471,0.823529,17,1,105,85,20,0.809524,0.190476,0.809524,19,1,-1, merged,1,0,0.116496791657
37389,1000012,4,488,422,66,0.864754,0.135246,3.460904,64,2,489,422,67,0.862986,0.137014,3.437388,65,2,1, merged,1,1,0.100290175765
37389,1000121,2,1705,1404,301,0.82346,0.17654,1.72115,285,16,1708,1405,303,0.8226,0.1774,1.714403,287,16,1, merged,1,1,0.102366465244
37390,1000007,2,1252,1006,246,0.803514,0.196486,1.68741,219,27,1253,1007,246,0.803671,0.196329,1.688,219,27,1, merged,0,0,1.30338251231
37392,1000004,1,2616,2324,292,0.888379,0.111621,0.888379,227,65,2617,2325,292,0.888422,0.111578,0.888422,227,65,-1, abandoned,0,0,0.470254746421
37392,1000329,2,2624,2042,582,0.778201,0.221799,1.66658,511,71,2625,2043,582,0.778286,0.221714,1.666708,511,71,-1, abandoned,0,0,0.640292338089
37394,1000011,3,609,561,48,0.921182,0.078818,2.485095,44,4,610,562,48,0.921311,0.078689,2.48505,44,4,1, merged,0,0,0.00997075837076
37394,1000120,2,1157,980,177,0.847018,0.152982,1.563913,156,21,1159,980,179,0.845557,0.154443,1.563738,156,23,-1, merged,1,1,0.0170379802869
37394,1000534,1,219,157,62,0.716895,0.283105,0.716895,58,4,220,158,62,0.718182,0.281818,0.718182,58,4,-1, merged,0,0,0.00529188801842
37405,1000015,2,1685,1511,174,0.896736,0.103264,1.614918,162,12,1686,1512,174,0.896797,0.103203,1.616254,162,12,1, merged,0,0,0.685331918451
37405,1000534,1,220,158,62,0.718182,0.281818,0.718182,58,4,221,159,62,0.719457,0.280543,0.719457,58,4,1, merged,0,0,0.721887402988
37408,1000130,3,329,275,54,0.835866,0.164134,2.509559,42,12,330,276,54,0.836364,0.163636,2.511129,42,12,-1, abandoned,0,0,0.49361740431
37408,1000329,2,2627,2045,582,0.778455,0.221545,1.673693,511,71,2628,2046,582,0.778539,0.221461,1.674765,511,71,-1, abandoned,0,0,0.622662669577
37410,1000003,2,951,796,155,0.837014,0.162986,1.615552,140,15,952,797,155,0.837185,0.162815,1.615808,140,15,-1, abandoned,0,0,0.178352423352
37410,1000329,1,2628,2046,582,0.778539,0.221461,0.778539,511,71,2629,2047,582,0.778623,0.221377,0.778623,511,71,-1, abandoned,0,0,0.150898150869
37414,1000003,2,952,797,155,0.837185,0.162815,1.68567,140,15,953,798,155,0.837356,0.162644,1.685926,140,15,1, merged,0,0,0.0334165561364
37414,1000014,1,1782,1512,270,0.848485,0.151515,0.848485,249,21,1783,1513,270,0.84857,0.15143,0.84857,249,21,1, merged,0,0,0.0636563570701
37417,1000004,3,2617,2325,292,0.888422,0.111578,2.524188,227,65,2618,2326,292,0.888464,0.111536,2.417256,227,65,1, merged,0,0,0.0247385614397
37417,1000329,2,2629,2047,582,0.778623,0.221377,1.635766,511,71,2631,2049,582,0.778791,0.221209,1.528791,511,71,-1, merged,0,0,0.033115466188
37424,1000005,2,307,241,66,0.785016,0.214984,1.607616,60,6,308,242,66,0.785714,0.214286,1.608418,60,6,1, merged,0,0,0.0114679920782
37424,1000121,1,1708,1405,303,0.8226,0.1774,0.8226,287,16,1709,1406,303,0.822703,0.177297,0.822703,287,16,-1, merged,0,0,0.000380470089792
37425,1000063,1,2453,2193,260,0.894007,0.105993,0.894007,216,44,2455,2195,260,0.894094,0.105906,0.894094,216,44,-1, merged,0,0,0.0199037585796
37425,1000329,2,2631,2049,582,0.778791,0.221209,1.672799,511,71,2632,2049,583,0.778495,0.221505,1.672589,512,71,1, merged,1,1,0.0228598555161
37428,1000004,3,2618,2326,292,0.888464,0.111536,2.630818,227,65,2619,2327,292,0.888507,0.111493,2.631116,227,65,-1, abandoned,0,0,0.00300543786454
37428,1000015,1,1686,1512,174,0.896797,0.103203,0.896797,162,12,1688,1514,174,0.896919,0.103081,0.896919,162,12,-1, abandoned,0,0,0.000210137000698
37428,1000120,2,1159,980,179,0.845557,0.154443,1.742354,156,23,1160,981,179,0.84569,0.15431,1.742609,156,23,-1, abandoned,0,0,0.0042542810007
37431,1000003,3,953,798,155,0.837356,0.162644,2.225905,140,15,954,799,155,0.837526,0.162474,2.059113,140,15,-1, abandoned,0,0,0.00803004901584
37431,1000004,2,2620,2328,292,0.88855,0.11145,1.38855,227,65,2622,2329,293,0.888253,0.111747,1.221587,228,65,-1, abandoned,1,0,0.00300603205142
37432,1000023,1,684,606,78,0.885965,0.114035,0.885965,73,5,685,607,78,0.886131,0.113869,0.886131,73,5,1, merged,0,0,0.0032740952568
37434,1000003,2,954,799,155,0.837526,0.162474,1.725779,140,15,956,801,155,0.837866,0.162134,1.725781,140,15,-1, abandoned,0,0,0.0136745812597
37434,1000004,1,2622,2329,293,0.888253,0.111747,0.888253,228,65,2623,2329,294,0.887915,0.112085,0.887915,229,65,1, abandoned,1,1,0.0189596073087
37435,1000023,1,685,607,78,0.886131,0.113869,0.886131,73,5,686,608,78,0.886297,0.113703,0.886297,73,5,1, merged,0,0,0.00323883989965
37435,1000063,2,2456,2196,260,0.894137,0.105863,1.780268,216,44,2457,2197,260,0.89418,0.10582,1.780477,216,44,1, merged,0,0,0.00405450497625
37436,1000023,2,686,608,78,0.886297,0.113703,1.746591,73,5,687,609,78,0.886463,0.113537,1.747777,73,5,1, merged,0,0,0.00634471398622
37438,1000063,1,2457,2197,260,0.89418,0.10582,0.89418,216,44,2458,2198,260,0.894223,0.105777,0.894223,216,44,1, merged,0,0,0.00223480440585
37438,1000121,2,1709,1406,303,0.822703,0.177297,1.716883,287,16,1710,1407,303,0.822807,0.177193,1.71703,287,16,1, merged,0,0,6.09432021203e-05
37440,1000004,1,2623,2329,294,0.887915,0.112085,0.887915,229,65,2624,2330,294,0.887957,0.112043,0.887957,229,65,-1, abandoned,0,0,0.206388801496
37440,1000015,2,1688,1514,174,0.896919,0.103081,1.784834,162,12,1689,1515,174,0.89698,0.10302,1.784938,162,12,-1, abandoned,0,0,0.286852058358
37442,1000023,2,687,609,78,0.886463,0.113537,1.772177,73,5,690,612,78,0.886957,0.113043,1.729062,73,5,-1, merged,0,0,0.000285872643499
37442,1000121,4,1710,1407,303,0.822807,0.177193,3.453252,287,16,1711,1408,303,0.822911,0.177089,3.411347,287,16,1, merged,0,0,0.000100416524041
37443,1000015,1,1690,1516,174,0.897041,0.102959,0.897041,162,12,1691,1517,174,0.897102,0.102898,0.897102,162,12,-1, abandoned,0,0,0.00203215710798
37449,1000110,1,102,86,16,0.843137,0.156863,0.843137,14,2,103,87,16,0.84466,0.15534,0.84466,14,2,1, merged,0,0,0.21581887565
37449,1000140,2,106,86,20,0.811321,0.188679,1.654458,19,1,107,87,20,0.813084,0.186916,1.657744,19,1,1, merged,0,0,0.157223860907
37450,1000011,2,614,566,48,0.921824,0.078176,1.641281,44,4,615,567,48,0.921951,0.078049,1.642672,44,4,1, merged,0,0,0.943846513726
37450,1000534,1,221,159,62,0.719457,0.280543,0.719457,58,4,222,160,62,0.720721,0.279279,0.720721,58,4,1, merged,0,0,1.09491125656
37455,1000003,2,956,801,155,0.837866,0.162134,1.390498,140,15,957,802,155,0.838036,0.161964,1.402138,140,15,1, merged,0,0,0.249088891599
37457,1000023,1,690,612,78,0.886957,0.113043,0.886957,73,5,691,613,78,0.88712,0.11288,0.88712,73,5,1, merged,0,0,0.26314548082
37476,1000005,2,312,246,66,0.788462,0.211538,1.611372,60,6,313,247,66,0.789137,0.210863,1.611567,60,6,-1, merged,0,0,0
37476,1000121,1,1711,1408,303,0.822911,0.177089,0.822911,287,16,1712,1408,304,0.82243,0.17757,0.82243,288,16,1, merged,1,1,0
37476,1000132,3,296,265,31,0.89527,0.10473,2.506642,23,8,298,267,31,0.895973,0.104027,2.50754,23,8,-1, merged,0,0,0
37477,1000091,2,446,344,102,0.7713,0.2287,1.7713,87,15,447,345,102,0.771812,0.228188,1.571812,87,15,1, merged,0,0,0.220158048755
37478,1000011,3,615,567,48,0.921951,0.078049,2.367516,44,4,616,568,48,0.922078,0.077922,2.319137,44,4,1, merged,0,0,0.317620943496
37503,1000043,2,407,338,69,0.830467,0.169533,1.830467,59,10,408,339,69,0.830882,0.169118,1.830882,59,10,1, merged,0,0,0
37508,1000014,3,1786,1516,270,0.848824,0.151176,2.526937,249,21,1787,1517,270,0.848909,0.151091,2.529493,249,21,1, merged,0,0,0
37510,1000592,2,563,477,86,0.847247,0.152753,1.70439,54,32,564,478,86,0.847518,0.152482,1.707518,54,32,1, merged,0,0,0.0959514861633
37512,1000592,3,564,478,86,0.847518,0.152482,2.470676,54,32,565,479,86,0.847788,0.152212,2.476766,54,32,1, merged,0,0,0.450793109052
37513,1000121,1,1713,1409,304,0.822534,0.177466,0.822534,288,16,1714,1410,304,0.822637,0.177363,0.822637,288,16,-1, abandoned,0,0,0
37515,1000108,2,86,70,16,0.813953,0.186047,1.658614,12,4,87,70,17,0.804598,0.195402,1.645719,13,4,1, merged,1,1,0.123740983135
37515,1000110,1,103,87,16,0.84466,0.15534,0.84466,14,2,107,90,17,0.841121,0.158879,0.841121,15,2,-1, merged,1,0,0.163377703291
37515,1000140,3,107,87,20,0.813084,0.186916,2.471698,19,1,108,88,20,0.814815,0.185185,2.460534,19,1,1, merged,0,0,0.11877169261
37518,1000005,2,313,247,66,0.789137,0.210863,1.573967,60,6,314,248,66,0.789809,0.210191,1.574971,60,6,1, merged,0,0,0.0211075601576
37518,1000327,1,646,507,139,0.78483,0.21517,0.78483,107,32,647,508,139,0.785162,0.214838,0.785162,107,32,1, merged,0,0,0
37519,1000110,2,107,90,17,0.841121,0.158879,1.655936,15,2,108,91,17,0.842593,0.157407,1.659106,15,2,1, merged,0,0,0.324388946553
37519,1000140,1,108,88,20,0.814815,0.185185,0.814815,19,1,109,89,20,0.816514,0.183486,0.816514,19,1,-1, merged,0,0,0.237597745503
37524,1000109,2,403,341,62,0.846154,0.153846,1.648134,59,3,404,342,62,0.846535,0.153465,1.649166,59,3,1, merged,0,0,0.144856339872
37527,1000004,3,2629,2335,294,0.88817,0.11183,2.133853,229,65,2630,2336,294,0.888213,0.111787,2.120097,229,65,1, merged,0,0,0.435244748372
37539,1000004,1,2631,2337,294,0.888255,0.111745,0.888255,229,65,2634,2339,295,0.888003,0.111997,0.888003,230,65,-1, merged,1,0,0.0783376916045
37539,1000121,3,1715,1411,304,0.822741,0.177259,1.960996,288,16,1716,1412,304,0.822844,0.177156,2.210847,288,16,1, merged,0,0,0.0839824678944
37555,1000004,1,2636,2341,295,0.888088,0.111912,0.888088,230,65,2637,2342,295,0.88813,0.11187,0.88813,230,65,-1, abandoned,0,0,0.0730987813164
37555,1000007,2,1255,1008,247,0.803187,0.196813,1.691275,220,27,1256,1009,247,0.803344,0.196656,1.691474,220,27,-1, abandoned,0,0,0.17512911007
37557,1000004,2,2637,2342,295,0.88813,0.11187,1.686267,230,65,2638,2342,296,0.887794,0.112206,1.683459,231,65,1, abandoned,1,1,0
37557,1000153,3,855,779,76,0.911111,0.088889,2.597378,61,15,856,780,76,0.911215,0.088785,2.594674,61,15,-1, abandoned,0,0,0
37560,1000023,3,693,615,78,0.887446,0.112554,2.34876,73,5,694,616,78,0.887608,0.112392,2.416594,73,5,1, merged,0,0,0.00239113364972
37564,1000063,1,2458,2198,260,0.894223,0.105777,0.894223,216,44,2459,2199,260,0.894266,0.105734,0.894266,216,44,1, merged,0,0,0.00601872860031
37565,1000153,3,856,780,76,0.911215,0.088785,2.595343,61,15,857,781,76,0.911319,0.088681,2.587605,61,15,1, merged,0,0,0.0853354094337
37567,1000023,3,694,616,78,0.887608,0.112392,2.417584,73,5,695,617,78,0.88777,0.11223,2.466341,73,5,1, merged,0,0,0.000318624168564
37568,1000023,3,695,617,78,0.88777,0.11223,2.466341,73,5,696,618,78,0.887931,0.112069,2.503179,73,5,1, merged,0,0,0.00645802167006
37574,1000120,1,1161,982,179,0.845823,0.154177,0.845823,156,23,1162,983,179,0.845955,0.154045,0.845955,156,23,1, merged,0,0,0.0174181675827
37574,1000140,2,111,91,20,0.81982,0.18018,1.665642,19,1,112,92,20,0.821429,0.178571,1.667384,19,1,1, merged,0,0,0.00499507988601
37578,1000011,2,617,569,48,0.922204,0.077796,1.771113,44,4,618,570,48,0.92233,0.07767,1.770849,44,4,1, merged,0,0,0.0090876711286
37578,1000014,1,1787,1517,270,0.848909,0.151091,0.848909,249,21,1789,1518,271,0.848519,0.151481,0.848519,250,21,1, merged,1,1,0.00266621283089
37579,1000014,1,1789,1518,271,0.848519,0.151481,0.848519,250,21,1790,1518,272,0.848045,0.151955,0.848045,251,21,1, merged,1,1,0.186867251046
37579,1000023,4,696,618,78,0.887931,0.112069,3.630759,73,5,697,619,78,0.888092,0.111908,3.380488,73,5,1, merged,0,0,0.353166314553
37579,1000063,3,2460,2200,260,0.894309,0.105691,2.742828,216,44,2461,2201,260,0.894352,0.105648,2.492397,216,44,-1, merged,0,0,0.358712814468
37593,1000109,2,404,342,62,0.846535,0.153465,1.691605,59,3,405,343,62,0.846914,0.153086,1.692419,59,3,1, merged,0,0,0.0205035825608
37593,1000199,1,355,300,55,0.84507,0.15493,0.84507,50,5,356,301,55,0.845506,0.154494,0.845506,50,5,1, merged,0,0,0.0171847200419
37596,1000014,1,1790,1518,272,0.848045,0.151955,0.848045,251,21,1792,1519,273,0.847656,0.152344,0.847656,252,21,1, merged,1,1,0
37596,1000043,2,409,340,69,0.831296,0.168704,1.679341,59,10,411,341,70,0.829684,0.170316,1.67734,60,10,1, merged,1,1,0
37603,1000009,1,972,815,157,0.838477,0.161523,0.838477,141,16,973,815,158,0.837616,0.162384,0.837616,142,16,1, merged,1,1,0.305603070031
37603,1000011,2,618,570,48,0.92233,0.07767,1.760807,44,4,619,571,48,0.922456,0.077544,1.760071,44,4,1, merged,0,0,0.337221309255
37611,1000054,2,269,240,29,0.892193,0.107807,1.642193,21,8,271,242,29,0.892989,0.107011,1.585297,21,8,-1, merged,0,0,0.77015766312
37612,1000014,4,1797,1524,273,0.84808,0.15192,3.103655,252,21,1798,1525,273,0.848165,0.151835,3.118006,252,21,1, merged,0,0,0.0531214520237
37612,1000054,5,271,242,29,0.892989,0.107011,3.996644,21,8,272,243,29,0.893382,0.106618,4.011388,21,8,1, merged,0,0,0.0721123072447
37613,1000043,2,412,342,70,0.830097,0.169903,1.704715,60,10,414,344,70,0.830918,0.169082,1.704773,60,10,-1, merged,0,0,0.229239781744
37613,1000070,1,981,858,123,0.874618,0.125382,0.874618,104,19,983,859,124,0.873856,0.126144,0.873856,105,19,1, merged,1,1,0.240450802456
37616,1000014,1,1798,1525,273,0.848165,0.151835,0.848165,252,21,1799,1525,274,0.847693,0.152307,0.847693,253,21,1, abandoned,1,1,0
37616,1000043,3,414,344,70,0.830918,0.169082,2.539842,60,10,415,344,71,0.828916,0.171084,2.526609,61,10,1, abandoned,1,1,0
37621,1000109,2,405,343,62,0.846914,0.153086,1.692419,59,3,406,344,62,0.847291,0.152709,1.693229,59,3,1, merged,0,0,0.0423672487209
37621,1000199,1,356,301,55,0.845506,0.154494,0.845506,50,5,357,302,55,0.845938,0.154062,0.845938,50,5,1, merged,0,0,0.0433617594936
37632,1000004,1,2638,2342,296,0.887794,0.112206,0.887794,231,65,2641,2345,296,0.887921,0.112079,0.887921,231,65,-1, merged,0,0,0.513415979103
37632,1000014,2,1799,1525,274,0.847693,0.152307,1.735487,253,21,1800,1526,274,0.847778,0.152222,1.735699,253,21,1, merged,0,0,0.7044523459
37636,1000153,2,857,781,76,0.911319,0.088681,1.726133,61,15,858,782,76,0.911422,0.088578,1.729604,61,15,1, merged,0,0,0.180900569164
37637,1000054,2,274,245,29,0.894161,0.105839,1.710554,21,8,278,248,30,0.892086,0.107914,1.700528,22,8,1, merged,1,1,0.770196247609
37637,1000166,1,305,249,56,0.816393,0.183607,0.816393,53,3,308,249,59,0.808442,0.191558,0.808442,56,3,1, merged,1,1,0.507368173258
37645,1000166,1,308,249,59,0.808442,0.191558,0.808442,56,3,310,250,60,0.806452,0.193548,0.806452,57,3,1, merged,1,1,0.458854901961
37645,1002169,2,322,198,124,0.614907,0.385093,1.423348,121,3,324,200,124,0.617284,0.382716,1.423736,121,3,-1, merged,0,0,0
37647,1000153,2,858,782,76,0.911422,0.088578,1.632143,61,15,859,783,76,0.911525,0.088475,1.633498,61,15,-1, abandoned,0,0,0
37647,1000534,1,222,160,62,0.720721,0.279279,0.720721,58,4,223,161,62,0.721973,0.278027,0.721973,58,4,-1, abandoned,0,0,0
37650,1000108,3,89,71,18,0.797753,0.202247,2.265914,14,4,91,72,19,0.791209,0.208791,2.255482,15,4,1, merged,1,1,0.000112747596945
37650,1000110,2,114,97,17,0.850877,0.149123,1.468161,15,2,115,97,18,0.843478,0.156522,1.464273,16,2,1, merged,1,1,0.00022547590494
37650,1000130,4,332,278,54,0.837349,0.162651,3.103263,42,12,334,280,54,0.838323,0.161677,3.093806,42,12,-1, merged,0,0,0.00102367331364
37650,1002169,1,324,200,124,0.617284,0.382716,0.617284,121,3,327,203,124,0.620795,0.379205,0.620795,121,3,-1, merged,0,0,0
37651,1000110,3,115,97,18,0.843478,0.156522,2.387684,16,2,116,97,19,0.836207,0.163793,2.386314,17,2,1, merged,1,1,0.455092486433
37651,1000130,2,334,280,54,0.838323,0.161677,1.544206,42,12,335,280,55,0.835821,0.164179,1.550107,43,12,1, merged,1,1,0.479204068601
37654,1000054,3,278,248,30,0.892086,0.107914,2.319333,22,8,283,250,33,0.883392,0.116608,2.307312,23,10,1, merged,1,1,0.0561657702436
37654,1000121,4,1717,1413,304,0.822947,0.177053,3.14228,288,16,1719,1415,304,0.823153,0.176847,3.130465,288,16,-1, merged,0,0,0.0360384683039
37654,1000166,2,310,250,60,0.806452,0.193548,1.427247,57,3,311,250,61,0.803859,0.196141,1.423919,58,3,1, merged,1,1,0.0383076581344
37654,1002169,1,327,203,124,0.620795,0.379205,0.620795,121,3,329,204,125,0.620061,0.379939,0.620061,121,4,-1, merged,1,0,0
37658,1000011,2,620,572,48,0.922581,0.077419,1.819805,44,4,621,573,48,0.922705,0.077295,1.82005,44,4,1, merged,0,0,0.0371272998381
37658,1000015,1,1693,1519,174,0.897224,0.102776,0.897224,162,12,1695,1521,174,0.897345,0.102655,0.897345,162,12,-1, merged,0,0,0.037220629813
37659,1000140,1,118,97,21,0.822034,0.177966,0.822034,19,2,120,99,21,0.825,0.175,0.825,19,2,-1, merged,0,0,0.23968069418
37659,1000328,2,790,578,212,0.731646,0.268354,1.553679,189,23,791,579,212,0.731985,0.268015,1.556985,189,23,1, merged,0,0,0.215788981464
37660,1000109,1,406,344,62,0.847291,0.152709,0.847291,59,3,407,345,62,0.847666,0.152334,0.847666,59,3,1, merged,0,0,0.0170157068063
37662,1000130,1,335,280,55,0.835821,0.164179,0.835821,43,12,336,280,56,0.833333,0.166667,0.833333,43,13,-1, merged,1,1,0.497790939432
37663,1000004,1,2641,2345,296,0.887921,0.112079,0.887921,231,65,2642,2346,296,0.887964,0.112036,0.887964,231,65,-1, merged,0,0,0.00306838639618
37663,1000120,3,1165,986,179,0.846352,0.153648,1.734273,156,23,1167,987,180,0.845758,0.154242,2.733722,157,23,1, merged,1,1,0.0189575983274
37674,1000091,2,447,345,102,0.771812,0.228188,1.571812,87,15,448,346,102,0.772321,0.227679,1.605655,87,15,1, merged,0,0,0.22083807627
37680,1000009,1,977,817,160,0.836233,0.163767,0.836233,144,16,979,818,161,0.835546,0.164454,0.835546,145,16,1, merged,1,1,0.230279600966
37681,1000009,1,979,818,161,0.835546,0.164454,0.835546,145,16,981,819,162,0.834862,0.165138,0.834862,146,16,1, merged,1,1,0.583377678875
37681,1000534,2,223,161,62,0.721973,0.278027,1.55752,58,4,226,162,64,0.716814,0.283186,1.551677,60,4,-1, merged,1,0,0.556064348456
37686,1000121,2,1719,1415,304,0.823153,0.176847,1.601437,288,16,1720,1416,304,0.823256,0.176744,1.601624,288,16,1, merged,0,0,0.0360583108023
37686,1000328,3,791,579,212,0.731985,0.268015,2.333422,189,23,792,580,212,0.732323,0.267677,2.333947,189,23,1, merged,0,0,0.100883037232
37686,1000329,1,2634,2050,584,0.778284,0.221716,0.778284,512,72,2635,2051,584,0.778368,0.221632,0.778368,512,72,-1, merged,0,0,0.0554593696339
37689,1000023,2,699,621,78,0.888412,0.111588,1.782893,73,5,700,622,78,0.888571,0.111429,1.783095,73,5,1, merged,0,0,0.0016489665316
37689,1000063,1,2464,2204,260,0.894481,0.105519,0.894481,216,44,2465,2205,260,0.894523,0.105477,0.894523,216,44,-1, merged,0,0,0.00196916359936
37690,1000592,2,565,479,86,0.847788,0.152212,1.467848,54,32,566,480,86,0.848057,0.151943,1.469269,54,32,1, merged,0,0,0.586482882359
37690,1002169,1,329,204,125,0.620061,0.379939,0.620061,121,4,330,205,125,0.621212,0.378788,0.621212,121,4,-1, merged,0,0,0
37697,1000070,1,983,859,124,0.873856,0.126144,0.873856,105,19,984,860,124,0.873984,0.126016,0.873984,105,19,1, merged,0,0,0
37697,1000166,2,311,250,61,0.803859,0.196141,1.677714,58,3,312,251,61,0.804487,0.195513,1.678471,58,3,1, merged,0,0,0
37702,1000023,4,701,623,78,0.88873,0.11127,3.341461,73,5,702,624,78,0.888889,0.111111,3.30781,73,5,-1, abandoned,0,0,0.00030167018385
37702,1000329,3,2636,2052,584,0.778452,0.221548,2.452731,512,72,2637,2053,584,0.778536,0.221464,2.418921,512,72,-1, abandoned,0,0,0.00701145686508
37704,1000023,3,702,624,78,0.888889,0.111111,2.529274,73,5,703,625,78,0.889047,0.110953,2.496955,73,5,-1, abandoned,0,0,0.000346295230763
37704,1000329,4,2637,2053,584,0.778536,0.221464,3.30781,512,72,2638,2054,584,0.77862,0.22138,3.275575,512,72,-1, abandoned,0,0,0.00722791420466
37707,1000014,2,1800,1526,274,0.847778,0.152222,1.713026,253,21,1801,1527,274,0.847862,0.152138,1.714059,253,21,1, merged,0,0,0.190289182904
37708,1000004,1,2646,2350,296,0.888133,0.111867,0.888133,231,65,2649,2353,296,0.88826,0.11174,0.88826,231,65,-1, merged,0,0,0.0371396657645
37708,1000329,2,2638,2054,584,0.77862,0.22138,1.666753,512,72,2640,2056,584,0.778788,0.221212,1.667048,512,72,-1, merged,0,0,0.0237785487135
37711,1000003,3,957,802,155,0.838036,0.161964,2.28349,140,15,958,803,155,0.838205,0.161795,2.36716,140,15,1, merged,0,0,0
37711,1000004,5,2650,2354,296,0.888302,0.111698,4.019654,231,65,2651,2354,297,0.887967,0.112033,4.103073,231,66,-1, merged,1,1,0
37711,1000014,4,1801,1527,274,0.847862,0.152138,3.131352,253,21,1802,1528,274,0.847947,0.152053,3.215107,253,21,1, merged,0,0,0
37711,1000329,1,2640,2056,584,0.778788,0.221212,0.778788,512,72,2642,2058,584,0.778955,0.221045,0.778955,512,72,-1, merged,0,0,0
37713,1000091,3,448,346,102,0.772321,0.227679,2.405655,87,15,451,347,104,0.769401,0.230599,2.300651,89,15,1, merged,1,1,0.221362292878
37714,1000023,2,703,625,78,0.889047,0.110953,1.389047,73,5,704,625,79,0.887784,0.112216,1.221117,74,5,1, merged,1,1,0.00332180445535
37714,1000054,6,284,251,33,0.883803,0.116197,4.596501,23,10,287,252,35,0.878049,0.121951,4.298606,25,10,-1, merged,1,0,0.000203004466098
37714,1000109,8,408,346,62,0.848039,0.151961,5.44454,59,3,409,346,63,0.845966,0.154034,5.144572,60,3,1, merged,1,1,0.012252692844
37714,1000166,3,312,251,61,0.804487,0.195513,2.193534,58,3,315,251,64,0.796825,0.203175,2.017943,61,3,1, merged,1,1,0
37715,1000109,1,409,346,63,0.845966,0.154034,0.845966,60,3,411,347,64,0.844282,0.155718,0.844282,61,3,1, merged,1,1,0.140154408298
37720,1000012,2,493,426,67,0.864097,0.135903,1.700304,65,2,494,427,67,0.864372,0.135628,1.701979,65,2,1, merged,0,0,0.382884556827
37720,1000110,1,116,97,19,0.836207,0.163793,0.836207,17,2,117,98,19,0.837607,0.162393,0.837607,17,2,1, merged,0,0,0.157573811918
37725,1000003,1,958,803,155,0.838205,0.161795,0.838205,140,15,959,804,155,0.838373,0.161627,0.838373,140,15,1, merged,0,0,0.000270953757225
37725,1000153,2,862,786,76,0.911833,0.088167,1.750038,61,15,863,787,76,0.911935,0.088065,1.750308,61,15,1, merged,0,0,0.00111653328128
37727,1000329,1,2642,2058,584,0.778955,0.221045,0.778955,512,72,2643,2059,584,0.779039,0.220961,0.779039,512,72,-1, abandoned,0,0,0.0107593490527
37727,1000592,2,566,480,86,0.848057,0.151943,1.627012,54,32,567,481,86,0.848325,0.151675,1.627363,54,32,-1, abandoned,0,0,0.0107873882501
37732,1000110,2,117,98,19,0.837607,0.162393,1.662607,17,2,118,99,19,0.838983,0.161017,1.665429,17,2,1, merged,0,0,0.689743443341
37732,1000140,1,120,99,21,0.825,0.175,0.825,19,2,121,100,21,0.826446,0.173554,0.826446,19,2,1, merged,0,0,0.482674212728
37735,1000009,1,981,819,162,0.834862,0.165138,0.834862,146,16,984,820,164,0.833333,0.166667,0.833333,148,16,1, merged,1,1,0.287228069119
37744,1000003,1,959,804,155,0.838373,0.161627,0.838373,140,15,961,806,155,0.83871,0.16129,0.83871,140,15,-1, merged,0,0,0
37744,1000023,2,704,625,79,0.887784,0.112216,1.726157,74,5,706,627,79,0.888102,0.111898,1.726812,74,5,-1, merged,0,0,0.00395780571888
37751,1000004,1,2652,2355,297,0.888009,0.111991,0.888009,231,66,2653,2356,297,0.888051,0.111949,0.888051,231,66,-1, abandoned,0,0,0.0102234808228
37751,1000120,2,1169,989,180,0.846022,0.153978,1.734031,157,23,1170,990,180,0.846154,0.153846,1.734205,157,23,-1, abandoned,0,0,0.0435690442807
37756,1000026,2,331,305,26,0.92145,0.07855,1.800343,24,2,332,305,27,0.918675,0.081325,1.799627,25,2,1, merged,1,1,0.450210450672
37756,1000054,1,289,254,35,0.878893,0.121107,0.878893,25,10,294,259,35,0.880952,0.119048,0.880952,25,10,-1, merged,0,0,0.673985425305
37759,1000007,2,1258,1011,247,0.803657,0.196343,1.637833,220,27,1259,1012,247,0.803813,0.196187,1.638156,220,27,1, merged,0,0,0.175370152932
37759,1000009,1,989,825,164,0.834176,0.165824,0.834176,148,16,990,826,164,0.834343,0.165657,0.834343,148,16,1, merged,0,0,0.165772709643
37763,1000014,3,1802,1528,274,0.847947,0.152053,2.183445,253,21,1807,1532,275,0.847814,0.152186,2.217152,254,21,-1, merged,1,0,0
37763,1000070,4,985,861,124,0.874112,0.125888,3.057556,105,19,986,862,124,0.874239,0.125761,3.091392,105,19,1, merged,0,0,0
37763,1002169,1,330,205,125,0.621212,0.378788,0.621212,121,4,334,209,125,0.625749,0.374251,0.625749,121,4,-1, merged,0,0,0
37771,1000153,2,864,788,76,0.912037,0.087963,1.628851,61,15,865,789,76,0.912139,0.087861,1.631437,61,15,-1, merged,0,0,0.21584525323
37771,1000534,1,226,162,64,0.716814,0.283186,0.716814,60,4,228,164,64,0.719298,0.280702,0.719298,60,4,-1, merged,0,0,0.219798397621
37774,1000004,1,2653,2356,297,0.888051,0.111949,0.888051,231,66,2654,2357,297,0.888093,0.111907,0.888093,231,66,-1, abandoned,0,0,0
37774,1000329,2,2643,2059,584,0.779039,0.220961,1.66709,512,72,2644,2060,584,0.779123,0.220877,1.667216,512,72,-1, abandoned,0,0,0
37775,1000015,2,1700,1526,174,0.897647,0.102353,1.897647,162,12,1701,1527,174,0.897707,0.102293,1.897707,162,12,1, merged,0,0,1.02642776533
37776,1000004,1,2654,2357,297,0.888093,0.111907,0.888093,231,66,2655,2358,297,0.888136,0.111864,0.888136,231,66,1, merged,0,0,0
37776,1000329,2,2644,2060,584,0.779123,0.220877,1.667216,512,72,2645,2060,585,0.778828,0.221172,1.666964,512,73,-1, merged,1,1,0
37778,1000132,1,298,267,31,0.895973,0.104027,0.895973,23,8,300,268,32,0.893333,0.106667,0.893333,24,8,-1, abandoned,1,0,0
37781,1000130,2,338,282,56,0.83432,0.16568,1.577909,43,13,339,283,56,0.834808,0.165192,1.584808,43,13,1, merged,0,0,0.532572536836
37783,1000329,1,2645,2060,585,0.778828,0.221172,0.778828,512,73,2646,2060,586,0.778534,0.221466,0.778534,513,73,1, abandoned,1,1,0.195561033072
37796,1000153,3,865,789,76,0.912139,0.087861,2.319546,61,15,866,790,76,0.91224,0.08776,2.305097,61,15,1, merged,0,0,0.0031656540884
37798,1000110,2,120,101,19,0.841667,0.158333,1.405769,17,2,122,103,19,0.844262,0.155738,1.405238,17,2,1, merged,0,0,0.675386276481
37800,1000015,1,1702,1528,174,0.897767,0.102233,0.897767,162,12,1703,1528,175,0.89724,0.10276,0.89724,162,13,-1, merged,1,1,0
37800,1000120,3,1170,990,180,0.846154,0.153846,2.63483,157,23,1171,990,181,0.845431,0.154569,2.617671,157,24,-1, merged,1,1,0
37804,1000009,2,992,827,165,0.833669,0.166331,1.552968,149,16,993,828,165,0.833837,0.166163,1.554361,149,16,1, merged,0,0,1.17602373517
37804,1000534,1,228,164,64,0.719298,0.280702,0.719298,60,4,229,165,64,0.720524,0.279476,0.720524,60,4,-1, merged,0,0,1.11536247209
37806,1000110,2,122,103,19,0.844262,0.155738,1.405238,17,2,123,104,19,0.845528,0.154472,1.426924,17,2,1, merged,0,0,0.677983630952
37818,1000023,2,707,628,79,0.88826,0.11174,1.778169,74,5,708,629,79,0.888418,0.111582,1.770236,74,5,-1, abandoned,0,0,0.31867613681
37821,1000121,4,1721,1417,304,0.823359,0.176641,3.087996,288,16,1722,1418,304,0.823461,0.176539,3.123259,288,16,1, merged,0,0,0.416004719979
37821,1002169,1,334,209,125,0.625749,0.374251,0.625749,121,4,335,210,125,0.626866,0.373134,0.626866,121,4,-1, merged,0,0,0
37823,1000140,1,122,101,21,0.827869,0.172131,0.827869,19,2,123,102,21,0.829268,0.170732,0.829268,19,2,1, merged,0,0,0.0939673297752
37826,1000014,2,1808,1533,275,0.847898,0.152102,1.653541,254,21,1811,1534,277,0.847046,0.152954,1.650171,256,21,1, merged,1,1,0.0356934166592
37828,1000327,1,648,509,139,0.785494,0.214506,0.785494,107,32,649,510,139,0.785824,0.214176,0.785824,107,32,1, merged,0,0,0.299088321927
37830,1000014,1,1811,1534,277,0.847046,0.152954,0.847046,256,21,1814,1535,279,0.846196,0.153804,0.846196,257,22,1, merged,1,1,0.0959326133078
37830,1000023,2,708,629,79,0.888418,0.111582,1.735464,74,5,709,629,80,0.887165,0.112835,1.733361,74,6,-1, merged,1,1,0.0490424666923
37830,1000121,4,1722,1418,304,0.823461,0.176539,3.236891,288,16,1723,1419,304,0.823564,0.176436,3.237597,288,16,1, merged,0,0,0.0766112993048
37833,1000014,2,1814,1535,279,0.846196,0.153804,1.676108,257,22,1816,1536,280,0.845815,0.154185,1.671396,258,22,1, merged,1,1,0
37833,1000015,3,1704,1529,175,0.8973,0.1027,2.573409,162,13,1706,1530,176,0.896835,0.103165,2.568231,163,13,1, merged,1,1,0
37833,1000091,5,451,347,104,0.769401,0.230599,4.191402,89,15,453,349,104,0.770419,0.229581,4.187508,89,15,1, merged,0,0,0
37833,1000130,1,341,283,58,0.829912,0.170088,0.829912,45,13,344,284,60,0.825581,0.174419,0.825581,47,13,1, merged,1,1,0
37833,1000592,4,568,482,86,0.848592,0.151408,3.422,54,32,569,483,86,0.848858,0.151142,3.417089,54,32,1, merged,0,0,0
37836,1000592,2,570,484,86,0.849123,0.150877,1.615357,54,32,571,485,86,0.849387,0.150613,1.618618,54,32,1, merged,0,0,0.616238443516
37837,1000592,2,571,485,86,0.849387,0.150613,1.618618,54,32,572,486,86,0.84965,0.15035,1.621802,54,32,1, merged,0,0,0.301652186298
37844,1000328,2,792,580,212,0.732323,0.267677,1.510941,189,23,793,581,212,0.732661,0.267339,1.511151,189,23,1, merged,0,0,0.0377199956704
37844,1000329,1,2647,2061,586,0.778617,0.221383,0.778617,513,73,2650,2063,587,0.778491,0.221509,0.778491,514,73,-1, merged,1,0,0.0375376985697
37844,1000592,3,572,486,86,0.84965,0.15035,2.360591,54,32,573,487,86,0.849913,0.150087,2.361064,54,32,1, merged,0,0,0.033521905781
37850,1000009,2,994,829,165,0.834004,0.165996,1.752679,149,16,995,829,166,0.833166,0.166834,1.749082,150,16,1, merged,1,1,0.00137059965374
37850,1000026,1,332,305,27,0.918675,0.081325,0.918675,25,2,333,305,28,0.915916,0.084084,0.915916,26,2,1, merged,1,1,0.0151375205255
37850,1000153,3,867,791,76,0.912341,0.087659,2.66502,61,15,868,792,76,0.912442,0.087558,2.661524,61,15,1, merged,0,0,0.00332133243419
37851,1000329,2,2650,2063,587,0.778491,0.221509,1.559741,514,73,2651,2064,587,0.778574,0.221426,1.53615,514,73,-1, abandoned,0,0,0.633627185187
37852,1000003,3,961,806,155,0.83871,0.16129,2.470191,140,15,962,807,155,0.838877,0.161123,2.320796,140,15,-1, abandoned,0,0,0.00135260326537
37858,1000063,3,2468,2208,260,0.894652,0.105348,2.429007,216,44,2469,2209,260,0.894694,0.105306,2.366424,216,44,1, merged,0,0,0.328108335491
37863,1000004,1,2658,2361,297,0.888262,0.111738,0.888262,231,66,2659,2362,297,0.888304,0.111696,0.888304,231,66,-1, merged,0,0,0.0786030273976
37863,1000120,2,1171,990,181,0.845431,0.154569,1.733693,157,24,1172,991,181,0.845563,0.154437,1.733867,157,24,1, merged,0,0,0.0989580958783
37865,1000063,2,2469,2209,260,0.894694,0.105306,1.760891,216,44,2471,2211,260,0.894779,0.105221,1.762835,216,44,-1, merged,0,0,0.000852604594834
37870,1000108,1,91,72,19,0.791209,0.208791,0.791209,15,4,92,73,19,0.793478,0.206522,0.793478,15,4,1, merged,0,0,0.17066123363
37870,1000110,2,123,104,19,0.845528,0.154472,1.636737,17,2,124,105,19,0.846774,0.153226,1.640252,17,2,1, merged,0,0,0.232880465781
37889,1000023,1,709,629,80,0.887165,0.112835,0.887165,74,6,710,630,80,0.887324,0.112676,0.887324,74,6,1, merged,0,0,0.0069150807379
37889,1000026,2,333,305,28,0.915916,0.084084,1.803081,26,2,334,306,28,0.916168,0.083832,1.803492,26,2,1, merged,0,0,0.0010126816061
37891,1000054,1,299,264,35,0.882943,0.117057,0.882943,25,10,300,265,35,0.883333,0.116667,0.883333,25,10,-1, abandoned,0,0,0.770990446737
37891,1000166,2,315,251,64,0.796825,0.203175,1.679769,61,3,316,251,65,0.794304,0.205696,1.677637,62,3,1, abandoned,1,1,0.510402057036
37895,1000121,3,1726,1422,304,0.82387,0.17613,2.487896,288,16,1727,1423,304,0.823972,0.176028,2.48942,288,16,1, merged,0,0,0.233357922219
37897,1000014,1,1818,1538,280,0.845985,0.154015,0.845985,258,22,1820,1540,280,0.846154,0.153846,0.846154,258,22,-1, merged,0,0,0.0599674553596
37897,1000043,2,417,346,71,0.829736,0.170264,1.675721,61,10,418,346,72,0.827751,0.172249,1.673905,62,10,1, merged,1,1,0.0689764113822
37897,1000070,3,992,867,125,0.873992,0.126008,2.549713,106,19,993,868,125,0.874119,0.125881,2.548024,106,19,1, merged,0,0,0.0722326645609
37898,1000023,1,710,630,80,0.887324,0.112676,0.887324,74,6,711,631,80,0.887482,0.112518,0.887482,74,6,1, merged,0,0,0.00707167257968
37898,1000063,2,2471,2211,260,0.894779,0.105221,1.782103,216,44,2472,2212,260,0.894822,0.105178,1.782304,216,44,1, merged,0,0,0.00716938418628
37903,1000108,1,92,73,19,0.793478,0.206522,0.793478,15,4,94,75,19,0.797872,0.202128,0.797872,15,4,-1, merged,0,0,0.544879290027
37903,1000110,2,124,105,19,0.846774,0.153226,1.640252,17,2,125,106,19,0.848,0.152,1.645872,17,2,1, merged,0,0,0.608937171827
37904,1000014,1,1820,1540,280,0.846154,0.153846,0.846154,258,22,1821,1540,281,0.845689,0.154311,0.845689,259,22,1, abandoned,1,1,0
37904,1000592,2,574,488,86,0.850174,0.149826,1.696328,54,32,576,490,86,0.850694,0.149306,1.696384,54,32,-1, abandoned,0,0,0
37906,1000004,1,2666,2368,298,0.888222,0.111778,0.888222,232,66,2667,2369,298,0.888264,0.111736,0.888264,232,66,-1, abandoned,0,0,0.00115878584994
37906,1000023,2,711,631,80,0.887482,0.112518,1.775704,74,6,712,632,80,0.88764,0.11236,1.775904,74,6,-1, abandoned,0,0,0.000223030086759
37906,1000329,3,2652,2065,587,0.778658,0.221342,2.554362,514,73,2653,2066,587,0.778741,0.221259,2.554645,514,73,-1, abandoned,0,0,0.000432082095598
37907,1000014,1,1821,1540,281,0.845689,0.154311,0.845689,259,22,1823,1542,281,0.845858,0.154142,0.845858,259,22,-1, merged,0,0,0
37907,1000070,2,994,869,125,0.874245,0.125755,1.719935,106,19,995,870,125,0.874372,0.125628,1.72023,106,19,1, merged,0,0,0
37910,1000004,1,2667,2369,298,0.888264,0.111736,0.888264,232,66,2668,2370,298,0.888306,0.111694,0.888306,232,66,1, merged,0,0,0.0100421642151
37910,1000070,3,995,870,125,0.874372,0.125628,2.512636,106,19,996,871,125,0.874498,0.125502,2.521425,106,19,1, merged,0,0,0.00469208211144
37912,1000070,2,997,872,125,0.874624,0.125376,1.207957,106,19,998,873,125,0.874749,0.125251,1.124749,106,19,1, merged,0,0,0.00470346002188
37918,1000023,1,712,632,80,0.88764,0.11236,0.88764,74,6,713,633,80,0.887798,0.112202,0.887798,74,6,1, merged,0,0,0
37918,1000132,2,304,272,32,0.894737,0.105263,1.782377,24,8,305,273,32,0.895082,0.104918,1.78288,24,8,1, merged,0,0,0
37920,1000329,1,2653,2066,587,0.778741,0.221259,0.778741,514,73,2654,2067,587,0.778824,0.221176,0.778824,514,73,-1, merged,0,0,0
37930,1000063,2,2473,2213,260,0.894865,0.105135,1.853198,216,44,2474,2214,260,0.894907,0.105093,1.854907,216,44,1, merged,0,0,0.00600209462497
37933,1000023,1,714,634,80,0.887955,0.112045,0.887955,74,6,715,635,80,0.888112,0.111888,0.888112,74,6,1, merged,0,0,0.00448324956187
37934,1000023,1,715,635,80,0.888112,0.111888,0.888112,74,6,717,637,80,0.888424,0.111576,0.888424,74,6,-1, merged,0,0,0.0101943821077
37935,1000023,2,717,637,80,0.888424,0.111576,1.821757,74,6,718,638,80,0.888579,0.111421,1.826079,74,6,1, merged,0,0,0.00462734629396
37935,1000063,3,2474,2214,260,0.894907,0.105093,2.716664,216,44,2475,2215,260,0.894949,0.105051,2.721029,216,44,1, merged,0,0,0.00564224770599
37940,1000014,2,1823,1542,281,0.845858,0.154142,1.758402,259,22,1824,1542,282,0.845395,0.154605,1.756991,260,22,1, abandoned,1,1,0
37940,1000015,4,1706,1530,176,0.896835,0.103165,3.537589,163,13,1707,1531,176,0.896895,0.103105,3.534321,163,13,-1, abandoned,0,0,0
37940,1000153,1,869,793,76,0.912543,0.087457,0.912543,61,15,871,794,77,0.911596,0.088404,0.911596,62,15,1, abandoned,1,1,0
37950,1000012,2,498,430,68,0.863454,0.136546,1.694099,66,2,499,431,68,0.863727,0.136273,1.695727,66,2,1, merged,0,0,0.41970521542
37950,1000140,1,124,103,21,0.830645,0.169355,0.830645,19,2,125,104,21,0.832,0.168,0.832,19,2,1, merged,0,0,0.490711614774
37956,1000153,1,871,794,77,0.911596,0.088404,0.911596,62,15,872,795,77,0.911697,0.088303,0.911697,62,15,1, merged,0,0,0.0194655328096
37961,1000007,2,1259,1012,247,0.803813,0.196187,1.71551,220,27,1261,1014,247,0.804124,0.195876,1.714879,220,27,-1, merged,0,0,1.30019256636
37961,1000009,3,995,829,166,0.833166,0.166834,2.548676,150,16,996,830,166,0.833333,0.166667,2.548212,150,16,1, merged,0,0,1.24391319458
37961,1000153,1,872,795,77,0.911697,0.088303,0.911697,62,15,874,796,78,0.910755,0.089245,0.910755,63,15,1, merged,1,1,1.1174008246
37964,1000023,1,719,639,80,0.888734,0.111266,0.888734,74,6,720,640,80,0.888889,0.111111,0.888889,74,6,1, merged,0,0,0.000480758022516
37968,1000007,1,1261,1014,247,0.804124,0.195876,0.804124,220,27,1262,1015,247,0.804279,0.195721,0.804279,220,27,1, merged,0,0,1.02352892798
37968,1000153,2,874,796,78,0.910755,0.089245,1.714879,63,15,875,797,78,0.910857,0.089143,1.715136,63,15,1, merged,0,0,0.944855337713
37977,1000592,3,576,490,86,0.850694,0.149306,2.480106,54,32,577,491,86,0.850953,0.149047,2.483025,54,32,1, merged,0,0,0.126684309706
37978,1000108,2,96,77,19,0.802083,0.197917,1.552083,15,4,97,78,19,0.804124,0.195876,1.560221,15,4,1, merged,0,0,0.00388970949934
37979,1000108,1,97,78,19,0.804124,0.195876,0.804124,15,4,98,78,20,0.795918,0.204082,0.795918,16,4,1, merged,1,1,0.00926578886895
37979,1000110,3,128,109,19,0.851562,0.148438,2.487686,17,2,129,110,19,0.852713,0.147287,2.483277,17,2,1, merged,0,0,0.0243917464662
37979,1000140,2,125,104,21,0.832,0.168,1.636124,19,2,127,106,21,0.834646,0.165354,1.630564,19,2,-1, merged,0,0,0.00872577667933
37980,1000009,2,997,831,166,0.833501,0.166499,1.556444,150,16,998,832,166,0.833667,0.166333,1.558989,150,16,-1, merged,0,0,1.17625483511
37980,1000534,1,231,167,64,0.722944,0.277056,0.722944,60,4,233,169,64,0.725322,0.274678,0.725322,60,4,-1, merged,0,0,1.1152272061
37982,1000108,2,98,78,20,0.795918,0.204082,1.630564,16,4,99,79,20,0.79798,0.20202,1.633917,16,4,1, merged,0,0,0.255062486403
37982,1000140,1,127,106,21,0.834646,0.165354,0.834646,19,2,128,107,21,0.835938,0.164062,0.835938,19,2,-1, merged,0,0,0.244140501072
37986,1000011,2,627,579,48,0.923445,0.076555,1.787716,44,4,628,580,48,0.923567,0.076433,1.786117,44,4,1, merged,0,0,0.0105874991767
37986,1000012,1,501,433,68,0.864271,0.135729,0.864271,66,2,502,433,69,0.86255,0.13745,0.86255,67,2,1, merged,1,1,0.27756413367
37988,1000054,2,301,266,35,0.883721,0.116279,1.65414,25,10,303,268,35,0.884488,0.115512,1.655414,25,10,1, merged,0,0,0.676803701045
37988,1000091,1,453,349,104,0.770419,0.229581,0.770419,89,15,454,350,104,0.770925,0.229075,0.770925,89,15,1, merged,0,0,0.465328245885
37995,1000070,1,1001,876,125,0.875125,0.124875,0.875125,106,19,1002,877,125,0.87525,0.12475,0.87525,106,19,1, merged,0,0,0.727629662005
37995,1000110,2,129,110,19,0.852713,0.147287,1.727838,17,2,130,111,19,0.853846,0.146154,1.729096,17,2,1, merged,0,0,0.607992316097
38003,1000014,1,1826,1544,282,0.845564,0.154436,0.845564,260,22,1830,1547,283,0.845355,0.154645,0.845355,261,22,-1, merged,1,0,0.343360302068
38006,1000004,1,2670,2371,299,0.888015,0.111985,0.888015,233,66,2671,2372,299,0.888057,0.111943,0.888057,233,66,-1, abandoned,0,0,0.0615587591711
38006,1000329,2,2658,2070,588,0.778781,0.221219,1.666796,515,73,2659,2071,588,0.778864,0.221136,1.666921,515,73,-1, abandoned,0,0,0.0248105753829
38007,1000014,1,1830,1547,283,0.845355,0.154645,0.845355,261,22,1831,1548,283,0.84544,0.15456,0.84544,261,22,1, merged,0,0,0.220145307496
38007,1000121,4,1727,1423,304,0.823972,0.176028,3.425425,288,16,1728,1424,304,0.824074,0.175926,3.431418,288,16,1, merged,0,0,0.130438720409
38013,1000009,2,999,833,166,0.833834,0.166166,1.679922,150,16,1000,834,166,0.834,0.166,1.680219,150,16,1, merged,0,0,0.00394133972603
38013,1000011,3,629,581,48,0.923688,0.076312,2.603611,44,4,630,582,48,0.92381,0.07619,2.604029,44,4,1, merged,0,0,0.00589555978128
38013,1000120,1,1176,995,181,0.846088,0.153912,0.846088,157,24,1177,996,181,0.846219,0.153781,0.846219,157,24,1, merged,0,0,0.00970514463764
38014,1000014,1,1831,1548,283,0.84544,0.15456,0.84544,261,22,1832,1548,284,0.844978,0.155022,0.844978,262,22,1, abandoned,1,1,0
38014,1000043,2,420,348,72,0.828571,0.171429,1.674011,62,10,421,348,73,0.826603,0.173397,1.671581,63,10,1, abandoned,1,1,0.695522225284
38017,1000015,2,1708,1532,176,0.896956,0.103044,1.7583,163,13,1709,1533,176,0.897016,0.102984,1.75894,163,13,1, merged,0,0,0.000569516622766
38019,1000004,2,2674,2374,300,0.887809,0.112191,1.734028,234,66,2675,2375,300,0.88785,0.11215,1.7342,234,66,1, merged,0,0,0.0635303707994
38019,1000120,1,1177,996,181,0.846219,0.153781,0.846219,157,24,1178,997,181,0.84635,0.15365,0.84635,157,24,1, merged,0,0,0.149619433198
38021,1000054,2,303,268,35,0.884488,0.115512,1.642064,25,10,304,269,35,0.884868,0.115132,1.649574,25,10,1, merged,0,0,0.677440420389
38024,1000121,1,1728,1424,304,0.824074,0.175926,0.824074,288,16,1729,1425,304,0.824176,0.175824,0.824176,288,16,-1, abandoned,0,0,0.500929004012
38025,1000043,2,421,348,73,0.826603,0.173397,1.605468,63,10,424,349,75,0.823113,0.176887,1.602061,63,12,-1, merged,1,1,0.555304777973
38025,1000329,1,2659,2071,588,0.778864,0.221136,0.778864,515,73,2660,2072,588,0.778947,0.221053,0.778947,515,73,1, merged,0,0,0.623729545988
38026,1000327,1,649,510,139,0.785824,0.214176,0.785824,107,32,650,511,139,0.786154,0.213846,0.786154,107,32,-1, merged,0,0,0.661984862819
38026,1000328,2,793,581,212,0.732661,0.267339,1.518485,189,23,795,583,212,0.733333,0.266667,1.519487,189,23,-1, merged,0,0,0.643355359765
38028,1000121,1,1729,1425,304,0.824176,0.175824,0.824176,288,16,1730,1426,304,0.824277,0.175723,0.824277,288,16,1, merged,0,0,0.00552882905732
38028,1000140,3,128,107,21,0.835938,0.164062,2.530862,19,2,129,108,21,0.837209,0.162791,2.533108,19,2,1, merged,0,0,0.0105484484518
38030,1000003,1,962,807,155,0.838877,0.161123,0.838877,140,15,963,808,155,0.839045,0.160955,0.839045,140,15,1, merged,0,0,0.539919051044
38031,1000054,2,304,269,35,0.884868,0.115132,1.758202,25,10,305,270,35,0.885246,0.114754,1.759418,25,10,1, merged,0,0,0.768329683082
38032,1000140,2,129,108,21,0.837209,0.162791,1.711381,19,2,130,109,21,0.838462,0.161538,1.713462,19,2,1, merged,0,0,0.0410480234557
38033,1000063,2,2475,2215,260,0.894949,0.105051,1.769949,216,44,2476,2216,260,0.894992,0.105008,1.770809,216,44,1, merged,0,0,0.0072226520577
38034,1000023,2,720,640,80,0.888889,0.111111,1.659722,74,6,721,641,80,0.889043,0.110957,1.664553,74,6,1, merged,0,0,0.000337294523158
38036,1000153,1,875,797,78,0.910857,0.089143,0.910857,63,15,876,798,78,0.910959,0.089041,0.910959,63,15,1, merged,0,0,1.07672868563
38042,1000054,2,306,271,35,0.885621,0.114379,1.740583,25,10,307,272,35,0.885993,0.114007,1.742054,25,10,1, merged,0,0,0.566898865303
38042,1000110,1,131,112,19,0.854962,0.145038,0.854962,17,2,132,113,19,0.856061,0.143939,0.856061,17,2,1, merged,0,0,0.423049869874
38045,1000023,1,721,641,80,0.889043,0.110957,0.889043,74,6,723,641,82,0.886584,0.113416,0.886584,76,6,1, merged,1,1,0.000795081782143
38045,1000063,3,2476,2216,260,0.894992,0.105008,2.420399,216,44,2478,2218,260,0.895077,0.104923,2.364994,216,44,-1, merged,0,0,0.00084858331291
38050,1000023,1,723,641,82,0.886584,0.113416,0.886584,76,6,724,642,82,0.88674,0.11326,0.88674,76,6,1, merged,0,0,0.000477151430108
38055,1000140,3,130,109,21,0.838462,0.161538,2.577292,19,2,131,109,22,0.832061,0.167939,2.553542,20,2,1, abandoned,1,1,0.0312935708752
38060,1000004,2,2675,2375,300,0.88785,0.11215,1.764394,234,66,2677,2377,300,0.887934,0.112066,1.770287,234,66,-1, merged,0,0,0
38061,1000009,1,1003,836,167,0.8335,0.1665,0.8335,151,16,1004,837,167,0.833665,0.166335,0.833665,151,16,-1, abandoned,0,0,0.306878978789
38061,1000120,2,1180,999,181,0.84661,0.15339,1.68011,157,24,1181,1000,181,0.84674,0.15326,1.680405,157,24,-1, abandoned,0,0,0
38066,1000004,2,2677,2377,300,0.887934,0.112066,1.774675,234,66,2678,2378,300,0.887976,0.112024,1.774873,234,66,1, merged,0,0,4.0397769003e-09
38066,1000023,1,724,642,82,0.88674,0.11326,0.88674,76,6,725,643,82,0.886897,0.113103,0.886897,76,6,1, merged,0,0,4.95235222492e-06
38072,1000043,2,424,349,75,0.823113,0.176887,1.734072,63,12,425,350,75,0.823529,0.176471,1.73459,63,12,1, merged,0,0,0.524555938038
38072,1000153,1,876,798,78,0.910959,0.089041,0.910959,63,15,877,799,78,0.91106,0.08894,0.91106,63,15,1, merged,0,0,0.59504002295
38086,1000091,2,454,350,104,0.770925,0.229075,1.53434,89,15,455,350,105,0.769231,0.230769,1.533086,90,15,1, abandoned,1,1,0
38087,1000014,2,1834,1550,284,0.845147,0.154853,1.609853,262,22,1835,1551,284,0.845232,0.154768,1.623009,262,22,1, merged,0,0,0.438118127676
38088,1000132,2,305,273,32,0.895082,0.104918,1.690035,24,8,306,274,32,0.895425,0.104575,1.691022,24,8,1, merged,0,0,0.00543386646998
38088,1000166,1,317,252,65,0.794953,0.205047,0.794953,62,3,318,253,65,0.795597,0.204403,0.795597,62,3,1, merged,0,0,0.00565602979647
38091,1000140,1,131,109,22,0.832061,0.167939,0.832061,20,2,136,109,27,0.801471,0.198529,0.801471,25,2,1, merged,1,1,0.0276470693404
38093,1000110,3,133,114,19,0.857143,0.142857,2.461083,17,2,134,115,19,0.858209,0.141791,2.453829,17,2,-1, abandoned,0,0,0.231730448043
38093,1000140,2,136,109,27,0.801471,0.198529,1.60394,25,2,137,109,28,0.79562,0.20438,1.59562,26,2,1, abandoned,1,1,0.166972597234
38096,1000043,2,425,350,75,0.823529,0.176471,1.705882,63,12,427,350,77,0.819672,0.180328,1.683308,65,12,1, merged,1,1,0.171120205995
38096,1000110,3,134,115,19,0.858209,0.141791,2.564091,17,2,135,116,19,0.859259,0.140741,2.542568,17,2,1, merged,0,0,0.0685453666328
38101,1000140,1,137,109,28,0.79562,0.20438,0.79562,26,2,138,109,29,0.789855,0.210145,0.789855,27,2,1, merged,1,1,0.0287587927918
38118,1000004,3,2679,2379,300,0.888018,0.111982,2.604631,234,66,2680,2380,300,0.88806,0.11194,2.556145,234,66,1, merged,0,0,0.0102649643934
38118,1000329,2,2662,2074,588,0.779113,0.220887,1.716613,515,73,2663,2075,588,0.779196,0.220804,1.668085,515,73,-1, merged,0,0,0.00280595726311
38119,1000124,2,640,592,48,0.925,0.075,1.758333,42,6,642,593,49,0.923676,0.076324,1.780819,42,7,-1, merged,1,1,0.389679462381
38119,1000132,3,307,275,32,0.895765,0.104235,2.654099,24,8,308,276,32,0.896104,0.103896,2.676923,24,8,1, merged,0,0,0.493465045593
38120,1000130,2,345,285,60,0.826087,0.173913,1.6267,47,13,346,286,60,0.82659,0.17341,1.627813,47,13,-1, abandoned,0,0,0.0431548755868
38125,1000110,2,135,116,19,0.859259,0.140741,1.661089,17,2,136,117,19,0.860294,0.139706,1.662726,17,2,1, merged,0,0,0.0758709219348
38135,1000014,2,1837,1553,284,0.8454,0.1546,1.8454,262,22,1838,1554,284,0.845484,0.154516,1.845484,262,22,1, merged,0,0,0.0349549988028
38135,1000132,3,308,276,32,0.896104,0.103896,2.741504,24,8,309,277,32,0.89644,0.10356,2.741924,24,8,1, merged,0,0,0.0175508119923
38144,1000043,1,427,350,77,0.819672,0.180328,0.819672,65,12,429,352,77,0.820513,0.179487,0.820513,65,12,-1, abandoned,0,0,0.0583810764633
38146,1000003,2,963,808,155,0.839045,0.160955,1.727104,140,15,964,809,155,0.839212,0.160788,1.727313,140,15,-1, abandoned,0,0,0.186646947931
38146,1000004,1,2680,2380,300,0.88806,0.11194,0.88806,234,66,2681,2381,300,0.888101,0.111899,0.888101,234,66,-1, abandoned,0,0,0.113470183288
38146,1000329,3,2663,2075,588,0.779196,0.220804,2.506301,515,73,2664,2076,588,0.779279,0.220721,2.506592,515,73,-1, abandoned,0,0,0.104239634489
38147,1000153,1,880,801,79,0.910227,0.089773,0.910227,63,16,881,802,79,0.910329,0.089671,0.910329,63,16,-1, abandoned,0,0,0.00127070746443
38150,1000004,2,2681,2381,300,0.888101,0.111899,1.750847,234,66,2683,2383,300,0.888185,0.111815,1.734339,234,66,-1, merged,0,0,0
38156,1000054,2,310,275,35,0.887097,0.112903,1.682694,25,10,311,275,36,0.884244,0.115756,1.677348,26,10,1, abandoned,1,1,0
38156,1000166,1,318,253,65,0.795597,0.204403,0.795597,62,3,319,253,66,0.793103,0.206897,0.793103,63,3,1, abandoned,1,1,0
38158,1000054,2,311,275,36,0.884244,0.115756,1.677994,26,10,312,275,37,0.88141,0.11859,1.672688,27,10,1, abandoned,1,1,0
38158,1000166,1,320,254,66,0.79375,0.20625,0.79375,63,3,321,254,67,0.791277,0.208723,0.791277,64,3,1, abandoned,1,1,0
38161,1000109,1,412,348,64,0.84466,0.15534,0.84466,61,3,414,350,64,0.845411,0.154589,0.845411,61,3,-1, merged,0,0,0.299055944995
38163,1002169,1,335,210,125,0.626866,0.373134,0.626866,121,4,336,210,126,0.625,0.375,0.625,121,5,-1, merged,1,1,0
38164,1000023,2,725,643,82,0.886897,0.113103,1.770617,76,6,726,644,82,0.887052,0.112948,1.767052,76,6,1, merged,0,0,0.0349207375102
38171,1000153,2,881,802,79,0.910329,0.089671,1.663952,63,16,882,803,79,0.910431,0.089569,1.667574,63,16,1, merged,0,0,1.07803465633
38173,1000054,1,312,275,37,0.88141,0.11859,0.88141,27,10,313,276,37,0.881789,0.118211,0.881789,27,10,1, merged,0,0,0.136153053231
38173,1000091,2,455,350,105,0.769231,0.230769,1.650641,90,15,456,351,105,0.769737,0.230263,1.651526,90,15,1, merged,0,0,0.110313086665
38173,1000166,3,321,254,67,0.791277,0.208723,2.441918,64,3,322,255,67,0.791925,0.208075,2.443451,64,3,1, merged,0,0,0.215049109699
38175,1000023,1,726,644,82,0.887052,0.112948,0.887052,76,6,728,646,82,0.887363,0.112637,0.887363,76,6,-1, merged,0,0,0.00365286887832
38177,1000329,2,2664,2076,588,0.779279,0.220721,1.407851,515,73,2665,2077,588,0.779362,0.220638,1.413165,515,73,1, merged,0,0,0.163984554781
38182,1000014,2,1839,1555,284,0.845568,0.154432,1.725568,262,22,1843,1558,285,0.845361,0.154639,1.710529,263,22,-1, abandoned,1,0,0.0731890167059
38182,1000070,3,1007,881,126,0.874876,0.125124,2.600444,107,19,1008,881,127,0.874008,0.125992,2.584537,108,19,1, abandoned,1,1,0.0717245258749
38183,1000004,1,2683,2383,300,0.888185,0.111815,0.888185,234,66,2686,2384,302,0.887565,0.112435,0.887565,236,66,1, merged,1,1,0.333728271857
38184,1000004,1,2686,2384,302,0.887565,0.112435,0.887565,236,66,2687,2385,302,0.887607,0.112393,0.887607,236,66,1, merged,0,0,0.392422354454
38184,1000014,2,1843,1558,285,0.845361,0.154639,1.732926,263,22,1844,1559,285,0.845445,0.154555,1.733052,263,22,1, merged,0,0,0.508059394398
38188,1000026,4,334,306,28,0.916168,0.083832,3.47958,26,2,335,307,28,0.916418,0.083582,3.494505,26,2,1, merged,0,0,0.0848290260958
38188,1000054,1,313,276,37,0.881789,0.118211,0.881789,27,10,314,276,38,0.878981,0.121019,0.878981,28,10,1, merged,1,1,0.12802689026
38188,1000121,2,1732,1428,304,0.82448,0.17552,1.70627,288,16,1734,1429,305,0.824106,0.175894,1.703087,289,16,1, merged,1,1,0.104030139799
38197,1000043,2,432,355,77,0.821759,0.178241,1.670816,65,12,433,356,77,0.822171,0.177829,1.655504,65,12,1, merged,0,0,0
38201,1000109,2,417,353,64,0.846523,0.153477,1.652348,61,3,418,354,64,0.84689,0.15311,1.653342,61,3,1, merged,0,0,0.300782691546
38222,1000327,2,650,511,139,0.786154,0.213846,1.465929,107,32,651,512,139,0.786482,0.213518,1.468047,107,32,1, merged,0,0,0.302040721127
38225,1000004,1,2687,2385,302,0.887607,0.112393,0.887607,236,66,2689,2386,303,0.887319,0.112681,0.887319,236,67,-1, merged,1,0,0.00721801676502
38225,1000121,2,1734,1429,305,0.824106,0.175894,1.711713,289,16,1736,1431,305,0.824309,0.175691,1.711627,289,16,1, merged,0,0,0.00618911146071
38230,1000121,1,1736,1431,305,0.824309,0.175691,0.824309,289,16,1737,1432,305,0.82441,0.17559,0.82441,289,16,1, merged,0,0,0.500876529818
38230,1000329,2,2669,2081,588,0.779693,0.220307,1.604002,515,73,2670,2082,588,0.779775,0.220225,1.604185,515,73,1, merged,0,0,0.680852075555
38231,1000121,2,1737,1432,305,0.82441,0.17559,1.44941,289,16,1738,1433,305,0.824511,0.175489,1.450624,289,16,-1, abandoned,0,0,0.415821829279
38231,1002169,1,336,210,126,0.625,0.375,0.625,121,5,337,211,126,0.626113,0.373887,0.626113,121,5,-1, abandoned,0,0,0
38233,1000023,1,730,648,82,0.887671,0.112329,0.887671,76,6,731,649,82,0.887825,0.112175,0.887825,76,6,1, merged,0,0,0.00435572999477
38238,1000054,2,314,276,38,0.878981,0.121019,1.670906,28,10,315,277,38,0.879365,0.120635,1.671935,28,10,1, merged,0,0,0.770649583573
38238,1000166,1,322,255,67,0.791925,0.208075,0.791925,64,3,323,256,67,0.79257,0.20743,0.79257,64,3,1, merged,0,0,0.535325276037
38239,1000110,2,137,118,19,0.861314,0.138686,1.641534,17,2,138,119,19,0.862319,0.137681,1.643341,17,2,1, merged,0,0,0.381359582702
38242,1000004,1,2689,2386,303,0.887319,0.112681,0.887319,236,67,2692,2389,303,0.887444,0.112556,0.887444,236,67,-1, merged,0,0,0.0144700739235
38242,1000121,4,1738,1433,305,0.824511,0.175489,3.351697,289,16,1739,1434,305,0.824612,0.175388,3.352034,289,16,1, merged,0,0,0.0124004951522
38242,1000329,3,2670,2082,588,0.779775,0.220225,2.527186,515,73,2672,2083,589,0.779566,0.220434,2.527422,515,74,-1, merged,1,1,0.0176630713022
38256,1000070,2,1008,881,127,0.874008,0.125992,1.759973,108,19,1009,882,127,0.874133,0.125867,1.761089,108,19,1, merged,0,0,0.198777229966
38257,1000007,1,1262,1015,247,0.804279,0.195721,0.804279,220,27,1263,1016,247,0.804434,0.195566,0.804434,220,27,1, merged,0,0,1.22211177813
38257,1000199,2,359,304,55,0.846797,0.153203,1.651076,50,5,360,305,55,0.847222,0.152778,1.651656,50,5,1, merged,0,0,0.14859375217
38258,1000043,2,434,357,77,0.822581,0.177419,1.733113,65,12,436,359,77,0.823394,0.176606,1.734028,65,12,1, merged,0,0,0
38258,1000153,1,883,804,79,0.910532,0.089468,0.910532,63,16,884,805,79,0.910633,0.089367,0.910633,63,16,-1, merged,0,0,0
38265,1000023,1,732,650,82,0.887978,0.112022,0.887978,76,6,733,651,82,0.888131,0.111869,0.888131,76,6,1, merged,0,0,0.00608496492223
38276,1000592,2,581,494,87,0.850258,0.149742,1.712896,55,32,582,495,87,0.850515,0.149485,1.709211,55,32,1, merged,0,0,0.273042167377
38285,1000166,2,340,273,67,0.802941,0.197059,1.640779,64,3,341,274,67,0.803519,0.196481,1.645624,64,3,1, merged,0,0,0.300443212133
38293,1000130,4,346,286,60,0.82659,0.17341,3.116656,47,13,347,287,60,0.827089,0.172911,3.117264,47,13,1, merged,0,0,0.0643057262221
38301,1000120,1,1204,1021,183,0.848007,0.151993,0.848007,159,24,1205,1022,183,0.848133,0.151867,0.848133,159,24,1, merged,0,0,0.0400499419352
38301,1000329,2,2673,2084,589,0.779648,0.220352,1.627655,515,74,2674,2085,589,0.779731,0.220269,1.627864,515,74,1, merged,0,0,0.0354273235633
38303,1000120,1,1206,1023,183,0.848259,0.151741,0.848259,159,24,1207,1024,183,0.848384,0.151616,0.848384,159,24,1, merged,0,0,0.0269657148655
38303,1000329,2,2674,2085,589,0.779731,0.220269,1.627989,515,74,2675,2086,589,0.779813,0.220187,1.628198,515,74,1, merged,0,0,0.0236988044031
38309,1000004,2,2695,2392,303,0.88757,0.11243,1.68132,236,67,2697,2392,305,0.886911,0.113089,1.672187,236,69,-1, merged,1,1,0.0329835693577
38309,1000120,3,1212,1029,183,0.84901,0.15099,2.530329,159,24,1213,1029,184,0.84831,0.15169,2.520497,159,25,-1, merged,1,1,0.0767589572046
38310,1000120,2,1213,1029,184,0.84831,0.15169,1.628123,159,25,1214,1030,184,0.848435,0.151565,1.628039,159,25,1, merged,0,0,0.0379622452788
38310,1000329,1,2675,2086,589,0.779813,0.220187,0.779813,515,74,2677,2087,590,0.779604,0.220396,0.779604,515,75,-1, merged,1,1,0.00604122388419
38312,1000004,1,2697,2392,305,0.886911,0.113089,0.886911,236,69,2698,2392,306,0.886583,0.113417,0.886583,236,70,-1, merged,1,1,0.106120850371
38312,1000023,3,733,651,82,0.888131,0.111869,2.554646,76,6,734,651,83,0.886921,0.113079,2.552817,76,7,-1, merged,1,1,0.076387737612
38312,1000329,2,2677,2087,590,0.779604,0.220396,1.666515,515,75,2678,2087,591,0.779313,0.220687,1.665896,515,76,-1, merged,1,1,0.123235526112
38313,1000070,2,1010,883,127,0.874257,0.125743,1.646985,108,19,1011,883,128,0.873393,0.126607,1.65117,109,19,1, abandoned,1,1,0.0976899935425
38314,1000124,1,642,593,49,0.923676,0.076324,0.923676,42,7,643,594,49,0.923795,0.076205,0.923795,42,7,1, merged,0,0,0.00468107684289
38314,1000166,2,342,275,67,0.804094,0.195906,1.72777,64,3,343,276,67,0.804665,0.195335,1.728459,64,3,1, merged,0,0,0.00527586436124
38337,1000592,2,582,495,87,0.850515,0.149485,1.53208,55,32,583,496,87,0.850772,0.149228,1.534105,55,32,-1, abandoned,0,0,0
38338,1000592,2,583,496,87,0.850772,0.149228,1.534105,55,32,584,497,87,0.851027,0.148973,1.53611,55,32,-1, abandoned,0,0,0
38342,1000004,3,2698,2392,306,0.886583,0.113417,2.471525,236,70,2699,2393,306,0.886625,0.113375,2.470101,236,70,1, merged,0,0,0.117234157806
38342,1000014,2,1845,1560,285,0.845528,0.154472,1.584942,263,22,1846,1561,285,0.845612,0.154388,1.583476,263,22,1, merged,0,0,0.130378921268
38343,1000063,1,2482,2221,261,0.894843,0.105157,0.894843,216,45,2483,2222,261,0.894885,0.105115,0.894885,216,45,1, merged,0,0,0.00321474700325
38351,1000004,1,2701,2395,306,0.886709,0.113291,0.886709,236,70,2702,2395,307,0.88638,0.11362,0.88638,237,70,1, abandoned,1,1,0.469328467142
38354,1000004,3,2702,2395,307,0.88638,0.11362,2.590688,237,70,2703,2396,307,0.886422,0.113578,2.591661,237,70,1, merged,0,0,0.399480490419
38354,1000014,1,1846,1561,285,0.845612,0.154388,0.845612,263,22,1848,1563,285,0.845779,0.154221,0.845779,263,22,1, merged,0,0,0.510886837393
38356,1000004,2,2703,2396,307,0.886422,0.113578,1.761422,237,70,2704,2397,307,0.886464,0.113536,1.704646,237,70,-1, merged,0,0,0
38364,1000121,2,1740,1435,305,0.824713,0.175287,1.562577,289,16,1741,1436,305,0.824813,0.175187,1.563523,289,16,1, merged,0,0,0.238241830729
38365,1000592,3,585,498,87,0.851282,0.148718,2.389447,55,32,586,499,87,0.851536,0.148464,2.393394,55,32,1, merged,0,0,0.511882636514
38369,1000023,1,737,654,83,0.887381,0.112619,0.887381,76,7,739,655,84,0.886333,0.113667,0.886333,77,7,1, merged,1,1,0
38380,1000534,2,233,169,64,0.725322,0.274678,0.725322,60,4,234,170,64,0.726496,0.273504,1.226496,60,4,1, merged,0,0,0.710819438185
38381,1000023,2,739,655,84,0.886333,0.113667,1.753421,77,7,740,656,84,0.886486,0.113514,1.754411,77,7,1, merged,0,0,0.00887254429773
38384,1000023,2,740,656,84,0.886486,0.113514,1.795577,77,7,741,657,84,0.88664,0.11336,1.809717,77,7,1, merged,0,0,0
38384,1000054,3,316,278,38,0.879747,0.120253,2.675324,28,10,317,279,38,0.880126,0.119874,2.689843,28,10,1, merged,0,0,0
38385,1000023,2,741,657,84,0.88664,0.11336,1.809717,77,7,745,661,84,0.887248,0.112752,1.753915,77,7,-1, merged,0,0,0.000728385025515
38385,1000054,3,317,279,38,0.880126,0.119874,2.689843,28,10,319,281,38,0.880878,0.119122,2.634793,28,10,-1, merged,0,0,0.000732250875517
38386,1000023,2,745,661,84,0.887248,0.112752,1.502633,77,7,746,662,84,0.887399,0.112601,1.530257,77,7,1, merged,0,0,0.00730366900859
38387,1000023,1,746,662,84,0.887399,0.112601,0.887399,77,7,747,663,84,0.88755,0.11245,0.88755,77,7,1, merged,0,0,0.00460816005961
38387,1000063,2,2483,2222,261,0.894885,0.105115,1.782285,216,45,2484,2223,261,0.894928,0.105072,1.782478,216,45,1, merged,0,0,0.00471767680992
38388,1000023,1,747,663,84,0.88755,0.11245,0.88755,77,7,748,664,84,0.887701,0.112299,0.887701,77,7,1, merged,0,0,0.00089844628787
38388,1000063,2,2484,2223,261,0.894928,0.105072,1.782478,216,45,2485,2224,261,0.89497,0.10503,1.78267,216,45,1, merged,0,0,0.000878976283067
38389,1000023,2,748,664,84,0.887701,0.112299,1.575201,77,7,749,665,84,0.88785,0.11215,1.593733,77,7,1, merged,0,0,0.00353380782062
38389,1000063,3,2485,2224,261,0.89497,0.10503,2.47017,216,45,2486,2225,261,0.895012,0.104988,2.488745,216,45,1, merged,0,0,0.0035138347581
38393,1000120,3,1226,1042,184,0.849918,0.150082,2.367276,159,25,1227,1043,184,0.850041,0.149959,2.37767,159,25,1, merged,0,0,0.0755306970534
38395,1000120,2,1227,1043,184,0.850041,0.149959,1.634354,159,25,1228,1044,184,0.850163,0.149837,1.638624,159,25,1, merged,0,0,0.157541111981
38396,1000592,2,588,501,87,0.852041,0.147959,1.466795,55,32,589,502,87,0.852292,0.147708,1.470178,55,32,1, merged,0,0,0.596241340573
38403,1000023,2,750,666,84,0.888,0.112,1.682118,77,7,751,667,84,0.888149,0.111851,1.685251,77,7,1, merged,0,0,0.30557323006
38403,1000054,3,319,281,38,0.880878,0.119122,2.562995,28,10,320,282,38,0.88125,0.11875,2.566501,28,10,1, merged,0,0,0.504320591873
38403,1000121,4,1745,1439,306,0.824642,0.175358,3.387637,289,17,1746,1440,306,0.824742,0.175258,3.391243,289,17,1, merged,0,0,0.456108013301
38406,1000014,2,1850,1565,285,0.845946,0.154054,1.740683,263,22,1851,1566,285,0.846029,0.153971,1.746029,263,22,1, merged,0,0,0.110668504182
38406,1000054,3,320,282,38,0.88125,0.11875,2.621933,28,10,321,283,38,0.88162,0.11838,2.627649,28,10,1, merged,0,0,0.244336761595
38409,1000026,1,335,307,28,0.916418,0.083582,0.916418,26,2,337,308,29,0.913947,0.086053,0.913947,27,2,1, merged,1,1,0.0679476898641
38409,1000109,2,418,354,64,0.84689,0.15311,1.763308,61,3,419,355,64,0.847255,0.152745,1.761202,61,3,1, merged,0,0,0.0289389914741
38410,1000043,2,438,361,77,0.824201,0.175799,1.746881,65,12,439,362,77,0.824601,0.175399,1.747678,65,12,1, merged,0,0,0.504180285079
38414,1000329,4,2680,2089,591,0.779478,0.220522,2.604201,515,76,2683,2092,591,0.779724,0.220276,2.594201,515,76,-1, merged,0,0,0.338785964475
38417,1000121,2,1747,1440,307,0.82427,0.17573,1.603994,290,17,1748,1441,307,0.824371,0.175629,1.604177,290,17,1, merged,0,0,0.344447711484
38417,1000329,1,2683,2092,591,0.779724,0.220276,0.779724,515,76,2684,2093,591,0.779806,0.220194,0.779806,515,76,1, merged,0,0,0.318122575568
38419,1000153,2,884,805,79,0.910633,0.089367,1.700107,63,16,885,806,79,0.910734,0.089266,1.710734,63,16,1, merged,0,0,1.11406829435
38422,1000070,2,1012,884,128,0.873518,0.126482,1.755871,109,19,1013,885,128,0.873643,0.126357,1.756976,109,19,1, merged,0,0,0.372869749968
38428,1000120,2,1232,1048,184,0.850649,0.149351,1.635925,159,25,1233,1048,185,0.849959,0.150041,1.633092,160,25,1, merged,1,1,0.382303339372
38428,1000327,4,651,512,139,0.786482,0.213518,3.27426,107,32,652,513,139,0.78681,0.21319,3.261365,107,32,1, merged,0,0,0.574808454425
38429,1000063,1,2490,2229,261,0.895181,0.104819,0.895181,216,45,2491,2230,261,0.895223,0.104777,0.895223,216,45,1, merged,0,0,0.00705265298034
38439,1000005,2,339,272,67,0.80236,0.19764,1.626731,61,6,340,273,67,0.802941,0.197059,1.627412,61,6,1, merged,0,0,0.0231259080381
38439,1000121,1,1748,1441,307,0.824371,0.175629,0.824371,290,17,1749,1442,307,0.824471,0.175529,0.824471,290,17,1, merged,0,0,0.000579066684613
38442,1000023,1,751,667,84,0.888149,0.111851,0.888149,77,7,755,670,85,0.887417,0.112583,0.887417,78,7,-1, merged,1,0,8.00019457262e-05
38442,1000063,3,2492,2231,261,0.895265,0.104735,2.607885,216,45,2493,2232,261,0.895307,0.104693,2.607296,216,45,1, merged,0,0,0.000115293730199
38442,1000121,2,1749,1442,307,0.824471,0.175529,1.71262,290,17,1750,1443,307,0.824571,0.175429,1.711989,290,17,1, merged,0,0,1.51029169397e-05
38448,1000054,2,321,283,38,0.88162,0.11838,1.706191,28,10,324,286,38,0.882716,0.117284,1.706817,28,10,-1, merged,0,0,0.0341968955528
38448,1000121,1,1750,1443,307,0.824571,0.175429,0.824571,290,17,1751,1443,308,0.824101,0.175899,0.824101,291,17,1, merged,1,1,0.00458255672215
38448,1000166,3,343,276,67,0.804665,0.195335,2.510856,64,3,344,277,67,0.805233,0.194767,2.512049,64,3,1, merged,0,0,0.0237928512813
38449,1000004,2,2709,2402,307,0.886674,0.113326,1.66648,237,70,2712,2405,307,0.886799,0.113201,1.666315,237,70,-1, merged,0,0,0.476725288543
38449,1000329,1,2684,2093,591,0.779806,0.220194,0.779806,515,76,2685,2093,592,0.779516,0.220484,0.779516,516,76,1, merged,1,1,0.657325292214
38451,1000070,3,1013,885,128,0.873643,0.126357,2.230082,109,19,1015,886,129,0.872906,0.127094,2.168261,110,19,1, merged,1,1,0
38451,1000329,2,2685,2093,592,0.779516,0.220484,1.356439,516,76,2686,2093,593,0.779226,0.220774,1.295355,517,76,1, merged,1,1,0
38453,1000023,1,755,670,85,0.887417,0.112583,0.887417,78,7,757,672,85,0.887715,0.112285,0.887715,78,7,-1, merged,0,0,0.304609069869
38453,1000063,2,2493,2232,261,0.895307,0.104693,1.782724,216,45,2494,2233,261,0.895349,0.104651,1.783064,216,45,-1, merged,0,0,0.316698121363
38458,1000120,2,1236,1051,185,0.850324,0.149676,1.629549,160,25,1237,1052,185,0.850445,0.149555,1.629752,160,25,1, merged,0,0,0.212194186881
38458,1000329,1,2686,2093,593,0.779226,0.220774,0.779226,517,76,2687,2094,593,0.779308,0.220692,0.779308,517,76,1, merged,0,0,0.313167666133
38476,1000023,1,757,672,85,0.887715,0.112285,0.887715,78,7,758,673,85,0.887863,0.112137,0.887863,78,7,1, merged,0,0,0.0074081832922
38476,1000063,2,2494,2233,261,0.895349,0.104651,1.783064,216,45,2495,2234,261,0.895391,0.104609,1.783254,216,45,1, merged,0,0,0.00786880380698
38480,1000004,2,2716,2409,307,0.886966,0.113034,1.769682,237,70,2717,2410,307,0.887008,0.112992,1.770085,237,70,1, merged,0,0,0.0906505643925
38480,1000054,1,324,286,38,0.882716,0.117284,0.882716,28,10,325,287,38,0.883077,0.116923,0.883077,28,10,1, merged,0,0,0.219664870918
38492,1000003,2,965,810,155,0.839378,0.160622,1.687024,140,15,966,811,155,0.839545,0.160455,1.688446,140,15,-1, merged,0,0,0.0958169081857
38492,1000199,1,361,306,55,0.847645,0.152355,0.847645,50,5,364,309,55,0.848901,0.151099,0.848901,50,5,-1, merged,0,0,0.0520575323045
38493,1000109,3,420,356,64,0.847619,0.152381,2.499695,61,3,421,357,64,0.847981,0.152019,2.498341,61,3,-1, merged,0,0,0.0022500351568
38493,1000199,2,364,309,55,0.848901,0.151099,1.652076,50,5,366,311,55,0.849727,0.150273,1.65036,50,5,-1, merged,0,0,0.00232794994908
38494,1000199,2,366,311,55,0.849727,0.150273,1.65036,50,5,367,312,55,0.850136,0.149864,1.651398,50,5,1, merged,0,0,0.0391580394073
38495,1000023,1,759,674,85,0.888011,0.111989,0.888011,78,7,760,674,86,0.886842,0.113158,0.886842,79,7,1, merged,1,1,0.00393637817665
38495,1000026,4,337,308,29,0.913947,0.086053,3.398253,27,2,338,309,29,0.914201,0.085799,3.37549,27,2,1, merged,0,0,0.00633363979978
38495,1000109,5,421,357,64,0.847981,0.152019,4.246234,61,3,422,358,64,0.848341,0.151659,4.223831,61,3,1, merged,0,0,0.014119321599
38496,1000043,2,439,362,77,0.824601,0.175399,1.748071,65,12,440,363,77,0.825,0.175,1.748858,65,12,1, merged,0,0,0
38500,1000054,2,326,288,38,0.883436,0.116564,1.689794,28,10,327,289,38,0.883792,0.116208,1.690708,28,10,1, merged,0,0,0.0419531078223
38500,1000166,1,346,279,67,0.806358,0.193642,0.806358,64,3,347,280,67,0.806916,0.193084,0.806916,64,3,1, merged,0,0,0.0307892363652
38501,1000014,1,1852,1567,285,0.846112,0.153888,0.846112,263,22,1853,1568,285,0.846195,0.153805,0.846195,263,22,1, merged,0,0,0
38501,1000070,3,1018,889,129,0.873281,0.126719,2.560857,110,19,1019,890,129,0.873405,0.126595,2.562974,110,19,1, merged,0,0,0
38502,1000026,2,338,309,29,0.914201,0.085799,1.824936,27,2,339,310,29,0.914454,0.085546,1.825289,27,2,1, merged,0,0,0.00177716112334
38502,1000153,1,885,806,79,0.910734,0.089266,0.910734,63,16,886,807,79,0.910835,0.089165,0.910835,63,16,-1, merged,0,0,0
38503,1000054,4,327,289,38,0.883792,0.116208,3.151969,28,10,328,290,38,0.884146,0.115854,3.1196,28,10,1, merged,0,0,0.674988184793
38503,1002169,1,337,211,126,0.626113,0.373887,0.626113,121,5,338,212,126,0.627219,0.372781,0.627219,121,5,-1, merged,0,0,0
38506,1000166,2,347,280,67,0.806916,0.193084,1.536646,64,3,348,280,68,0.804598,0.195402,1.515124,65,3,1, abandoned,1,1,0
38509,1000110,1,142,123,19,0.866197,0.133803,0.866197,17,2,144,125,19,0.868056,0.131944,0.868056,17,2,-1, merged,0,0,0.205064502564
38513,1000063,1,2495,2234,261,0.895391,0.104609,0.895391,216,45,2496,2234,262,0.895032,0.104968,0.895032,216,46,-1, merged,1,1,0
38514,1000063,1,2496,2234,262,0.895032,0.104968,0.895032,216,46,2497,2234,263,0.894674,0.105326,0.894674,216,47,-1, merged,1,1,0.328140565448
38517,1000063,1,2498,2235,263,0.894716,0.105284,0.894716,216,47,2500,2236,264,0.8944,0.1056,0.8944,217,47,-1, abandoned,1,0,0.109365037561
38520,1000592,2,597,509,88,0.852596,0.147404,1.479815,56,32,598,510,88,0.852843,0.147157,1.481161,56,32,-1, abandoned,0,0,0.0620506765842
38520,1002169,1,338,212,126,0.627219,0.372781,0.627219,121,5,339,213,126,0.628319,0.371681,0.628319,121,5,-1, abandoned,0,0,0
38521,1000063,2,2500,2236,264,0.8944,0.1056,1.63311,217,47,2501,2237,264,0.894442,0.105558,1.633992,217,47,1, merged,0,0,0.0317214247316
38530,1000121,2,1751,1443,308,0.824101,0.175899,1.628698,291,17,1752,1444,308,0.824201,0.175799,1.629359,291,17,1, merged,0,0,0.0356808248562
38530,1000166,1,348,280,68,0.804598,0.195402,0.804598,65,3,349,281,68,0.805158,0.194842,0.805158,65,3,1, merged,0,0,0.050436186166
38531,1000328,1,797,585,212,0.734003,0.265997,0.734003,189,23,798,586,212,0.734336,0.265664,0.734336,189,23,1, merged,0,0,0.688125615402
38531,1000329,2,2687,2094,593,0.779308,0.220692,1.51331,517,76,2689,2094,595,0.778728,0.221272,1.513064,517,78,-1, merged,1,1,0.680824500413
38533,1000004,1,2721,2414,307,0.887174,0.112826,0.887174,237,70,2722,2415,307,0.887215,0.112785,0.887215,237,70,1, merged,0,0,0.0147400520666
38537,1000004,1,2722,2415,307,0.887215,0.112785,0.887215,237,70,2724,2417,307,0.887298,0.112702,0.887298,237,70,1, merged,0,0,0.0271634589007
38551,1000109,2,422,358,64,0.848341,0.151659,1.644951,61,3,423,359,64,0.8487,0.1513,1.6487,61,3,1, merged,0,0,0.010119841053
38564,1000121,1,1752,1444,308,0.824201,0.175799,0.824201,291,17,1753,1445,308,0.824301,0.175699,0.824301,291,17,1, merged,0,0,0.00595169297774
38564,1000592,2,599,510,89,0.851419,0.148581,1.67562,57,32,600,511,89,0.851667,0.148333,1.675968,57,32,1, merged,0,0,0.0090303191013
38566,1000003,1,966,811,155,0.839545,0.160455,0.839545,140,15,969,813,156,0.839009,0.160991,0.839009,141,15,1, merged,1,1,0
38567,1000023,2,760,674,86,0.886842,0.113158,1.747573,79,7,761,675,86,0.886991,0.113009,1.748039,79,7,1, merged,0,0,0.30730131136
38570,1000592,2,601,512,89,0.851913,0.148087,1.542131,57,32,602,513,89,0.852159,0.147841,1.540332,57,32,1, merged,0,0,0.0816126234046
38572,1000003,1,969,813,156,0.839009,0.160991,0.839009,141,15,973,816,157,0.838643,0.161357,0.838643,142,15,-1, merged,1,0,0
38572,1000014,3,1854,1569,285,0.846278,0.153722,2.487089,263,22,1855,1570,285,0.846361,0.153639,2.482624,263,22,-1, merged,0,0,0
38573,1000121,1,1753,1445,308,0.824301,0.175699,0.824301,291,17,1754,1446,308,0.824401,0.175599,0.824401,291,17,1, merged,0,0,0.000502915657201
38573,1000592,2,602,513,89,0.852159,0.147841,1.676461,57,32,603,514,89,0.852405,0.147595,1.676806,57,32,1, merged,0,0,0.00106320112373
38574,1000121,2,1754,1446,308,0.824401,0.175599,1.676806,291,17,1755,1447,308,0.824501,0.175499,1.674336,291,17,1, merged,0,0,0.00251356221801
38574,1000592,1,603,514,89,0.852405,0.147595,0.852405,57,32,606,515,91,0.849835,0.150165,0.849835,57,34,-1, merged,1,1,0.00382166126159
38575,1000121,1,1755,1447,308,0.824501,0.175499,0.824501,291,17,1756,1448,308,0.824601,0.175399,0.824601,291,17,1, merged,0,0,0.00077216543117
38575,1000592,2,606,515,91,0.849835,0.150165,1.674336,57,34,607,516,91,0.850082,0.149918,1.674684,57,34,1, merged,0,0,0.00186598444341
38576,1000121,2,1756,1448,308,0.824601,0.175399,1.674684,291,17,1757,1449,308,0.824701,0.175299,1.673634,291,17,1, merged,0,0,0.00316175778677
38576,1000592,1,607,516,91,0.850082,0.149918,0.850082,57,34,609,517,92,0.848933,0.151067,0.848933,58,34,1, merged,1,1,0.00865533230294
38577,1000011,2,631,583,48,0.92393,0.07607,1.770763,44,4,632,584,48,0.924051,0.075949,1.771251,44,4,-1, merged,0,0,0.227817180794
38577,1000120,1,1247,1056,191,0.846832,0.153168,0.846832,166,25,1250,1059,191,0.8472,0.1528,0.8472,166,25,-1, merged,0,0,0.179238226256
38586,1000004,1,2726,2419,307,0.887381,0.112619,0.887381,237,70,2727,2420,307,0.887422,0.112578,0.887422,237,70,-1, abandoned,0,0,0.117339407994
38586,1000329,2,2689,2094,595,0.778728,0.221272,1.666109,517,78,2690,2095,595,0.77881,0.22119,1.666232,517,78,-1, abandoned,0,0,0.160770772158
38588,1000015,2,1723,1547,176,0.897853,0.102147,1.808688,163,13,1724,1548,176,0.897912,0.102088,1.808848,163,13,1, merged,0,0,0.0808168341964
38588,1000153,1,886,807,79,0.910835,0.089165,0.910835,63,16,887,808,79,0.910936,0.089064,0.910936,63,16,1, merged,0,0,0.0801093337043
38590,1000023,3,761,675,86,0.886991,0.113009,2.61221,79,7,763,677,86,0.887287,0.112713,2.614312,79,7,1, merged,0,0,0.000277536167111
38591,1000023,3,763,677,86,0.887287,0.112713,2.449606,79,7,764,678,86,0.887435,0.112565,2.410216,79,7,1, merged,0,0,0.00109680156719
38592,1000023,3,764,678,86,0.887435,0.112565,2.608256,79,7,766,678,88,0.885117,0.114883,2.607757,79,9,-1, merged,1,1,0.0109669126735
38595,1000110,2,145,126,19,0.868966,0.131034,1.666585,17,2,146,127,19,0.869863,0.130137,1.668083,17,2,1, merged,0,0,0.234656391264
38597,1000004,1,2727,2420,307,0.887422,0.112578,0.887422,237,70,2730,2423,307,0.887546,0.112454,0.887546,237,70,-1, merged,0,0,0
38600,1000121,1,1757,1449,308,0.824701,0.175299,0.824701,291,17,1758,1450,308,0.824801,0.175199,0.824801,291,17,1, merged,0,0,0.0163489263609
38600,1000592,2,609,517,92,0.848933,0.151067,1.673634,58,34,610,518,92,0.84918,0.15082,1.673981,58,34,1, merged,0,0,0.0286498771197
38610,1000043,1,447,370,77,0.82774,0.17226,0.82774,65,12,448,370,78,0.825893,0.174107,0.825893,66,12,1, merged,1,1,0
38610,1000329,2,2690,2095,595,0.77881,0.22119,1.606551,517,78,2691,2096,595,0.778893,0.221107,1.604785,517,78,1, merged,0,0,0
38612,1000003,2,973,816,157,0.838643,0.161357,1.72623,142,15,974,816,158,0.837782,0.162218,1.725044,143,15,1, merged,1,1,0
38612,1000004,1,2731,2424,307,0.887587,0.112413,0.887587,237,70,2732,2424,308,0.887262,0.112738,0.887262,238,70,1, merged,1,1,0
38612,1000014,3,1856,1571,285,0.846444,0.153556,2.572674,263,22,1857,1572,285,0.846527,0.153473,2.571571,263,22,-1, merged,0,0,0
38613,1000109,1,423,359,64,0.8487,0.1513,0.8487,61,3,424,360,64,0.849057,0.150943,0.849057,61,3,1, merged,0,0,0.304624304484
38614,1000153,2,887,808,79,0.910936,0.089064,1.773284,63,16,889,810,79,0.911136,0.088864,1.770007,63,16,-1, abandoned,0,0,0.94543186458
38617,1000110,1,146,127,19,0.869863,0.130137,0.869863,17,2,147,128,19,0.870748,0.129252,0.870748,17,2,1, merged,0,0,0.729903706635
38617,1000140,2,143,114,29,0.797203,0.202797,1.667066,27,2,144,115,29,0.798611,0.201389,1.669359,27,2,1, merged,0,0,0.514553482053
38622,1000023,2,766,678,88,0.885117,0.114883,1.751784,79,9,767,679,88,0.885267,0.114733,1.760267,79,9,1, merged,0,0,0.0372370897481
38624,1000014,1,1857,1572,285,0.846527,0.153473,0.846527,263,22,1858,1573,285,0.846609,0.153391,0.846609,263,22,1, merged,0,0,0
38625,1000015,2,1724,1548,176,0.897912,0.102088,1.897912,163,13,1725,1549,176,0.897971,0.102029,1.897971,163,13,1, merged,0,0,0.342078921775
38628,1000023,1,767,679,88,0.885267,0.114733,0.885267,79,9,768,680,88,0.885417,0.114583,0.885417,79,9,1, merged,0,0,0.007485794411
38629,1000023,1,768,680,88,0.885417,0.114583,0.885417,79,9,769,681,88,0.885566,0.114434,0.885566,79,9,1, merged,0,0,0.0375763087981
38631,1000091,2,461,356,105,0.772234,0.227766,1.568694,90,15,462,356,106,0.770563,0.229437,1.565884,91,15,1, abandoned,1,1,0.206313856355
38633,1000166,1,350,282,68,0.805714,0.194286,0.805714,65,3,352,283,69,0.803977,0.196023,0.803977,66,3,1, merged,1,1,0.55283643018
38646,1000014,3,1860,1575,285,0.846774,0.153226,2.255051,263,22,1865,1579,286,0.846649,0.153351,2.293043,264,22,-1, abandoned,1,0,0
38646,1000070,6,1020,891,129,0.873529,0.126471,4.733118,110,19,1023,892,131,0.871945,0.128055,4.772395,112,19,1, abandoned,1,1,0
38646,1000105,4,457,347,110,0.7593,0.2407,3.01435,100,10,459,349,110,0.760349,0.239651,3.053391,100,10,-1, abandoned,0,0,0
38646,1000121,7,1758,1450,308,0.824801,0.175199,5.557919,291,17,1759,1450,309,0.824332,0.175668,5.596727,292,17,1, abandoned,1,1,0
38646,1002169,2,341,215,126,0.630499,0.369501,1.408276,121,5,342,216,126,0.631579,0.368421,1.446394,121,5,-1, abandoned,0,0,0
38649,1000014,1,1865,1579,286,0.846649,0.153351,0.846649,264,22,1866,1580,286,0.846731,0.153269,0.846731,264,22,-1, merged,0,0,0.632327917052
38649,1000015,2,1728,1551,177,0.897569,0.102431,1.744218,164,13,1729,1552,177,0.897629,0.102371,1.74436,164,13,1, merged,0,0,0.932174532691
38650,1000109,2,424,360,64,0.849057,0.150943,1.651564,61,3,425,361,64,0.849412,0.150588,1.65315,61,3,1, merged,0,0,0
38652,1000110,2,148,129,19,0.871622,0.128378,1.66754,17,2,149,130,19,0.872483,0.127517,1.668995,17,2,1, merged,0,0,0
38652,1000140,3,144,115,29,0.798611,0.201389,2.466151,27,2,145,116,29,0.8,0.2,2.468995,27,2,1, merged,0,0,0
38654,1000091,2,462,356,106,0.770563,0.229437,1.417622,91,15,463,357,106,0.771058,0.228942,1.437725,91,15,1, merged,0,0,0.292948717949
38661,1000023,3,771,683,88,0.885863,0.114137,1.677529,79,9,772,684,88,0.88601,0.11399,2.680531,79,9,1, merged,0,0,0
38669,1000004,1,2734,2426,308,0.887345,0.112655,0.887345,238,70,2735,2427,308,0.887386,0.112614,0.887386,238,70,-1, merged,0,0,0.215096025903
38669,1000043,2,457,379,78,0.829322,0.170678,1.716666,66,12,458,380,78,0.829694,0.170306,1.71708,66,12,1, merged,0,0,0.319891627881
38675,1000110,1,150,131,19,0.873333,0.126667,0.873333,17,2,151,132,19,0.874172,0.125828,0.874172,17,2,1, merged,0,0,0.373902542511
38681,1000121,2,1759,1450,309,0.824332,0.175668,1.612708,292,17,1760,1451,309,0.824432,0.175568,1.613122,292,17,1, merged,0,0,0.00269730853675
38683,1000121,2,1760,1451,309,0.824432,0.175568,1.824432,292,17,1761,1452,309,0.824532,0.175468,1.491198,292,17,1, merged,0,0,0.00157345020806
38684,1000121,3,1761,1452,309,0.824532,0.175468,2.280203,292,17,1762,1453,309,0.824631,0.175369,2.328234,292,17,1, merged,0,0,0.00157861738067
38685,1000014,1,1866,1580,286,0.846731,0.153269,0.846731,264,22,1867,1581,286,0.846813,0.153187,0.846813,264,22,1, merged,0,0,0.00165407144375
38685,1000023,3,774,686,88,0.886305,0.113695,2.58048,79,9,775,687,88,0.886452,0.113548,2.580831,79,9,1, merged,0,0,0.0126286682958
38685,1000120,2,1252,1061,191,0.847444,0.152556,1.694175,166,25,1253,1062,191,0.847566,0.152434,1.694379,166,25,1, merged,0,0,0.000777967947721
38687,1000121,1,1762,1453,309,0.824631,0.175369,0.824631,292,17,1763,1454,309,0.824731,0.175269,0.824731,292,17,-1, abandoned,0,0,0
38687,1000329,2,2692,2097,595,0.778975,0.221025,1.603606,517,78,2693,2098,595,0.779057,0.220943,1.603787,517,78,-1, abandoned,0,0,0
38688,1000121,1,1763,1454,309,0.824731,0.175269,0.824731,292,17,1764,1455,309,0.82483,0.17517,0.82483,292,17,-1, abandoned,0,0,0
38688,1000329,2,2693,2098,595,0.779057,0.220943,1.603787,517,78,2694,2098,596,0.778768,0.221232,1.603598,518,78,1, abandoned,1,1,0
38692,1000121,1,1764,1455,309,0.82483,0.17517,0.82483,292,17,1765,1456,309,0.824929,0.175071,0.824929,292,17,-1, abandoned,0,0,0
38692,1000329,2,2694,2098,596,0.778768,0.221232,1.603598,518,78,2695,2099,596,0.77885,0.22115,1.603779,518,78,-1, abandoned,0,0,0
38693,1000015,2,1729,1552,177,0.897629,0.102371,1.678651,164,13,1730,1552,178,0.89711,0.10289,1.678928,165,13,1, abandoned,1,1,0
38704,1000110,2,151,132,19,0.874172,0.125828,1.595102,17,2,152,133,19,0.875,0.125,1.602273,17,2,1, merged,0,0,0.417345075016
38711,1000004,1,2740,2431,309,0.887226,0.112774,0.887226,239,70,2741,2432,309,0.887267,0.112733,0.887267,239,70,-1, abandoned,0,0,0
38711,1000120,2,1257,1066,191,0.848051,0.151949,1.735277,166,25,1258,1067,191,0.848172,0.151828,1.735439,166,25,-1, abandoned,0,0,0
38711,1000329,3,2697,2100,597,0.778643,0.221357,2.51392,519,78,2698,2101,597,0.778725,0.221275,2.514164,519,78,-1, abandoned,0,0,0
38714,1000110,1,152,133,19,0.875,0.125,0.875,17,2,153,134,19,0.875817,0.124183,0.875817,17,2,1, merged,0,0,0.731198461589
38716,1000110,1,153,134,19,0.875817,0.124183,0.875817,17,2,154,135,19,0.876623,0.123377,0.876623,17,2,1, merged,0,0,0.733434303954
38716,1000140,2,145,116,29,0.8,0.2,1.675817,27,2,146,117,29,0.80137,0.19863,1.677993,27,2,1, merged,0,0,0.516760435831
38717,1000132,2,312,279,33,0.894231,0.105769,1.818089,25,8,313,280,33,0.894569,0.105431,1.818811,25,8,1, merged,0,0,0.954350010046
38722,1000109,1,425,361,64,0.849412,0.150588,0.849412,61,3,427,363,64,0.850117,0.149883,0.850117,61,3,-1, merged,0,0,0.022420356642
38722,1000153,2,891,812,79,0.911336,0.088664,1.760747,63,16,893,814,79,0.911534,0.088466,1.761651,63,16,-1, merged,0,0,0.00234638673124
38729,1000023,3,775,687,88,0.886452,0.113548,2.614408,79,9,776,688,88,0.886598,0.113402,2.61628,79,9,1, merged,0,0,0.314896686197
38735,1000003,1,974,816,158,0.837782,0.162218,0.837782,143,15,978,817,161,0.835378,0.164622,0.835378,146,15,1, merged,1,1,0
38735,1000121,4,1765,1456,309,0.824929,0.175071,2.957566,292,17,1766,1457,309,0.825028,0.174972,2.954077,292,17,-1, merged,0,0,0
38735,1000329,3,2698,2101,597,0.778725,0.221275,2.132636,519,78,2700,2102,598,0.778519,0.221481,2.129048,520,78,-1, merged,1,0,0
38748,1000003,1,978,817,161,0.835378,0.164622,0.835378,146,15,979,818,161,0.835546,0.164454,0.835546,146,15,1, merged,0,0,0
38748,1000070,2,1027,896,131,0.872444,0.127556,1.707822,112,19,1028,896,132,0.871595,0.128405,1.707142,112,20,-1, merged,1,1,0.393758750719
38752,1000070,1,1028,896,132,0.871595,0.128405,0.871595,112,20,1030,897,133,0.870874,0.129126,0.870874,113,20,1, merged,1,1,0.0796181812491
38752,1000091,3,463,357,106,0.771058,0.228942,2.383868,91,15,464,358,106,0.771552,0.228448,2.384464,91,15,-1, merged,0,0,0.175124493434
38764,1000004,1,2743,2434,309,0.88735,0.11265,0.88735,239,70,2744,2435,309,0.887391,0.112609,0.887391,239,70,-1, abandoned,0,0,0.00521500386582
38764,1000120,2,1263,1070,193,0.847189,0.152811,1.734539,168,25,1264,1071,193,0.84731,0.15269,1.734701,168,25,-1, abandoned,0,0,0.032574836535
38773,1000120,1,1265,1072,193,0.847431,0.152569,0.847431,168,25,1266,1073,193,0.847551,0.152449,0.847551,168,25,-1, abandoned,0,0,0
38783,1000005,1,344,277,67,0.805233,0.194767,0.805233,61,6,345,278,67,0.805797,0.194203,0.805797,61,6,1, merged,0,0,0
38783,1000120,2,1276,1083,193,0.848746,0.151254,1.653979,168,25,1277,1084,193,0.848865,0.151135,1.654662,168,25,1, merged,0,0,0
38784,1000004,1,2744,2435,309,0.887391,0.112609,0.887391,239,70,2745,2436,309,0.887432,0.112568,0.887432,239,70,1, merged,0,0,0
38784,1000120,2,1277,1084,193,0.848865,0.151135,1.736255,168,25,1278,1085,193,0.848983,0.151017,1.736414,168,25,1, merged,0,0,0
38787,1000023,1,776,688,88,0.886598,0.113402,0.886598,79,9,777,689,88,0.886744,0.113256,0.886744,79,9,1, merged,0,0,0.267964778365
38787,1000120,2,1279,1086,193,0.849101,0.150899,1.735699,168,25,1280,1087,193,0.849219,0.150781,1.735963,168,25,1, merged,0,0,0.403780429418
38789,1000023,1,777,689,88,0.886744,0.113256,0.886744,79,9,778,690,88,0.886889,0.113111,0.886889,79,9,1, merged,0,0,0.000887587094484
38789,1000121,2,1766,1457,309,0.825028,0.174972,1.711772,292,17,1767,1458,309,0.825127,0.174873,1.712017,292,17,1, merged,0,0,0.000376144891012
38790,1000121,1,1767,1458,309,0.825127,0.174873,0.825127,292,17,1769,1460,309,0.825325,0.174675,0.825325,292,17,-1, abandoned,0,0,0
38790,1000592,3,615,523,92,0.850407,0.149593,2.550534,58,34,616,524,92,0.850649,0.149351,2.533117,58,34,-1, abandoned,0,0,0
38791,1000023,1,778,690,88,0.886889,0.113111,0.886889,79,9,779,690,89,0.885751,0.114249,0.885751,80,9,1, abandoned,1,1,0
38796,1000121,2,1769,1460,309,0.825325,0.174675,1.619811,292,17,1770,1461,309,0.825424,0.174576,1.620424,292,17,1, merged,0,0,0.415453025163
38797,1000023,2,779,690,89,0.885751,0.114249,1.745751,80,9,781,692,89,0.886044,0.113956,1.716232,80,9,-1, merged,0,0,0.00497803554069
38798,1000004,1,2745,2436,309,0.887432,0.112568,0.887432,239,70,2746,2437,309,0.887473,0.112527,0.887473,239,70,1, merged,0,0,0.144888311026
38798,1000120,2,1281,1088,193,0.849336,0.150664,1.736768,168,25,1282,1089,193,0.849454,0.150546,1.736927,168,25,1, merged,0,0,0.127397953046
38799,1000004,2,2746,2437,309,0.887473,0.112527,1.736927,239,70,2747,2438,309,0.887514,0.112486,1.737085,239,70,1, merged,0,0,0.439209554344
38799,1000120,1,1282,1089,193,0.849454,0.150546,0.849454,168,25,1283,1090,193,0.849571,0.150429,0.849571,168,25,1, merged,0,0,0.385212257727
38803,1000043,1,460,382,78,0.830435,0.169565,0.830435,66,12,461,383,78,0.830803,0.169197,0.830803,66,12,1, merged,0,0,0
38803,1000070,2,1032,899,133,0.871124,0.128876,1.701559,113,20,1033,900,133,0.871249,0.128751,1.702051,113,20,1, merged,0,0,0
38807,1000130,1,357,296,61,0.829132,0.170868,0.829132,48,13,359,297,62,0.827298,0.172702,0.827298,48,14,-1, merged,1,0,0
38808,1000054,2,330,292,38,0.884848,0.115152,1.764478,28,10,333,295,38,0.885886,0.114114,1.757446,28,10,-1, merged,0,0,0
38813,1000121,2,1770,1461,309,0.825424,0.174576,1.825424,292,17,1771,1462,309,0.825522,0.174478,1.575522,292,17,1, merged,0,0,0
38825,1000329,1,2702,2103,599,0.778312,0.221688,0.778312,520,79,2703,2104,599,0.778394,0.221606,0.778394,520,79,-1, merged,0,0,0.20581921646
38836,1000043,1,461,383,78,0.830803,0.169197,0.830803,66,12,463,385,78,0.831533,0.168467,0.831533,66,12,-1, merged,0,0,0.387081918242
38837,1000070,2,1033,900,133,0.871249,0.128751,1.7605,113,20,1034,901,133,0.871373,0.128627,1.760984,113,20,1, merged,0,0,0.0441519570626
38844,1000009,2,1018,848,170,0.833006,0.166994,1.591627,154,16,1019,849,170,0.83317,0.16683,1.575105,154,16,1, merged,0,0,1.16456574343
38844,1000153,3,893,814,79,0.911534,0.088466,2.503161,63,16,894,815,79,0.911633,0.088367,2.486738,63,16,1, merged,0,0,1.08057095097
38847,1000011,1,635,587,48,0.924409,0.075591,0.924409,44,4,636,588,48,0.924528,0.075472,0.924528,44,4,-1, merged,0,0,0.173042765743
38847,1000120,2,1283,1090,193,0.849571,0.150429,1.773981,168,25,1284,1091,193,0.849688,0.150312,1.774217,168,25,-1, merged,0,0,0.139049906943
38850,1000003,3,979,818,161,0.835546,0.164454,2.472014,146,15,980,819,161,0.835714,0.164286,2.466677,146,15,1, merged,0,0,0.29875577242
38855,1000014,1,1868,1582,286,0.846895,0.153105,0.846895,264,22,1869,1583,286,0.846977,0.153023,0.846977,264,22,1, merged,0,0,0.000650667942877
38855,1000054,2,335,297,38,0.886567,0.113433,1.733462,28,10,336,298,38,0.886905,0.113095,1.733882,28,10,1, merged,0,0,0.000872925386551
38856,1000023,1,781,692,89,0.886044,0.113956,0.886044,80,9,782,693,89,0.886189,0.113811,0.886189,80,9,1, merged,0,0,0.00423268397068
38856,1000153,2,894,815,79,0.911633,0.088367,1.797677,63,16,895,816,79,0.911732,0.088268,1.797921,63,16,1, merged,0,0,9.71817298348e-05
38857,1000130,5,359,297,62,0.827298,0.172702,4.13945,48,14,360,297,63,0.825,0.175,4.016542,49,14,1, abandoned,1,1,0
38861,1000003,1,980,819,161,0.835714,0.164286,0.835714,146,15,981,820,161,0.835882,0.164118,0.835882,146,15,1, merged,0,0,0.000127895555394
38863,1000014,2,1870,1584,286,0.847059,0.152941,1.428454,264,22,1871,1585,286,0.847141,0.152859,1.434097,264,22,1, merged,0,0,0
38872,1000109,1,427,363,64,0.850117,0.149883,0.850117,61,3,428,363,65,0.848131,0.151869,0.848131,62,3,1, merged,1,1,0.00724325430455
38872,1000153,2,895,816,79,0.911732,0.088268,1.761849,63,16,898,819,79,0.912027,0.087973,1.760158,63,16,-1, merged,0,0,0.000719941202291
38872,1000199,3,367,312,55,0.850136,0.149864,2.611985,50,5,368,313,55,0.850543,0.149457,2.610701,50,5,1, merged,0,0,0.0062412468783
38873,1000015,2,1732,1554,178,0.897229,0.102771,1.621805,165,13,1733,1555,178,0.897288,0.102712,1.623026,165,13,1, merged,0,0,0
38873,1000534,1,236,171,65,0.724576,0.275424,0.724576,61,4,237,172,65,0.725738,0.274262,0.725738,61,4,1, merged,0,0,0
38878,1000005,3,346,279,67,0.806358,0.193642,2.550406,61,6,347,279,68,0.804035,0.195965,2.43899,62,6,1, merged,1,1,0
38878,1000054,1,336,298,38,0.886905,0.113095,0.886905,28,10,339,300,39,0.884956,0.115044,0.884956,29,10,1, merged,1,1,0
38885,1000023,1,782,693,89,0.886189,0.113811,0.886189,80,9,784,695,89,0.88648,0.11352,0.88648,80,9,1, merged,0,0,0.000177377692538
38886,1000015,2,1734,1556,178,0.897347,0.102653,1.897347,165,13,1735,1557,178,0.897406,0.102594,1.897406,165,13,1, merged,0,0,0.513562764629
38887,1000007,2,1264,1017,247,0.804589,0.195411,1.637758,220,27,1265,1018,247,0.804743,0.195257,1.637096,220,27,1, merged,0,0,0.717612395702
38887,1000009,1,1019,849,170,0.83317,0.16683,0.83317,154,16,1020,849,171,0.832353,0.167647,0.832353,154,17,-1, merged,1,1,0.677490764108
38892,1000004,1,2747,2438,309,0.887514,0.112486,0.887514,239,70,2748,2439,309,0.887555,0.112445,0.887555,239,70,1, merged,0,0,0
38892,1000007,2,1270,1022,248,0.804724,0.195276,1.692238,220,28,1271,1023,248,0.804878,0.195122,1.692433,220,28,1, merged,0,0,0
38893,1000007,3,1271,1023,248,0.804878,0.195122,2.527807,220,28,1272,1024,248,0.805031,0.194969,2.528118,220,28,1, merged,0,0,1.23566898473
38893,1000015,1,1735,1557,178,0.897406,0.102594,0.897406,165,13,1736,1558,178,0.897465,0.102535,0.897465,165,13,1, merged,0,0,1.0268214687
38893,1000121,2,1771,1462,309,0.825522,0.174478,1.722929,292,17,1772,1463,309,0.825621,0.174379,1.723086,292,17,1, merged,0,0,0.432352718949
38898,1000121,3,1772,1463,309,0.825621,0.174379,2.497752,292,17,1773,1464,309,0.825719,0.174281,2.503138,292,17,1, merged,0,0,0.130099138625
38903,1000023,2,784,695,89,0.88648,0.11352,1.553146,80,9,785,696,89,0.886624,0.113376,1.566624,80,9,1, merged,0,0,0.000307593861049
38904,1000023,2,785,696,89,0.886624,0.113376,1.566624,80,9,786,697,89,0.886768,0.113232,1.579076,80,9,1, merged,0,0,0.000338068595292
38906,1000023,1,786,697,89,0.886768,0.113232,0.886768,80,9,787,698,89,0.886912,0.113088,0.886912,80,9,1, merged,0,0,0.00036853789355
38913,1000043,3,463,385,78,0.831533,0.168467,2.344264,66,12,464,386,78,0.831897,0.168103,2.345373,66,12,1, merged,0,0,0
38913,1000328,1,798,586,212,0.734336,0.265664,0.734336,189,23,800,588,212,0.735,0.265,0.735,189,23,-1, merged,0,0,0
38913,1000329,2,2703,2104,599,0.778394,0.221606,1.51273,520,79,2704,2105,599,0.778476,0.221524,1.513476,520,79,1, merged,0,0,0
38914,1000014,1,1873,1587,286,0.847304,0.152696,0.847304,264,22,1874,1588,286,0.847385,0.152615,0.847385,264,22,1, merged,0,0,0
38914,1000091,2,464,358,106,0.771552,0.228448,1.618856,91,15,465,359,106,0.772043,0.227957,1.619428,91,15,1, merged,0,0,0
38914,1000329,3,2704,2105,599,0.778476,0.221524,2.397332,520,79,2705,2106,599,0.778558,0.221442,2.397987,520,79,1, merged,0,0,0
38933,1000009,1,1021,850,171,0.832517,0.167483,0.832517,154,17,1022,851,171,0.832681,0.167319,0.832681,154,17,1, merged,0,0,1.15482487514
38933,1000153,2,902,822,80,0.911308,0.088692,1.743825,64,16,903,823,80,0.911406,0.088594,1.744087,64,16,1, merged,0,0,1.07579132441
38934,1000023,2,788,699,89,0.887056,0.112944,1.693507,80,9,789,700,89,0.887199,0.112801,1.684074,80,9,1, merged,0,0,0.000269834791112
38936,1000109,2,428,363,65,0.848131,0.151869,1.648131,62,3,429,364,65,0.848485,0.151515,1.651116,62,3,1, merged,0,0,0.0222295554089
38942,1000011,1,637,589,48,0.924647,0.075353,0.924647,44,4,638,589,49,0.923197,0.076803,0.923197,45,4,1, merged,1,1,0.231016079104
38942,1000120,2,1288,1095,193,0.850155,0.149845,1.774802,168,25,1289,1096,193,0.850272,0.149728,1.773469,168,25,1, merged,0,0,0.18249205222
38944,1000110,2,159,139,20,0.874214,0.125786,1.678268,18,2,160,140,20,0.875,0.125,1.680369,18,2,1, merged,0,0,0
38944,1000140,1,148,119,29,0.804054,0.195946,0.804054,27,2,149,120,29,0.805369,0.194631,0.805369,27,2,1, merged,0,0,0
38947,1000003,3,982,821,161,0.836049,0.163951,2.64498,146,15,983,822,161,0.836216,0.163784,2.645304,146,15,1, merged,0,0,0.312801037278
38947,1000015,1,1737,1559,178,0.897524,0.102476,0.897524,165,13,1738,1560,178,0.897583,0.102417,0.897583,165,13,1, merged,0,0,0.395912528035
38947,1000153,2,903,823,80,0.911406,0.088594,1.808931,64,16,904,824,80,0.911504,0.088496,1.809088,64,16,1, merged,0,0,0.414797611897
38951,1000011,2,638,589,49,0.923197,0.076803,1.607408,45,4,639,590,49,0.923318,0.076682,1.637603,45,4,1, merged,0,0,0.467379739418
38969,1000009,1,1024,853,171,0.833008,0.166992,0.833008,154,17,1026,854,172,0.832359,0.167641,0.832359,155,17,1, merged,1,1,0.579497412329
38970,1000009,1,1026,854,172,0.832359,0.167641,0.832359,155,17,1028,855,173,0.831712,0.168288,0.831712,156,17,1, merged,1,1,0.579676327118
38971,1000015,3,1739,1561,178,0.897642,0.102358,2.65851,165,13,1740,1562,178,0.897701,0.102299,2.658783,165,13,1, merged,0,0,0.099126598805
38971,1000120,1,1289,1096,193,0.850272,0.149728,0.850272,168,25,1290,1097,193,0.850388,0.149612,0.850388,168,25,1, merged,0,0,0.0646551349472
38971,1000153,2,906,825,81,0.910596,0.089404,1.760868,64,17,907,826,81,0.910695,0.089305,1.761082,64,17,1, merged,0,0,0.0516446305559
38975,1000004,1,2753,2444,309,0.887759,0.112241,0.887759,239,70,2755,2446,309,0.88784,0.11216,0.88784,239,70,-1, merged,0,0,0.0465747844951
38975,1000011,2,639,590,49,0.923318,0.076682,1.811076,45,4,640,591,49,0.923438,0.076563,1.811278,45,4,-1, merged,0,0,0.0777341581306
38975,1000120,3,1291,1098,193,0.850503,0.149497,2.66158,168,25,1292,1099,193,0.850619,0.149381,2.661897,168,25,-1, merged,0,0,0.0627054560993
38976,1000011,2,640,591,49,0.923438,0.076563,1.774057,45,4,641,592,49,0.923557,0.076443,1.774407,45,4,1, merged,0,0,0.0269395434561
38976,1000120,1,1292,1099,193,0.850619,0.149381,0.850619,168,25,1294,1101,193,0.85085,0.14915,0.85085,168,25,-1, merged,0,0,0.0951542359771
38977,1000003,1,986,824,162,0.8357,0.1643,0.8357,147,15,987,825,162,0.835866,0.164134,0.835866,147,15,1, merged,0,0,0.463774189046
38977,1000015,2,1740,1562,178,0.897701,0.102299,1.733401,165,13,1741,1563,178,0.89776,0.10224,1.733626,165,13,1, merged,0,0,0.472910948629
38977,1000153,3,907,826,81,0.910695,0.089305,2.644096,64,17,908,827,81,0.910793,0.089207,2.644419,64,17,1, merged,0,0,0.47418755038
38987,1000023,2,789,700,89,0.887199,0.112801,1.713114,80,9,790,701,89,0.887342,0.112658,1.713355,80,9,1, merged,0,0,3.54206442251e-05
38987,1000121,1,1775,1466,309,0.825915,0.174085,0.825915,292,17,1776,1467,309,0.826014,0.173986,0.826014,292,17,1, merged,0,0,6.00704382202e-05
38988,1000003,2,987,825,162,0.835866,0.164134,1.632741,147,15,988,825,163,0.83502,0.16498,1.619636,148,15,1, merged,1,1,0.0115810674723
38989,1000003,1,988,825,163,0.83502,0.16498,0.83502,148,15,989,825,164,0.834176,0.165824,0.834176,149,15,1, merged,1,1,0.00166687873637
38989,1000023,2,790,701,89,0.887342,0.112658,1.722362,80,9,793,703,90,0.886507,0.113493,1.720683,81,9,-1, merged,1,0,0.00095444852387
38990,1000003,1,989,825,164,0.834176,0.165824,0.834176,149,15,993,828,165,0.833837,0.166163,0.833837,150,15,-1, merged,1,0,0.00748365061082
38990,1000023,4,793,703,90,0.886507,0.113493,3.300769,81,9,794,704,90,0.88665,0.11335,3.284709,81,9,-1, merged,0,0,0.00346390998409
38994,1000054,1,340,301,39,0.885294,0.114706,0.885294,29,10,342,303,39,0.885965,0.114035,0.885965,29,10,-1, merged,0,0,0.0652317247559
38994,1000140,2,149,120,29,0.805369,0.194631,1.690663,27,2,150,121,29,0.806667,0.193333,1.692632,27,2,1, merged,0,0,0.0297153423994
38995,1000121,2,1779,1470,309,0.826307,0.173693,1.604741,292,17,1780,1471,309,0.826404,0.173596,1.604921,292,17,1, merged,0,0,0
38995,1000329,1,2708,2108,600,0.778434,0.221566,0.778434,521,79,2709,2109,600,0.778516,0.221484,0.778516,521,79,1, merged,0,0,0
38996,1000328,2,800,588,212,0.735,0.265,1.588333,189,23,801,589,212,0.735331,0.264669,1.590594,189,23,-1, abandoned,0,0,0
38997,1000014,3,1879,1593,286,0.847791,0.152209,2.591584,264,22,1880,1594,286,0.847872,0.152128,2.592588,264,22,1, merged,0,0,0.061475249609
38997,1000023,1,794,704,90,0.88665,0.11335,0.88665,81,9,795,705,90,0.886792,0.113208,0.886792,81,9,1, merged,0,0,0.0678132392164
39000,1002169,1,342,216,126,0.631579,0.368421,0.631579,121,5,343,217,126,0.632653,0.367347,0.632653,121,5,-1, abandoned,0,0,0
39001,1000014,2,1880,1594,286,0.847872,0.152128,1.480525,264,22,1881,1595,286,0.847953,0.152047,1.478767,264,22,1, merged,0,0,0
39001,1000070,3,1039,906,133,0.871992,0.128008,2.352518,113,20,1040,907,133,0.872115,0.127885,2.350883,113,20,1, merged,0,0,0
39001,1002169,1,343,217,126,0.632653,0.367347,0.632653,121,5,344,217,127,0.630814,0.369186,0.630814,121,6,-1, merged,1,1,0
39004,1000004,2,2758,2449,309,0.887962,0.112038,1.798755,239,70,2759,2450,309,0.888003,0.111997,1.796794,239,70,1, merged,0,0,0
39004,1000153,1,908,827,81,0.910793,0.089207,0.910793,64,17,910,827,83,0.908791,0.091209,0.908791,64,19,-1, merged,1,1,0
39008,1000014,1,1881,1595,286,0.847953,0.152047,0.847953,264,22,1882,1596,286,0.848034,0.151966,0.848034,264,22,1, merged,0,0,0.247967667775
39008,1000153,2,910,827,83,0.908791,0.091209,1.756744,64,19,911,827,84,0.907794,0.092206,1.755828,64,20,-1, merged,1,1,0.295833835327
39009,1000003,3,993,828,165,0.833837,0.166163,2.602188,150,15,994,829,165,0.834004,0.165996,2.60301,150,15,1, merged,0,0,0.624510039957
39009,1000153,2,911,827,84,0.907794,0.092206,1.768351,64,20,912,828,84,0.907895,0.092105,1.769006,64,20,1, merged,0,0,0.826204962686
39011,1000004,1,2761,2452,309,0.888084,0.111916,0.888084,239,70,2762,2453,309,0.888125,0.111875,0.888125,239,70,1, merged,0,0,0
39011,1000120,2,1294,1101,193,0.85085,0.14915,1.738934,168,25,1295,1102,193,0.850965,0.149035,1.73909,168,25,1, merged,0,0,0
39019,1000329,1,2709,2109,600,0.778516,0.221484,0.778516,521,79,2710,2110,600,0.778598,0.221402,0.778598,521,79,1, merged,0,0,0
39019,1000592,2,622,530,92,0.85209,0.14791,1.630606,58,34,623,531,92,0.852327,0.147673,1.630925,58,34,1, merged,0,0,0
39022,1000109,1,429,364,65,0.848485,0.151515,0.848485,62,3,430,365,65,0.848837,0.151163,0.848837,62,3,1, merged,0,0,0
39022,1000120,2,1295,1102,193,0.850965,0.149035,1.69945,168,25,1296,1103,193,0.85108,0.14892,1.699917,168,25,1, merged,0,0,0
39031,1000054,2,342,303,39,0.885965,0.114035,1.619298,29,10,343,304,39,0.886297,0.113703,1.625428,29,10,1, merged,0,0,0.26864256809
39033,1000023,1,797,707,90,0.887077,0.112923,0.887077,81,9,798,708,90,0.887218,0.112782,0.887218,81,9,1, merged,0,0,0.00309714145443
39088,1000014,1,1885,1599,286,0.848276,0.151724,0.848276,264,22,1886,1600,286,0.848356,0.151644,0.848356,264,22,1, merged,0,0,0
39095,1000110,2,163,143,20,0.877301,0.122699,1.683967,18,2,164,144,20,0.878049,0.121951,1.687259,18,2,1, merged,0,0,0
39095,1000140,1,150,121,29,0.806667,0.193333,0.806667,27,2,152,123,29,0.809211,0.190789,0.809211,27,2,-1, merged,0,0,0
39102,1000011,1,642,593,49,0.923676,0.076324,0.923676,45,4,645,595,50,0.922481,0.077519,0.922481,46,4,-1, merged,1,0,0.141193200025
39102,1000120,2,1300,1107,193,0.851538,0.148462,1.775214,168,25,1302,1109,193,0.851767,0.148233,1.774247,168,25,-1, merged,0,0,0.111717721347
39106,1000132,2,314,281,33,0.894904,0.105096,1.716333,25,8,315,282,33,0.895238,0.104762,1.719799,25,8,1, merged,0,0,0
39112,1000070,1,1042,909,133,0.872361,0.127639,0.872361,113,20,1044,910,134,0.871648,0.128352,0.871648,113,21,-1, merged,1,0,0.586401252293
39112,1000132,2,315,282,33,0.895238,0.104762,1.767599,25,8,316,283,33,0.89557,0.10443,1.767217,25,8,1, merged,0,0,0.626528460998
39113,1000132,1,316,283,33,0.89557,0.10443,0.89557,25,8,317,284,33,0.895899,0.104101,0.895899,25,8,1, merged,0,0,0.627668539326
39114,1000026,1,340,311,29,0.914706,0.085294,0.914706,27,2,341,312,29,0.914956,0.085044,0.914956,27,2,1, merged,0,0,0.504697220769
39114,1000054,2,343,304,39,0.886297,0.113703,1.801003,29,10,344,305,39,0.886628,0.113372,1.801584,29,10,1, merged,0,0,0.377986435786
39117,1000003,3,994,829,165,0.834004,0.165996,2.514275,150,15,995,830,165,0.834171,0.165829,2.512226,150,15,-1, abandoned,0,0,0.0155151356634
39117,1000014,2,1886,1600,286,0.848356,0.151644,1.680271,264,22,1887,1600,287,0.847907,0.152093,1.678055,265,22,1, abandoned,1,1,0
39117,1000043,1,470,391,79,0.831915,0.168085,0.831915,67,12,471,391,80,0.830149,0.169851,0.830149,68,12,1, abandoned,1,1,0.00490860899796
39118,1000003,3,995,830,165,0.834171,0.165829,2.512226,150,15,996,831,165,0.834337,0.165663,2.510185,150,15,-1, abandoned,0,0,0.0160415954094
39118,1000014,2,1887,1600,287,0.847907,0.152093,1.678055,265,22,1888,1600,288,0.847458,0.152542,1.675847,266,22,1, abandoned,1,1,0
39118,1000043,1,471,391,80,0.830149,0.169851,0.830149,68,12,472,391,81,0.82839,0.17161,0.82839,69,12,1, abandoned,1,1,0.00560749476197
39135,1000121,4,1785,1476,309,0.826891,0.173109,2.664986,292,17,1787,1478,309,0.827084,0.172916,2.699143,292,17,-1, merged,0,0,0.085550892551
39153,1000004,1,2762,2453,309,0.888125,0.111875,0.888125,239,70,2763,2454,309,0.888165,0.111835,0.888165,239,70,-1, abandoned,0,0,0.0673097262766
39153,1000120,2,1304,1111,193,0.851994,0.148006,1.740118,168,25,1305,1112,193,0.852107,0.147893,1.740272,168,25,-1, abandoned,0,0,0.152885624344
39155,1000023,3,800,710,90,0.8875,0.1125,2.597547,81,9,801,711,90,0.88764,0.11236,2.599449,81,9,1, merged,0,0,0.301537978426
39160,1000003,4,996,831,165,0.834337,0.165663,3.523661,150,15,997,832,165,0.834504,0.165496,3.524397,150,15,1, merged,0,0,0.961164485287
39160,1000015,1,1744,1566,178,0.897936,0.102064,0.897936,165,13,1745,1567,178,0.897994,0.102006,0.897994,165,13,1, merged,0,0,1.0938011508
39160,1000153,3,913,829,84,0.907996,0.092004,2.689324,64,20,914,830,84,0.908096,0.091904,2.689893,64,20,1, merged,0,0,1.10162288179
39161,1000023,1,801,711,90,0.88764,0.11236,0.88764,81,9,803,713,90,0.88792,0.11208,0.88792,81,9,-1, merged,0,0,0.146301608689
39162,1000023,1,803,713,90,0.88792,0.11208,0.88792,81,9,805,714,91,0.886957,0.113043,0.886957,82,9,-1, merged,1,0,0
39166,1000014,1,1890,1602,288,0.847619,0.152381,0.847619,266,22,1891,1603,288,0.8477,0.1523,0.8477,266,22,1, merged,0,0,0.5296406903
39169,1000011,1,645,595,50,0.922481,0.077519,0.922481,46,4,646,596,50,0.922601,0.077399,0.922601,46,4,1, merged,0,0,0.705314580644
39169,1000120,2,1307,1114,193,0.852334,0.147666,1.774814,168,25,1308,1115,193,0.852446,0.147554,1.775047,168,25,1, merged,0,0,0.558541728689
39170,1000014,1,1893,1605,288,0.847861,0.152139,0.847861,266,22,1894,1606,288,0.847941,0.152059,0.847941,266,22,1, merged,0,0,0.425806340913
39170,1000091,2,465,359,106,0.772043,0.227957,1.619904,91,15,466,360,106,0.772532,0.227468,1.620473,91,15,1, merged,0,0,0.454185119864
39175,1000005,1,350,282,68,0.805714,0.194286,0.805714,62,6,351,283,68,0.806268,0.193732,0.806268,62,6,1, merged,0,0,0.00288739172281
39176,1000005,1,351,283,68,0.806268,0.193732,0.806268,62,6,352,284,68,0.806818,0.193182,0.806818,62,6,1, merged,0,0,0
39176,1000120,3,1308,1115,193,0.852446,0.147554,2.516609,168,25,1309,1116,193,0.852559,0.147441,2.518016,168,25,1, merged,0,0,0
39178,1000023,1,807,715,92,0.885998,0.114002,0.885998,83,9,808,716,92,0.886139,0.113861,0.886139,83,9,1, merged,0,0,0
39186,1000003,4,997,832,165,0.834504,0.165496,3.293997,150,15,998,833,165,0.834669,0.165331,3.298993,150,15,1, merged,0,0,0.00814015218545
39186,1000023,1,809,717,92,0.886279,0.113721,0.886279,83,9,812,719,93,0.885468,0.114532,0.885468,83,10,-1, merged,1,1,0.00471189141221
39187,1000070,3,1044,910,134,0.871648,0.128352,2.568393,113,21,1045,911,134,0.87177,0.12823,2.560659,113,21,1, merged,0,0,0
39193,1000054,1,344,305,39,0.886628,0.113372,0.886628,29,10,346,305,41,0.881503,0.118497,0.881503,31,10,1, merged,1,1,0.0121205025557
39193,1000140,2,152,123,29,0.809211,0.190789,1.695838,27,2,154,125,29,0.811688,0.188312,1.693191,27,2,-1, merged,0,0,0.00565642471371
39194,1000023,2,812,719,93,0.885468,0.114532,1.589172,83,10,813,720,93,0.885609,0.114391,1.599895,83,10,1, merged,0,0,0.00664967894707
39195,1000043,2,472,391,81,0.82839,0.17161,1.658898,69,12,473,392,81,0.828753,0.171247,1.662086,69,12,1, merged,0,0,0.0109633776534
39197,1000109,2,433,368,65,0.849885,0.150115,1.733687,62,3,435,370,65,0.850575,0.149425,1.731694,62,3,-1, merged,0,0,0.303684364371
39204,1000012,2,505,436,69,0.863366,0.136634,1.635105,67,2,506,437,69,0.863636,0.136364,1.6362,67,2,1, merged,0,0,0.058342824176
39210,1000023,2,814,721,93,0.885749,0.114251,1.738421,83,10,815,722,93,0.88589,0.11411,1.737911,83,10,-1, abandoned,0,0,0.000141173295596
39210,1000120,1,1310,1117,193,0.852672,0.147328,0.852672,168,25,1311,1117,194,0.852021,0.147979,0.852021,169,25,1, abandoned,1,1,8.84454333135e-11
39216,1000105,2,460,350,110,0.76087,0.23913,1.507566,100,10,461,350,111,0.759219,0.240781,1.504274,101,10,1, abandoned,1,1,0.38062034074
39220,1000023,1,816,723,93,0.886029,0.113971,0.886029,83,10,817,723,94,0.884945,0.115055,0.884945,84,10,1, abandoned,1,1,0.00593674064066
39222,1000026,2,341,312,29,0.914956,0.085044,1.775533,27,2,342,313,29,0.915205,0.084795,1.771664,27,2,1, merged,0,0,0.0384965654245
39226,1000070,3,1047,913,134,0.872015,0.127985,2.6991,113,21,1048,914,134,0.872137,0.127863,2.698759,113,21,-1, abandoned,0,0,0.0882337781
39226,1000121,2,1787,1478,309,0.827084,0.172916,1.827084,292,17,1788,1478,310,0.826622,0.173378,1.826622,293,17,1, abandoned,1,1,0
39227,1000026,2,342,313,29,0.915205,0.084795,1.765779,27,2,343,314,29,0.915452,0.084548,1.766369,27,2,1, merged,0,0,0
39227,1000109,1,435,370,65,0.850575,0.149425,0.850575,62,3,436,371,65,0.850917,0.149083,0.850917,62,3,1, merged,0,0,0
39234,1000110,2,168,148,20,0.880952,0.119048,1.547619,18,2,169,149,20,0.881657,0.118343,1.581657,18,2,1, merged,0,0,0.435266072856
39253,1000014,2,1894,1606,288,0.847941,0.152059,1.756037,266,22,1896,1606,290,0.847046,0.152954,1.75316,268,22,1, abandoned,1,1,0.0545649742212
39253,1000153,1,914,830,84,0.908096,0.091904,0.908096,64,20,916,830,86,0.906114,0.093886,0.906114,66,20,1, abandoned,1,1,0.094163668567
39259,1000014,1,1896,1606,290,0.847046,0.152954,0.847046,268,22,1899,1607,292,0.846235,0.153765,0.846235,270,22,1, merged,1,1,0.436137466146
39263,1000023,2,818,724,94,0.885086,0.114914,1.674715,84,10,820,726,94,0.885366,0.114634,1.673827,84,10,1, merged,0,0,0
39272,1000592,2,624,532,92,0.852564,0.147436,1.547301,58,34,625,533,92,0.8528,0.1472,1.549135,58,34,1, merged,0,0,0.61951255172
39275,1000023,1,826,730,96,0.883777,0.116223,0.883777,86,10,827,731,96,0.883918,0.116082,0.883918,86,10,1, merged,0,0,5.36180450925e-06
39292,1000023,1,827,731,96,0.883918,0.116082,0.883918,86,10,828,732,96,0.884058,0.115942,0.884058,86,10,-1, merged,0,0,0.000205883305857
39293,1000328,1,801,589,212,0.735331,0.264669,0.735331,189,23,802,590,212,0.735661,0.264339,0.735661,189,23,1, merged,0,0,0.244970699641
39297,1000023,2,828,732,96,0.884058,0.115942,1.770237,86,10,830,734,96,0.884337,0.115663,1.76337,86,10,-1, abandoned,0,0,0.065359995631
39313,1000109,1,437,372,65,0.851259,0.148741,0.851259,62,3,438,372,66,0.849315,0.150685,0.849315,63,3,1, merged,1,1,0.0269097740867
39313,1000121,2,1788,1478,310,0.826622,0.173378,1.677881,293,17,1789,1479,310,0.826719,0.173281,1.676034,293,17,1, merged,0,0,0.00168787583533
39317,1000014,3,1900,1608,292,0.846316,0.153684,2.522699,270,22,1902,1610,292,0.846477,0.153523,2.508028,270,22,-1, merged,0,0,0
39317,1000070,1,1049,915,134,0.872259,0.127741,0.872259,113,21,1051,916,135,0.871551,0.128449,0.871551,114,21,1, merged,1,1,0
39336,1000014,1,1902,1610,292,0.846477,0.153523,0.846477,270,22,1903,1611,292,0.846558,0.153442,0.846558,270,22,1, merged,0,0,0.0423914026151
39336,1000199,2,372,316,56,0.849462,0.150538,1.69594,50,6,373,317,56,0.849866,0.150134,1.696424,50,6,1, merged,0,0,0.0138007348623
39346,1000004,1,2765,2456,309,0.888246,0.111754,0.888246,239,70,2766,2456,310,0.887925,0.112075,0.887925,240,70,1, merged,1,1,0
39346,1000011,2,647,597,50,0.92272,0.07728,1.810966,46,4,648,597,51,0.921296,0.078704,1.809221,47,4,1, merged,1,1,0
39346,1000015,3,1750,1572,178,0.898286,0.101714,2.709252,165,13,1751,1573,178,0.898344,0.101656,2.707565,165,13,-1, merged,0,0,0
39355,1000592,2,626,534,92,0.853035,0.146965,1.625187,58,34,627,535,92,0.85327,0.14673,1.62827,58,34,1, merged,0,0,0
39358,1000329,1,2711,2111,600,0.778679,0.221321,0.778679,521,79,2713,2112,601,0.778474,0.221526,0.778474,522,79,1, merged,1,1,0
39362,1000004,1,2766,2456,310,0.887925,0.112075,0.887925,240,70,2767,2457,310,0.887965,0.112035,0.887965,240,70,1, merged,0,0,0
39362,1000592,2,627,535,92,0.85327,0.14673,1.741194,58,34,628,536,92,0.853503,0.146497,1.741468,58,34,1, merged,0,0,0
39366,1000023,3,833,737,96,0.884754,0.115246,2.600007,86,10,834,738,96,0.884892,0.115108,2.601744,86,10,1, merged,0,0,0
39371,1000004,2,2767,2457,310,0.887965,0.112035,1.666439,240,70,2769,2459,310,0.888046,0.111954,1.666602,240,70,-1, abandoned,0,0,0
39371,1000329,1,2713,2112,601,0.778474,0.221526,0.778474,522,79,2714,2113,601,0.778556,0.221444,0.778556,522,79,-1, abandoned,0,0,0
39390,1000003,1,1001,835,166,0.834166,0.165834,0.834166,151,15,1002,835,167,0.833333,0.166667,0.833333,152,15,1, abandoned,1,1,0.570067095743
39390,1000199,3,373,317,56,0.849866,0.150134,2.479213,50,6,374,318,56,0.850267,0.149733,2.471836,50,6,-1, abandoned,0,0,0.314987078768
39396,1000003,1,1002,835,167,0.833333,0.166667,0.833333,152,15,1003,836,167,0.8335,0.1665,0.8335,152,15,1, merged,0,0,0.570169389676
39398,1000003,2,1003,836,167,0.8335,0.1665,1.628371,152,15,1004,837,167,0.833665,0.166335,1.618475,152,15,1, merged,0,0,0.00484549459612
39401,1000014,2,1903,1611,292,0.846558,0.153442,1.696825,270,22,1904,1612,292,0.846639,0.153361,1.697305,270,22,1, merged,0,0,0.0301654367197
39401,1000199,1,374,318,56,0.850267,0.149733,0.850267,50,6,375,319,56,0.850667,0.149333,0.850667,50,6,1, merged,0,0,0.0095188713914
39402,1000014,1,1904,1612,292,0.846639,0.153361,0.846639,270,22,1905,1613,292,0.846719,0.153281,0.846719,270,22,1, merged,0,0,0
39402,1000070,2,1051,916,135,0.871551,0.128449,1.71819,114,21,1052,917,135,0.871673,0.128327,1.718392,114,21,1, merged,0,0,0
39404,1000003,1,1004,837,167,0.833665,0.166335,0.833665,152,15,1005,838,167,0.833831,0.166169,0.833831,152,15,-1, merged,0,0,0.000969846587903
39404,1000153,2,918,832,86,0.906318,0.093682,1.739983,66,20,919,833,86,0.90642,0.09358,1.740251,66,20,1, merged,0,0,0.00141728624535
39408,1000003,1,1006,839,167,0.833996,0.166004,0.833996,152,15,1007,839,168,0.833168,0.166832,0.833168,153,15,1, abandoned,1,1,0.00537657584458
39408,1000009,3,1048,874,174,0.833969,0.166031,2.517281,157,17,1049,875,174,0.834128,0.165872,2.516954,157,17,-1, abandoned,0,0,1.28286952255e-05
39408,1000109,2,438,372,66,0.849315,0.150685,1.683311,63,3,439,373,66,0.849658,0.150342,1.682826,63,3,-1, abandoned,0,0,0.00774217945337
39413,1000166,2,359,290,69,0.807799,0.192201,1.474466,66,3,360,291,69,0.808333,0.191667,1.475,66,3,1, merged,0,0,0
39414,1000003,1,1007,839,168,0.833168,0.166832,0.833168,153,15,1009,841,168,0.833499,0.166501,0.833499,153,15,-1, merged,0,0,0.521582674986
39414,1000109,2,440,373,67,0.847727,0.152273,1.680895,64,3,441,373,68,0.845805,0.154195,1.679304,64,4,-1, merged,1,1,0.151432615368
39415,1000003,1,1009,841,168,0.833499,0.166501,0.833499,153,15,1011,843,168,0.833828,0.166172,0.833828,153,15,-1, merged,0,0,0.284413114103
39415,1000109,2,441,373,68,0.845805,0.154195,1.679304,64,4,442,374,68,0.846154,0.153846,1.679982,64,4,1, merged,0,0,0.151444985371
39416,1000070,2,1052,917,135,0.871673,0.128327,1.67547,114,21,1053,918,135,0.871795,0.128205,1.670537,114,21,1, merged,0,0,0
39416,1000140,1,158,127,31,0.803797,0.196203,0.803797,28,3,159,127,32,0.798742,0.201258,0.798742,29,3,1, merged,1,1,0
39417,1000003,1,1011,843,168,0.833828,0.166172,0.833828,153,15,1012,844,168,0.833992,0.166008,0.833992,153,15,1, merged,0,0,0.284709069347
39417,1000109,2,442,374,68,0.846154,0.153846,1.679982,64,4,443,375,68,0.846501,0.153499,1.680493,64,4,1, merged,0,0,0.151507194762
39418,1000003,1,1012,844,168,0.833992,0.166008,0.833992,153,15,1015,847,168,0.834483,0.165517,0.834483,153,15,-1, merged,0,0,0.130506643662
39418,1000109,2,443,375,68,0.846501,0.153499,1.680493,64,4,444,375,69,0.844595,0.155405,1.679077,64,5,-1, merged,1,1,0.0369636391969
39422,1000014,1,1905,1613,292,0.846719,0.153281,0.846719,270,22,1907,1614,293,0.846356,0.153644,0.846356,271,22,-1, abandoned,1,0,0
39422,1000121,2,1790,1480,310,0.826816,0.173184,1.673535,293,17,1792,1482,310,0.827009,0.172991,1.673364,293,17,-1, abandoned,0,0,0
39426,1000043,2,473,392,81,0.828753,0.171247,1.495419,69,12,474,393,81,0.829114,0.170886,1.579114,69,12,1, merged,0,0,0.684165976935
39434,1000004,3,2771,2461,310,0.888127,0.111873,2.481274,240,70,2772,2462,310,0.888167,0.111833,2.463167,240,70,-1, abandoned,0,0,0.0086210575671
39436,1000166,2,360,291,69,0.808333,0.191667,1.475,66,3,361,292,69,0.808864,0.191136,1.490682,66,3,1, merged,0,0,0.000274949640393
39437,1000014,3,1907,1614,293,0.846356,0.153644,2.682421,271,22,1909,1616,293,0.846517,0.153483,2.585764,271,22,-1, merged,0,0,0
39438,1000166,3,361,292,69,0.808864,0.191136,2.26846,66,3,362,293,69,0.809392,0.190608,2.305044,66,3,1, merged,0,0,0.26373735628
39443,1000153,2,919,833,86,0.90642,0.09358,1.632158,66,20,921,835,86,0.906623,0.093377,1.633514,66,20,-1, merged,0,0,1.1099800973
39443,1000534,1,237,172,65,0.725738,0.274262,0.725738,61,4,238,173,65,0.726891,0.273109,0.726891,61,4,-1, merged,0,0,1.12435496028
39447,1000004,2,2773,2463,310,0.888208,0.111792,1.615098,240,70,2777,2466,311,0.888009,0.111991,1.616042,241,70,-1, merged,1,0,0.25731250873
39447,1000153,3,921,835,86,0.906623,0.093377,2.521722,66,20,922,836,86,0.906725,0.093275,2.522767,66,20,-1, merged,0,0,0.555022846644
39447,1000534,1,238,173,65,0.726891,0.273109,0.726891,61,4,239,174,65,0.728033,0.271967,0.728033,61,4,-1, merged,0,0,0.562324269061
39448,1000015,2,1753,1575,178,0.89846,0.10154,1.805184,165,13,1754,1576,178,0.898518,0.101482,1.805444,165,13,1, merged,0,0,0.511837382707
39448,1000153,1,922,836,86,0.906725,0.093275,0.906725,66,20,924,838,86,0.906926,0.093074,0.906926,66,20,-1, merged,0,0,0.539227190395
39453,1000328,4,803,591,212,0.73599,0.26401,1.514627,189,23,804,592,212,0.736318,0.263682,3.515037,189,23,1, merged,0,0,0
39453,1000329,1,2715,2114,601,0.778637,0.221363,0.778637,522,79,2716,2115,601,0.778719,0.221281,0.778719,522,79,1, merged,0,0,0
39454,1000004,2,2777,2466,311,0.888009,0.111991,1.466956,241,70,2778,2467,311,0.888049,0.111951,1.488049,241,70,1, merged,0,0,0.0593706325335
39456,1000014,2,1909,1616,293,0.846517,0.153483,1.712188,271,22,1911,1618,293,0.846677,0.153323,1.709422,271,22,-1, merged,0,0,0
39456,1000120,3,1319,1124,195,0.852161,0.147839,2.564349,169,26,1320,1125,195,0.852273,0.147727,2.561695,169,26,1, merged,0,0,0
39459,1000023,2,836,740,96,0.885167,0.114833,1.737928,86,10,838,741,97,0.884248,0.115752,1.731809,87,10,1, merged,1,1,0.000536350096481
39462,1000014,3,1911,1618,293,0.846677,0.153323,2.499422,271,22,1912,1619,293,0.846757,0.153243,2.502251,271,22,1, merged,0,0,0
39463,1000166,3,362,293,69,0.809392,0.190608,2.305044,66,3,363,294,69,0.809917,0.190083,2.348099,66,3,1, merged,0,0,0.0668861416831
39464,1000166,2,363,294,69,0.809917,0.190083,1.529917,66,3,364,295,69,0.81044,0.18956,1.541209,66,3,1, merged,0,0,0.257650915556
39465,1000109,2,444,375,69,0.844595,0.155405,1.629405,64,5,445,376,69,0.844944,0.155056,1.632444,64,5,1, merged,0,0,0.00804824503684
39470,1000121,2,1792,1482,310,0.827009,0.172991,1.75934,293,17,1793,1483,310,0.827105,0.172895,1.752479,293,17,1, merged,0,0,0.000344668286469
39473,1000014,1,1912,1619,293,0.846757,0.153243,0.846757,271,22,1913,1620,293,0.846837,0.153163,0.846837,271,22,1, merged,0,0,0
39473,1000070,2,1053,918,135,0.871795,0.128205,1.718552,114,21,1054,919,135,0.871917,0.128083,1.718754,114,21,1, merged,0,0,0
39476,1000014,1,1913,1620,293,0.846837,0.153163,0.846837,271,22,1916,1623,293,0.847077,0.152923,0.847077,271,22,-1, merged,0,0,0.717339577052
39476,1000015,3,1754,1576,178,0.898518,0.101482,2.597851,165,13,1755,1577,178,0.898575,0.101425,2.59826,165,13,1, merged,0,0,1.09037528625
39476,1000120,2,1322,1127,195,0.852496,0.147504,1.699334,169,26,1323,1128,195,0.852608,0.147392,1.699685,169,26,1, merged,0,0,0.468837874307
39480,1000109,1,445,376,69,0.844944,0.155056,0.844944,64,5,446,377,69,0.845291,0.154709,0.845291,64,5,1, merged,0,0,0.0166621995086
39483,1000003,1,1015,847,168,0.834483,0.165517,0.834483,153,15,1017,848,169,0.833825,0.166175,0.833825,154,15,1, merged,1,1,0.522052771574
39483,1000109,2,446,377,69,0.845291,0.154709,1.679774,64,5,447,378,69,0.845638,0.154362,1.679463,64,5,1, merged,0,0,0.149750922875
39484,1000043,2,475,394,81,0.829474,0.170526,1.529474,69,12,476,395,81,0.829832,0.170168,1.531324,69,12,1, merged,0,0,0
39491,1000109,1,447,378,69,0.845638,0.154362,0.845638,64,5,449,380,69,0.846325,0.153675,0.846325,64,5,-1, merged,0,0,0.018365504791
39491,1000199,2,375,319,56,0.850667,0.149333,1.696304,50,6,376,320,56,0.851064,0.148936,1.697389,50,6,1, merged,0,0,0.013049226036
39498,1000328,2,804,592,212,0.736318,0.263682,1.736318,189,23,805,593,212,0.736646,0.263354,1.736646,189,23,1, merged,0,0,0
39500,1000009,3,1050,876,174,0.834286,0.165714,2.580223,157,17,1051,876,175,0.833492,0.166508,2.568069,157,18,-1, merged,1,1,1.1662819839
39500,1000153,1,927,841,86,0.907228,0.092772,0.907228,66,20,930,843,87,0.906452,0.093548,0.906452,66,21,-1, merged,1,0,1.10798642771
39516,1000108,1,103,82,21,0.796117,0.203883,0.796117,17,4,104,83,21,0.798077,0.201923,0.798077,17,4,-1, merged,0,0,0
39526,1000014,2,1917,1624,293,0.847157,0.152843,1.710572,271,22,1918,1625,293,0.847237,0.152763,1.711314,271,22,1, merged,0,0,0.583322001574
39537,1000130,2,362,299,63,0.825967,0.174033,1.624286,49,14,364,300,64,0.824176,0.175824,1.623619,50,14,1, abandoned,1,1,0
39542,1000014,3,1919,1626,293,0.847316,0.152684,2.504724,271,22,1921,1628,293,0.847475,0.152525,2.50076,271,22,-1, merged,0,0,0.250984218375
39542,1000109,4,449,380,69,0.846325,0.153675,3.351049,64,5,450,381,69,0.846667,0.153333,3.347427,64,5,1, merged,0,0,0.152638394693
39542,1000199,1,378,322,56,0.851852,0.148148,0.851852,50,6,379,322,57,0.849604,0.150396,0.849604,51,6,1, merged,1,1,0.158774441048
39546,1000004,2,2785,2474,311,0.88833,0.11167,1.652219,241,70,2787,2476,311,0.88841,0.11159,1.645167,241,70,-1, merged,0,0,0
39548,1000004,2,2787,2476,311,0.88841,0.11159,1.667129,241,70,2788,2476,312,0.888092,0.111908,1.666524,242,70,1, abandoned,1,1,0.235163745995
39548,1000329,1,2716,2115,601,0.778719,0.221281,0.778719,522,79,2717,2115,602,0.778432,0.221568,0.778432,523,79,1, abandoned,1,1,0.321634325376
39554,1000121,3,1801,1490,311,0.827318,0.172682,2.502775,293,18,1802,1491,311,0.827414,0.172586,2.511757,293,18,1, merged,0,0,4.2110408311e-05
39555,1000121,3,1802,1491,311,0.827414,0.172586,2.511757,293,18,1803,1492,311,0.82751,0.17249,2.519999,293,18,1, merged,0,0,5.89485104478e-05
39556,1000121,3,1803,1492,311,0.82751,0.17249,2.519999,293,18,1804,1493,311,0.827605,0.172395,2.527605,293,18,1, merged,0,0,0.000137534708362
39562,1000327,3,654,515,139,0.787462,0.212538,2.054128,107,32,655,515,140,0.78626,0.21374,1.941021,108,32,1, merged,1,1,0.561178540018
39563,1000023,2,839,742,97,0.884386,0.115614,1.67451,87,10,840,743,97,0.884524,0.115476,1.677207,87,10,1, merged,0,0,0.000111129990667
39564,1000023,1,840,743,97,0.884524,0.115476,0.884524,87,10,843,746,97,0.884935,0.115065,0.884935,87,10,-1, merged,0,0,0.000138668901207
39566,1000023,1,843,746,97,0.884935,0.115065,0.884935,87,10,844,747,97,0.885071,0.114929,0.885071,87,10,1, merged,0,0,0.00470469113488
39568,1000014,1,1922,1629,293,0.847555,0.152445,0.847555,271,22,1923,1630,293,0.847634,0.152366,0.847634,271,22,1, merged,0,0,0
39568,1000070,2,1056,919,137,0.870265,0.129735,1.71782,116,21,1057,920,137,0.870388,0.129612,1.718022,116,21,1, merged,0,0,0
39569,1000121,2,1810,1498,312,0.827624,0.172376,1.727624,294,18,1812,1500,312,0.827815,0.172185,1.732576,294,18,1, merged,0,0,2.90593138744e-06
39570,1000091,3,466,360,106,0.772532,0.227468,2.262859,91,15,467,361,106,0.773019,0.226981,2.264212,91,15,1, merged,0,0,0.229713406048
39573,1000023,1,844,747,97,0.885071,0.114929,0.885071,87,10,846,749,97,0.885343,0.114657,0.885343,87,10,-1, merged,0,0,0.00242971803484
39576,1000014,1,1924,1631,293,0.847713,0.152287,0.847713,271,22,1925,1632,293,0.847792,0.152208,0.847792,271,22,1, merged,0,0,0
39578,1000592,2,632,540,92,0.85443,0.14557,1.709694,58,34,633,541,92,0.85466,0.14534,1.711803,58,34,1, merged,0,0,0.599950336846
39579,1000009,2,1054,879,175,0.833966,0.166034,1.476823,157,18,1055,880,175,0.834123,0.165877,1.50079,157,18,1, merged,0,0,1.15711051189
39592,1000004,2,2789,2477,312,0.888132,0.111868,1.475088,242,70,2790,2478,312,0.888172,0.111828,1.483917,242,70,1, merged,0,0,0
39592,1000121,4,1814,1502,312,0.828004,0.171996,2.983093,294,18,1815,1503,312,0.828099,0.171901,2.994556,294,18,1, merged,0,0,0
39598,1000120,1,1329,1134,195,0.853273,0.146727,0.853273,169,26,1330,1135,195,0.853383,0.146617,0.853383,169,26,1, merged,0,0,0
39604,1000043,1,478,397,81,0.830544,0.169456,0.830544,69,12,479,398,81,0.830898,0.169102,0.830898,69,12,1, merged,0,0,0.21397474537
39606,1000043,1,479,398,81,0.830898,0.169102,0.830898,69,12,480,399,81,0.83125,0.16875,0.83125,69,12,1, merged,0,0,0.37894179686
39608,1000054,2,355,312,43,0.878873,0.121127,1.689313,32,11,356,313,43,0.879213,0.120787,1.690172,32,11,1, merged,0,0,0.698910529065
39608,1000166,1,364,295,69,0.81044,0.18956,0.81044,66,3,365,296,69,0.810959,0.189041,0.810959,66,3,1, merged,0,0,0.485719638174
39611,1000009,2,1055,880,175,0.834123,0.165877,1.681994,157,18,1056,881,175,0.83428,0.16572,1.68223,157,18,-1, abandoned,0,0,0
39611,1000014,1,1926,1633,293,0.847871,0.152129,0.847871,271,22,1927,1634,293,0.84795,0.15205,0.84795,271,22,-1, abandoned,0,0,0
39621,1000004,3,2791,2478,313,0.887854,0.112146,2.43087,243,70,2792,2479,313,0.887894,0.112106,2.427726,243,70,1, merged,0,0,0.0140125772061
39621,1000327,1,655,515,140,0.78626,0.21374,0.78626,108,32,656,516,140,0.786585,0.213415,0.786585,108,32,1, merged,0,0,0.00319858200303
39629,1000043,3,480,399,81,0.83125,0.16875,2.326042,69,12,481,400,81,0.831601,0.168399,2.338046,69,12,1, merged,0,0,0.85714121246
39631,1000105,1,461,350,111,0.759219,0.240781,0.759219,101,10,462,350,112,0.757576,0.242424,0.757576,102,10,1, merged,1,1,0.620388848328
39637,1000121,3,1815,1503,312,0.828099,0.171901,2.648893,294,18,1816,1504,312,0.828194,0.171806,2.644667,294,18,-1, abandoned,0,0,0
39637,1000132,2,319,286,33,0.896552,0.103448,1.820794,25,8,320,287,33,0.896875,0.103125,1.816473,25,8,-1, abandoned,0,0,0
39641,1000121,2,1816,1504,312,0.828194,0.171806,1.614779,294,18,1817,1505,312,0.828288,0.171712,1.613677,294,18,-1, abandoned,0,0,0.225954368048
39641,1000327,1,656,516,140,0.786585,0.213415,0.786585,108,32,657,516,141,0.785388,0.214612,0.785388,109,32,1, abandoned,1,1,0.348471526574
39641,1000329,4,2718,2116,602,0.778514,0.221486,3.188804,523,79,2720,2117,603,0.778309,0.221691,3.188005,524,79,-1, abandoned,1,0,0.3399514231
39648,1000015,2,1759,1581,178,0.898806,0.101194,1.778694,165,13,1760,1582,178,0.898864,0.101136,1.779086,165,13,1, merged,0,0,0.00122019098232
39648,1000054,1,358,315,43,0.879888,0.120112,0.879888,32,11,359,316,43,0.880223,0.119777,0.880223,32,11,1, merged,0,0,0.0174829293519
39650,1000014,2,1927,1634,293,0.84795,0.15205,1.640029,271,22,1928,1635,293,0.848029,0.151971,1.642147,271,22,1, merged,0,0,0.515353295717
39651,1000014,2,1928,1635,293,0.848029,0.151971,1.642147,271,22,1929,1636,293,0.848108,0.151892,1.644224,271,22,1, merged,0,0,0.519325870551
39652,1000014,1,1929,1636,293,0.848108,0.151892,0.848108,271,22,1931,1637,294,0.847747,0.152253,0.847747,272,22,-1, abandoned,1,0,0.27077379028
39654,1000004,1,2793,2480,313,0.887934,0.112066,0.887934,243,70,2794,2481,313,0.887974,0.112026,0.887974,243,70,-1, merged,0,0,0.19491146218
39654,1000054,2,360,317,43,0.880556,0.119444,1.76849,32,11,361,318,43,0.880886,0.119114,1.768861,32,11,1, merged,0,0,0.232208994015
39659,1000009,1,1056,881,175,0.83428,0.16572,0.83428,157,18,1058,881,177,0.832703,0.167297,0.832703,159,18,1, merged,1,1,0.123336292232
39659,1000011,2,655,603,52,0.920611,0.079389,1.754891,48,4,656,604,52,0.920732,0.079268,1.753435,48,4,-1, merged,0,0,0.143786841268
39659,1000120,3,1330,1135,195,0.853383,0.146617,2.608274,169,26,1331,1136,195,0.853494,0.146506,2.606929,169,26,1, merged,0,0,0.115702643321
39660,1000005,1,357,289,68,0.809524,0.190476,0.809524,62,6,358,290,68,0.810056,0.189944,0.810056,62,6,1, merged,0,0,0.0367633945187
39660,1000023,2,846,749,97,0.885343,0.114657,1.694867,87,10,847,750,97,0.885478,0.114522,1.695534,87,10,1, merged,0,0,0.0362206660613
39665,1000534,2,240,175,65,0.729167,0.270833,0.729167,61,4,241,176,65,0.73029,0.26971,1.73029,61,4,1, merged,0,0,0
39676,1000004,2,2795,2482,313,0.888014,0.111986,1.745157,243,70,2796,2483,313,0.888054,0.111946,1.763054,243,70,-1, merged,0,0,0.0810404024926
39676,1000091,4,467,361,106,0.773019,0.226981,3.257307,91,15,469,362,107,0.771855,0.228145,3.258314,92,15,1, merged,1,1,0.20611589638
39679,1000121,4,1818,1506,312,0.828383,0.171617,2.319576,294,18,1819,1507,312,0.828477,0.171523,2.825259,294,18,-1, merged,0,0,0.193509787753
39688,1000120,2,1332,1137,195,0.853604,0.146396,0.853604,169,26,1333,1137,196,0.852963,0.147037,0.852963,169,27,-1, merged,1,1,0
39696,1000014,1,1931,1637,294,0.847747,0.152253,0.847747,272,22,1933,1639,294,0.847905,0.152095,0.847905,272,22,-1, merged,0,0,0.331804781132
39711,1000121,1,1820,1508,312,0.828571,0.171429,0.828571,294,18,1821,1509,312,0.828666,0.171334,0.828666,294,18,1, merged,0,0,0.426738408463
39711,1000132,2,322,289,33,0.897516,0.102484,1.726087,25,8,323,290,33,0.897833,0.102167,1.726498,25,8,1, merged,0,0,0.966516606643
39716,1000108,2,107,86,21,0.803738,0.196262,1.603738,17,4,108,87,21,0.805556,0.194444,1.601852,17,4,1, merged,0,0,0.0353817705992
39716,1000140,1,160,128,32,0.8,0.2,0.8,29,3,162,129,33,0.796296,0.203704,0.796296,29,4,-1, merged,1,0,0.0431801290379
39875,1000014,2,1933,1639,294,0.847905,0.152095,1.625683,272,22,1935,1640,295,0.847545,0.152455,1.584387,273,22,1, merged,1,1,0.12372461668
39880,1000121,1,1823,1511,312,0.828854,0.171146,0.828854,294,18,1824,1512,312,0.828947,0.171053,0.828947,294,18,1, merged,0,0,0.38813174271
39886,1000121,2,1825,1513,312,0.829041,0.170959,1.733803,294,18,1827,1515,312,0.829228,0.170772,1.738319,294,18,1, merged,0,0,3.4473449031e-06
39887,1000121,2,1827,1515,312,0.829228,0.170772,1.738319,294,18,1829,1517,312,0.829415,0.170585,1.742458,294,18,1, merged,0,0,3.96434155135e-06
39888,1000329,1,2722,2119,603,0.778472,0.221528,0.778472,524,79,2723,2120,603,0.778553,0.221447,0.778553,524,79,1, merged,0,0,0.000203548829451
39902,1000015,2,1762,1584,178,0.898978,0.101022,1.648978,165,13,1763,1585,178,0.899036,0.100964,1.699036,165,13,1, merged,0,0,0.0498127436861
39912,1000121,2,1829,1517,312,0.829415,0.170585,1.704415,294,18,1830,1518,312,0.829508,0.170492,1.718397,294,18,1, merged,0,0,0.0380813712498
39920,1000054,1,364,321,43,0.881868,0.118132,0.881868,32,11,365,321,44,0.879452,0.120548,0.879452,33,11,1, merged,1,1,0.47753845115
39920,1000328,3,805,593,212,0.736646,0.263354,2.349283,189,23,807,595,212,0.737299,0.262701,2.320454,189,23,-1, merged,0,0,0.739986263404
39921,1000014,2,1936,1641,295,0.847624,0.152376,1.694291,273,22,1938,1643,295,0.847781,0.152219,1.692571,273,22,-1, merged,0,0,0.717599837784
39921,1000109,1,450,381,69,0.846667,0.153333,0.846667,64,5,451,381,70,0.844789,0.155211,0.844789,65,5,1, merged,1,1,0.142233497172
39923,1000003,1,1018,849,169,0.833988,0.166012,0.833988,154,15,1019,850,169,0.834151,0.165849,0.834151,154,15,1, merged,0,0,0.00257699592084
39949,1000109,1,452,382,70,0.845133,0.154867,0.845133,65,5,453,383,70,0.845475,0.154525,0.845475,65,5,1, merged,0,0,0.106138025464
39949,1000120,2,1340,1143,197,0.852985,0.147015,1.698118,170,27,1341,1144,197,0.853095,0.146905,1.698569,170,27,1, merged,0,0,0.271695363967
39950,1000014,2,1938,1643,295,0.847781,0.152219,1.693256,273,22,1940,1645,295,0.847938,0.152062,1.694092,273,22,-1, merged,0,0,0.331985684836
39950,1000026,3,350,320,30,0.914286,0.085714,2.607542,28,2,351,321,30,0.91453,0.08547,2.608622,28,2,1, merged,0,0,0.810464652508
39950,1000109,1,453,383,70,0.845475,0.154525,0.845475,65,5,455,385,70,0.846154,0.153846,0.846154,65,5,-1, merged,0,0,0.106674517883
39953,1000004,2,2800,2487,313,0.888214,0.111786,1.693704,243,70,2801,2488,313,0.888254,0.111746,1.693897,243,70,1, merged,0,0,0.486270624665
39953,1000007,1,1275,1027,248,0.80549,0.19451,0.80549,220,28,1276,1028,248,0.805643,0.194357,0.805643,220,28,1, merged,0,0,1.32099295621
39954,1000004,1,2801,2488,313,0.888254,0.111746,0.888254,243,70,2802,2489,313,0.888294,0.111706,0.888294,243,70,1, merged,0,0,0.485973606177
39954,1000007,2,1276,1028,248,0.805643,0.194357,1.693897,220,28,1277,1029,248,0.805795,0.194205,1.694089,220,28,1, merged,0,0,1.30593164508
39958,1000026,1,351,321,30,0.91453,0.08547,0.91453,28,2,352,322,30,0.914773,0.085227,0.914773,28,2,1, merged,0,0,0.000629978850061
39965,1000070,2,1061,924,137,0.870877,0.129123,1.57921,116,21,1062,925,137,0.870998,0.129002,1.585284,116,21,1, merged,0,0,0.419202718083
39966,1000070,2,1062,925,137,0.870998,0.129002,1.585284,116,21,1063,926,137,0.871119,0.128881,1.591119,116,21,1, merged,0,0,0.216739558405
39968,1000054,2,365,321,44,0.879452,0.120548,1.690927,33,11,366,322,44,0.879781,0.120219,1.691771,33,11,1, merged,0,0,0.00939914935571
39968,1000166,1,366,297,69,0.811475,0.188525,0.811475,66,3,367,298,69,0.811989,0.188011,0.811989,66,3,1, merged,0,0,0.00687917564978
39969,1000005,1,362,292,70,0.80663,0.19337,0.80663,64,6,363,293,70,0.807163,0.192837,0.807163,64,6,1, merged,0,0,0.349032249289
39970,1000014,1,1940,1645,295,0.847938,0.152062,0.847938,273,22,1941,1646,295,0.848016,0.151984,0.848016,273,22,1, merged,0,0,0.332371610294
39970,1000026,2,352,322,30,0.914773,0.085227,1.762711,28,2,353,323,30,0.915014,0.084986,1.763031,28,2,1, merged,0,0,0.807314291382
39972,1000005,2,363,293,70,0.807163,0.192837,1.692641,64,6,364,293,71,0.804945,0.195055,1.688337,65,6,1, abandoned,1,1,0.0102798400914
39972,1000023,1,847,750,97,0.885478,0.114522,0.885478,87,10,849,750,99,0.883392,0.116608,0.883392,89,10,1, abandoned,1,1,0.000699161006792
39973,1000023,4,849,750,99,0.883392,0.116608,3.348355,89,10,850,751,99,0.883529,0.116471,3.359502,89,10,1, merged,0,0,0.00611103184182
39974,1000004,2,2802,2489,313,0.888294,0.111706,1.666886,243,70,2803,2489,314,0.887977,0.112023,1.666732,243,71,-1, merged,1,1,0
39974,1000329,1,2728,2124,604,0.778592,0.221408,0.778592,524,80,2730,2126,604,0.778755,0.221245,0.778755,524,80,-1, merged,0,0,0
39988,1000014,1,1941,1646,295,0.848016,0.151984,0.848016,273,22,1942,1647,295,0.848095,0.151905,0.848095,273,22,-1, merged,0,0,0.600807229018
39988,1000015,2,1768,1590,178,0.899321,0.100679,1.747338,165,13,1769,1591,178,0.899378,0.100622,1.747473,165,13,1, merged,0,0,0.570946936714
39988,1000108,3,108,87,21,0.805556,0.194444,2.552893,17,4,109,88,21,0.807339,0.192661,2.554812,17,4,1, merged,0,0,0.479119623417
39990,1000004,2,2803,2489,314,0.887977,0.112023,1.787355,243,71,2804,2490,314,0.888017,0.111983,1.787452,243,71,1, merged,0,0,0.414460925882
39990,1000015,1,1769,1591,178,0.899378,0.100622,0.899378,165,13,1770,1592,178,0.899435,0.100565,0.899435,165,13,1, merged,0,0,0.574010970299
39991,1000004,2,2804,2490,314,0.888017,0.111983,1.787452,243,71,2805,2491,314,0.888057,0.111943,1.787549,243,71,1, merged,0,0,0.0487258164318
39991,1000015,1,1770,1592,178,0.899435,0.100565,0.899435,165,13,1771,1593,178,0.899492,0.100508,0.899492,165,13,1, merged,0,0,0.0150213015335
39992,1000004,2,2805,2491,314,0.888057,0.111943,1.787549,243,71,2806,2492,314,0.888097,0.111903,1.787645,243,71,1, merged,0,0,0.0359063178173
39992,1000015,1,1771,1593,178,0.899492,0.100508,0.899492,165,13,1772,1594,178,0.899549,0.100451,0.899549,165,13,1, merged,0,0,0.0735587288888
40000,1000014,1,1942,1647,295,0.848095,0.151905,0.848095,273,22,1944,1647,297,0.847222,0.152778,0.847222,275,22,1, abandoned,1,1,0.0923489411235
40002,1000592,2,633,541,92,0.85466,0.14534,0.85466,58,34,634,542,92,0.85489,0.14511,1.85489,58,34,1, merged,0,0,0.200401871987
40003,1000132,2,323,290,33,0.897833,0.102167,1.574998,25,8,324,291,33,0.898148,0.101852,1.577836,25,8,1, merged,0,0,0
40012,1000023,1,850,751,99,0.883529,0.116471,0.883529,89,10,851,752,99,0.883666,0.116334,0.883666,89,10,1, merged,0,0,0.00413087747334
40012,1000121,2,1830,1518,312,0.829508,0.170492,1.713038,294,18,1831,1519,312,0.829601,0.170399,1.713268,294,18,1, merged,0,0,0.00135652920962
40019,1000329,2,2731,2126,605,0.778469,0.221531,0.778469,524,81,2732,2127,605,0.778551,0.221449,1.778551,524,81,1, merged,0,0,0.055824330227
40021,1000003,2,1020,851,169,0.834314,0.165686,1.637053,154,15,1021,852,169,0.834476,0.165524,1.637755,154,15,1, merged,0,0,0.26810999569
40021,1000004,3,2809,2495,314,0.888216,0.111784,2.52527,243,71,2810,2496,314,0.888256,0.111744,2.526011,243,71,1, merged,0,0,0.210658165036
40022,1000003,1,1021,852,169,0.834476,0.165524,0.834476,154,15,1022,853,169,0.834638,0.165362,0.834638,154,15,1, merged,0,0,0.536722792625
40022,1000004,2,2810,2496,314,0.888256,0.111744,1.722732,243,71,2811,2497,314,0.888296,0.111704,1.722934,243,71,1, merged,0,0,0.421392289824
40036,1000043,2,481,400,81,0.831601,0.168399,1.713954,69,12,482,401,81,0.83195,0.16805,1.715671,69,12,1, merged,0,0,0.800449184934
40039,1000012,3,508,439,69,0.864173,0.135827,2.336818,67,2,509,440,69,0.86444,0.13556,2.360987,67,2,1, merged,0,0,0.00155232383936
40039,1000121,1,1833,1521,312,0.829787,0.170213,0.829787,294,18,1834,1522,312,0.82988,0.17012,0.82988,294,18,1, merged,0,0,0.00299933585552
40045,1000004,3,2812,2498,314,0.888336,0.111664,2.592701,243,71,2813,2499,314,0.888375,0.111625,2.594294,243,71,1, merged,0,0,0.359925917909
40045,1000014,1,1944,1647,297,0.847222,0.152778,0.847222,275,22,1947,1649,298,0.846944,0.153056,0.846944,276,22,-1, merged,1,0,0.4409506027
40047,1000014,1,1947,1649,298,0.846944,0.153056,0.846944,276,22,1948,1650,298,0.847023,0.152977,0.847023,276,22,-1, merged,0,0,0.21271263427
40047,1000130,2,364,300,64,0.824176,0.175824,1.67112,50,14,365,301,64,0.824658,0.175342,1.67168,50,14,1, merged,0,0,0.202574965997
40061,1000003,1,1022,853,169,0.834638,0.165362,0.834638,154,15,1023,854,169,0.8348,0.1652,0.8348,154,15,1, merged,0,0,0
40061,1000070,2,1067,930,137,0.871603,0.128397,1.706241,116,21,1068,931,137,0.871723,0.128277,1.706522,116,21,1, merged,0,0,0
40076,1000329,2,2734,2128,606,0.778347,0.221653,1.501617,524,82,2736,2129,607,0.778143,0.221857,1.492429,525,82,-1, abandoned,1,0,0
40086,1000004,2,2816,2502,314,0.888494,0.111506,1.735909,243,71,2819,2505,314,0.888613,0.111387,1.73575,243,71,-1, merged,0,0,0.164907754873
40086,1000014,1,1953,1655,298,0.847414,0.152586,0.847414,276,22,1956,1657,299,0.847137,0.152863,0.847137,277,22,1, merged,1,1,0.218837127651
40090,1000054,1,370,325,45,0.878378,0.121622,0.878378,33,12,374,328,46,0.877005,0.122995,0.877005,34,12,-1, merged,1,0,0.730004041072
40091,1000328,3,807,595,212,0.737299,0.262701,2.374597,189,23,808,596,212,0.737624,0.262376,2.371662,189,23,1, merged,0,0,0.244398346948
40091,1000329,2,2736,2129,607,0.778143,0.221857,1.637298,525,82,2737,2130,607,0.778224,0.221776,1.634038,525,82,-1, merged,0,0,0.265967742556
40093,1000140,2,162,129,33,0.796296,0.203704,1.65211,29,4,163,130,33,0.797546,0.202454,1.650081,29,4,1, merged,0,0,0.0497294632314
40094,1000011,2,658,606,52,0.920973,0.079027,1.774395,48,4,661,608,53,0.919818,0.080182,1.77335,48,5,1, merged,1,0,0.103366201041
40094,1000120,1,1344,1147,197,0.853423,0.146577,0.853423,170,27,1345,1148,197,0.853532,0.146468,0.853532,170,27,-1, merged,0,0,0.083320380049
40096,1000043,1,482,401,81,0.83195,0.16805,0.83195,69,12,484,403,81,0.832645,0.167355,0.832645,69,12,-1, merged,0,0,0.00119301035386
40096,1000070,3,1071,934,137,0.872082,0.127918,2.534293,116,21,1072,934,138,0.871269,0.128731,2.533274,117,21,1, merged,1,1,0.00151339806574
40096,1000105,4,463,351,112,0.758099,0.241901,3.292392,102,10,466,353,113,0.757511,0.242489,3.290785,103,10,-1, merged,1,0,0.00273500186619
40096,1000121,2,1844,1531,313,0.83026,0.16974,1.662211,295,18,1846,1531,315,0.829361,0.170639,1.662005,297,18,1, merged,1,1,0.00284866704367
40098,1000014,3,1958,1659,299,0.847293,0.152707,2.518562,277,22,1962,1662,300,0.847095,0.152905,2.52141,278,22,-1, merged,1,0,0.247985952476
40098,1000070,2,1072,934,138,0.871269,0.128731,1.671269,117,21,1074,935,139,0.870577,0.129423,1.674316,118,21,1, merged,1,1,0.288011315322
40101,1000328,2,808,596,212,0.737624,0.262376,1.417311,189,23,809,597,212,0.737948,0.262052,1.420119,189,23,1, merged,0,0,0.0699712713689
40111,1000009,2,1062,885,177,0.833333,0.166667,1.680428,159,18,1063,886,177,0.83349,0.16651,1.680663,159,18,1, merged,0,0,0
40111,1000014,1,1962,1662,300,0.847095,0.152905,0.847095,278,22,1963,1663,300,0.847173,0.152827,0.847173,278,22,1, merged,0,0,0
40113,1000009,1,1063,886,177,0.83349,0.16651,0.83349,159,18,1064,887,177,0.833647,0.166353,0.833647,159,18,1, merged,0,0,1.24992379507
40116,1000003,1,1027,858,169,0.835443,0.164557,0.835443,154,15,1030,860,170,0.834951,0.165049,0.834951,155,15,-1, merged,1,0,0.582096155877
40116,1000109,2,456,386,70,0.846491,0.153509,1.681934,65,5,457,387,70,0.846827,0.153173,1.681779,65,5,1, merged,0,0,0.32023711596
40123,1000054,3,374,328,46,0.877005,0.122995,2.414996,34,12,375,329,46,0.877333,0.122667,2.399683,34,12,1, merged,0,0,0.729772385459
40123,1000166,2,368,299,69,0.8125,0.1875,1.53799,66,3,370,300,70,0.810811,0.189189,1.522349,67,3,1, merged,1,1,0.519004568617
40124,1000110,1,177,156,21,0.881356,0.118644,0.881356,19,2,178,157,21,0.882022,0.117978,0.882022,19,2,-1, abandoned,0,0,0
40124,1000130,2,365,301,64,0.824658,0.175342,1.706013,50,14,366,302,64,0.825137,0.174863,1.707159,50,14,-1, abandoned,0,0,0
40129,1000014,1,1963,1663,300,0.847173,0.152827,0.847173,278,22,1964,1664,300,0.847251,0.152749,0.847251,278,22,-1, merged,0,0,0.292872777944
40129,1000070,3,1074,935,139,0.870577,0.129423,2.521488,118,21,1075,936,139,0.870698,0.129302,2.525288,118,21,1, merged,0,0,0.4203557834
40137,1000534,2,241,176,65,0.73029,0.26971,1.73029,61,4,242,177,65,0.731405,0.268595,1.731405,61,4,1, merged,0,0,1.09913635324
40138,1000054,1,375,329,46,0.877333,0.122667,0.877333,34,12,376,330,46,0.87766,0.12234,0.87766,34,12,-1, merged,0,0,0.719135601203
40141,1000329,3,2738,2131,607,0.778305,0.221695,2.561699,525,82,2739,2132,607,0.778386,0.221614,2.313333,525,82,1, merged,0,0,0.643334447008
40147,1000130,5,368,304,64,0.826087,0.173913,4.123505,50,14,369,305,64,0.826558,0.173442,4.094665,50,14,1, merged,0,0,0
40158,1000014,2,1968,1667,301,0.847053,0.152947,1.695267,278,23,1969,1668,301,0.847131,0.152869,1.696019,278,23,1, merged,0,0,0.0857006091947
40158,1000329,4,2739,2132,607,0.778386,0.221614,3.335331,525,82,2740,2133,607,0.778467,0.221533,3.336478,525,82,1, merged,0,0,0.133619139418
40159,1000014,2,1969,1668,301,0.847131,0.152869,1.696019,278,23,1970,1669,301,0.847208,0.152792,1.696766,278,23,1, merged,0,0,0.159091753775
40166,1000007,1,1286,1037,249,0.806376,0.193624,0.806376,220,29,1287,1037,250,0.80575,0.19425,0.80575,221,29,1, merged,1,1,0.65390583997
40166,1000009,2,1066,889,177,0.833959,0.166041,1.640335,159,18,1067,890,177,0.834114,0.165886,1.639864,159,18,1, merged,0,0,0.625067805103
40171,1000026,2,353,323,30,0.915014,0.084986,1.726335,28,2,354,324,30,0.915254,0.084746,1.727082,28,2,1, merged,0,0,0.543826061146
40171,1000166,1,371,301,70,0.811321,0.188679,0.811321,67,3,372,302,70,0.811828,0.188172,0.811828,67,3,1, merged,0,0,0.46298773103
40174,1000023,2,854,754,100,0.882904,0.117096,1.78613,90,10,855,755,100,0.883041,0.116959,1.789291,90,10,1, merged,0,0,0.0014594870382
40185,1000012,2,520,451,69,0.867308,0.132692,1.724451,67,2,521,452,69,0.867562,0.132438,1.725382,67,2,1, merged,0,0,0.0695580990088
40187,1000012,2,521,452,69,0.867562,0.132438,1.726053,67,2,522,453,69,0.867816,0.132184,1.726971,67,2,1, merged,0,0,0.466866904449
40206,1000012,2,524,455,69,0.868321,0.131679,1.728583,67,2,525,456,69,0.868571,0.131429,1.725093,67,2,1, merged,0,0,0.00577273411679
40207,1000012,1,525,456,69,0.868571,0.131429,0.868571,67,2,527,457,70,0.867173,0.132827,0.867173,68,2,1, merged,1,1,0.112154365914
40215,1000070,1,1075,936,139,0.870698,0.129302,0.870698,118,21,1076,937,139,0.870818,0.129182,0.870818,118,21,1, merged,0,0,0.294911008641
40215,1000105,4,466,353,113,0.757511,0.242489,3.339592,103,10,467,354,113,0.75803,0.24197,3.340983,103,10,1, merged,0,0,0.310604264177
40215,1000110,3,178,157,21,0.882022,0.117978,2.582081,19,2,179,158,21,0.882682,0.117318,2.582953,19,2,1, merged,0,0,0.201948360982
40215,1000121,2,1846,1531,315,0.829361,0.170639,1.700058,297,18,1847,1532,315,0.829453,0.170547,1.700271,297,18,1, merged,0,0,0.189744337077
40221,1000043,2,484,403,81,0.832645,0.167355,1.499311,69,12,485,404,81,0.83299,0.16701,1.58299,69,12,1, merged,0,0,0.0196472982139
40242,1000015,1,1782,1604,178,0.900112,0.099888,0.900112,165,13,1783,1605,178,0.900168,0.099832,0.900168,165,13,1, merged,0,0,0.00156494161193
40247,1000007,1,1288,1038,250,0.805901,0.194099,0.805901,221,29,1290,1040,250,0.806202,0.193798,0.806202,221,29,-1, merged,0,0,1.24123316522
40247,1000014,2,1970,1669,301,0.847208,0.152792,1.653109,278,23,1972,1671,301,0.847363,0.152637,1.653565,278,23,1, merged,0,0,0.687713811272
40250,1000054,2,382,335,47,0.876963,0.123037,0.876963,35,12,383,336,47,0.877285,0.122715,1.377285,35,12,1, merged,0,0,0.719302052256
40254,1000043,1,485,404,81,0.83299,0.16701,0.83299,69,12,486,405,81,0.833333,0.166667,0.833333,69,12,-1, merged,0,0,0.878789395505
40259,1000004,1,2823,2509,314,0.888771,0.111229,0.888771,243,71,2824,2510,314,0.88881,0.11119,0.88881,243,71,1, merged,0,0,0.0134594159908
40259,1000043,3,486,405,81,0.833333,0.166667,2.472104,69,12,487,406,81,0.833676,0.166324,2.522486,69,12,1, merged,0,0,0.0102748512028
40260,1000004,2,2824,2510,314,0.88881,0.11119,1.68881,243,71,2825,2511,314,0.88885,0.11115,1.722183,243,71,-1, merged,0,0,0
40260,1000043,3,487,406,81,0.833676,0.166324,2.522486,69,12,488,407,81,0.834016,0.165984,2.556199,69,12,1, merged,0,0,0
40262,1000054,2,383,336,47,0.877285,0.122715,1.689617,35,12,385,338,47,0.877922,0.122078,1.688083,35,12,-1, merged,0,0,0.719656868062
40262,1000166,1,373,303,70,0.812332,0.187668,0.812332,67,3,374,303,71,0.81016,0.18984,0.81016,68,3,1, merged,1,1,0.516888538104
40268,1000003,2,1031,861,170,0.835112,0.164888,1.73528,155,15,1032,862,170,0.835271,0.164729,1.734991,155,15,1, merged,0,0,0.288527103211
40268,1000015,1,1783,1605,178,0.900168,0.099832,0.900168,165,13,1785,1606,179,0.89972,0.10028,0.89972,166,13,1, merged,1,1,0.345643542856
40269,1000026,1,355,325,30,0.915493,0.084507,0.915493,28,2,357,326,31,0.913165,0.086835,0.913165,29,2,1, merged,1,1,0.0282160946856
40269,1000054,3,385,338,47,0.877922,0.122078,2.603575,35,12,386,339,47,0.878238,0.121762,2.599914,35,12,-1, merged,0,0,0.0331698713126
40269,1000166,2,374,303,71,0.81016,0.18984,1.725653,68,3,376,304,72,0.808511,0.191489,1.721676,69,3,1, merged,1,1,0.0232221135985
40269,1000199,4,383,326,57,0.851175,0.148825,3.45475,51,6,384,327,57,0.851562,0.148438,3.451477,51,6,1, merged,0,0,0.00840150692046
40280,1000009,1,1067,890,177,0.834114,0.165886,0.834114,159,18,1071,892,179,0.832866,0.167134,0.832866,161,18,1, merged,1,1,0.0962069112847
40280,1000014,3,1976,1675,301,0.847672,0.152328,2.181786,278,23,1984,1679,305,0.84627,0.15373,2.01247,282,23,-1, merged,1,0,0.0535250824277
40280,1000534,4,242,177,65,0.731405,0.268595,2.913191,61,4,243,177,66,0.728395,0.271605,2.740865,62,4,1, merged,1,1,0.0888571144236
40281,1000014,2,1984,1679,305,0.84627,0.15373,1.179603,282,23,1985,1680,305,0.846348,0.153652,1.096348,282,23,1, merged,0,0,0.114988204178
40283,1000007,2,1290,1040,250,0.806202,0.193798,1.652549,221,29,1292,1042,250,0.806502,0.193498,1.652501,221,29,-1, merged,0,0,0.0941665255286
40283,1000014,1,1985,1680,305,0.846348,0.153652,0.846348,282,23,1987,1681,306,0.845999,0.154001,0.845999,283,23,1, merged,1,1,0.0527781991703
40284,1000121,2,1847,1532,315,0.829453,0.170547,1.649966,297,18,1848,1533,315,0.829545,0.170455,1.654545,297,18,1, merged,0,0,0.00875717631698
40286,1000070,2,1076,937,139,0.870818,0.129182,1.870818,118,21,1077,938,139,0.870938,0.129062,1.870938,118,21,1, merged,0,0,0.563140636227
40286,1000105,3,467,354,113,0.75803,0.24197,2.628848,103,10,468,355,113,0.758547,0.241453,2.629485,103,10,1, merged,0,0,0.537502677233
40287,1000023,1,855,755,100,0.883041,0.116959,0.883041,90,10,856,756,100,0.883178,0.116822,0.883178,90,10,-1, abandoned,0,0,0.00455335896028
40287,1000054,2,386,339,47,0.878238,0.121762,1.761279,35,12,387,339,48,0.875969,0.124031,1.759147,36,12,1, abandoned,1,1,0.000811293201363
40288,1000043,1,488,407,81,0.834016,0.165984,0.834016,69,12,489,408,81,0.834356,0.165644,0.834356,69,12,-1, abandoned,0,0,0.0344853550184
40289,1000121,2,1848,1533,315,0.829545,0.170455,1.577919,297,18,1849,1534,315,0.829638,0.170362,1.578555,297,18,1, merged,0,0,0.065540376778
40290,1000327,2,657,516,141,0.785388,0.214612,1.618721,109,32,658,517,141,0.785714,0.214286,1.60661,109,32,1, merged,0,0,0.553972434378
40291,1000070,2,1077,938,139,0.870938,0.129062,1.691833,118,21,1078,939,139,0.871058,0.128942,1.679881,118,21,-1, merged,0,0,0.27843568051
40291,1000327,3,658,517,141,0.785714,0.214286,2.477548,109,32,659,518,141,0.786039,0.213961,2.46592,109,32,1, merged,0,0,0.283833657578
40294,1000014,1,1987,1681,306,0.845999,0.154001,0.845999,283,23,1988,1682,306,0.846076,0.153924,0.846076,283,23,1, merged,0,0,0.496529697345
40299,1000014,2,1988,1682,306,0.846076,0.153924,1.653416,283,23,1989,1683,306,0.846154,0.153846,1.655245,283,23,1, merged,0,0,0.491131659462
40301,1000014,1,1989,1683,306,0.846154,0.153846,0.846154,283,23,1990,1684,306,0.846231,0.153769,0.846231,283,23,1, merged,0,0,0.598954849844
40301,1000070,2,1078,939,139,0.871058,0.128942,1.717211,118,21,1079,940,139,0.871177,0.128823,1.717408,118,21,1, merged,0,0,0.716383235486
40302,1000121,2,1851,1536,315,0.829822,0.170178,1.633945,297,18,1852,1537,315,0.829914,0.170086,1.619914,297,18,-1, merged,0,0,0.38762631569
40303,1000005,3,367,296,71,0.80654,0.19346,2.467107,65,6,368,296,72,0.804348,0.195652,2.455216,66,6,1, abandoned,1,1,0.00763227923389
40303,1000120,1,1347,1150,197,0.853749,0.146251,0.853749,170,27,1348,1150,198,0.853116,0.146884,0.853116,171,27,1, abandoned,1,1,0.00110847189232
40311,1000054,2,388,340,48,0.876289,0.123711,1.684799,36,12,391,342,49,0.87468,0.12532,1.67311,37,12,-1, merged,1,0,0.721845543841
40311,1000166,1,376,304,72,0.808511,0.191489,0.808511,69,3,382,305,77,0.798429,0.201571,0.798429,74,3,1, merged,1,1,0.520138743638
40314,1000004,2,2825,2511,314,0.88885,0.11115,1.810098,243,71,2826,2512,314,0.888889,0.111111,1.81037,243,71,-1, merged,0,0,0.394705920468
40314,1000011,1,673,620,53,0.921248,0.078752,0.921248,48,5,675,622,53,0.921481,0.078519,0.921481,48,5,-1, merged,0,0,0.710493262026
40314,1000120,3,1348,1150,198,0.853116,0.146884,2.663213,171,27,1349,1151,198,0.853225,0.146775,2.663595,171,27,-1, merged,0,0,0.586258309592
40317,1000004,3,2826,2512,314,0.888889,0.111111,2.399984,243,71,2827,2512,315,0.888574,0.111426,2.399887,243,72,-1, merged,1,1,0.0557750381296
40317,1000091,2,471,364,107,0.772824,0.227176,1.511095,92,15,472,365,107,0.773305,0.226695,1.511312,92,15,1, merged,0,0,0
40317,1000121,4,1852,1537,315,0.829914,0.170086,3.229898,297,18,1853,1537,316,0.829466,0.170534,3.229353,297,19,-1, merged,1,1,0
40317,1000328,1,810,598,212,0.738272,0.261728,0.738272,189,23,813,600,213,0.738007,0.261993,0.738007,190,23,1, merged,1,1,0.216718303078
40317,1000329,5,2742,2135,607,0.778629,0.221371,4.008527,525,82,2743,2135,608,0.778345,0.221655,4.007698,525,83,-1, merged,1,1,0.118384302439
40318,1000121,1,1853,1537,316,0.829466,0.170534,0.829466,297,19,1854,1537,317,0.829018,0.170982,0.829018,297,20,-1, merged,1,1,0
40318,1000329,2,2743,2135,608,0.778345,0.221655,1.607811,525,83,2744,2135,609,0.778061,0.221939,1.60708,525,84,-1, merged,1,1,0.660720186854
40320,1000003,1,1032,862,170,0.835271,0.164729,0.835271,155,15,1034,863,171,0.834623,0.165377,0.834623,156,15,1, merged,1,1,0.359856166759
40320,1000014,2,1990,1684,306,0.846231,0.153769,1.681502,283,23,1991,1685,306,0.846308,0.153692,1.680931,283,23,1, merged,0,0,0.330276295315
40323,1000014,1,1991,1685,306,0.846308,0.153692,0.846308,283,23,1993,1686,307,0.845961,0.154039,0.845961,284,23,1, merged,1,1,0.0010699737821
40323,1000015,2,1790,1611,179,0.9,0.1,1.746308,166,13,1791,1612,179,0.900056,0.099944,1.746017,166,13,1, merged,0,0,0.000209053000633
40328,1000007,2,1292,1042,250,0.806502,0.193498,1.473168,221,29,1293,1043,250,0.806651,0.193349,1.506651,221,29,1, merged,0,0,0.410676841967
40331,1000004,2,2827,2512,315,0.888574,0.111426,1.741799,243,72,2828,2513,315,0.888614,0.111386,1.741947,243,72,1, merged,0,0,0
40331,1000120,1,1349,1151,198,0.853225,0.146775,0.853225,171,27,1350,1152,198,0.853333,0.146667,0.853333,171,27,-1, merged,0,0,0
40334,1000121,2,1854,1537,317,0.829018,0.170982,1.829018,297,20,1855,1538,317,0.829111,0.170889,1.495777,297,20,1, merged,0,0,0.420485227955
40335,1000070,1,1080,941,139,0.871296,0.128704,0.871296,118,21,1082,941,141,0.869686,0.130314,0.869686,118,23,-1, merged,1,1,0.58920899869
40335,1000132,2,327,294,33,0.899083,0.100917,1.770379,25,8,329,296,33,0.899696,0.100304,1.769382,25,8,1, merged,0,0,0.638359972203
40343,1000003,1,1035,864,171,0.834783,0.165217,0.834783,156,15,1036,864,172,0.833977,0.166023,0.833977,157,15,1, merged,1,1,0.360496350954
40343,1000026,2,357,326,31,0.913165,0.086835,1.747948,29,2,358,326,32,0.910615,0.089385,1.744591,30,2,1, merged,1,1,0.807954545455
40347,1000005,1,369,296,73,0.802168,0.197832,0.802168,67,6,371,298,73,0.803235,0.196765,0.803235,67,6,1, merged,0,0,0.00724311582557
40347,1000120,2,1350,1152,198,0.853333,0.146667,1.655501,171,27,1351,1153,198,0.853442,0.146558,1.656676,171,27,1, merged,0,0,0.142130750605
40350,1000014,1,1993,1686,307,0.845961,0.154039,0.845961,284,23,1994,1687,307,0.846038,0.153962,0.846038,284,23,1, merged,0,0,0.503349040934
40350,1000070,2,1083,942,141,0.869806,0.130194,1.715767,118,23,1084,943,141,0.869926,0.130074,1.715964,118,23,1, merged,0,0,0.563056005939
40358,1000054,1,391,342,49,0.87468,0.12532,0.87468,37,12,392,342,50,0.872449,0.127551,0.872449,37,13,-1, merged,1,1,0.508915451108
40358,1000166,2,382,305,77,0.798429,0.201571,1.67311,74,3,383,306,77,0.798956,0.201044,1.671405,74,3,1, merged,0,0,0.774491662746
40361,1000026,2,358,326,32,0.910615,0.089385,1.752495,30,2,359,327,32,0.910864,0.089136,1.753417,30,2,1, merged,0,0,0.230900078253
40367,1000121,1,1855,1538,317,0.829111,0.170889,0.829111,297,20,1858,1540,318,0.828848,0.171152,0.828848,298,20,1, merged,1,1,0.0693433505352
40367,1000329,2,2744,2135,609,0.778061,0.221939,1.607172,525,84,2746,2137,609,0.778223,0.221777,1.607071,525,84,-1, merged,0,0,0.0886057000802
40369,1000043,1,490,409,81,0.834694,0.165306,0.834694,69,12,491,409,82,0.832994,0.167006,0.832994,70,12,1, abandoned,1,1,0.434251197873
40381,1000004,1,2829,2514,315,0.888653,0.111347,0.888653,243,72,2832,2517,315,0.888771,0.111229,0.888771,243,72,-1, merged,0,0,0.0533366453406
40381,1000015,2,1799,1620,179,0.9005,0.0995,1.789154,166,13,1800,1621,179,0.900556,0.099444,1.789327,166,13,1, merged,0,0,0.00022500692329
40381,1000054,3,394,344,50,0.873096,0.126904,2.66225,37,13,395,345,50,0.873418,0.126582,2.662744,37,13,1, merged,0,0,0.00238905085844
40388,1000014,4,1995,1688,307,0.846115,0.153885,2.38847,284,23,1996,1689,307,0.846192,0.153808,2.459107,284,23,1, merged,0,0,0
40388,1000121,3,1859,1541,318,0.82894,0.17106,1.542355,298,20,1860,1542,318,0.829032,0.170968,1.612915,298,20,1, merged,0,0,4.75476524284e-05
40390,1000003,1,1038,865,173,0.833333,0.166667,0.833333,158,15,1039,866,173,0.833494,0.166506,0.833494,158,15,-1, merged,0,0,0.0176323585417
40393,1000043,2,491,409,82,0.832994,0.167006,1.710772,70,12,493,410,83,0.831643,0.168357,1.710764,70,13,-1, merged,1,1,0.880632735946
40395,1000004,2,2832,2517,315,0.888771,0.111229,1.570942,243,72,2833,2517,316,0.888457,0.111543,1.573073,244,72,1, abandoned,1,1,0.0628966358914
40401,1000004,1,2833,2517,316,0.888457,0.111543,0.888457,244,72,2835,2519,316,0.888536,0.111464,0.888536,244,72,-1, merged,0,0,0.0177527987692
40405,1000592,2,634,542,92,0.85489,0.14511,1.713864,58,34,635,543,92,0.855118,0.144882,1.715878,58,34,1, merged,0,0,0.118408192905
40406,1000004,1,2836,2519,317,0.888223,0.111777,0.888223,245,72,2837,2520,317,0.888262,0.111738,0.888262,245,72,1, merged,0,0,0.00793792603637
40411,1000004,3,2837,2520,317,0.888262,0.111738,2.512835,245,72,2838,2520,318,0.887949,0.112051,2.514223,246,72,1, abandoned,1,1,0
40411,1000130,2,370,306,64,0.827027,0.172973,1.624573,50,14,371,307,64,0.827493,0.172507,1.626274,50,14,-1, abandoned,0,0,0
40411,1000140,1,163,130,33,0.797546,0.202454,0.797546,29,4,164,131,33,0.79878,0.20122,0.79878,29,4,-1, abandoned,0,0,0
40412,1000004,2,2838,2520,318,0.887949,0.112051,1.637949,246,72,2839,2521,318,0.887989,0.112011,1.645564,246,72,1, merged,0,0,0.452771093827
40420,1000004,2,2839,2521,318,0.887989,0.112011,0.887989,246,72,2840,2522,318,0.888028,0.111972,1.888028,246,72,1, merged,0,0,0.452772234677
40423,1000014,1,1996,1689,307,0.846192,0.153808,0.846192,284,23,1997,1690,307,0.846269,0.153731,0.846269,284,23,1, merged,0,0,0.48994485784
40423,1000091,2,475,367,108,0.772632,0.227368,1.618824,93,15,476,368,108,0.773109,0.226891,1.619379,93,15,1, merged,0,0,0.484696542762
40425,1000004,2,2844,2526,318,0.888186,0.111814,1.761603,246,72,2845,2527,318,0.888225,0.111775,1.759437,246,72,-1, abandoned,0,0,0.424516255907
40425,1000054,1,395,345,50,0.873418,0.126582,0.873418,37,13,396,345,51,0.871212,0.128788,0.871212,38,13,1, abandoned,1,1,0.507507974482
40427,1000023,2,857,757,100,0.883314,0.116686,1.730475,90,10,858,758,100,0.88345,0.11655,1.731276,90,10,1, merged,0,0,0.00491250196579
40434,1000004,2,2845,2527,318,0.888225,0.111775,1.661334,246,72,2846,2527,319,0.887913,0.112087,1.659401,247,72,1, abandoned,1,1,0
40434,1000091,1,476,368,108,0.773109,0.226891,0.773109,93,15,477,368,109,0.771488,0.228512,0.771488,94,15,1, abandoned,1,1,0
40439,1000121,1,1861,1542,319,0.828587,0.171413,0.828587,299,20,1862,1543,319,0.828679,0.171321,0.828679,299,20,1, merged,0,0,0.105430239762
40440,1000121,2,1862,1543,319,0.828679,0.171321,1.728679,299,20,1864,1543,321,0.82779,0.17221,1.736881,301,20,1, abandoned,1,1,0.0923847846029
40442,1000121,1,1864,1543,321,0.82779,0.17221,0.82779,301,20,1865,1544,321,0.827882,0.172118,0.827882,301,20,1, merged,0,0,0.00135598207672
40442,1000329,2,2746,2137,609,0.778223,0.221777,1.606013,525,84,2747,2138,609,0.778304,0.221696,1.606186,525,84,1, merged,0,0,0.00143692854245
40445,1000043,2,494,411,83,0.831984,0.168016,1.649375,70,13,495,412,83,0.832323,0.167677,1.644289,70,13,1, merged,0,0,0.145746276157
40445,1000108,1,115,94,21,0.817391,0.182609,0.817391,17,4,117,95,22,0.811966,0.188034,0.811966,18,4,1, merged,1,1,0.0271305065472
40459,1000023,1,858,758,100,0.88345,0.11655,0.88345,90,10,859,759,100,0.883586,0.116414,0.883586,90,10,1, merged,0,0,0.00459011079434
40460,1000011,1,676,623,53,0.921598,0.078402,0.921598,48,5,677,623,54,0.920236,0.079764,0.920236,49,5,1, merged,1,1,0.885031563057
40463,1000054,2,396,345,51,0.871212,0.128788,1.722775,38,13,397,346,51,0.871537,0.128463,1.723485,38,13,1, merged,0,0,0.401137384736
40463,1000199,1,384,327,57,0.851562,0.148438,0.851562,51,6,385,328,57,0.851948,0.148052,0.851948,51,6,1, merged,0,0,0.0128697665627
40467,1000015,1,1808,1627,181,0.899889,0.100111,0.899889,168,13,1809,1628,181,0.899945,0.100055,0.899945,168,13,1, merged,0,0,0.0892594580643
40468,1000003,2,1039,866,173,0.833494,0.166506,1.610089,158,15,1041,868,173,0.833814,0.166186,1.607665,158,15,-1, merged,0,0,0
40470,1000054,2,397,346,51,0.871537,0.128463,1.674815,38,13,398,347,51,0.871859,0.128141,1.675674,38,13,1, merged,0,0,0.0771265414501
40477,1000054,3,398,347,51,0.871859,0.128141,2.247617,38,13,399,348,51,0.87218,0.12782,2.311836,38,13,1, merged,0,0,0.715140745456
40481,1000091,1,477,368,109,0.771488,0.228512,0.771488,94,15,478,369,109,0.771967,0.228033,0.771967,94,15,1, merged,0,0,0.166724600818
40481,1000121,2,1865,1544,321,0.827882,0.172118,1.599371,301,20,1866,1545,321,0.827974,0.172026,1.599941,301,20,1, merged,0,0,0.154784912437
40482,1000023,2,861,761,100,0.883856,0.116144,1.668802,90,10,863,762,101,0.882966,0.117034,1.669443,91,10,1, merged,1,1,0.30634530249
40487,1000004,1,2852,2532,320,0.887798,0.112202,0.887798,248,72,2853,2532,321,0.887487,0.112513,0.887487,249,72,1, merged,1,1,0
40487,1000120,2,1351,1153,198,0.853442,0.146558,1.74124,171,27,1352,1154,198,0.85355,0.14645,1.741037,171,27,1, merged,0,0,0
40492,1000140,2,164,131,33,0.79878,0.20122,1.669009,29,4,165,132,33,0.8,0.2,1.671212,29,4,1, merged,0,0,0.314139783949
40496,1000014,2,1998,1691,307,0.846346,0.153654,1.71687,284,23,1999,1692,307,0.846423,0.153577,1.716267,284,23,1, merged,0,0,0.646391689206
40496,1000070,1,1089,948,141,0.870523,0.129477,0.870523,118,23,1091,949,142,0.869844,0.130156,0.869844,118,24,-1, merged,1,0,0.800683890578
40501,1000015,3,1810,1628,182,0.899448,0.100552,2.623576,169,13,1811,1629,182,0.899503,0.100497,2.619941,169,13,1, merged,0,0,0.139668724614
40501,1000054,2,399,348,51,0.87218,0.12782,1.724129,38,13,400,349,51,0.8725,0.1275,1.720438,38,13,1, merged,0,0,0.115204108249
40501,1000199,1,385,328,57,0.851948,0.148052,0.851948,51,6,388,329,59,0.847938,0.152062,0.847938,53,6,1, merged,1,1,0.0406181437254
40502,1000014,2,1999,1692,307,0.846423,0.153577,1.673916,284,23,2001,1693,308,0.846077,0.153923,1.671346,285,23,1, merged,1,1,0.0847760781215
40502,1000121,3,1866,1545,321,0.827974,0.172026,2.501891,301,20,1869,1547,322,0.827715,0.172285,2.499061,302,20,-1, merged,1,0,0.0595063229918
40502,1000130,1,371,307,64,0.827493,0.172507,0.827493,50,14,372,307,65,0.825269,0.174731,0.825269,51,14,1, merged,1,1,0.0924976240144
40503,1000023,2,865,764,101,0.883237,0.116763,1.572892,91,10,866,765,101,0.883372,0.116628,1.578287,91,10,1, merged,0,0,0.272135402124
40514,1000054,1,403,352,51,0.873449,0.126551,0.873449,38,13,404,353,51,0.873762,0.126238,0.873762,38,13,1, merged,0,0,0.30900598732
40528,1000329,2,2747,2138,609,0.778304,0.221696,1.734825,525,84,2748,2138,610,0.77802,0.22198,1.736354,526,84,1, abandoned,1,1,0
40541,1000007,1,1294,1044,250,0.806801,0.193199,0.806801,221,29,1295,1045,250,0.80695,0.19305,0.80695,221,29,1, merged,0,0,0.187569949006
40543,1000166,2,384,307,77,0.799479,0.200521,1.617661,74,3,385,308,77,0.8,0.2,1.633333,74,3,1, merged,0,0,0.0504749150179
40557,1000004,2,2853,2532,321,0.887487,0.112513,0.887487,249,72,2854,2533,321,0.887526,0.112474,1.887526,249,72,1, merged,0,0,0.0252993547987
40558,1000005,1,375,301,74,0.802667,0.197333,0.802667,68,6,376,302,74,0.803191,0.196809,0.803191,68,6,1, merged,0,0,0.093314197723
40567,1000004,2,2854,2533,321,0.887526,0.112474,1.887526,249,72,2855,2533,322,0.887215,0.112785,1.387215,250,72,1, abandoned,1,1,0.388894213949
40576,1000015,1,1814,1632,182,0.899669,0.100331,0.899669,169,13,1815,1633,182,0.899725,0.100275,0.899725,169,13,1, merged,0,0,0.144502100937
40576,1000153,2,939,851,88,0.906283,0.093717,1.805953,67,21,940,852,88,0.906383,0.093617,1.806107,67,21,1, merged,0,0,0.153590151903
40577,1000105,2,468,355,113,0.758547,0.241453,1.58663,103,10,470,357,113,0.759574,0.240426,1.587308,103,10,-1, merged,0,0,0.00975251913393
40577,1000121,1,1873,1551,322,0.828083,0.171917,0.828083,302,20,1875,1552,323,0.827733,0.172267,0.827733,303,20,1, merged,1,1,0.00842760547385
40578,1000004,2,2857,2535,322,0.887294,0.112706,1.715028,250,72,2858,2536,322,0.887334,0.112666,1.715159,250,72,1, merged,0,0,0.0300513464355
40578,1000121,1,1875,1552,323,0.827733,0.172267,0.827733,303,20,1876,1553,323,0.827825,0.172175,0.827825,303,20,1, merged,0,0,0.00295992480561
40586,1000054,2,405,354,51,0.874074,0.125926,1.797869,38,13,406,355,51,0.874384,0.125616,1.798297,38,13,1, merged,0,0,0.720662937752
40586,1000124,1,643,594,49,0.923795,0.076205,0.923795,42,7,644,595,49,0.923913,0.076087,0.923913,42,7,1, merged,0,0,0.542162107396
40594,1000004,2,2859,2537,322,0.887373,0.112627,1.571989,250,72,2862,2539,323,0.887142,0.112858,1.573709,251,72,-1, merged,1,0,0.000914647169051
40609,1000109,3,466,396,70,0.849785,0.150215,2.390975,65,5,467,397,70,0.850107,0.149893,2.406559,65,5,1, merged,0,0,0
40613,1000003,1,1041,868,173,0.833814,0.166186,0.833814,158,15,1042,868,174,0.833013,0.166987,0.833013,159,15,1, abandoned,1,1,0
40618,1000327,1,659,518,141,0.786039,0.213961,0.786039,109,32,660,519,141,0.786364,0.213636,0.786364,109,32,-1, abandoned,0,0,0.0357327381443
40619,1000091,2,479,370,109,0.772443,0.227557,1.639109,94,15,480,371,109,0.772917,0.227083,1.636124,94,15,1, merged,0,0,0.643904779037
40621,1000015,2,1815,1633,182,0.899725,0.100275,1.62812,169,13,1816,1634,182,0.89978,0.10022,1.629288,169,13,1, merged,0,0,1.01074083452
40621,1000534,1,243,177,66,0.728395,0.271605,0.728395,62,4,244,178,66,0.729508,0.270492,0.729508,62,4,1, merged,0,0,1.12030712877
40626,1000091,2,480,371,109,0.772917,0.227083,1.636124,94,15,481,372,109,0.773389,0.226611,1.633854,94,15,1, merged,0,0,0.0464089817206
40643,1000054,2,406,355,51,0.874384,0.125616,1.756141,38,13,407,356,51,0.874693,0.125307,1.756848,38,13,1, merged,0,0,0.101065222297
40644,1000121,1,1886,1559,327,0.826617,0.173383,0.826617,306,21,1887,1560,327,0.826709,0.173291,0.826709,306,21,1, merged,0,0,0.0253600268626
40651,1000110,2,179,158,21,0.882682,0.117318,1.749348,19,2,180,159,21,0.883333,0.116667,1.751102,19,2,1, merged,0,0,0.0919061739278
40655,1000105,1,470,357,113,0.759574,0.240426,0.759574,103,10,471,357,114,0.757962,0.242038,0.757962,103,11,-1, merged,1,1,0
40656,1000007,2,1295,1045,250,0.80695,0.19305,1.653257,221,29,1296,1046,250,0.807099,0.192901,1.653483,221,29,1, merged,0,0,0.113622986792
40656,1000014,1,2004,1696,308,0.846307,0.153693,0.846307,285,23,2005,1697,308,0.846384,0.153616,0.846384,285,23,1, merged,0,0,0.0622529219843
40661,1000014,1,2005,1697,308,0.846384,0.153616,0.846384,285,23,2007,1698,309,0.846039,0.153961,0.846039,286,23,-1, merged,1,0,0.0271357712379
40661,1000015,2,1816,1634,182,0.89978,0.10022,1.746164,169,13,1817,1634,183,0.899285,0.100715,1.745323,169,14,-1, merged,1,1,0.0393592580034
40668,1000003,1,1042,868,174,0.833013,0.166987,0.833013,159,15,1043,869,174,0.833174,0.166826,0.833174,159,15,1, merged,0,0,0.182076115633
40668,1000121,2,1887,1560,327,0.826709,0.173291,1.659722,306,21,1888,1561,327,0.826801,0.173199,1.659974,306,21,1, merged,0,0,0.169260157627
40669,1000007,2,1296,1046,250,0.807099,0.192901,1.653214,221,29,1297,1047,250,0.807247,0.192753,1.65344,221,29,1, merged,0,0,0.058557712594
40669,1000014,1,2008,1699,309,0.846116,0.153884,0.846116,286,23,2009,1700,309,0.846192,0.153808,0.846192,286,23,1, merged,0,0,0.0318975796157
40672,1000004,1,2863,2540,323,0.887181,0.112819,0.887181,251,72,2865,2542,323,0.88726,0.11274,0.88726,251,72,-1, abandoned,0,0,0
40672,1000153,2,941,853,88,0.906482,0.093518,1.793664,67,21,942,854,88,0.906582,0.093418,1.793842,67,21,-1, abandoned,0,0,0
40675,1000004,2,2865,2542,323,0.88726,0.11274,1.733452,251,72,2866,2543,323,0.887299,0.112701,1.733071,251,72,-1, merged,0,0,0.0229039125584
40675,1000014,1,2009,1700,309,0.846192,0.153808,0.846192,286,23,2010,1700,310,0.845771,0.154229,0.845771,287,23,1, merged,1,1,0.0326250700051
40675,1000015,3,1818,1635,183,0.89934,0.10066,2.632792,169,14,1819,1636,183,0.899395,0.100605,2.632466,169,14,1, merged,0,0,0.0471721124097
40684,1000004,1,2866,2543,323,0.887299,0.112701,0.887299,251,72,2867,2544,323,0.887339,0.112661,0.887339,251,72,1, merged,0,0,0.113974802817
40684,1000120,2,1357,1159,198,0.85409,0.14591,1.741389,171,27,1358,1160,198,0.854197,0.145803,1.741536,171,27,1, merged,0,0,0.138641822579
40685,1000121,2,1890,1563,327,0.826984,0.173016,1.709534,306,21,1892,1565,327,0.827167,0.172833,1.71011,306,21,1, merged,0,0,0.0191268835048
40693,1000004,2,2869,2545,324,0.887069,0.112931,1.714327,252,72,2871,2547,324,0.887147,0.112853,1.71406,252,72,-1, merged,0,0,0.00266882699092
40693,1000121,1,1893,1566,327,0.827258,0.172742,0.827258,306,21,1895,1567,328,0.826913,0.173087,0.826913,307,21,1, merged,1,1,0.00060168685868
40695,1000121,2,1895,1567,328,0.826913,0.173087,1.826913,307,21,1896,1568,328,0.827004,0.172996,1.577004,307,21,-1, abandoned,0,0,0.0845107240707
40701,1000091,2,484,374,110,0.772727,0.227273,1.467643,95,15,485,375,110,0.773196,0.226804,1.456529,95,15,1, merged,0,0,0.292229396467
40701,1000121,4,1896,1568,328,0.827004,0.172996,3.044647,307,21,1897,1569,328,0.827095,0.172905,3.083625,307,21,1, merged,0,0,0.349618776647
40706,1000004,2,2871,2547,324,0.887147,0.112853,1.750784,252,72,2873,2548,325,0.886878,0.113122,1.715449,253,72,1, abandoned,1,1,0.0404572516692
40706,1000329,5,2750,2140,610,0.778182,0.221818,3.960527,526,84,2751,2141,610,0.778262,0.221738,3.933394,526,84,-1, abandoned,0,0,0.0201603996845
40708,1000004,2,2875,2550,325,0.886957,0.113043,1.581224,253,72,2876,2551,325,0.886996,0.113004,1.583198,253,72,1, merged,0,0,0.0253429665212
40722,1000054,3,407,356,51,0.874693,0.125307,2.520585,38,13,408,357,51,0.875,0.125,2.521798,38,13,1, merged,0,0,0.533165347286
40722,1000166,2,391,312,79,0.797954,0.202046,1.645892,76,3,392,313,79,0.798469,0.201531,1.646798,76,3,1, merged,0,0,0.424854385476
40722,1000199,1,388,329,59,0.847938,0.152062,0.847938,53,6,389,330,59,0.848329,0.151671,0.848329,53,6,1, merged,0,0,0.158469541881
40725,1000014,1,2011,1701,310,0.845848,0.154152,0.845848,287,23,2012,1701,311,0.845427,0.154573,0.845427,288,23,1, merged,1,1,0.229568865044
40728,1000009,2,1073,894,179,0.833178,0.166822,1.678605,161,18,1074,895,179,0.833333,0.166667,1.678838,161,18,1, merged,0,0,0.383849968186
40728,1000014,1,2012,1701,311,0.845427,0.154573,0.845427,288,23,2013,1702,311,0.845504,0.154496,0.845504,288,23,1, merged,0,0,0.229292003084
40731,1000014,1,2015,1704,311,0.845658,0.154342,0.845658,288,23,2016,1705,311,0.845734,0.154266,0.845734,288,23,1, merged,0,0,0.114850005723
40731,1000199,2,389,330,59,0.848329,0.151671,1.693987,53,6,390,331,59,0.848718,0.151282,1.694452,53,6,1, merged,0,0,0.0270412868472
40735,1000011,2,678,624,54,0.920354,0.079646,1.766165,49,5,679,625,54,0.920471,0.079529,1.766358,49,5,1, merged,0,0,0.0841877631263
40735,1000014,1,2017,1706,311,0.845811,0.154189,0.845811,288,23,2018,1707,311,0.845887,0.154113,0.845887,288,23,1, merged,0,0,0.0627704220383
40736,1000003,1,1043,869,174,0.833174,0.166826,0.833174,159,15,1044,870,174,0.833333,0.166667,0.833333,159,15,1, merged,0,0,0.0643736748981
40737,1000014,1,2018,1707,311,0.845887,0.154113,0.845887,288,23,2019,1708,311,0.845963,0.154037,0.845963,288,23,1, merged,0,0,0.0431758163022
40738,1000012,1,532,462,70,0.868421,0.131579,0.868421,68,2,533,462,71,0.866792,0.133208,0.866792,69,2,1, merged,1,1,0.0654301426552
40738,1000014,2,2019,1708,311,0.845963,0.154037,1.714384,288,23,2021,1709,312,0.845621,0.154379,1.712413,289,23,1, merged,1,1,0.0691998016751
40744,1000121,1,1897,1569,328,0.827095,0.172905,0.827095,307,21,1899,1570,329,0.826751,0.173249,0.826751,307,22,-1, merged,1,0,0.000127512414387
40745,1000121,1,1899,1570,329,0.826751,0.173249,0.826751,307,22,1901,1571,330,0.826407,0.173593,0.826407,308,22,-1, abandoned,1,0,0
40745,1000140,2,169,136,33,0.804734,0.195266,1.631485,29,4,170,137,33,0.805882,0.194118,1.63229,29,4,-1, abandoned,0,0,0
40746,1000054,1,408,357,51,0.875,0.125,0.875,38,13,410,358,52,0.873171,0.126829,0.873171,39,13,1, merged,1,1,0.0679075200415
40746,1000140,2,170,137,33,0.805882,0.194118,1.680882,29,4,171,138,33,0.807018,0.192982,1.680188,29,4,-1, merged,0,0,0.159782694861
40747,1000327,1,660,519,141,0.786364,0.213636,0.786364,109,32,661,520,141,0.786687,0.213313,0.786687,109,32,1, merged,0,0,0.284909816501
40748,1000327,2,661,520,141,0.786687,0.213313,1.510825,109,32,662,521,141,0.787009,0.212991,1.520342,109,32,1, merged,0,0,0.555952692677
40762,1000105,1,471,357,114,0.757962,0.242038,0.757962,103,11,472,358,114,0.758475,0.241525,0.758475,103,11,1, merged,0,0,0
40762,1000121,2,1903,1571,332,0.825539,0.174461,1.5835,310,22,1904,1572,332,0.82563,0.17437,1.584105,310,22,1, merged,0,0,0
40764,1000132,1,331,298,33,0.900302,0.099698,0.900302,25,8,332,299,33,0.900602,0.099398,0.900602,25,8,1, merged,0,0,0.124756470114
40766,1000054,1,410,358,52,0.873171,0.126829,0.873171,39,13,411,359,52,0.873479,0.126521,0.873479,39,13,1, merged,0,0,0.686922821025
40771,1000004,3,2877,2552,325,0.887035,0.112965,2.537534,253,72,2878,2553,325,0.887074,0.112926,2.535474,253,72,-1, abandoned,0,0,0
40771,1000014,2,2021,1709,312,0.845621,0.154379,1.650499,289,23,2022,1710,312,0.845697,0.154303,1.6484,289,23,-1, abandoned,0,0,0
40773,1000004,1,2878,2553,325,0.887074,0.112926,0.887074,253,72,2879,2554,325,0.887114,0.112886,0.887114,253,72,-1, merged,0,0,0.197763080377
40773,1000120,2,1359,1161,198,0.854305,0.145695,1.741379,171,27,1360,1162,198,0.854412,0.145588,1.741525,171,27,1, merged,0,0,0.293899731998
40791,1000004,2,2879,2554,325,0.887114,0.112886,1.747579,253,72,2880,2555,325,0.887153,0.112847,1.748264,253,72,-1, abandoned,0,0,0
40794,1000091,2,485,375,110,0.773196,0.226804,1.598826,95,15,486,376,110,0.773663,0.226337,1.599384,95,15,1, merged,0,0,0.360358647358
40794,1000121,1,1904,1572,332,0.82563,0.17437,0.82563,310,22,1905,1573,332,0.825722,0.174278,0.825722,310,22,1, merged,0,0,0.356612199622
40800,1000091,1,486,376,110,0.773663,0.226337,0.773663,95,15,487,377,110,0.774127,0.225873,0.774127,95,15,1, merged,0,0,0.293284050179
40801,1000121,2,1905,1573,332,0.825722,0.174278,1.659055,310,22,1906,1574,332,0.825813,0.174187,1.682956,310,22,1, merged,0,0,0.349657290114
40802,1000054,2,412,360,52,0.873786,0.126214,1.743705,39,13,414,362,52,0.874396,0.125604,1.737299,39,13,-1, merged,0,0,0.689839060967
40802,1000166,3,392,313,79,0.798469,0.201531,2.542174,76,3,394,314,80,0.796954,0.203046,2.534254,77,3,1, merged,1,1,0.473983457019
40804,1000023,2,871,770,101,0.884041,0.115959,1.734469,91,10,874,772,102,0.883295,0.116705,1.734359,91,11,1, merged,1,0,0.000564530642192
40806,1000004,2,2880,2555,325,0.887153,0.112847,1.761852,253,72,2881,2556,325,0.887192,0.112808,1.762192,253,72,1, merged,0,0,0.000653227995994
40806,1000015,3,1834,1651,183,0.900218,0.099782,2.66207,169,14,1835,1652,183,0.900272,0.099728,2.662464,169,14,1, merged,0,0,0.000196612067706
40806,1000054,1,415,363,52,0.874699,0.125301,0.874699,39,13,416,364,52,0.875,0.125,0.875,39,13,1, merged,0,0,0.000775300174813
40808,1000121,2,1906,1574,332,0.825813,0.174187,1.628516,310,22,1907,1575,332,0.825905,0.174095,1.629139,310,22,1, merged,0,0,0.393827959386
40811,1000014,3,2025,1712,313,0.845432,0.154568,2.43083,290,23,2026,1713,313,0.845508,0.154492,2.431504,290,23,1, merged,0,0,0.0135789612274
40811,1000105,2,474,360,114,0.759494,0.240506,1.585398,103,11,475,361,114,0.76,0.24,1.585996,103,11,1, merged,0,0,0.0173806104179
40811,1000121,1,1907,1575,332,0.825905,0.174095,0.825905,310,22,1908,1576,332,0.825996,0.174004,0.825996,310,22,1, merged,0,0,0.0159143272701
40813,1000003,1,1045,870,175,0.832536,0.167464,0.832536,160,15,1046,871,175,0.832696,0.167304,0.832696,160,15,1, merged,0,0,0.000585676037483
40813,1000004,2,2881,2556,325,0.887192,0.112808,1.719728,253,72,2882,2557,325,0.887231,0.112769,1.719927,253,72,1, merged,0,0,0.00024263379057
40814,1000026,2,362,330,32,0.911602,0.088398,1.786602,30,2,363,331,32,0.911846,0.088154,1.787444,30,2,1, merged,0,0,0.00215703197931
40814,1000054,1,416,364,52,0.875,0.125,0.875,39,13,418,366,52,0.875598,0.124402,0.875598,39,13,-1, merged,0,0,0.00239456983506
40816,1000003,2,1046,871,175,0.832696,0.167304,1.607344,160,15,1049,874,175,0.833174,0.166826,1.608613,160,15,1, merged,0,0,0.178221609645
40818,1000121,1,1908,1576,332,0.825996,0.174004,0.825996,310,22,1909,1576,333,0.825563,0.174437,0.825563,311,22,1, merged,1,1,0.0845663294621
40825,1000004,1,2885,2560,325,0.887348,0.112652,0.887348,253,72,2887,2561,326,0.88708,0.11292,0.88708,254,72,-1, merged,1,0,0.00198588665071
40825,1000121,2,1909,1576,333,0.825563,0.174437,1.712911,311,22,1910,1576,334,0.825131,0.174869,1.712211,312,22,1, merged,1,1,0.00212700140019
40828,1000004,1,2887,2561,326,0.88708,0.11292,0.88708,254,72,2890,2564,326,0.887197,0.112803,0.887197,254,72,-1, merged,0,0,0.0542005062968
40828,1000121,2,1910,1576,334,0.825131,0.174869,1.712211,312,22,1911,1576,335,0.824699,0.175301,1.711896,313,22,1, merged,1,1,0.00998208343998
40828,1000329,4,2751,2141,610,0.778262,0.221738,3.351233,526,84,2752,2141,611,0.77798,0.22202,3.339876,527,84,1, merged,1,1,0.0253312999579
40829,1000328,1,823,607,216,0.737546,0.262454,0.737546,193,23,824,608,216,0.737864,0.262136,0.737864,193,23,1, merged,0,0,0.741282694608
40829,1000329,2,2752,2141,611,0.77798,0.22202,1.515525,527,84,2753,2142,611,0.77806,0.22194,1.515924,527,84,1, merged,0,0,0.662111197917
40840,1000004,1,2891,2565,326,0.887236,0.112764,0.887236,254,72,2892,2566,326,0.887275,0.112725,0.887275,254,72,-1, abandoned,0,0,0.000958244496083
40840,1000023,2,874,772,102,0.883295,0.116705,1.770531,91,11,876,774,102,0.883562,0.116438,1.770837,91,11,-1, abandoned,0,0,0.000730921293066
40843,1000054,2,419,367,52,0.875895,0.124105,1.767199,39,13,420,367,53,0.87381,0.12619,1.765701,40,13,1, abandoned,1,1,0.582046770666
40844,1000153,2,943,855,88,0.906681,0.093319,1.701618,67,21,945,855,90,0.904762,0.095238,1.700216,67,23,-1, merged,1,1,0.587090799154
40844,1000166,1,395,314,81,0.794937,0.205063,0.794937,78,3,396,315,81,0.795455,0.204545,0.795455,78,3,1, merged,0,0,0.71397214793
40846,1000004,1,2892,2566,326,0.887275,0.112725,0.887275,254,72,2894,2567,327,0.887008,0.112992,0.887008,255,72,1, merged,1,1,0.01955878461
40847,1000004,1,2894,2567,327,0.887008,0.112992,0.887008,255,72,2895,2568,327,0.887047,0.112953,0.887047,255,72,1, merged,0,0,0.388162480511
40847,1000199,2,390,331,59,0.848718,0.151282,1.735726,53,6,391,332,59,0.849105,0.150895,1.736151,53,6,1, merged,0,0,0.162802881798
40848,1000007,2,1297,1047,250,0.807247,0.192753,1.652832,221,29,1298,1047,251,0.806626,0.193374,1.652438,222,29,1, abandoned,1,1,0
40848,1000014,1,2027,1714,313,0.845585,0.154415,0.845585,290,23,2030,1717,313,0.845813,0.154187,0.845813,290,23,-1, abandoned,0,0,0
40848,1000015,4,1835,1652,183,0.900272,0.099728,3.295143,169,14,1836,1652,184,0.899782,0.100218,3.291903,170,14,1, abandoned,1,1,0
40856,1000054,1,421,368,53,0.874109,0.125891,0.874109,40,13,422,369,53,0.874408,0.125592,0.874408,40,13,1, merged,0,0,0.165074379733
40860,1000140,2,171,138,33,0.807018,0.192982,1.66416,29,4,172,139,33,0.80814,0.19186,1.68314,29,4,1, merged,0,0,0.092503477986
40861,1000009,2,1074,895,179,0.833333,0.166667,1.688385,161,18,1075,896,179,0.833488,0.166512,1.687914,161,18,1, merged,0,0,0.00277032266273
40861,1000120,1,1366,1168,198,0.855051,0.144949,0.855051,171,27,1367,1168,199,0.854426,0.145574,0.854426,172,27,1, merged,1,1,0.00742771266053
40862,1000054,1,423,370,53,0.874704,0.125296,0.874704,40,13,425,371,54,0.872941,0.127059,0.872941,41,13,1, merged,1,1,0.165527658906
40867,1000054,1,425,371,54,0.872941,0.127059,0.872941,41,13,426,371,55,0.870892,0.129108,0.870892,42,13,1, merged,1,1,0.217891424792
40875,1000023,1,877,775,102,0.883694,0.116306,0.883694,91,11,878,775,103,0.882688,0.117312,0.882688,92,11,1, merged,1,1,0.134865486962
40875,1000121,3,1913,1578,335,0.824882,0.175118,2.511811,313,22,1914,1579,335,0.824974,0.175026,2.508737,313,22,1, merged,0,0,0.0883271380889
40879,1000012,2,534,463,71,0.867041,0.132959,1.712854,69,2,535,464,71,0.86729,0.13271,1.713178,69,2,1, merged,0,0,0.025771636039
40879,1000014,1,2030,1717,313,0.845813,0.154187,0.845813,290,23,2031,1718,313,0.845889,0.154111,0.845889,290,23,1, merged,0,0,0.0293273792335
40887,1000004,2,2895,2568,327,0.887047,0.112953,1.712386,255,72,2896,2569,327,0.887086,0.112914,1.712516,255,72,1, merged,0,0,0.00823027906432
40887,1000054,3,429,373,56,0.869464,0.130536,2.581849,43,13,430,374,56,0.869767,0.130233,2.582283,43,13,1, merged,0,0,0.00915186162458
40887,1000121,1,1918,1583,335,0.825339,0.174661,0.825339,313,22,1919,1584,335,0.82543,0.17457,0.82543,313,22,1, merged,0,0,0.00807601994232
40892,1000003,2,1049,874,175,0.833174,0.166826,1.679063,160,15,1050,875,175,0.833333,0.166667,1.678542,160,15,-1, merged,0,0,0.116506299776
40892,1000014,1,2031,1718,313,0.845889,0.154111,0.845889,290,23,2035,1720,315,0.845209,0.154791,0.845209,292,23,1, merged,1,1,0.101094870741
40894,1000014,1,2037,1721,316,0.84487,0.15513,0.84487,293,23,2040,1723,317,0.844608,0.155392,0.844608,294,23,1, merged,1,1,0.0835141803462
40894,1000153,2,946,856,90,0.904863,0.095137,1.749732,67,23,947,857,90,0.904963,0.095037,1.749571,67,23,1, merged,0,0,0.110177613063
40898,1000004,3,2896,2569,327,0.887086,0.112914,2.610868,255,72,2898,2569,329,0.886473,0.113527,2.607921,255,74,-1, merged,1,1,0.0175102327948
40898,1000054,2,430,374,56,0.869767,0.130233,1.723782,43,13,432,375,57,0.868056,0.131944,1.721447,44,13,1, merged,1,1,0.000592444589608
40898,1000120,1,1370,1170,200,0.854015,0.145985,0.854015,173,27,1371,1170,201,0.853392,0.146608,0.853392,174,27,1, merged,1,1,0.0460132011693
40899,1000054,2,432,375,57,0.868056,0.131944,1.791969,44,13,433,376,57,0.86836,0.13164,1.792391,44,13,1, merged,0,0,0.000619995720908
40899,1000124,1,644,595,49,0.923913,0.076087,0.923913,42,7,645,596,49,0.924031,0.075969,0.924031,42,7,1, merged,0,0,0.000913370717074
40901,1000015,1,1838,1654,184,0.899891,0.100109,0.899891,170,14,1839,1655,184,0.899946,0.100054,0.899946,170,14,1, merged,0,0,0.0147732389949
40901,1000054,2,434,377,57,0.868664,0.131336,1.768555,44,13,435,378,57,0.868966,0.131034,1.768911,44,13,1, merged,0,0,0.0782010793039
40906,1000015,1,1839,1655,184,0.899946,0.100054,0.899946,170,14,1840,1656,184,0.9,0.1,0.9,170,14,1, merged,0,0,0.0485522775723
40906,1000054,2,438,381,57,0.869863,0.130137,1.769809,44,13,439,382,57,0.870159,0.129841,1.770159,44,13,1, merged,0,0,0.204752584079
40908,1000015,1,1840,1656,184,0.9,0.1,0.9,170,14,1844,1658,186,0.899132,0.100868,0.899132,172,14,1, merged,1,1,1.59735806018e-06
40908,1000054,2,439,382,57,0.870159,0.129841,1.770159,44,13,441,382,59,0.866213,0.133787,1.765345,46,13,1, merged,1,1,8.27028475025e-06
40910,1000012,2,536,465,71,0.867537,0.132463,1.675677,69,2,537,466,71,0.867784,0.132216,1.677033,69,2,1, merged,0,0,0
40910,1000140,1,172,139,33,0.80814,0.19186,0.80814,29,4,173,140,33,0.809249,0.190751,0.809249,29,4,1, merged,0,0,0
40916,1000121,1,1919,1584,335,0.82543,0.17457,0.82543,313,22,1921,1586,335,0.825612,0.174388,0.825612,313,22,-1, abandoned,0,0,0
40920,1000004,3,2898,2569,329,0.886473,0.113527,2.448062,255,74,2900,2571,329,0.886552,0.113448,2.442864,255,74,-1, merged,0,0,0.384153106137
40920,1000014,1,2040,1723,317,0.844608,0.155392,0.844608,294,23,2041,1724,317,0.844684,0.155316,0.844684,294,23,-1, merged,0,0,0.502498061572
40923,1000121,1,1921,1586,335,0.825612,0.174388,0.825612,313,22,1922,1587,335,0.825702,0.174298,0.825702,313,22,1, merged,0,0,0.175142636478
40923,1000132,2,336,303,33,0.901786,0.098214,1.727397,25,8,337,304,33,0.902077,0.097923,1.72778,25,8,1, merged,0,0,0.263124988158
40929,1000005,1,380,306,74,0.805263,0.194737,0.805263,68,6,381,307,74,0.805774,0.194226,0.805774,68,6,1, merged,0,0,0.117916814991
40929,1000054,2,446,387,59,0.867713,0.132287,1.672976,46,13,447,388,59,0.868009,0.131991,1.673783,46,13,1, merged,0,0,0.605226512771
40939,1000004,1,2900,2571,329,0.886552,0.113448,0.886552,255,74,2901,2572,329,0.886591,0.113409,0.886591,255,74,-1, abandoned,0,0,0.447687689994
40939,1000014,2,2041,1724,317,0.844684,0.155316,1.731236,294,23,2042,1725,317,0.84476,0.15524,1.731351,294,23,-1, abandoned,0,0,0.514102734058
40943,1000121,1,1922,1587,335,0.825702,0.174298,0.825702,313,22,1923,1588,335,0.825793,0.174207,0.825793,313,22,1, merged,0,0,0.0389264528749
40946,1000023,2,879,776,103,0.882821,0.117179,1.688944,92,11,880,777,103,0.882955,0.117045,1.691035,92,11,1, merged,0,0,0.000365205843293
40951,1000054,1,452,393,59,0.869469,0.130531,0.869469,46,13,453,394,59,0.869757,0.130243,0.869757,46,13,1, merged,0,0,0.62945610169
40958,1000014,2,2043,1726,317,0.844836,0.155164,1.678836,294,23,2044,1727,317,0.844912,0.155088,1.679243,294,23,1, merged,0,0,0.0373081309799
40958,1000043,1,500,417,83,0.834,0.166,0.834,70,13,501,418,83,0.834331,0.165669,0.834331,70,13,1, merged,0,0,0.00395652422105
40959,1000011,1,682,628,54,0.920821,0.079179,0.920821,49,5,684,628,56,0.918129,0.081871,0.918129,51,5,1, merged,1,1,0.00353482577544
40959,1000120,2,1373,1172,201,0.853605,0.146395,1.774426,174,27,1375,1174,201,0.853818,0.146182,1.771947,174,27,1, merged,0,0,0.0054894741155
40960,1000003,2,1051,876,175,0.833492,0.166508,1.677374,160,15,1052,876,176,0.8327,0.1673,1.673036,161,15,1, merged,1,1,0.26859912887
40965,1000004,1,2901,2572,329,0.886591,0.113409,0.886591,255,74,2904,2575,329,0.886708,0.113292,0.886708,255,74,-1, merged,0,0,0.0145969850918
40966,1000054,2,453,394,59,0.869757,0.130243,1.69555,46,13,454,395,59,0.870044,0.129956,1.695928,46,13,1, merged,0,0,0.017751671881
40966,1000121,1,1923,1588,335,0.825793,0.174207,0.825793,313,22,1924,1589,335,0.825884,0.174116,0.825884,313,22,1, merged,0,0,0.0112190636449
40967,1000005,2,381,307,74,0.805774,0.194226,1.668678,68,6,382,308,74,0.806283,0.193717,1.663426,68,6,1, merged,0,0,0.118178203428
40967,1000054,3,454,395,59,0.870044,0.129956,2.538722,46,13,455,396,59,0.87033,0.12967,2.533755,46,13,1, merged,0,0,0.601142352038
40976,1000130,2,373,307,66,0.823056,0.176944,1.632305,52,14,374,308,66,0.823529,0.176471,1.633874,52,14,1, merged,0,0,0
40976,1000140,1,173,140,33,0.809249,0.190751,0.809249,29,4,174,141,33,0.810345,0.189655,0.810345,29,4,1, merged,0,0,0
40977,1000130,1,374,308,66,0.823529,0.176471,0.823529,52,14,375,308,67,0.821333,0.178667,0.821333,52,15,-1, merged,1,1,0
40977,1000329,3,2753,2142,611,0.77806,0.22194,2.402665,527,84,2754,2142,612,0.777778,0.222222,2.398039,527,85,-1, merged,1,1,0.428950896378
40988,1000012,1,538,467,71,0.86803,0.13197,0.86803,69,2,539,468,71,0.868275,0.131725,0.868275,69,2,1, merged,0,0,0.448738485125
40999,1000003,1,1054,878,176,0.833017,0.166983,0.833017,161,15,1055,879,176,0.833175,0.166825,0.833175,161,15,-1, merged,0,0,0.796575897332
40999,1000012,2,539,468,71,0.868275,0.131725,1.701292,69,2,540,468,72,0.866667,0.133333,1.699842,70,2,1, merged,1,1,0.670914592252
40999,1000153,3,950,860,90,0.905263,0.094737,2.606555,67,23,951,861,90,0.905363,0.094637,2.605205,67,23,1, merged,0,0,1.05203128377
41001,1000054,2,457,398,59,0.870897,0.129103,1.666867,46,13,458,399,59,0.871179,0.128821,1.663679,46,13,1, merged,0,0,0.314293627197
41001,1000166,1,397,316,81,0.79597,0.20403,0.79597,78,3,400,317,83,0.7925,0.2075,0.7925,80,3,1, merged,1,1,0.236558022311
41004,1000004,1,2905,2576,329,0.886747,0.113253,0.886747,255,74,2906,2577,329,0.886786,0.113214,0.886786,255,74,1, merged,0,0,0.240415421055
41004,1000007,2,1299,1048,251,0.806774,0.193226,1.693521,222,29,1300,1049,251,0.806923,0.193077,1.693709,222,29,1, merged,0,0,0.654898527303
41007,1000105,2,475,361,114,0.76,0.24,1.653401,103,11,477,363,114,0.761006,0.238994,1.650454,103,11,-1, merged,0,0,0.398703718247
41008,1000015,1,1844,1658,186,0.899132,0.100868,0.899132,172,14,1845,1659,186,0.899187,0.100813,0.899187,172,14,1, merged,0,0,0
41008,1000026,2,365,332,33,0.909589,0.090411,1.808721,31,2,366,333,33,0.909836,0.090164,1.809023,31,2,1, merged,0,0,0.552439240731
41013,1000015,1,1845,1659,186,0.899187,0.100813,0.899187,172,14,1846,1660,186,0.899242,0.100758,0.899242,172,14,1, merged,0,0,0.408075908393
41013,1000026,2,366,333,33,0.909836,0.090164,1.809023,31,2,367,334,33,0.910082,0.089918,1.809323,31,2,1, merged,0,0,0.475082025361
41016,1000026,2,367,334,33,0.910082,0.089918,1.781261,31,2,368,335,33,0.910326,0.089674,1.781786,31,2,1, merged,0,0,0.00539253513972
41016,1000054,1,458,399,59,0.871179,0.128821,0.871179,46,13,459,400,59,0.87146,0.12854,0.87146,46,13,1, merged,0,0,0.00634093225429
41017,1000004,1,2907,2578,329,0.886825,0.113175,0.886825,255,74,2908,2578,330,0.88652,0.11348,0.88652,256,74,1, abandoned,1,1,0
41023,1000004,1,2908,2578,330,0.88652,0.11348,0.88652,256,74,2909,2579,330,0.886559,0.113441,0.886559,256,74,1, merged,0,0,0.000518370004777
41023,1000005,2,382,308,74,0.806283,0.193717,1.692803,68,6,383,309,74,0.806789,0.193211,1.693347,68,6,1, merged,0,0,0.00286512426007
41024,1000004,3,2909,2579,330,0.886559,0.113441,2.573923,256,74,2910,2580,330,0.886598,0.113402,2.517999,256,74,-1, merged,0,0,0
41024,1000120,1,1377,1176,201,0.854031,0.145969,0.854031,174,27,1380,1178,202,0.853623,0.146377,0.853623,175,27,-1, merged,1,0,0.00431243489696
41033,1000012,4,540,468,72,0.866667,0.133333,3.503436,70,2,541,469,72,0.866913,0.133087,3.5055,70,2,1, merged,0,0,0.0263228785245
41033,1000121,2,1930,1595,335,0.826425,0.173575,1.63677,313,22,1932,1596,336,0.826087,0.173913,1.638587,314,22,1, merged,1,1,0.0271582170655
41033,1000140,1,174,141,33,0.810345,0.189655,0.810345,29,4,176,143,33,0.8125,0.1875,0.8125,29,4,-1, merged,0,0,0.0388530805597
41035,1000004,2,2910,2580,330,0.886598,0.113402,1.386598,256,74,2911,2581,330,0.886637,0.113363,1.21997,256,74,-1, abandoned,0,0,0.0443790711236
41040,1000120,1,1380,1178,202,0.853623,0.146377,0.853623,175,27,1381,1179,202,0.853729,0.146271,0.853729,175,27,1, merged,0,0,0.406740166786
41041,1000014,1,2045,1728,317,0.844988,0.155012,0.844988,294,23,2046,1729,317,0.845064,0.154936,0.845064,294,23,1, merged,0,0,0.246780478821
41046,1000014,3,2046,1729,317,0.845064,0.154936,2.561806,294,23,2047,1730,317,0.845139,0.154861,2.562611,294,23,1, merged,0,0,0.494720470735
41046,1000120,1,1381,1179,202,0.853729,0.146271,0.853729,175,27,1382,1180,202,0.853835,0.146165,0.853835,175,27,-1, merged,0,0,0.40799867264
41054,1000015,2,1847,1661,186,0.899296,0.100704,1.804659,172,14,1849,1663,186,0.899405,0.100595,1.803917,172,14,1, merged,0,0,0.0025936335208
41054,1000153,1,951,861,90,0.905363,0.094637,0.905363,67,23,953,862,91,0.904512,0.095488,0.904512,68,23,1, merged,1,1,0.00263273595726
41060,1000121,4,1933,1597,336,0.826177,0.173823,2.848803,314,22,1934,1598,336,0.826267,0.173733,2.858975,314,22,1, merged,0,0,0.036784405537
41060,1000592,3,635,543,92,0.855118,0.144882,2.022627,58,34,637,545,92,0.855573,0.144427,2.032708,58,34,-1, merged,0,0,0
41061,1000121,4,1934,1598,336,0.826267,0.173733,3.451267,314,22,1935,1599,336,0.826357,0.173643,3.484476,314,22,1, merged,0,0,0.350191913741
41069,1000015,2,1851,1664,187,0.898974,0.101026,1.630681,172,15,1852,1665,187,0.899028,0.100972,1.631822,172,15,1, merged,0,0,0.0106142117537
41069,1000534,1,246,180,66,0.731707,0.268293,0.731707,62,4,247,181,66,0.732794,0.267206,0.732794,62,4,1, merged,0,0,0.0121179665364
41093,1000003,2,1056,880,176,0.833333,0.166667,1.737845,161,15,1057,881,176,0.833491,0.166509,1.738203,161,15,1, merged,0,0,0.47027405048
41093,1000153,1,953,862,91,0.904512,0.095488,0.904512,68,23,955,864,91,0.904712,0.095288,0.904712,68,23,1, merged,0,0,0.558187879828
41094,1000023,2,884,781,103,0.883484,0.116516,1.735805,92,11,886,783,103,0.883747,0.116253,1.733747,92,11,-1, merged,0,0,2.67345314064e-05
41095,1000070,1,1093,951,142,0.870082,0.129918,0.870082,118,24,1094,952,142,0.870201,0.129799,0.870201,118,24,1, merged,0,0,0.589922847861
41095,1000140,2,178,145,33,0.814607,0.185393,1.684689,29,4,179,146,33,0.815642,0.184358,1.685844,29,4,1, merged,0,0,0.224724129283
41097,1000023,3,889,786,103,0.884139,0.115861,2.443854,92,11,890,787,103,0.88427,0.11573,2.450145,92,11,1, merged,0,0,0.257114427393
41100,1000091,1,487,377,110,0.774127,0.225873,0.774127,95,15,488,378,110,0.77459,0.22541,0.77459,95,15,1, merged,0,0,0.294335482715
41102,1000023,1,890,787,103,0.88427,0.11573,0.88427,92,11,891,788,103,0.8844,0.1156,0.8844,92,11,-1, merged,0,0,0.00035053896887
41107,1000054,1,468,407,61,0.869658,0.130342,0.869658,48,13,469,408,61,0.869936,0.130064,0.869936,48,13,1, merged,0,0,0.156544092078
41107,1000121,3,1939,1603,336,0.826715,0.173285,2.696373,314,22,1940,1604,336,0.826804,0.173196,2.69674,314,22,1, merged,0,0,0.0875314270694
41114,1000015,1,1853,1666,187,0.899083,0.100917,0.899083,172,15,1854,1667,187,0.899137,0.100863,0.899137,172,15,1, merged,0,0,0
41114,1000054,2,472,411,61,0.870763,0.129237,1.769845,48,13,473,412,61,0.871036,0.128964,1.770173,48,13,1, merged,0,0,0.000475115809479
41122,1000023,2,892,788,104,0.883408,0.116592,1.796452,93,11,893,789,104,0.883539,0.116461,1.800205,93,11,1, merged,0,0,0.000364322856291
41122,1000121,3,1940,1604,336,0.826804,0.173196,2.623256,314,22,1941,1605,336,0.826893,0.173107,2.627099,314,22,1, merged,0,0,0.000993288499284
41123,1000003,1,1057,881,176,0.833491,0.166509,0.833491,161,15,1058,882,176,0.833648,0.166352,0.833648,161,15,1, merged,0,0,0.39916318699
41123,1000015,2,1854,1667,187,0.899137,0.100863,1.732628,172,15,1855,1668,187,0.899191,0.100809,1.73284,172,15,1, merged,0,0,0.499598867492
41131,1000004,2,2912,2582,330,0.886676,0.113324,1.797487,256,74,2913,2583,330,0.886715,0.113285,1.795317,256,74,-1, merged,0,0,0.450314829195
41131,1000026,1,370,337,33,0.910811,0.089189,0.910811,31,2,372,338,34,0.908602,0.091398,0.908602,32,2,1, merged,1,1,0.346870888815
41132,1000054,2,474,413,61,0.871308,0.128692,1.698201,48,13,475,413,62,0.869474,0.130526,1.695941,49,13,1, merged,1,1,0.126721933238
41132,1000121,1,1941,1605,336,0.826893,0.173107,0.826893,314,22,1942,1605,337,0.826468,0.173532,0.826468,315,22,1, merged,1,1,0.0701099012371
41134,1000023,1,894,790,104,0.883669,0.116331,0.883669,93,11,895,791,104,0.883799,0.116201,0.883799,93,11,1, merged,0,0,0.000376045421138
41151,1000023,1,895,791,104,0.883799,0.116201,0.883799,93,11,896,792,104,0.883929,0.116071,0.883929,93,11,1, merged,0,0,0.000398772205003
41158,1000015,1,1856,1669,187,0.899246,0.100754,0.899246,172,15,1858,1670,188,0.898816,0.101184,0.898816,173,15,1, merged,1,1,0.327518052072
41159,1000121,2,1942,1605,337,0.826468,0.173532,1.576468,315,22,1943,1606,337,0.826557,0.173443,1.626557,315,22,1, merged,0,0,0.00235946079181
41162,1000009,1,1078,899,179,0.833952,0.166048,0.833952,161,18,1080,901,179,0.834259,0.165741,0.834259,161,18,-1, abandoned,0,0,0.0486342123502
41167,1000023,1,896,792,104,0.883929,0.116071,0.883929,93,11,897,792,105,0.882943,0.117057,0.882943,94,11,1, merged,1,1,6.99090726967e-05
41179,1000121,3,1943,1606,337,0.826557,0.173443,2.280017,315,22,1944,1606,338,0.826132,0.173868,2.281208,316,22,1, abandoned,1,1,0
41179,1000328,1,824,608,216,0.737864,0.262136,0.737864,193,23,825,609,216,0.738182,0.261818,0.738182,193,23,-1, abandoned,0,0,0
41181,1000121,2,1944,1606,338,0.826132,0.173868,1.715021,316,22,1945,1607,338,0.826221,0.173779,1.726221,316,22,1, merged,0,0,0.350505553111
41185,1000054,1,483,419,64,0.867495,0.132505,0.867495,51,13,484,419,65,0.865702,0.134298,0.865702,52,13,1, abandoned,1,1,0
41186,1000121,2,1946,1608,338,0.82631,0.17369,1.72631,316,22,1947,1609,338,0.8264,0.1736,1.73549,316,22,1, merged,0,0,0.350323485811
41189,1000004,1,2916,2586,330,0.886831,0.113169,0.886831,256,74,2917,2587,330,0.88687,0.11313,0.88687,256,74,-1, abandoned,0,0,0
41189,1000015,2,1859,1671,188,0.89887,0.10113,1.785702,173,15,1860,1671,189,0.898387,0.101613,1.785257,174,15,1, abandoned,1,1,0
41189,1000054,3,484,419,65,0.865702,0.134298,2.651404,52,13,485,419,66,0.863918,0.136082,2.649175,53,13,1, abandoned,1,1,0
41192,1000003,1,1058,882,176,0.833648,0.166352,0.833648,161,15,1059,883,176,0.833805,0.166195,0.833805,161,15,1, merged,0,0,0.278623489271
41192,1000121,2,1947,1609,338,0.8264,0.1736,1.660048,316,22,1948,1610,338,0.826489,0.173511,1.660294,316,22,1, merged,0,0,0.193046161319
41194,1000009,2,1080,901,179,0.834259,0.165741,1.73917,161,18,1081,902,179,0.834413,0.165587,1.739423,161,18,1, merged,0,0,1.15552923139
41194,1000153,1,957,866,91,0.904911,0.095089,0.904911,68,23,958,867,91,0.90501,0.09499,0.90501,68,23,1, merged,0,0,1.04558679307
41197,1000054,4,485,419,66,0.863918,0.136082,2.809423,53,13,486,420,66,0.864198,0.135802,2.969758,53,13,1, merged,0,0,0.60442549439
41197,1000108,1,122,100,22,0.819672,0.180328,0.819672,18,4,124,101,23,0.814516,0.185484,0.814516,19,4,-1, merged,1,0,0.17777284827
41197,1000166,3,400,317,83,0.7925,0.2075,1.945505,80,3,402,318,84,0.791045,0.208955,2.105561,81,3,1, merged,1,1,0.459024447475
41198,1000121,2,1948,1610,338,0.826489,0.173511,1.73558,316,22,1950,1611,339,0.826154,0.173846,1.742821,316,23,-1, merged,1,1,0.350567734063
41210,1000328,2,825,609,216,0.738182,0.261818,1.51596,193,23,826,610,216,0.738499,0.261501,1.516357,193,23,1, merged,0,0,0.331326865058
41210,1000329,1,2754,2142,612,0.777778,0.222222,0.777778,527,85,2755,2143,612,0.777858,0.222142,0.777858,527,85,1, merged,0,0,0.17787963172
41213,1000054,2,486,420,66,0.864198,0.135802,1.780864,53,13,487,421,66,0.864476,0.135524,1.787553,53,13,1, merged,0,0,0.6318568915
41215,1000004,2,2917,2587,330,0.88687,0.11313,1.742443,256,74,2918,2588,330,0.886909,0.113091,1.742708,256,74,1, merged,0,0,0.0177243389138
41215,1000592,1,637,545,92,0.855573,0.144427,0.855573,58,34,638,546,92,0.855799,0.144201,0.855799,58,34,1, merged,0,0,0.0183711926956
41217,1000120,2,1386,1184,202,0.854257,0.145743,1.710056,175,27,1387,1185,202,0.854362,0.145638,1.709276,175,27,1, merged,0,0,0.137548112947
41217,1000592,1,638,546,92,0.855799,0.144201,0.855799,58,34,641,548,93,0.854914,0.145086,0.854914,58,35,-1, merged,1,0,0.146943506342
41220,1000009,2,1092,910,182,0.833333,0.166667,0.833333,163,19,1093,911,182,0.833486,0.166514,1.833486,163,19,-1, abandoned,0,0,0.416728814699
41220,1000534,3,247,181,66,0.732794,0.267206,1.566127,62,4,248,182,66,0.733871,0.266129,2.567357,62,4,-1, abandoned,0,0,0.388190390034
41221,1000043,2,505,422,83,0.835644,0.164356,1.297182,70,13,506,423,83,0.835968,0.164032,1.302635,70,13,1, merged,0,0,0.212914088132
41224,1000009,2,1093,911,182,0.833486,0.166514,1.567357,163,19,1097,912,185,0.831358,0.168642,1.559705,166,19,1, merged,1,1,0.294318194407
41224,1000534,1,248,182,66,0.733871,0.266129,0.733871,62,4,254,185,69,0.728346,0.271654,0.728346,65,4,1, merged,1,1,0.283277582545
41225,1000023,2,897,792,105,0.882943,0.117057,1.736004,94,11,898,793,105,0.883073,0.116927,1.736732,94,11,1, merged,0,0,0.000876096500305
41229,1000109,3,469,399,70,0.850746,0.149254,2.460704,65,5,470,399,71,0.848936,0.151064,2.445053,66,5,1, abandoned,1,1,0
41245,1000003,1,1061,885,176,0.834119,0.165881,0.834119,161,15,1062,886,176,0.834275,0.165725,0.834275,161,15,1, merged,0,0,0.316078905182
41245,1000121,2,1952,1612,340,0.82582,0.17418,1.659938,317,23,1953,1613,340,0.825909,0.174091,1.660184,317,23,1, merged,0,0,0.20770749062
41248,1000054,4,487,421,66,0.864476,0.135524,3.292884,53,13,488,422,66,0.864754,0.135246,3.309027,53,13,1, merged,0,0,0.633656637858
41248,1000166,3,402,318,84,0.791045,0.208955,2.428407,81,3,403,319,84,0.791563,0.208437,2.444273,81,3,1, merged,0,0,0.48872199742
41249,1000014,2,2051,1734,317,0.845441,0.154559,1.7434,294,23,2052,1735,317,0.845517,0.154483,1.743049,294,23,1, merged,0,0,0.0355335401287
41249,1000015,1,1862,1672,190,0.897959,0.102041,0.897959,175,15,1864,1673,191,0.897532,0.102468,0.897532,176,15,1, merged,1,1,0.0124414240031
41250,1000014,1,2052,1735,317,0.845517,0.154483,0.845517,294,23,2053,1736,317,0.845592,0.154408,0.845592,294,23,1, merged,0,0,0.504726439932
41250,1000015,2,1864,1673,191,0.897532,0.102468,1.743049,176,15,1865,1674,191,0.897587,0.102413,1.743179,176,15,1, merged,0,0,0.548181162423
41253,1000026,1,372,338,34,0.908602,0.091398,0.908602,32,2,373,338,35,0.906166,0.093834,0.906166,33,2,1, merged,1,1,0.0199603064316
41253,1000105,3,481,367,114,0.762994,0.237006,2.507212,103,11,483,369,114,0.763975,0.236025,2.494466,103,11,1, merged,0,0,0.013093721278
41256,1000105,2,483,369,114,0.763975,0.236025,1.588299,103,11,484,370,114,0.764463,0.235537,1.591129,103,11,1, merged,0,0,0.0130228124415
41258,1000105,1,484,370,114,0.764463,0.235537,0.764463,103,11,485,371,114,0.764948,0.235052,0.764948,103,11,1, merged,0,0,0.000702741830607
41258,1000132,2,343,309,34,0.900875,0.099125,1.665337,26,8,344,310,34,0.901163,0.098837,1.666111,26,8,1, merged,0,0,2.0383552203e-05
41266,1000121,2,1953,1613,340,0.825909,0.174091,1.75448,317,23,1954,1614,340,0.825998,0.174002,1.759331,317,23,1, merged,0,0,0.350540021414
41274,1000054,1,488,422,66,0.864754,0.135246,0.864754,53,13,489,423,66,0.865031,0.134969,0.865031,53,13,1, merged,0,0,0.635941752119
41274,1000166,2,403,319,84,0.791563,0.208437,1.656317,81,3,404,320,84,0.792079,0.207921,1.65711,81,3,1, merged,0,0,0.492880593296
41279,1000105,2,487,373,114,0.765914,0.234086,1.667363,103,11,488,374,114,0.766393,0.233607,1.668128,103,11,1, merged,0,0,0.026317121189
41279,1000132,1,345,311,34,0.901449,0.098551,0.901449,26,8,346,312,34,0.901734,0.098266,0.901734,26,8,1, merged,0,0,0.0319232006356
41285,1000004,3,2919,2589,330,0.886948,0.113052,2.586198,256,74,2921,2590,331,0.886683,0.113317,2.582141,257,74,1, merged,1,1,0.000282206857627
41285,1000014,2,2053,1736,317,0.845592,0.154408,1.69925,294,23,2055,1737,318,0.845255,0.154745,1.695458,295,23,1, merged,1,1,0.00100976102322
41290,1000054,1,489,423,66,0.865031,0.134969,0.865031,53,13,490,424,66,0.865306,0.134694,0.865306,53,13,1, merged,0,0,0.606536046529
41291,1000105,1,491,377,114,0.767821,0.232179,0.767821,103,11,492,377,115,0.76626,0.23374,0.76626,104,11,1, merged,1,1,0.080240497777
41299,1000328,4,826,610,216,0.738499,0.261501,3.063204,193,23,827,611,216,0.738815,0.261185,3.058683,193,23,-1, abandoned,0,0,0.00258540644916
41299,1000329,5,2756,2144,612,0.777939,0.222061,3.841143,527,85,2757,2145,612,0.77802,0.22198,3.836702,527,85,-1, abandoned,0,0,0.0107156779287
41312,1000005,2,390,316,74,0.810256,0.189744,1.618476,68,6,391,317,74,0.810742,0.189258,1.621552,68,6,1, merged,0,0,0.04315644082
41317,1000004,1,2922,2591,331,0.886721,0.113279,0.886721,257,74,2923,2592,331,0.88676,0.11324,0.88676,257,74,1, merged,0,0,0.195362282696
41317,1000121,2,1957,1617,340,0.826265,0.173735,1.712986,317,23,1958,1618,340,0.826353,0.173647,1.713114,317,23,1, merged,0,0,0.194069044306
41323,1000054,1,490,424,66,0.865306,0.134694,0.865306,53,13,491,425,66,0.86558,0.13442,0.86558,53,13,1, merged,0,0,0.422611352685
41323,1000070,2,1104,960,144,0.869565,0.130435,1.734871,120,24,1105,961,144,0.869683,0.130317,1.735264,120,24,1, merged,0,0,0.537448187939
41334,1000007,2,1302,1051,251,0.80722,0.19278,1.712329,222,29,1303,1052,251,0.807368,0.192632,1.712576,222,29,1, merged,0,0,0.119200947182
41334,1000153,1,959,868,91,0.905109,0.094891,0.905109,68,23,960,869,91,0.905208,0.094792,0.905208,68,23,1, merged,0,0,0.0980242000651
41335,1000026,1,374,339,35,0.906417,0.093583,0.906417,33,2,375,340,35,0.906667,0.093333,0.906667,33,2,1, merged,0,0,0.582782620324
41346,1000015,1,1868,1677,191,0.897752,0.102248,0.897752,176,15,1870,1677,193,0.896791,0.103209,0.896791,176,17,-1, merged,1,1,0.0263349213672
41346,1000054,2,491,425,66,0.86558,0.13442,1.763332,53,13,492,426,66,0.865854,0.134146,1.762645,53,13,1, merged,0,0,0.364755494434
41350,1000070,2,1105,961,144,0.869683,0.130317,1.767913,120,24,1106,962,144,0.869801,0.130199,1.768479,120,24,1, merged,0,0,0.000144365017022
41351,1000054,1,492,426,66,0.865854,0.134146,0.865854,53,13,493,427,66,0.866126,0.133874,0.866126,53,13,1, merged,0,0,0.554414641781
41352,1000054,1,493,427,66,0.866126,0.133874,0.866126,53,13,494,428,66,0.866397,0.133603,0.866397,53,13,1, merged,0,0,0.607443177584
41361,1000004,2,2928,2597,331,0.886954,0.113046,1.75362,257,74,2929,2598,331,0.886992,0.113008,1.751912,257,74,-1, abandoned,0,0,0.0526068838025
41361,1000054,1,495,429,66,0.866667,0.133333,0.866667,53,13,496,429,67,0.864919,0.135081,0.864919,54,13,1, abandoned,1,1,0.00383669165886
41374,1000004,1,2929,2598,331,0.886992,0.113008,0.886992,257,74,2930,2598,332,0.886689,0.113311,0.886689,258,74,1, abandoned,1,1,0
41374,1000121,2,1959,1619,340,0.826442,0.173558,1.713434,317,23,1960,1619,341,0.82602,0.17398,1.71271,318,23,1, abandoned,1,1,0
41375,1000004,2,2930,2598,332,0.886689,0.113311,1.73217,258,74,2931,2599,332,0.886728,0.113272,1.732359,258,74,1, merged,0,0,0.0689215610609
41375,1000014,1,2058,1740,318,0.845481,0.154519,0.845481,295,23,2060,1742,318,0.845631,0.154369,0.845631,295,23,-1, merged,0,0,0.0287604629741
41377,1000004,2,2931,2599,332,0.886728,0.113272,1.19442,258,74,2933,2601,332,0.886805,0.113195,1.17252,258,74,-1, abandoned,0,0,0.00459285211372
41377,1000121,3,1960,1619,341,0.82602,0.17398,2.020441,318,23,1961,1619,342,0.825599,0.174401,1.998119,319,23,1, abandoned,1,1,0.00413569060063
41382,1000015,2,1873,1680,193,0.896957,0.103043,1.696957,176,17,1874,1681,193,0.897012,0.102988,1.730345,176,17,1, merged,0,0,0.543797209079
41383,1000015,2,1874,1681,193,0.897012,0.102988,1.735995,176,17,1875,1682,193,0.897067,0.102933,1.7304,176,17,1, merged,0,0,0.000740740740741
41383,1000120,3,1387,1185,202,0.854362,0.145638,2.590357,175,27,1388,1186,202,0.854467,0.145533,2.584867,175,27,1, merged,0,0,0.13713817586
41398,1000004,2,2933,2601,332,0.886805,0.113195,1.579662,258,74,2934,2602,332,0.886844,0.113156,1.580794,258,74,1, merged,0,0,0.0689766326044
41402,1000120,1,1388,1186,202,0.854467,0.145533,0.854467,175,27,1389,1187,202,0.854572,0.145428,0.854572,175,27,1, merged,0,0,0.00519243974886
41406,1000121,2,1961,1619,342,0.825599,0.174401,1.727727,319,23,1962,1620,342,0.825688,0.174312,1.72823,319,23,1, merged,0,0,0.175261526457
41407,1000054,2,500,433,67,0.866,0.134,1.767961,54,13,501,434,67,0.866267,0.133733,1.765709,54,13,1, merged,0,0,0.306388968006
41407,1000132,1,357,322,35,0.901961,0.098039,0.901961,27,8,358,322,36,0.899441,0.100559,0.899441,28,8,1, merged,1,1,0.283427442672
41411,1000026,3,377,342,35,0.907162,0.092838,2.312469,33,2,379,344,35,0.907652,0.092348,2.313253,33,2,-1, merged,0,0,0.0263452702747
41411,1000153,2,961,870,91,0.905307,0.094693,1.405307,68,23,964,873,91,0.905602,0.094398,1.405602,68,23,-1, merged,0,0,0.0540958037138
41427,1000004,2,2934,2602,332,0.886844,0.113156,1.712532,258,74,2935,2603,332,0.886882,0.113118,1.712659,258,74,1, merged,0,0,0.0547566510172
41427,1000121,1,1962,1620,342,0.825688,0.174312,0.825688,319,23,1963,1621,342,0.825777,0.174223,0.825777,319,23,1, merged,0,0,0.00986621051989
41428,1000120,1,1389,1187,202,0.854572,0.145428,0.854572,175,27,1390,1188,202,0.854676,0.145324,0.854676,175,27,1, merged,0,0,0.0707156458915
41429,1000004,3,2935,2603,332,0.886882,0.113118,2.609726,258,74,2936,2604,332,0.886921,0.113079,2.609908,258,74,1, merged,0,0,0.0107816067634
41429,1000015,2,1875,1682,193,0.897067,0.102933,1.722844,176,17,1876,1683,193,0.897122,0.102878,1.722987,176,17,1, merged,0,0,0.000174463770789
41429,1000121,1,1963,1621,342,0.825777,0.174223,0.825777,319,23,1964,1622,342,0.825866,0.174134,0.825866,319,23,1, merged,0,0,0.00197729872876
41435,1000023,1,904,798,106,0.882743,0.117257,0.882743,95,11,905,799,106,0.882873,0.117127,0.882873,95,11,1, merged,0,0,0.000504465762488
41435,1000121,2,1966,1623,343,0.825534,0.174466,1.708277,320,23,1967,1624,343,0.825623,0.174377,1.708496,320,23,1, merged,0,0,0.00245177885464
41437,1000023,1,905,799,106,0.882873,0.117127,0.882873,95,11,906,800,106,0.883002,0.116998,0.883002,95,11,1, merged,0,0,0.273312170248
41437,1000121,2,1967,1624,343,0.825623,0.174377,1.708496,320,23,1968,1625,343,0.825711,0.174289,1.708714,320,23,1, merged,0,0,0.183691388781
41442,1000329,2,2758,2146,612,0.7781,0.2219,1.244767,527,85,2759,2147,612,0.778181,0.221819,1.278181,527,85,1, merged,0,0,0
41446,1000004,2,2936,2604,332,0.886921,0.113079,1.741597,258,74,2937,2605,332,0.886959,0.113041,1.74174,258,74,1, merged,0,0,0.0535259419201
41446,1000120,1,1390,1188,202,0.854676,0.145324,0.854676,175,27,1391,1189,202,0.854781,0.145219,0.854781,175,27,1, merged,0,0,0.141840490798
41449,1000329,1,2761,2149,612,0.778341,0.221659,0.778341,527,85,2762,2149,613,0.778059,0.221941,0.778059,528,85,1, abandoned,1,1,0
41450,1000070,1,1108,964,144,0.870036,0.129964,0.870036,120,24,1109,964,145,0.869252,0.130748,0.869252,121,24,1, abandoned,1,1,0.611729855559
41450,1000329,2,2762,2149,613,0.778059,0.221941,1.648095,528,85,2763,2150,613,0.77814,0.22186,1.647391,528,85,-1, abandoned,0,0,0.433333020643
41454,1000110,4,181,160,21,0.883978,0.116022,2.341494,19,2,182,161,21,0.884615,0.115385,2.283112,19,2,1, merged,0,0,0
41460,1000015,5,1876,1683,193,0.897122,0.102878,3.140015,176,17,1878,1685,193,0.897231,0.102769,3.160479,176,17,-1, merged,0,0,0
41460,1000329,2,2764,2151,613,0.77822,0.22178,1.430394,528,85,2765,2151,614,0.777939,0.222061,1.457939,529,85,1, merged,1,1,0
41479,1000091,2,490,379,111,0.773469,0.226531,1.56574,96,15,492,380,112,0.772358,0.227642,1.563223,96,16,-1, merged,1,1,0
41479,1000121,4,1971,1628,343,0.825977,0.174023,3.391717,320,23,1972,1629,343,0.826065,0.173935,3.255955,320,23,1, merged,0,0,0
41481,1000003,1,1064,888,176,0.834586,0.165414,0.834586,161,15,1065,889,176,0.834742,0.165258,0.834742,161,15,-1, merged,0,0,0.0475995176925
41490,1000120,2,1391,1189,202,0.854781,0.145219,0.854781,175,27,1392,1190,202,0.854885,0.145115,1.354885,175,27,1, merged,0,0,0.149019119141
41493,1000023,1,909,803,106,0.883388,0.116612,0.883388,95,11,910,804,106,0.883516,0.116484,0.883516,95,11,-1, abandoned,0,0,0
41493,1000121,2,1972,1629,343,0.826065,0.173935,1.709453,320,23,1974,1631,343,0.826241,0.173759,1.709758,320,23,-1, abandoned,0,0,0
41494,1000121,1,1974,1631,343,0.826241,0.173759,0.826241,320,23,1976,1633,343,0.826417,0.173583,0.826417,320,23,1, merged,0,0,0.00853926767471
41494,1000329,2,2766,2152,614,0.778019,0.221981,1.60426,529,85,2767,2153,614,0.778099,0.221901,1.604516,529,85,1, merged,0,0,0.0103797970126
41505,1000014,1,2062,1744,318,0.845781,0.154219,0.845781,295,23,2063,1745,318,0.845856,0.154144,0.845856,295,23,1, merged,0,0,0.0387187376046
41509,1000007,2,1303,1052,251,0.807368,0.192632,1.653223,222,29,1304,1053,251,0.807515,0.192485,1.65352,222,29,1, merged,0,0,0.655297815944
41509,1000014,1,2063,1745,318,0.845856,0.154144,0.845856,295,23,2065,1747,318,0.846005,0.153995,0.846005,295,23,-1, merged,0,0,0.352226655138
41510,1000009,4,1098,913,185,0.831512,0.168488,3.065558,166,19,1099,914,185,0.831665,0.168335,3.130691,166,19,1, merged,0,0,1.18088994522
41510,1000153,3,965,874,91,0.905699,0.094301,2.234046,68,23,966,875,91,0.905797,0.094203,2.299026,68,23,1, merged,0,0,1.05485310952
41510,1000534,1,254,185,69,0.728346,0.271654,0.728346,65,4,256,186,70,0.726562,0.273438,0.726562,66,4,1, merged,1,1,1.13540744255
41518,1000070,2,1109,964,145,0.869252,0.130748,1.680062,121,24,1110,965,145,0.869369,0.130631,1.682703,121,24,1, merged,0,0,0
41519,1000023,2,911,805,106,0.883644,0.116356,1.719542,95,11,913,806,107,0.882804,0.117196,1.719539,96,11,1, merged,1,1,0.0022415433575
41522,1000105,1,497,382,115,0.768612,0.231388,0.768612,104,11,498,383,115,0.769076,0.230924,0.769076,104,11,1, merged,0,0,0
41527,1000054,2,506,439,67,0.867589,0.132411,1.606404,54,13,507,439,68,0.865878,0.134122,1.605008,55,13,1, merged,1,1,0
41527,1000328,1,827,611,216,0.738815,0.261185,0.738815,193,23,828,612,216,0.73913,0.26087,0.73913,193,23,-1, merged,0,0,0
41527,1000329,3,2768,2154,614,0.778179,0.221821,2.384583,529,85,2771,2156,615,0.778058,0.221942,2.383067,530,85,-1, merged,1,0,0
41532,1000120,2,1392,1190,202,0.854885,0.145115,1.410441,175,27,1393,1191,202,0.854989,0.145011,1.426418,175,27,1, merged,0,0,0
41535,1000014,1,2066,1748,318,0.846079,0.153921,0.846079,295,23,2067,1749,318,0.846154,0.153846,0.846154,295,23,-1, abandoned,0,0,0
41537,1000003,1,1065,889,176,0.834742,0.165258,0.834742,161,15,1067,890,177,0.834114,0.165886,0.834114,162,15,1, merged,1,1,0.0891497727641
41537,1000004,2,2939,2607,332,0.887036,0.112964,1.721778,258,74,2940,2608,332,0.887075,0.112925,1.721189,258,74,1, merged,0,0,0.0648783094361
41539,1000105,2,498,383,115,0.769076,0.230924,1.510812,104,11,500,385,115,0.77,0.23,1.510741,104,11,-1, abandoned,0,0,0.0897544814694
41545,1000166,3,404,320,84,0.792079,0.207921,2.490797,81,3,405,320,85,0.790123,0.209877,2.411206,81,4,-1, merged,1,1,0.0231531921779
41547,1000023,1,913,806,107,0.882804,0.117196,0.882804,96,11,914,807,107,0.882932,0.117068,0.882932,96,11,1, merged,0,0,0
41547,1000121,2,1979,1636,343,0.82668,0.17332,1.709484,320,23,1980,1637,343,0.826768,0.173232,1.7097,320,23,1, merged,0,0,0
41548,1000023,1,914,807,107,0.882932,0.117068,0.882932,96,11,915,808,107,0.88306,0.11694,0.88306,96,11,1, merged,0,0,0
41548,1000121,2,1980,1637,343,0.826768,0.173232,1.7097,320,23,1981,1638,343,0.826855,0.173145,1.709915,320,23,1, merged,0,0,0
41549,1000004,5,2940,2608,332,0.887075,0.112925,3.292044,258,74,2941,2609,332,0.887113,0.112887,4.272365,258,74,1, merged,0,0,0
41549,1000121,3,1981,1638,343,0.826855,0.173145,2.404969,320,23,1982,1638,344,0.826438,0.173562,2.385252,321,23,1, merged,1,1,0
41554,1000004,1,2941,2609,332,0.887113,0.112887,0.887113,258,74,2942,2610,332,0.887152,0.112848,0.887152,258,74,1, merged,0,0,0
41554,1000592,3,643,549,94,0.85381,0.14619,1.740923,59,35,644,550,94,0.854037,0.145963,2.741189,59,35,1, merged,0,0,0
41556,1000043,2,508,425,83,0.836614,0.163386,1.718335,70,13,509,426,83,0.836935,0.163065,1.719914,70,13,1, merged,0,0,0.0550393584933
41557,1000043,2,509,426,83,0.836935,0.163065,1.719914,70,13,510,427,83,0.837255,0.162745,1.721465,70,13,1, merged,0,0,0.0490291262136
41558,1000054,2,507,439,68,0.865878,0.134122,1.769643,55,13,508,440,68,0.866142,0.133858,1.770308,55,13,1, merged,0,0,0.612330641332
41559,1000003,2,1067,890,177,0.834114,0.165886,1.637853,162,15,1070,892,178,0.833645,0.166355,1.629941,163,15,1, abandoned,1,1,0.554654918743
41559,1000329,3,2771,2156,615,0.778058,0.221942,2.415911,530,85,2772,2157,615,0.778139,0.221861,2.40808,530,85,-1, abandoned,0,0,0.43339599984
41567,1000005,1,400,325,75,0.8125,0.1875,0.8125,69,6,401,325,76,0.810474,0.189526,0.810474,70,6,1, merged,1,1,0.0371569086479
41571,1000003,2,1071,893,178,0.8338,0.1662,1.679954,163,15,1074,894,180,0.832402,0.167598,1.67863,163,17,-1, merged,1,1,0.00313577924114
41571,1000014,1,2067,1749,318,0.846154,0.153846,0.846154,295,23,2068,1750,318,0.846228,0.153772,0.846228,295,23,-1, merged,0,0,0.0153407662
41573,1000014,2,2068,1750,318,0.846228,0.153772,1.715715,295,23,2069,1751,318,0.846303,0.153697,1.715008,295,23,-1, merged,0,0,0.000796311818944
41573,1000043,3,511,428,83,0.837573,0.162427,2.553289,70,13,512,429,83,0.837891,0.162109,2.552898,70,13,1, merged,0,0,0.00176483564968
41573,1000070,1,1111,966,145,0.869487,0.130513,0.869487,121,24,1112,966,146,0.868705,0.131295,0.868705,122,24,1, merged,1,1,0.00533617929562
41574,1000012,1,542,470,72,0.867159,0.132841,0.867159,70,2,543,470,73,0.865562,0.134438,0.865562,71,2,1, merged,1,1,0.661182369708
41578,1000132,1,361,325,36,0.900277,0.099723,0.900277,28,8,362,326,36,0.900552,0.099448,0.900552,28,8,1, merged,0,0,0.562754197958
41579,1000003,1,1074,894,180,0.832402,0.167598,0.832402,163,17,1076,895,181,0.831784,0.168216,0.831784,164,17,1, merged,1,1,0.4959393815
41579,1000054,2,509,441,68,0.866405,0.133595,1.698807,55,13,510,442,68,0.866667,0.133333,1.698451,55,13,-1, merged,0,0,0.490877401959
41588,1000070,1,1112,966,146,0.868705,0.131295,0.868705,122,24,1113,967,146,0.868823,0.131177,0.868823,122,24,1, merged,0,0,0.0974093823742
41602,1000070,2,1113,967,146,0.868823,0.131177,1.773782,122,24,1114,967,147,0.868043,0.131957,1.769278,123,24,1, merged,1,1,0.397710963024
41616,1000014,1,2069,1751,318,0.846303,0.153697,0.846303,295,23,2070,1752,318,0.846377,0.153623,0.846377,295,23,1, merged,0,0,0
41617,1000014,1,2070,1752,318,0.846377,0.153623,0.846377,295,23,2071,1752,319,0.845968,0.154032,0.845968,296,23,1, abandoned,1,1,0
41617,1000120,3,1397,1195,202,0.855404,0.144596,2.559559,175,27,1398,1196,202,0.855508,0.144492,2.555458,175,27,-1, abandoned,0,0,0
41618,1000014,1,2071,1752,319,0.845968,0.154032,0.845968,296,23,2072,1752,320,0.84556,0.15444,0.84556,297,23,1, abandoned,1,1,0
41618,1000120,3,1398,1196,202,0.855508,0.144492,2.555458,175,27,1399,1197,202,0.855611,0.144389,2.551391,175,27,-1, abandoned,0,0,0
41622,1000054,2,513,444,69,0.865497,0.134503,1.79883,55,14,514,445,69,0.865759,0.134241,1.803259,55,14,1, merged,0,0,0.637696983112
41629,1000120,2,1400,1198,202,0.855714,0.144286,1.642821,175,27,1401,1199,202,0.855817,0.144183,1.641745,175,27,1, merged,0,0,0
41629,1000327,1,667,525,142,0.787106,0.212894,0.787106,110,32,668,525,143,0.785928,0.214072,0.785928,110,33,-1, merged,1,1,0
41633,1000121,1,1984,1640,344,0.826613,0.173387,0.826613,321,23,1985,1641,344,0.8267,0.1733,0.8267,321,23,1, merged,0,0,0.361826079928
41640,1000120,2,1408,1206,202,0.856534,0.143466,1.718236,175,27,1409,1207,202,0.856636,0.143364,1.719794,175,27,1, merged,0,0,0.0179327746238
41642,1000120,2,1410,1208,202,0.856738,0.143262,1.683438,175,27,1411,1209,202,0.856839,0.143161,1.683627,175,27,1, merged,0,0,0.00285034872646
41642,1000121,1,1985,1641,344,0.8267,0.1733,0.8267,321,23,1986,1642,344,0.826788,0.173212,0.826788,321,23,1, merged,0,0,0.0076419819912
41648,1000070,4,1114,967,147,0.868043,0.131957,2.823173,123,24,1115,968,147,0.868161,0.131839,2.82146,123,24,1, merged,0,0,0.644213381555
41649,1000043,2,514,431,83,0.838521,0.161479,1.701679,70,13,515,432,83,0.838835,0.161165,1.706182,70,13,1, merged,0,0,0.879376080465
41657,1000005,1,401,325,76,0.810474,0.189526,0.810474,70,6,402,326,76,0.810945,0.189055,0.810945,70,6,1, merged,0,0,0.104300661927
41662,1000014,1,2074,1754,320,0.845709,0.154291,0.845709,297,23,2076,1756,320,0.845857,0.154143,0.845857,297,23,1, merged,0,0,0.596850998464
41667,1000004,1,2950,2618,332,0.887458,0.112542,0.887458,258,74,2951,2618,333,0.887157,0.112843,0.887157,259,74,1, merged,1,1,0.00814854707659
41668,1000004,1,2951,2618,333,0.887157,0.112843,0.887157,259,74,2952,2619,333,0.887195,0.112805,0.887195,259,74,1, merged,0,0,0.00824201554744
41669,1000004,1,2952,2619,333,0.887195,0.112805,0.887195,259,74,2953,2620,333,0.887233,0.112767,0.887233,259,74,1, merged,0,0,0.00833547964129
41670,1000004,1,2953,2620,333,0.887233,0.112767,0.887233,259,74,2954,2621,333,0.887271,0.112729,0.887271,259,74,1, merged,0,0,0.00842893935846
41671,1000004,1,2954,2621,333,0.887271,0.112729,0.887271,259,74,2955,2622,333,0.88731,0.11269,0.88731,259,74,1, merged,0,0,0.00852239469926
41680,1000005,2,402,326,76,0.810945,0.189055,1.664329,70,6,403,327,76,0.811414,0.188586,1.665347,70,6,1, merged,0,0,0.319147083808
41684,1000014,1,2076,1756,320,0.845857,0.154143,0.845857,297,23,2077,1757,320,0.845932,0.154068,0.845932,297,23,1, merged,0,0,0
41685,1000014,1,2077,1757,320,0.845932,0.154068,0.845932,297,23,2078,1757,321,0.845525,0.154475,0.845525,298,23,1, merged,1,1,0
41685,1000120,2,1415,1212,203,0.856537,0.143463,1.702469,176,27,1416,1213,203,0.856638,0.143362,1.702163,176,27,-1, merged,0,0,0
41687,1000140,1,182,149,33,0.818681,0.181319,0.818681,29,4,184,150,34,0.815217,0.184783,0.815217,30,4,1, merged,1,1,0.605818907986
41688,1000108,1,127,104,23,0.818898,0.181102,0.818898,19,4,128,105,23,0.820312,0.179688,0.820312,19,4,-1, merged,0,0,0.508224015042
41688,1000140,2,184,150,34,0.815217,0.184783,1.634115,30,4,185,150,35,0.810811,0.189189,1.631123,31,4,1, merged,1,1,0.606916283056
41691,1000004,2,2955,2622,333,0.88731,0.11269,1.723375,259,74,2957,2624,333,0.887386,0.112614,1.724784,259,74,-1, abandoned,0,0,0.0104881119369
41693,1000004,2,2957,2624,333,0.887386,0.112614,1.744024,259,74,2959,2626,333,0.887462,0.112538,1.742892,259,74,-1, merged,0,0,0.00628327179138
41693,1000120,1,1416,1213,203,0.856638,0.143362,0.856638,176,27,1418,1213,205,0.85543,0.14457,0.85543,178,27,1, merged,1,1,0.000361255161772
41695,1000132,2,368,330,38,0.896739,0.103261,0.896739,28,10,369,331,38,0.897019,0.102981,1.897019,28,10,1, merged,0,0,0.267777098394
41698,1000054,2,515,446,69,0.866019,0.133981,1.366019,55,14,516,447,69,0.866279,0.133721,1.466279,55,14,1, merged,0,0,0.64092325277
41700,1000105,1,501,386,115,0.770459,0.229541,0.770459,104,11,503,388,115,0.771372,0.228628,0.771372,104,11,-1, abandoned,0,0,0
41700,1002169,2,344,217,127,0.630814,0.369186,1.401273,121,6,345,218,127,0.631884,0.368116,1.403256,121,6,-1, abandoned,0,0,0
41701,1000054,1,516,447,69,0.866279,0.133721,0.866279,55,14,517,448,69,0.866538,0.133462,0.866538,55,14,1, merged,0,0,0.0351794034768
41704,1000054,2,517,448,69,0.866538,0.133462,1.693325,55,14,518,449,69,0.866795,0.133205,1.693254,55,14,1, merged,0,0,0.114381767194
41704,1000121,1,1986,1642,344,0.826788,0.173212,0.826788,321,23,1988,1643,345,0.826459,0.173541,0.826459,322,23,1, merged,1,1,0.101335012957
41713,1000105,2,503,388,115,0.771372,0.228628,1.591684,104,11,504,389,115,0.771825,0.228175,1.593531,104,11,1, merged,0,0,0.508080128844
41713,1000108,1,128,105,23,0.820312,0.179688,0.820312,19,4,129,106,23,0.821705,0.178295,0.821705,19,4,1, merged,0,0,0.176349479551
41715,1000105,2,504,389,115,0.771825,0.228175,1.593531,104,11,505,390,115,0.772277,0.227723,1.595354,104,11,1, merged,0,0,0.508967686778
41715,1000108,1,129,106,23,0.821705,0.178295,0.821705,19,4,130,107,23,0.823077,0.176923,0.823077,19,4,1, merged,0,0,0.178766427424
41716,1000004,1,2959,2626,333,0.887462,0.112538,0.887462,259,74,2961,2628,333,0.887538,0.112462,0.887538,259,74,-1, merged,0,0,0.000374370481635
41716,1000015,3,1882,1689,193,0.89745,0.10255,2.583157,176,17,1883,1690,193,0.897504,0.102496,2.585042,176,17,1, merged,0,0,3.29037719042e-05
41719,1000054,2,519,450,69,0.867052,0.132948,1.698221,55,14,520,451,69,0.867308,0.132692,1.700641,55,14,1, merged,0,0,0.243775000611
41727,1000015,2,1883,1690,193,0.897504,0.102496,1.764812,176,17,1884,1691,193,0.897558,0.102442,1.765121,176,17,1, merged,0,0,0.100638622782
41727,1000054,1,520,451,69,0.867308,0.132692,0.867308,55,14,521,452,69,0.867562,0.132438,0.867562,55,14,1, merged,0,0,0.083615926481
41730,1000015,1,1884,1691,193,0.897558,0.102442,0.897558,176,17,1885,1692,193,0.897613,0.102387,0.897613,176,17,1, merged,0,0,0.543864441773
41730,1000054,2,521,452,69,0.867562,0.132438,1.765121,55,14,522,453,69,0.867816,0.132184,1.765429,55,14,1, merged,0,0,0.412566214043
41738,1000004,2,2961,2628,333,0.887538,0.112462,1.742968,259,74,2964,2631,333,0.887652,0.112348,1.743184,259,74,-1, merged,0,0,0.000280702054204
41738,1000015,3,1885,1692,193,0.897613,0.102387,2.640581,176,17,1886,1693,193,0.897667,0.102333,2.640851,176,17,1, merged,0,0,3.58689118188e-05
41738,1000120,1,1418,1213,205,0.85543,0.14457,0.85543,178,27,1419,1214,205,0.855532,0.144468,0.855532,178,27,-1, merged,0,0,0.00107398160816
41740,1000105,2,505,390,115,0.772277,0.227723,1.595354,104,11,506,391,115,0.772727,0.227273,1.597155,104,11,1, merged,0,0,0.509018406944
41740,1000108,1,130,107,23,0.823077,0.176923,0.823077,19,4,131,108,23,0.824427,0.175573,0.824427,19,4,1, merged,0,0,0.178429734467
41741,1000004,1,2964,2631,333,0.887652,0.112348,0.887652,259,74,2970,2637,333,0.887879,0.112121,0.887879,259,74,-1, merged,0,0,0
41741,1000120,2,1419,1214,205,0.855532,0.144468,1.743184,178,27,1421,1215,206,0.855032,0.144968,1.74291,179,27,-1, merged,1,0,0
41743,1000004,1,2970,2637,333,0.887879,0.112121,0.887879,259,74,2971,2638,333,0.887917,0.112083,0.887917,259,74,-1, abandoned,0,0,0.00462964875485
41743,1000120,2,1421,1215,206,0.855032,0.144968,1.74291,179,27,1422,1216,206,0.855134,0.144866,1.74305,179,27,-1, abandoned,0,0,0.000396358739694
41751,1000005,2,409,333,76,0.814181,0.185819,1.671324,70,6,410,334,76,0.814634,0.185366,1.675745,70,6,1, merged,0,0,0.145821763739
41755,1000026,2,388,353,35,0.909794,0.090206,1.679025,33,2,390,354,36,0.907692,0.092308,1.621978,34,2,1, merged,1,1,0.57964656244
41760,1000070,3,1115,968,147,0.868161,0.131839,2.704419,123,24,1116,969,147,0.86828,0.13172,2.695866,123,24,1, merged,0,0,0.130893828193
41776,1000004,2,2973,2640,333,0.887992,0.112008,1.743126,259,74,2974,2641,333,0.88803,0.11197,1.743265,259,74,1, merged,0,0,0.0344990027944
41776,1000120,1,1422,1216,206,0.855134,0.144866,0.855134,179,27,1423,1217,206,0.855235,0.144765,0.855235,179,27,1, merged,0,0,0.0381341270728
41778,1000004,2,2974,2641,333,0.88803,0.11197,1.743468,259,74,2975,2642,333,0.888067,0.111933,1.743607,259,74,1, merged,0,0,0.0531431553043
41778,1000120,1,1425,1219,206,0.855439,0.144561,0.855439,179,27,1426,1220,206,0.85554,0.14446,0.85554,179,27,1, merged,0,0,0.137556681782
41779,1000004,3,2975,2642,333,0.888067,0.111933,2.641274,259,74,2976,2643,333,0.888105,0.111895,2.641046,259,74,1, merged,0,0,0.026617992402
41779,1000015,1,1886,1693,193,0.897667,0.102333,0.897667,176,17,1889,1695,194,0.8973,0.1027,0.8973,176,18,1, merged,1,0,0.000697371877912
41779,1000120,2,1426,1220,206,0.85554,0.14446,1.753207,179,27,1427,1221,206,0.855641,0.144359,1.752941,179,27,1, merged,0,0,0.0690404566722
41783,1000004,2,2976,2643,333,0.888105,0.111895,1.666243,259,74,2977,2643,334,0.887807,0.112193,1.666025,259,75,-1, merged,1,1,0.443849931524
41783,1000329,1,2772,2157,615,0.778139,0.221861,0.778139,530,85,2773,2158,615,0.778219,0.221781,0.778219,530,85,1, merged,0,0,0.626237907588
41785,1000070,3,1116,969,147,0.86828,0.13172,2.523366,123,24,1117,970,147,0.868397,0.131603,2.524555,123,24,1, merged,0,0,4.39612956382e-09
41785,1000121,2,2000,1655,345,0.8275,0.1725,1.655086,322,23,2001,1656,345,0.827586,0.172414,1.656158,322,23,1, merged,0,0,1.72621906947e-10
41786,1000121,2,2001,1656,345,0.827586,0.172414,1.656158,322,23,2002,1657,345,0.827672,0.172328,1.657218,322,23,1, merged,0,0,0.0207934161524
41790,1000014,1,2078,1757,321,0.845525,0.154475,0.845525,298,23,2081,1759,322,0.845267,0.154733,0.845267,299,23,-1, merged,1,0,0
41790,1000329,2,2773,2158,615,0.778219,0.221781,1.623743,530,85,2774,2159,615,0.778298,0.221702,1.623565,530,85,-1, merged,0,0,0
41790,1002169,3,345,218,127,0.631884,0.368116,2.255627,121,6,347,220,127,0.634006,0.365994,2.257571,121,6,-1, merged,0,0,0
41793,1000004,1,2977,2643,334,0.887807,0.112193,0.887807,259,75,2981,2646,335,0.887622,0.112378,0.887622,260,75,-1, merged,1,0,0
41793,1000328,3,830,614,216,0.739759,0.260241,2.41328,193,23,832,616,216,0.740385,0.259615,2.414229,193,23,-1, merged,0,0,0
41793,1000329,4,2774,2159,615,0.778298,0.221702,3.191578,530,85,2775,2160,615,0.778378,0.221622,3.192608,530,85,1, merged,0,0,0
41794,1000329,2,2775,2160,615,0.778378,0.221622,1.412384,530,85,2776,2161,615,0.778458,0.221542,1.413516,530,85,1, merged,0,0,0
41794,1002169,1,347,220,127,0.634006,0.365994,0.634006,121,6,348,221,127,0.635057,0.364943,0.635057,121,6,-1, merged,0,0,0
41798,1000014,2,2081,1759,322,0.845267,0.154733,1.572893,299,23,2082,1760,322,0.845341,0.154659,1.574023,299,23,-1, abandoned,0,0,0
41798,1000534,1,257,187,70,0.727626,0.272374,0.727626,66,4,258,188,70,0.728682,0.271318,0.728682,66,4,-1, abandoned,0,0,0
41801,1000132,2,370,332,38,0.897297,0.102703,1.897297,28,10,371,333,38,0.897574,0.102426,1.897574,28,10,1, merged,0,0,0.562460776218
41802,1000023,1,923,814,109,0.881907,0.118093,0.881907,98,11,924,815,109,0.882035,0.117965,0.882035,98,11,1, merged,0,0,0.0302865208868
41804,1000004,2,2981,2646,335,0.887622,0.112378,1.887622,260,75,2982,2647,335,0.887659,0.112341,1.887659,260,75,1, merged,0,0,0
41805,1000004,1,2982,2647,335,0.887659,0.112341,0.887659,260,75,2983,2648,335,0.887697,0.112303,0.887697,260,75,1, merged,0,0,0.0574323903387
41806,1000121,1,2003,1658,345,0.827758,0.172242,0.827758,322,23,2006,1659,347,0.827019,0.172981,0.827019,324,23,1, merged,1,1,0.414880674379
41807,1000327,1,670,527,143,0.786567,0.213433,0.786567,110,33,672,529,143,0.787202,0.212798,0.787202,110,33,-1, abandoned,0,0,0.552784940691
41809,1000009,4,1100,915,185,0.831818,0.168182,3.085357,166,19,1102,917,185,0.832123,0.167877,2.935093,166,19,-1, abandoned,0,0,0.294225651433
41809,1000534,2,259,189,70,0.72973,0.27027,1.586873,66,4,261,190,71,0.727969,0.272031,1.477969,67,4,-1, abandoned,1,0,0.283313584153
41817,1000043,2,515,432,83,0.838835,0.161165,0.838835,70,13,516,433,83,0.839147,0.160853,0.839147,70,13,-1, abandoned,0,0,0.715956402302
41823,1000004,2,2983,2648,335,0.887697,0.112303,1.784997,260,75,2984,2649,335,0.887735,0.112265,1.785089,260,75,1, merged,0,0,0.00326988205068
41823,1000015,1,1889,1695,194,0.8973,0.1027,0.8973,176,18,1890,1696,194,0.897354,0.102646,0.897354,176,18,1, merged,0,0,0.000656232568822
41824,1000004,1,2984,2649,335,0.887735,0.112265,0.887735,260,75,2986,2651,335,0.88781,0.11219,0.88781,260,75,-1, merged,0,0,7.50720723799e-06
41824,1000015,2,1890,1696,194,0.897354,0.102646,1.785089,176,18,1891,1697,194,0.897409,0.102591,1.785219,176,18,1, merged,0,0,1.75770824336e-06
41826,1000121,4,2006,1659,347,0.827019,0.172981,3.434576,324,23,2007,1660,347,0.827105,0.172895,3.435644,324,23,1, merged,0,0,0.0298259602747
41826,1000130,3,375,308,67,0.821333,0.178667,2.607557,52,15,376,309,67,0.821809,0.178191,2.608538,52,15,1, merged,0,0,0.0471935468623
41828,1000026,1,391,355,36,0.907928,0.092072,0.907928,34,2,393,357,36,0.908397,0.091603,0.908397,34,2,-1, merged,0,0,0.488474446714
41828,1000054,2,529,459,70,0.867675,0.132325,1.775603,56,14,530,460,70,0.867925,0.132075,1.776321,56,14,1, merged,0,0,0.488138764723
41833,1000005,3,413,336,77,0.813559,0.186441,2.519131,71,6,414,336,78,0.811594,0.188406,2.509281,72,6,1, merged,1,1,0.0136868367472
41833,1000054,2,531,461,70,0.868173,0.131827,1.705572,56,14,534,463,71,0.867041,0.132959,1.697686,57,14,1, merged,1,1,0.0690776590229
41834,1000054,2,534,463,71,0.867041,0.132959,1.697686,57,14,535,464,71,0.86729,0.13271,1.69129,57,14,1, merged,0,0,0.140489903467
41835,1000004,3,2986,2651,335,0.88781,0.11219,2.451016,260,75,2987,2652,335,0.887847,0.112153,2.452849,260,75,1, merged,0,0,0.146845570175
41835,1000014,1,2083,1761,322,0.845415,0.154585,0.845415,299,23,2084,1762,322,0.845489,0.154511,0.845489,299,23,1, merged,0,0,0.171568324517
41836,1000054,2,535,464,71,0.86729,0.13271,1.773087,57,14,536,465,71,0.867537,0.132463,1.773432,57,14,1, merged,0,0,0.0257330953929
41836,1000153,1,966,875,91,0.905797,0.094203,0.905797,68,23,967,876,91,0.905895,0.094105,0.905895,68,23,1, merged,0,0,0.0320681696098
41838,1000015,2,1891,1697,194,0.897409,0.102591,1.764946,176,18,1892,1698,194,0.897463,0.102537,1.765493,176,18,1, merged,0,0,0.154238972105
41838,1000054,1,536,465,71,0.867537,0.132463,0.867537,57,14,538,467,71,0.86803,0.13197,0.86803,57,14,1, merged,0,0,0.147455206349
41839,1000015,2,1892,1698,194,0.897463,0.102537,1.765493,176,18,1893,1699,194,0.897517,0.102483,1.765792,176,18,1, merged,0,0,0.0263210584473
41839,1000054,1,538,467,71,0.86803,0.13197,0.86803,57,14,539,468,71,0.868275,0.131725,0.868275,57,14,1, merged,0,0,0.35856131046
41843,1000004,2,2987,2652,335,0.887847,0.112153,1.887847,260,75,2988,2653,335,0.887885,0.112115,1.887885,260,75,1, merged,0,0,0.106344565653
41845,1000015,2,1893,1699,194,0.897517,0.102483,1.766036,176,18,1894,1700,194,0.897571,0.102429,1.766333,176,18,1, merged,0,0,0.961416575485
41845,1000054,1,540,469,71,0.868519,0.131481,0.868519,57,14,541,470,71,0.868762,0.131238,0.868762,57,14,1, merged,0,0,0.407030984697
41848,1000004,1,2990,2655,335,0.88796,0.11204,0.88796,260,75,2993,2658,335,0.888072,0.111928,0.888072,260,75,-1, merged,0,0,8.36281090223e-06
41848,1000015,2,1894,1700,194,0.897571,0.102429,1.785531,176,18,1895,1701,194,0.897625,0.102375,1.785697,176,18,1, merged,0,0,2.2123818082e-06
41850,1000014,2,2085,1763,322,0.845564,0.154436,1.586189,299,23,2086,1764,322,0.845638,0.154362,1.583292,299,23,-1, abandoned,0,0,0.0156660348534
41850,1000329,4,2776,2161,615,0.778458,0.221542,3.130757,530,85,2777,2161,616,0.778178,0.221822,3.128136,531,85,1, abandoned,1,1,0.0224852387867
41852,1000014,2,2086,1764,322,0.845638,0.154362,1.583292,299,23,2087,1765,322,0.845712,0.154288,1.57884,299,23,-1, abandoned,0,0,0
41854,1000004,3,2993,2658,335,0.888072,0.111928,2.589627,260,75,2994,2659,335,0.88811,0.11189,2.589839,260,75,1, merged,0,0,0.319788744886
41854,1000014,2,2087,1765,322,0.845712,0.154288,1.701555,299,23,2088,1766,322,0.845785,0.154215,1.701729,299,23,1, merged,0,0,0.500471130554
41854,1000120,1,1429,1223,206,0.855843,0.144157,0.855843,179,27,1430,1224,206,0.855944,0.144056,0.855944,179,27,1, merged,0,0,0.289091876148
41856,1000054,2,543,472,71,0.869245,0.130755,1.656447,57,14,544,473,71,0.869485,0.130515,1.657004,57,14,1, merged,0,0,0.567847651173
41856,1000327,1,672,529,143,0.787202,0.212798,0.787202,110,33,673,530,143,0.787519,0.212481,0.787519,110,33,1, merged,0,0,0.559489436404
41858,1000105,1,508,393,115,0.773622,0.226378,0.773622,104,11,509,394,115,0.774067,0.225933,0.774067,104,11,1, merged,0,0,0.0421168510845
41860,1000070,1,1117,970,147,0.868397,0.131603,0.868397,123,24,1120,970,150,0.866071,0.133929,0.866071,126,24,1, merged,1,1,0.0340967700673
41862,1000026,2,393,357,36,0.908397,0.091603,1.777882,34,2,394,358,36,0.908629,0.091371,1.778354,34,2,1, merged,0,0,0.451637651048
41862,1000054,1,544,473,71,0.869485,0.130515,0.869485,57,14,545,474,71,0.869725,0.130275,0.869725,57,14,1, merged,0,0,0.408470992552
41871,1000108,1,132,109,23,0.825758,0.174242,0.825758,19,4,134,111,23,0.828358,0.171642,0.828358,19,4,-1, merged,0,0,0.518756886489
41871,1000110,3,182,161,21,0.884615,0.115385,2.592726,19,2,183,162,21,0.885246,0.114754,2.587391,19,2,1, merged,0,0,0.568078073899
41874,1000121,3,2007,1660,347,0.827105,0.172895,2.466895,324,23,2008,1661,347,0.827191,0.172809,2.47077,324,23,1, merged,0,0,0.0575983892527
41875,1000005,1,415,337,78,0.812048,0.187952,0.812048,72,6,416,337,79,0.810096,0.189904,0.810096,73,6,1, merged,1,1,0.0109081960006
41875,1000121,4,2008,1661,347,0.827191,0.172809,3.282818,324,23,2010,1661,349,0.826368,0.173632,3.261976,326,23,1, merged,1,1,0.0318030571533
41880,1000121,2,2010,1661,349,0.826368,0.173632,1.641753,326,23,2011,1662,349,0.826455,0.173545,1.643248,326,23,1, merged,0,0,0.349927989805
41892,1000014,2,2088,1766,322,0.845785,0.154215,1.704119,299,23,2091,1768,323,0.845528,0.154472,1.705033,300,23,-1, abandoned,1,0,0.00612853042177
41892,1000534,4,261,190,71,0.727969,0.272031,3.268908,67,4,262,191,71,0.729008,0.270992,3.260487,67,4,-1, abandoned,0,0,0.0102039593424
41902,1000004,1,2996,2661,335,0.888184,0.111816,0.888184,260,75,2998,2663,335,0.888259,0.111741,0.888259,260,75,-1, merged,0,0,0
41902,1000120,2,1437,1231,206,0.856646,0.143354,1.74483,179,27,1438,1232,206,0.856745,0.143255,1.745004,179,27,1, merged,0,0,0
41908,1000004,2,2998,2663,335,0.888259,0.111741,1.584063,260,75,2999,2664,335,0.888296,0.111704,1.58516,260,75,1, merged,0,0,0.0677933104267
41910,1000327,1,674,531,143,0.787834,0.212166,0.787834,110,33,675,532,143,0.788148,0.211852,0.788148,110,33,-1, merged,0,0,0.285197989684
41910,1000329,2,2780,2164,616,0.778417,0.221583,1.566251,531,85,2781,2165,616,0.778497,0.221503,1.566645,531,85,1, merged,0,0,0.19750551729
41912,1000014,1,2091,1768,323,0.845528,0.154472,0.845528,300,23,2093,1770,323,0.845676,0.154324,0.845676,300,23,1, merged,0,0,0.570435422636
41912,1000110,3,184,163,21,0.88587,0.11413,2.512574,19,2,185,164,21,0.886486,0.113514,2.513853,19,2,1, merged,0,0,0.570741023682
41913,1000004,2,3000,2665,335,0.888333,0.111667,1.75568,260,75,3001,2666,335,0.888371,0.111629,1.759658,260,75,1, merged,0,0,0.0779256451387
41918,1000054,2,551,480,71,0.871143,0.128857,1.729352,57,14,552,481,71,0.871377,0.128623,1.730113,57,14,1, merged,0,0,0.0808830595992
41925,1000054,1,554,483,71,0.871841,0.128159,0.871841,57,14,555,484,71,0.872072,0.127928,0.872072,57,14,1, merged,0,0,0.0619583978786
41927,1000014,1,2094,1771,323,0.84575,0.15425,0.84575,300,23,2095,1772,323,0.845823,0.154177,0.845823,300,23,1, merged,0,0,0.000911577028259
41927,1000153,2,967,876,91,0.905895,0.094105,1.751644,68,23,968,877,91,0.905992,0.094008,1.751815,68,23,1, merged,0,0,0.00172394450469
41929,1000003,1,1082,901,181,0.832717,0.167283,0.832717,164,17,1083,902,181,0.832872,0.167128,0.832872,164,17,-1, abandoned,0,0,0.0717637467674
41935,1000121,2,2011,1662,349,0.826455,0.173545,1.595685,326,23,2012,1663,349,0.826541,0.173459,1.601541,326,23,1, merged,0,0,0.206018614174
41936,1000054,2,559,488,71,0.872987,0.127013,1.708431,57,14,560,489,71,0.873214,0.126786,1.710714,57,14,1, merged,0,0,0.48720199687
41940,1000003,2,1083,902,181,0.832872,0.167128,1.770372,164,17,1084,903,181,0.833026,0.166974,1.774202,164,17,1, merged,0,0,0.0034307628524
41946,1000015,3,1897,1703,194,0.897733,0.102267,2.608448,176,18,1898,1704,194,0.897787,0.102213,2.610734,176,18,1, merged,0,0,0.0133245044988
41946,1000054,1,560,489,71,0.873214,0.126786,0.873214,57,14,561,490,71,0.87344,0.12656,0.87344,57,14,1, merged,0,0,0.179052352058
41947,1000015,2,1898,1704,194,0.897787,0.102213,1.763859,176,18,1899,1705,194,0.897841,0.102159,1.764032,176,18,1, merged,0,0,0.526768597965
41947,1000070,1,1120,970,150,0.866071,0.133929,0.866071,126,24,1121,971,150,0.866191,0.133809,0.866191,126,24,1, merged,0,0,0.561206390813
41948,1000004,1,3004,2669,335,0.888482,0.111518,0.888482,260,75,3005,2670,335,0.888519,0.111481,0.888519,260,75,1, merged,0,0,0.0287645111589
41948,1000120,2,1438,1232,206,0.856745,0.143255,1.745228,179,27,1439,1233,206,0.856845,0.143155,1.745364,179,27,1, merged,0,0,0.0845988258317
41949,1000014,1,2095,1772,323,0.845823,0.154177,0.845823,300,23,2098,1772,326,0.844614,0.155386,0.844614,303,23,1, merged,1,1,0
41949,1000054,3,561,490,71,0.87344,0.12656,2.452393,57,14,566,493,73,0.871025,0.128975,2.446526,59,14,-1, merged,1,0,0.609538862299
41958,1000004,3,3005,2670,335,0.888519,0.111481,2.599501,260,75,3006,2671,335,0.888556,0.111444,2.597847,260,75,1, merged,0,0,0.0366282091804
41958,1000120,2,1440,1234,206,0.856944,0.143056,1.710982,179,27,1441,1234,207,0.85635,0.14365,1.709291,180,27,1, merged,1,1,0.0217584561141
41958,1000592,1,644,550,94,0.854037,0.145963,0.854037,59,35,646,551,95,0.852941,0.147059,0.852941,60,35,1, merged,1,1,0.0103783060509
41959,1000054,1,567,494,73,0.871252,0.128748,0.871252,59,14,568,495,73,0.871479,0.128521,0.871479,59,14,1, merged,0,0,0.61014984473
41963,1000054,3,568,495,73,0.871479,0.128521,2.332115,59,14,569,496,73,0.871705,0.128295,2.337965,59,14,1, merged,0,0,0.411771901086
41964,1000004,1,3006,2671,335,0.888556,0.111444,0.888556,260,75,3007,2672,335,0.888593,0.111407,0.888593,260,75,1, merged,0,0,0.0283625329735
41964,1000120,2,1441,1234,207,0.85635,0.14365,1.744906,180,27,1442,1235,207,0.856449,0.143551,1.745043,180,27,1, merged,0,0,0.0827836434003
41970,1000005,2,416,337,79,0.810096,0.189904,1.617788,73,6,417,338,79,0.810552,0.189448,1.596266,73,6,1, merged,0,0,0.0175374663365
41973,1000070,1,1121,971,150,0.866191,0.133809,0.866191,126,24,1122,972,150,0.86631,0.13369,0.86631,126,24,1, merged,0,0,0.23129635711
41974,1000109,2,471,400,71,0.849257,0.150743,1.698747,66,5,472,401,71,0.849576,0.150424,1.699449,66,5,1, merged,0,0,0.00171701163385
41974,1000199,1,392,333,59,0.84949,0.15051,0.84949,53,6,393,334,59,0.849873,0.150127,0.849873,53,6,1, merged,0,0,0.00148615595271
41975,1000003,1,1084,903,181,0.833026,0.166974,0.833026,164,17,1085,903,182,0.832258,0.167742,0.832258,164,18,-1, merged,1,1,0.0129003594176
41975,1000109,2,472,401,71,0.849576,0.150424,1.682602,66,5,473,402,71,0.849894,0.150106,1.682152,66,5,1, merged,0,0,0.0124210919879
41982,1000070,1,1122,972,150,0.86631,0.13369,0.86631,126,24,1123,973,150,0.866429,0.133571,0.866429,126,24,1, merged,0,0,0.0775510983406
41984,1000004,2,3007,2672,335,0.888593,0.111407,1.745142,260,75,3008,2673,335,0.88863,0.11137,1.745378,260,75,1, merged,0,0,0.0144469859513
41984,1000120,1,1443,1236,207,0.856549,0.143451,0.856549,180,27,1445,1238,207,0.856747,0.143253,0.856747,180,27,-1, merged,0,0,0.0425424037069
41985,1000043,2,516,433,83,0.839147,0.160853,1.72203,70,13,517,434,83,0.839458,0.160542,1.723387,70,13,1, merged,0,0,0.402227714882
41987,1000026,1,395,359,36,0.908861,0.091139,0.908861,34,2,396,360,36,0.909091,0.090909,0.909091,34,2,1, merged,0,0,0.165599148518
41987,1000120,2,1445,1238,207,0.856747,0.143253,1.765608,180,27,1446,1239,207,0.856846,0.143154,1.765937,180,27,1, merged,0,0,0.0576332669697
41993,1000120,1,1448,1241,207,0.857044,0.142956,0.857044,180,27,1449,1242,207,0.857143,0.142857,0.857143,180,27,1, merged,0,0,0.0415509368398
41996,1000005,3,417,338,79,0.810552,0.189448,2.59202,73,6,418,339,79,0.811005,0.188995,2.590406,73,6,1, merged,0,0,0.106089244373
41996,1000026,1,396,360,36,0.909091,0.090909,0.909091,34,2,397,360,37,0.906801,0.093199,0.906801,35,2,1, merged,1,1,0.885195923388
41996,1000054,2,572,499,73,0.872378,0.127622,1.781469,59,14,573,500,73,0.8726,0.1274,1.779401,59,14,1, merged,0,0,0.638180201392
41998,1000120,2,1452,1245,207,0.857438,0.142562,1.710379,180,27,1453,1246,207,0.857536,0.142464,1.710705,180,27,1, merged,0,0,0.378099922121
41998,1000592,1,646,551,95,0.852941,0.147059,0.852941,60,35,647,552,95,0.853168,0.146832,0.853168,60,35,1, merged,0,0,0.470375881834
41999,1000120,1,1453,1246,207,0.857536,0.142464,0.857536,180,27,1454,1247,207,0.857634,0.142366,0.857634,180,27,1, merged,0,0,0.0427805564591
41999,1000199,2,393,334,59,0.849873,0.150127,1.707409,53,6,394,335,59,0.850254,0.149746,1.707888,53,6,1, merged,0,0,0.00355817046654
42002,1000328,3,832,616,216,0.740385,0.259615,2.302682,193,23,836,618,218,0.739234,0.260766,2.303189,195,23,-1, merged,1,0,0.148323992503
42002,1000329,2,2782,2166,616,0.778577,0.221423,1.562297,531,85,2784,2168,616,0.778736,0.221264,1.563955,531,85,-1, merged,0,0,0.0818196218931
42003,1000329,1,2784,2168,616,0.778736,0.221264,0.778736,531,85,2786,2170,616,0.778894,0.221106,0.778894,531,85,-1, abandoned,0,0,0.264163324083
42004,1000054,3,573,500,73,0.8726,0.1274,2.504208,59,14,574,500,74,0.87108,0.12892,2.49557,60,14,1, abandoned,1,1,0.284403659083
42004,1000329,1,2786,2170,616,0.778894,0.221106,0.778894,531,85,2788,2170,618,0.778336,0.221664,0.778336,533,85,1, abandoned,1,1,0.264302899005
42005,1000132,2,372,334,38,0.897849,0.102151,1.803361,28,10,373,335,38,0.898123,0.101877,1.800084,28,10,1, merged,0,0,0.0320560912592
42009,1000120,1,1456,1249,207,0.85783,0.14217,0.85783,180,27,1457,1250,207,0.857927,0.142073,0.857927,180,27,1, merged,0,0,0.124040738986
42009,1000329,2,2788,2170,618,0.778336,0.221664,1.636165,533,85,2789,2171,618,0.778415,0.221585,1.636342,533,85,1, merged,0,0,0.0247179272879
42010,1000120,1,1457,1250,207,0.857927,0.142073,0.857927,180,27,1459,1251,208,0.857437,0.142563,0.857437,181,27,1, merged,1,1,0.0622535524855
42010,1000329,2,2789,2171,618,0.778415,0.221585,1.636342,533,85,2791,2173,618,0.778574,0.221426,1.636011,533,85,-1, merged,0,0,0.0124631067725
42012,1000120,1,1460,1251,209,0.856849,0.143151,0.856849,182,27,1461,1252,209,0.856947,0.143053,0.856947,182,27,1, merged,0,0,0.0263036049612
42012,1000592,2,647,552,95,0.853168,0.146832,1.710018,60,35,648,553,95,0.853395,0.146605,1.710342,60,35,1, merged,0,0,0.0240392837578
42013,1000120,2,1461,1252,209,0.856947,0.143053,1.635521,182,27,1462,1253,209,0.857045,0.142955,1.635698,182,27,1, merged,0,0,0.0254194320211
42013,1000329,1,2791,2173,618,0.778574,0.221426,0.778574,533,85,2792,2174,618,0.778653,0.221347,0.778653,533,85,1, merged,0,0,0.0789244889781
42014,1000120,2,1462,1253,209,0.857045,0.142955,1.635698,182,27,1463,1254,209,0.857143,0.142857,1.635875,182,27,1, merged,0,0,0.0192883136489
42014,1000329,1,2792,2174,618,0.778653,0.221347,0.778653,533,85,2793,2175,618,0.778733,0.221267,0.778733,533,85,1, merged,0,0,0.0592804430202
42015,1000132,2,373,335,38,0.898123,0.101877,1.800084,28,10,376,337,39,0.896277,0.103723,1.791218,29,10,1, merged,1,1,0.011150947756
42021,1000014,2,2098,1772,326,0.844614,0.155386,1.704118,303,23,2100,1773,327,0.844286,0.155714,1.704368,304,23,-1, abandoned,1,0,0.000428079437328
42025,1000007,1,1304,1053,251,0.807515,0.192485,0.807515,222,29,1305,1054,251,0.807663,0.192337,0.807663,222,29,1, merged,0,0,0.65647130793
42025,1000009,2,1104,919,185,0.832428,0.167572,1.639943,166,19,1105,920,185,0.832579,0.167421,1.640242,166,19,1, merged,0,0,0.626698326837
42027,1000121,1,2013,1664,349,0.826627,0.173373,0.826627,326,23,2014,1665,349,0.826713,0.173287,0.826713,326,23,-1, abandoned,0,0,0
42027,1000329,2,2793,2175,618,0.778733,0.221267,1.605359,533,85,2794,2176,618,0.778812,0.221188,1.605525,533,85,-1, abandoned,0,0,0
42028,1000004,3,3012,2677,335,0.888778,0.111222,2.379955,260,75,3013,2678,335,0.888815,0.111185,2.36805,260,75,-1, abandoned,0,0,0.0122568063745
42034,1000070,2,1123,973,150,0.866429,0.133571,1.693142,126,24,1124,974,150,0.866548,0.133452,1.693347,126,24,1, merged,0,0,0.362979941219
42034,1000121,1,2014,1665,349,0.826713,0.173287,0.826713,326,23,2015,1666,349,0.826799,0.173201,0.826799,326,23,1, merged,0,0,0.214014538098
42035,1000327,2,675,532,143,0.788148,0.211852,1.567039,110,33,676,533,143,0.788462,0.211538,1.567511,110,33,1, merged,0,0,0
42035,1000329,1,2795,2177,618,0.778891,0.221109,0.778891,533,85,2797,2179,618,0.779049,0.220951,0.779049,533,85,-1, merged,0,0,0
42043,1000592,1,648,553,95,0.853395,0.146605,0.853395,60,35,651,556,95,0.854071,0.145929,0.854071,60,35,-1, merged,0,0,0.0597922989931
42047,1000014,1,2100,1773,327,0.844286,0.155714,0.844286,304,23,2101,1773,328,0.843884,0.156116,0.843884,305,23,1, merged,1,1,0.00123895267201
42047,1000109,3,473,402,71,0.849894,0.150106,2.413692,66,5,474,403,71,0.850211,0.149789,2.415307,66,5,1, merged,0,0,0.00257836884245
42052,1000004,2,3018,2683,335,0.888999,0.111001,1.732883,260,75,3019,2684,335,0.889036,0.110964,1.732994,260,75,1, merged,0,0,0.0539655343096
42052,1000014,1,2101,1773,328,0.843884,0.156116,0.843884,305,23,2102,1774,328,0.843958,0.156042,0.843958,305,23,1, merged,0,0,0.00617360422861
42056,1000026,1,397,360,37,0.906801,0.093199,0.906801,35,2,398,361,37,0.907035,0.092965,0.907035,35,2,1, merged,0,0,0.243408458281
42060,1000004,1,3020,2685,335,0.889073,0.110927,0.889073,260,75,3021,2686,335,0.88911,0.11089,0.88911,260,75,-1, merged,0,0,0.00829114874327
42062,1000015,1,1903,1709,194,0.898056,0.101944,0.898056,176,18,1904,1710,194,0.898109,0.101891,0.898109,176,18,-1, merged,0,0,0
42062,1000054,2,578,504,74,0.871972,0.128028,1.770028,60,14,579,504,75,0.870466,0.129534,1.768576,61,14,1, merged,1,1,0.61593611579
42063,1000014,1,2102,1774,328,0.843958,0.156042,0.843958,305,23,2103,1775,328,0.844032,0.155968,0.844032,305,23,1, merged,0,0,0
42063,1000121,3,2015,1666,349,0.826799,0.173201,2.467367,326,23,2016,1667,349,0.826885,0.173115,2.469237,326,23,1, merged,0,0,0
42066,1000015,3,1904,1710,194,0.898109,0.101891,2.366856,176,18,1905,1710,195,0.897638,0.102362,2.335517,177,18,1, merged,1,1,0.00564319615893
42067,1000054,2,579,504,75,0.870466,0.129534,1.66059,61,14,580,505,75,0.87069,0.12931,1.66133,61,14,1, merged,0,0,0.455389518149
42067,1000166,1,405,320,85,0.790123,0.209877,0.790123,81,4,406,321,85,0.79064,0.20936,0.79064,81,4,1, merged,0,0,0.683786018978
42070,1000054,3,580,505,75,0.87069,0.12931,2.312845,61,14,581,506,75,0.870912,0.129088,2.318783,61,14,1, merged,0,0,0.56536841843
42070,1000166,1,406,321,85,0.79064,0.20936,0.79064,81,4,407,322,85,0.791155,0.208845,0.791155,81,4,1, merged,0,0,0.426516107509
42075,1000004,1,3021,2686,335,0.88911,0.11089,0.88911,260,75,3023,2688,335,0.889183,0.110817,0.889183,260,75,-1, merged,0,0,0.140785247825
42075,1000329,3,2797,2179,618,0.779049,0.220951,2.389371,533,85,2798,2180,618,0.779128,0.220872,2.385178,533,85,-1, merged,0,0,0.171575415689
42081,1000054,3,584,509,75,0.871575,0.128425,2.319447,61,14,585,510,75,0.871795,0.128205,2.325226,61,14,1, merged,0,0,0.645979155784
42081,1000166,2,407,322,85,0.791155,0.208845,1.447871,81,4,408,323,85,0.791667,0.208333,1.453431,81,4,1, merged,0,0,0.491342584537
42082,1000004,2,3023,2688,335,0.889183,0.110817,1.786821,260,75,3025,2689,336,0.888926,0.111074,1.786146,261,75,-1, merged,1,0,0.00446063374437
42082,1000015,1,1905,1710,195,0.897638,0.102362,0.897638,177,18,1907,1711,196,0.897221,0.102779,0.897221,178,18,1, merged,1,1,0.00598009897643
42082,1000054,3,585,510,75,0.871795,0.128205,2.658616,61,14,586,511,75,0.872014,0.127986,2.65816,61,14,-1, merged,0,0,0.00716359913699
42086,1000054,1,586,511,75,0.872014,0.127986,0.872014,61,14,588,511,77,0.869048,0.130952,0.869048,61,16,-1, merged,1,1,0.0388865864603
42086,1000153,3,968,877,91,0.905992,0.094008,2.569672,68,23,969,878,91,0.906089,0.093911,2.567312,68,23,1, merged,0,0,0.00347815983928
42086,1000166,2,408,323,85,0.791667,0.208333,1.66368,81,4,409,324,85,0.792176,0.207824,1.661224,81,4,1, merged,0,0,0.0317777239208
42094,1000026,2,403,366,37,0.908189,0.091811,1.776209,35,2,404,367,37,0.908416,0.091584,1.775195,35,2,1, merged,0,0,0.481393806322
42094,1000054,1,591,513,78,0.86802,0.13198,0.86802,62,16,593,514,79,0.866779,0.133221,0.866779,63,16,1, merged,1,1,0.488774995474
42095,1000004,2,3027,2690,337,0.888669,0.111331,1.785889,262,75,3028,2691,337,0.888705,0.111295,1.785456,262,75,1, merged,0,0,0.127592742508
42095,1000015,1,1907,1711,196,0.897221,0.102779,0.897221,178,18,1908,1711,197,0.896751,0.103249,0.896751,179,18,1, merged,1,1,0.175217038645
42096,1000015,3,1908,1711,197,0.896751,0.103249,2.627811,179,18,1909,1712,197,0.896805,0.103195,2.623396,179,18,1, merged,0,0,0.124032258125
42096,1000534,2,264,193,71,0.731061,0.268939,1.731061,67,4,267,194,73,0.726592,0.273408,1.726592,69,4,1, merged,1,1,0.143257889135
42097,1000026,1,404,367,37,0.908416,0.091584,0.908416,35,2,405,368,37,0.908642,0.091358,0.908642,35,2,1, merged,0,0,0.80135597096
42097,1000054,2,593,514,79,0.866779,0.133221,1.775195,63,16,594,515,79,0.867003,0.132997,1.775645,63,16,1, merged,0,0,0.621173833425
42100,1000054,1,594,515,79,0.867003,0.132997,0.867003,63,16,595,515,80,0.865546,0.134454,0.865546,64,16,1, merged,1,1,0.0614855096867
42100,1000120,2,1464,1255,209,0.85724,0.14276,1.724244,182,27,1465,1255,210,0.856655,0.143345,1.722202,183,27,1, merged,1,1,0.0331025269881
42101,1000004,2,3028,2691,337,0.888705,0.111295,1.71559,262,75,3030,2693,337,0.888779,0.111221,1.715254,262,75,-1, merged,0,0,0.0112623956726
42101,1000121,1,2016,1667,349,0.826885,0.173115,0.826885,326,23,2017,1667,350,0.826475,0.173525,0.826475,327,23,1, merged,1,1,0.00975586001499
42112,1000026,3,406,369,37,0.908867,0.091133,2.680502,35,2,407,370,37,0.909091,0.090909,2.67937,35,2,1, merged,0,0,0.570300661661
42112,1000054,2,595,515,80,0.865546,0.134454,1.771635,64,16,596,515,81,0.864094,0.135906,1.77028,65,16,1, merged,1,1,0.361429694809
42112,1000153,1,969,878,91,0.906089,0.093911,0.906089,68,23,970,879,91,0.906186,0.093814,0.906186,68,23,-1, merged,0,0,0.0347162007276
42114,1000004,1,3031,2694,337,0.888816,0.111184,0.888816,262,75,3033,2696,337,0.888889,0.111111,0.888889,262,75,-1, merged,0,0,0.00155790284645
42114,1000023,2,932,823,109,0.883047,0.116953,1.771863,98,11,933,823,110,0.882101,0.117899,1.77099,99,11,1, merged,1,1,0.00027073037076
42116,1000009,2,1105,920,185,0.832579,0.167421,1.559171,166,19,1106,921,185,0.832731,0.167269,1.560343,166,19,1, merged,0,0,0.245683867041
42116,1000534,1,267,194,73,0.726592,0.273408,0.726592,69,4,268,195,73,0.727612,0.272388,0.727612,69,4,1, merged,0,0,0.238534987009
42123,1000004,1,3033,2696,337,0.888889,0.111111,0.888889,262,75,3036,2698,338,0.888669,0.111331,0.888669,263,75,-1, merged,1,0,0.105163890635
42123,1000054,3,598,517,81,0.864548,0.135452,2.440937,65,16,599,518,81,0.864775,0.135225,2.400503,65,16,1, merged,0,0,0.20491287764
42125,1000014,1,2106,1777,329,0.84378,0.15622,0.84378,306,23,2107,1778,329,0.843854,0.156146,0.843854,306,23,-1, merged,0,0,0.269013843886
42125,1000120,2,1466,1256,210,0.856753,0.143247,1.700533,183,27,1467,1257,210,0.856851,0.143149,1.700705,183,27,1, merged,0,0,0.181517868745
42128,1000004,2,3036,2698,338,0.888669,0.111331,1.700574,263,75,3037,2698,339,0.888377,0.111623,1.698353,263,76,-1, merged,1,1,0.0325339555353
42128,1000005,1,420,341,79,0.811905,0.188095,0.811905,73,6,421,341,80,0.809976,0.190024,0.809976,74,6,1, merged,1,1,0
42130,1000026,2,408,371,37,0.909314,0.090686,1.774088,35,2,409,372,37,0.909535,0.090465,1.773096,35,2,-1, abandoned,0,0,0.830682064443
42130,1000054,1,599,518,81,0.864775,0.135225,0.864775,65,16,601,519,82,0.863561,0.136439,0.863561,66,16,-1, abandoned,1,0,0.616511179476
42137,1000015,3,1909,1712,197,0.896805,0.103195,2.779158,179,18,1910,1713,197,0.896859,0.103141,2.785748,179,18,1, merged,0,0,6.09466332044e-07
42141,1000007,2,1308,1056,252,0.807339,0.192661,1.64007,223,29,1309,1057,252,0.807487,0.192513,1.640368,223,29,-1, abandoned,0,0,0
42141,1000009,1,1106,921,185,0.832731,0.167269,0.832731,166,19,1107,922,185,0.832882,0.167118,0.832882,166,19,-1, abandoned,0,0,0
42142,1000007,2,1309,1057,252,0.807487,0.192513,1.640368,223,29,1310,1058,252,0.807634,0.192366,1.640666,223,29,-1, abandoned,0,0,0
42142,1000009,1,1107,922,185,0.832882,0.167118,0.832882,166,19,1108,923,185,0.833032,0.166968,0.833032,166,19,-1, abandoned,0,0,0
42143,1000007,2,1310,1058,252,0.807634,0.192366,1.640666,223,29,1311,1059,252,0.80778,0.19222,1.640062,223,29,-1, abandoned,0,0,0
42143,1000009,1,1108,923,185,0.833032,0.166968,0.833032,166,19,1109,923,186,0.832281,0.167719,0.832281,167,19,1, abandoned,1,1,0
42145,1000009,1,1110,924,186,0.832432,0.167568,0.832432,167,19,1111,924,187,0.831683,0.168317,0.831683,168,19,1, abandoned,1,1,0
42145,1000534,2,269,196,73,0.728625,0.271375,1.561057,69,4,270,197,73,0.72963,0.27037,1.561313,69,4,-1, abandoned,0,0,0
42146,1000007,1,1311,1059,252,0.80778,0.19222,0.80778,223,29,1312,1059,253,0.807165,0.192835,0.807165,224,29,1, merged,1,1,0.405470350741
42146,1000009,2,1111,924,187,0.831683,0.168317,1.639463,168,19,1112,924,188,0.830935,0.169065,1.6381,169,19,1, merged,1,1,0.388698786548
42147,1000004,1,3037,2698,339,0.888377,0.111623,0.888377,263,76,3040,2701,339,0.888487,0.111513,0.888487,263,76,-1, merged,0,0,0.468209849993
42147,1000009,2,1112,924,188,0.830935,0.169065,1.719312,169,19,1113,925,188,0.831087,0.168913,1.719574,169,19,-1, merged,0,0,1.21104384488
42149,1000007,2,1312,1059,253,0.807165,0.192835,1.638403,224,29,1313,1060,253,0.807312,0.192688,1.638702,224,29,-1, abandoned,0,0,1.22634348592
42149,1000009,1,1114,926,188,0.831239,0.168761,0.831239,169,19,1115,927,188,0.83139,0.16861,0.83139,169,19,-1, abandoned,0,0,1.17383601374
42150,1000007,2,1313,1060,253,0.807312,0.192688,1.638702,224,29,1314,1061,253,0.807458,0.192542,1.638999,224,29,-1, abandoned,0,0,0
42150,1000009,1,1115,927,188,0.83139,0.16861,0.83139,169,19,1116,928,188,0.831541,0.168459,0.831541,169,19,-1, abandoned,0,0,0
42159,1000007,1,1314,1061,253,0.807458,0.192542,0.807458,224,29,1317,1063,254,0.807137,0.192863,0.807137,225,29,-1, merged,1,0,1.31830519903
42165,1000110,2,187,166,21,0.887701,0.112299,1.772656,19,2,189,167,22,0.883598,0.116402,1.760791,20,2,1, merged,1,1,0.271134840003
42166,1000110,2,189,167,22,0.883598,0.116402,1.760791,20,2,191,168,23,0.879581,0.120419,1.749146,21,2,1, merged,1,1,0.272937966289
42167,1000091,2,497,385,112,0.774648,0.225352,1.561496,96,16,498,385,113,0.773092,0.226908,1.55816,96,17,-1, merged,1,1,0.114734504126
42168,1000004,3,3040,2701,339,0.888487,0.111513,2.245435,263,76,3041,2702,339,0.888524,0.111476,2.301125,263,76,1, merged,0,0,0.0550219268296
42168,1000120,2,1468,1258,210,0.856948,0.143052,1.356948,183,27,1469,1259,210,0.857046,0.142954,1.412601,183,27,1, merged,0,0,0.129983679179
42181,1000012,1,548,475,73,0.866788,0.133212,0.866788,71,2,549,476,73,0.867031,0.132969,0.867031,71,2,1, merged,0,0,0.155604023074
42181,1000534,2,270,197,73,0.72963,0.27037,1.596418,69,4,272,197,75,0.724265,0.275735,1.591296,69,6,-1, merged,1,1,0.0293811776872
42183,1000015,2,1910,1713,197,0.896859,0.103141,1.72342,179,18,1911,1714,197,0.896913,0.103087,1.72315,179,18,1, merged,0,0,0.398640190138
42183,1000121,1,2018,1668,350,0.826561,0.173439,0.826561,327,23,2020,1669,351,0.826238,0.173762,0.826238,328,23,-1, merged,1,0,0.305051983407
42183,1000132,4,381,342,39,0.897638,0.102362,2.621057,29,10,382,343,39,0.897906,0.102094,2.954389,29,10,1, merged,0,0,0.533935711689
42188,1000009,4,1116,928,188,0.831541,0.168459,3.399734,169,19,1118,930,188,0.831843,0.168157,3.397392,169,19,-1, merged,0,0,1.17811506715
42188,1000014,3,2108,1779,329,0.843928,0.156072,2.568193,306,23,2109,1779,330,0.843528,0.156472,2.565549,307,23,1, merged,1,1,0.697448474856
42188,1000534,1,272,197,75,0.724265,0.275735,0.724265,69,6,277,200,77,0.722022,0.277978,0.722022,71,6,-1, merged,1,0,1.12393024918
42189,1000004,2,3041,2702,339,0.888524,0.111476,1.742594,263,76,3042,2703,339,0.88856,0.11144,1.741321,263,76,1, merged,0,0,0.0275561677107
42189,1000121,4,2020,1669,351,0.826238,0.173762,3.34796,328,23,2021,1669,352,0.825829,0.174171,3.345721,328,24,-1, merged,1,1,0.00503247643255
42189,1000329,3,2798,2180,618,0.779128,0.220872,2.521722,533,85,2800,2180,620,0.778571,0.221429,2.519892,533,87,-1, merged,1,1,0.0127226236765
42189,1000592,1,651,556,95,0.854071,0.145929,0.854071,60,35,652,556,96,0.852761,0.147239,0.852761,60,36,-1, merged,1,1,0
42192,1000004,1,3042,2703,339,0.88856,0.11144,0.88856,263,76,3043,2704,339,0.888597,0.111403,0.888597,263,76,1, merged,0,0,0
42192,1000120,3,1469,1259,210,0.857046,0.142954,2.563124,183,27,1470,1260,210,0.857143,0.142857,2.56458,183,27,1, merged,0,0,0
42194,1000015,1,1911,1714,197,0.896913,0.103087,0.896913,179,18,1912,1715,197,0.896967,0.103033,0.896967,179,18,1, merged,0,0,0.18968776496
42195,1000004,1,3043,2704,339,0.888597,0.111403,0.888597,263,76,3048,2709,339,0.88878,0.11122,0.88878,263,76,-1, merged,0,0,0.00128441776822
42198,1000130,3,377,310,67,0.822281,0.177719,2.319041,52,15,378,311,67,0.822751,0.177249,2.312149,52,15,1, merged,0,0,0
42201,1000121,2,2021,1669,352,0.825829,0.174171,1.532212,328,24,2022,1670,352,0.825915,0.174085,1.530556,328,24,-1, abandoned,0,0,0
42202,1000329,2,2801,2181,620,0.77865,0.22135,1.632099,533,87,2802,2182,620,0.778729,0.221271,1.632807,533,87,-1, abandoned,0,0,0.0429974462375
42204,1000004,2,3048,2709,339,0.88878,0.11122,1.745922,263,76,3049,2710,339,0.888816,0.111184,1.735875,263,76,-1, merged,0,0,0.0543685196563
42204,1000592,3,652,556,96,0.852761,0.147239,2.598683,60,36,653,557,96,0.852986,0.147014,2.588861,60,36,1, merged,0,0,0.0761019878997
42206,1000014,2,2109,1779,330,0.843528,0.156472,1.753722,307,23,2110,1780,330,0.843602,0.156398,1.754014,307,23,1, merged,0,0,0.0489395567528
42206,1000026,1,412,375,37,0.910194,0.089806,0.910194,35,2,413,376,37,0.910412,0.089588,0.910412,35,2,1, merged,0,0,0.068370172476
42208,1000023,3,934,823,111,0.881156,0.118844,2.527664,100,11,935,824,111,0.881283,0.118717,2.529975,100,11,1, merged,0,0,0.0048188301249
42208,1000109,2,474,403,71,0.850211,0.149789,1.646507,66,5,475,404,71,0.850526,0.149474,1.648691,66,5,1, merged,0,0,0.0232360922659
42212,1000043,2,518,435,83,0.839768,0.160232,1.839768,70,13,519,436,83,0.840077,0.159923,1.69722,70,13,1, merged,0,0,0.88598655755
42213,1000004,2,3051,2712,339,0.888889,0.111111,1.714804,263,76,3052,2713,339,0.888925,0.111075,1.714518,263,76,-1, merged,0,0,0.135787985616
42213,1000121,1,2022,1670,352,0.825915,0.174085,0.825915,328,24,2024,1671,353,0.825593,0.174407,0.825593,329,24,1, merged,1,1,0.120704369941
42213,1000329,3,2802,2182,620,0.778729,0.221271,2.493533,533,87,2803,2183,620,0.778808,0.221192,2.493327,533,87,1, merged,0,0,0.139303663479
42220,1000014,2,2110,1780,330,0.843602,0.156398,1.843602,307,23,2111,1781,330,0.843676,0.156324,1.843676,307,23,1, merged,0,0,0.000576321422691
42220,1000109,3,475,404,71,0.850526,0.149474,2.694128,66,5,476,405,71,0.85084,0.14916,2.694516,66,5,1, merged,0,0,0.00122105643744
42221,1000012,1,549,476,73,0.867031,0.132969,0.867031,71,2,551,477,74,0.865699,0.134301,0.865699,72,2,1, merged,1,1,0.801431683785
42224,1000054,2,607,524,83,0.863262,0.136738,1.529929,67,16,608,525,83,0.863487,0.136513,1.534915,67,16,1, merged,0,0,0.566971823131
42227,1000023,1,935,824,111,0.881283,0.118717,0.881283,100,11,936,824,112,0.880342,0.119658,0.880342,101,11,1, merged,1,1,0.000195334094863
42228,1000023,1,936,824,112,0.880342,0.119658,0.880342,101,11,937,824,113,0.879402,0.120598,0.879402,102,11,1, merged,1,1,0.000210383948762
42229,1000023,1,937,824,113,0.879402,0.120598,0.879402,102,11,938,825,113,0.879531,0.120469,0.879531,102,11,1, merged,0,0,0.000212531755637
42233,1000003,3,1085,903,182,0.832258,0.167742,2.537468,164,18,1086,904,182,0.832413,0.167587,2.537343,164,18,1, merged,0,0,0.0131436523891
42233,1000023,2,938,825,113,0.879531,0.120469,1.70521,102,11,939,826,113,0.879659,0.120341,1.704931,102,11,1, merged,0,0,0.00539125710946
42233,1000109,5,476,405,71,0.85084,0.14916,4.267889,66,5,477,406,71,0.851153,0.148847,4.268705,66,5,1, merged,0,0,0.0227519327275
42233,1000110,4,191,168,23,0.879581,0.120419,3.417049,21,2,192,169,23,0.880208,0.119792,3.417552,21,2,1, merged,0,0,0
42233,1000121,1,2025,1672,353,0.825679,0.174321,0.825679,329,24,2026,1672,354,0.825271,0.174729,0.825271,330,24,1, merged,1,1,0.00137137005191
42241,1000004,1,3053,2714,339,0.888962,0.111038,0.888962,263,76,3054,2715,339,0.888998,0.111002,0.888998,263,76,1, merged,0,0,0.0114634751305
42246,1000023,1,939,826,113,0.879659,0.120341,0.879659,102,11,940,826,114,0.878723,0.121277,0.878723,103,11,1, merged,1,1,0.00110556044782
42261,1000110,2,192,169,23,0.880208,0.119792,1.661458,21,2,193,170,23,0.880829,0.119171,1.663051,21,2,1, merged,0,0,0.571021394065
42262,1000199,2,394,335,59,0.850254,0.149746,1.850254,53,6,395,336,59,0.850633,0.149367,1.850633,53,6,1, merged,0,0,0
42266,1000121,2,2026,1672,354,0.825271,0.174729,1.511403,330,24,2028,1673,355,0.824951,0.175049,1.512894,331,24,-1, merged,1,0,0.451542620658
42274,1000105,3,513,398,115,0.775828,0.224172,2.382681,104,11,514,399,115,0.776265,0.223735,2.383194,104,11,1, merged,0,0,0.700488044145
42274,1000121,2,2030,1674,356,0.824631,0.175369,1.606853,332,24,2031,1674,357,0.824225,0.175775,1.60693,333,24,1, merged,1,1,0.436559744972
42276,1000014,1,2112,1782,330,0.84375,0.15625,0.84375,307,23,2114,1782,332,0.842952,0.157048,0.842952,309,23,1, abandoned,1,1,0
42290,1000014,1,2114,1782,332,0.842952,0.157048,0.842952,309,23,2115,1783,332,0.843026,0.156974,0.843026,309,23,1, merged,0,0,0.0288134886722
42290,1000054,2,619,536,83,0.865913,0.134087,1.708865,67,16,620,537,83,0.866129,0.133871,1.709155,67,16,1, merged,0,0,0.0240334245417
42291,1000023,1,942,828,114,0.878981,0.121019,0.878981,103,11,943,829,114,0.879109,0.120891,0.879109,103,11,1, merged,0,0,0.0037902749314
42291,1000120,3,1470,1260,210,0.857143,0.142857,2.623624,183,27,1471,1261,210,0.85724,0.14276,2.625238,183,27,1, merged,0,0,0.0623799468062
42294,1000026,1,415,378,37,0.910843,0.089157,0.910843,35,2,417,380,37,0.911271,0.088729,0.911271,35,2,-1, merged,0,0,0.485522610849
42294,1000054,2,620,537,83,0.866129,0.133871,1.776972,67,16,621,538,83,0.866345,0.133655,1.777616,67,16,1, merged,0,0,0.454271527376
42301,1000015,1,1913,1716,197,0.89702,0.10298,0.89702,179,18,1914,1717,197,0.897074,0.102926,0.897074,179,18,-1, merged,0,0,7.24308233989e-05
42302,1000015,2,1914,1717,197,0.897074,0.102926,1.763419,179,18,1916,1719,197,0.897182,0.102818,1.763741,179,18,1, merged,0,0,0.0212560793807
42302,1000054,1,621,538,83,0.866345,0.133655,0.866345,67,16,622,539,83,0.866559,0.133441,0.866559,67,16,-1, merged,0,0,0.025564393471
42304,1000026,1,417,380,37,0.911271,0.088729,0.911271,35,2,418,380,38,0.909091,0.090909,0.909091,36,2,1, merged,1,1,0.881518174134
42304,1000120,2,1473,1262,211,0.856755,0.143245,1.768026,184,27,1474,1263,211,0.856852,0.143148,1.765943,184,27,1, merged,0,0,0.264076378519
42306,1000015,2,1916,1719,197,0.897182,0.102818,1.791918,179,18,1917,1720,197,0.897235,0.102765,1.797235,179,18,1, merged,0,0,0.0269799510577
42308,1000070,4,1125,975,150,0.866667,0.133333,2.870568,126,24,1128,977,151,0.866135,0.133865,2.886737,127,24,-1, merged,1,0,0.0312235591189
42308,1000328,3,836,618,218,0.739234,0.260766,2.003902,195,23,838,619,219,0.738663,0.261337,2.020602,196,23,1, merged,1,1,0.0873870778051
42308,1002169,5,348,221,127,0.635057,0.364943,3.505626,121,6,349,222,127,0.636103,0.363897,3.52284,121,6,-1, merged,0,0,0
42309,1000015,1,1917,1720,197,0.897235,0.102765,0.897235,179,18,1918,1721,197,0.897289,0.102711,0.897289,179,18,1, merged,0,0,0.000469620410247
42309,1000120,2,1474,1263,211,0.856852,0.143148,1.754087,184,27,1475,1264,211,0.856949,0.143051,1.754238,184,27,1, merged,0,0,0.0413046345713
42312,1000329,1,2803,2183,620,0.778808,0.221192,0.778808,533,87,2804,2184,620,0.778887,0.221113,0.778887,533,87,-1, abandoned,0,0,0.642080217694
42313,1000004,1,3063,2724,339,0.889324,0.110676,0.889324,263,76,3064,2725,339,0.88936,0.11064,0.88936,263,76,1, merged,0,0,0.189981110608
42313,1000329,2,2804,2184,620,0.778887,0.221113,1.668211,533,87,2805,2185,620,0.778966,0.221034,1.668326,533,87,1, merged,0,0,0.223376516145
42314,1000004,1,3064,2725,339,0.88936,0.11064,0.88936,263,76,3065,2726,339,0.889396,0.110604,0.889396,263,76,1, merged,0,0,0.190031106046
42314,1000329,2,2805,2185,620,0.778966,0.221034,1.668326,533,87,2806,2186,620,0.779045,0.220955,1.668441,533,87,1, merged,0,0,0.223580526835
42315,1000327,1,677,534,143,0.788774,0.211226,0.788774,110,33,679,536,143,0.789396,0.210604,0.789396,110,33,-1, merged,0,0,0.674641356414
42315,1000329,2,2806,2186,620,0.779045,0.220955,1.567819,533,87,2808,2188,620,0.779202,0.220798,1.568598,533,87,-1, merged,0,0,0.642277602918
42317,1000109,3,478,407,71,0.851464,0.148536,2.502097,66,5,479,408,71,0.851775,0.148225,2.495284,66,5,-1, merged,0,0,0.0143846539802
42317,1000199,1,395,336,59,0.850633,0.149367,0.850633,53,6,397,337,60,0.848866,0.151134,0.848866,54,6,-1, merged,1,0,0.0156682858333
42328,1000011,1,688,632,56,0.918605,0.081395,0.918605,51,5,689,633,56,0.918723,0.081277,0.918723,51,5,-1, abandoned,0,0,0
42330,1000327,2,679,536,143,0.789396,0.210604,1.571334,110,33,680,537,143,0.789706,0.210294,1.572123,110,33,-1, abandoned,0,0,0.304863262008
42331,1000070,3,1128,977,151,0.866135,0.133865,2.163704,127,24,1129,977,152,0.865368,0.134632,2.148737,128,24,1, abandoned,1,1,0.826979373965
42347,1000014,4,2118,1786,332,0.843248,0.156752,3.26291,309,23,2119,1787,332,0.843322,0.156678,3.26431,309,23,1, merged,0,0,0.650471714708
42347,1000121,2,2032,1675,357,0.824311,0.175689,1.678388,333,24,2034,1677,357,0.824484,0.175516,1.679185,333,24,1, merged,0,0,0.362073395406
42358,1000043,2,519,436,83,0.840077,0.159923,1.316268,70,13,520,437,83,0.840385,0.159615,1.328757,70,13,1, merged,0,0,0.444473457846
42361,1000014,1,2119,1787,332,0.843322,0.156678,0.843322,309,23,2120,1787,333,0.842925,0.157075,0.842925,310,23,1, abandoned,1,1,0
42362,1000054,2,626,543,83,0.867412,0.132588,1.669065,67,16,627,544,83,0.867624,0.132376,1.662706,67,16,1, merged,0,0,0.000743423208339
42363,1000120,2,1477,1266,211,0.857143,0.142857,1.545086,184,27,1478,1267,211,0.85724,0.14276,1.540338,184,27,1, merged,0,0,0.38308440805
42366,1000023,1,944,830,114,0.879237,0.120763,0.879237,103,11,945,831,114,0.879365,0.120635,0.879365,103,11,1, merged,0,0,0.0074594767963
42370,1000004,2,3067,2728,339,0.889469,0.110531,1.689469,263,76,3069,2729,340,0.889215,0.110785,1.639215,264,76,1, merged,1,1,0.0287989806875
42370,1000120,3,1479,1268,211,0.857336,0.142664,2.546805,184,27,1480,1269,211,0.857432,0.142568,2.496647,184,27,1, merged,0,0,0.0832780908187
42371,1000199,2,397,337,60,0.848866,0.151134,1.645327,54,6,398,338,60,0.849246,0.150754,1.647492,54,6,1, merged,0,0,0.342461480684
42375,1000130,3,380,313,67,0.823684,0.176316,2.3289,52,15,381,314,67,0.824147,0.175853,2.326978,52,15,1, merged,0,0,0.0566722801315
42377,1000003,1,1086,904,182,0.832413,0.167587,0.832413,164,18,1087,905,182,0.832567,0.167433,0.832567,164,18,1, merged,0,0,0.374427473153
42377,1000121,3,2034,1677,357,0.824484,0.175516,2.451978,333,24,2035,1678,357,0.82457,0.17543,2.453885,333,24,1, merged,0,0,0.350096667804
42385,1000004,3,3069,2729,340,0.889215,0.110785,2.587458,264,76,3070,2730,340,0.889251,0.110749,2.588318,264,76,1, merged,0,0,0.0271690505824
42385,1000014,1,2120,1787,333,0.842925,0.157075,0.842925,310,23,2121,1787,334,0.842527,0.157473,0.842527,311,23,1, merged,1,1,0
42388,1000004,3,3070,2730,340,0.889251,0.110749,2.588318,264,76,3071,2731,340,0.889287,0.110713,2.584973,264,76,1, merged,0,0,0.0281705778875
42388,1000014,1,2121,1787,334,0.842527,0.157473,0.842527,311,23,2122,1787,335,0.84213,0.15787,0.84213,312,23,1, merged,1,1,0
42392,1000004,2,3071,2731,340,0.889287,0.110713,1.742843,264,76,3072,2732,340,0.889323,0.110677,1.739945,264,76,1, merged,0,0,0.0260020146835
42396,1000014,1,2123,1788,335,0.842204,0.157796,0.842204,312,23,2124,1788,336,0.841808,0.158192,0.841808,313,23,1, abandoned,1,1,0
42397,1000023,2,945,831,114,0.879365,0.120635,1.623268,103,11,946,832,114,0.879493,0.120507,1.626481,103,11,1, merged,0,0,0.00502776583366
42398,1000121,2,2035,1678,357,0.82457,0.17543,1.722476,333,24,2036,1679,357,0.824656,0.175344,1.717885,333,24,1, merged,0,0,0.0908222670567
42398,1000132,1,382,343,39,0.897906,0.102094,0.897906,29,10,384,343,41,0.893229,0.106771,0.893229,29,12,-1, merged,1,1,0.106257254897
42403,1000026,2,422,384,38,0.909953,0.090047,1.777787,36,2,423,385,38,0.910165,0.089835,1.77821,36,2,1, merged,0,0,0.244560132597
42403,1000054,1,628,545,83,0.867834,0.132166,0.867834,67,16,629,546,83,0.868045,0.131955,0.868045,67,16,1, merged,0,0,0.238572206295
42408,1000004,1,3072,2732,340,0.889323,0.110677,0.889323,264,76,3073,2732,341,0.889034,0.110966,0.889034,265,76,1, merged,1,1,0.40852466223
42408,1000121,2,2036,1679,357,0.824656,0.175344,1.713979,333,24,2037,1680,357,0.824742,0.175258,1.713776,333,24,1, merged,0,0,0.404745188409
42408,1000328,3,838,619,219,0.738663,0.261337,2.452643,196,23,839,619,220,0.737783,0.262217,2.451559,196,24,-1, merged,1,1,0.450682246243
42413,1000015,1,1918,1721,197,0.897289,0.102711,0.897289,179,18,1919,1722,197,0.897342,0.102658,0.897342,179,18,1, merged,0,0,4.14542138208e-05
42413,1000108,2,134,111,23,0.828358,0.171642,1.725647,19,4,135,112,23,0.82963,0.17037,1.726972,19,4,1, merged,0,0,0
42414,1000015,1,1919,1722,197,0.897342,0.102658,0.897342,179,18,1920,1722,198,0.896875,0.103125,0.896875,180,18,1, abandoned,1,1,0.000165811700088
42414,1000108,2,135,112,23,0.82963,0.17037,1.726972,19,4,136,113,23,0.830882,0.169118,1.727757,19,4,-1, abandoned,0,0,0.0013468013468
42415,1000054,2,629,546,83,0.868045,0.131955,1.58233,67,16,630,547,83,0.868254,0.131746,1.601587,67,16,1, merged,0,0,0.114106225553
42418,1000004,1,3073,2732,341,0.889034,0.110966,0.889034,265,76,3075,2734,341,0.889106,0.110894,0.889106,265,76,-1, merged,0,0,0.0792838707827
42418,1000014,2,2124,1788,336,0.841808,0.158192,1.730841,313,23,2126,1790,336,0.841957,0.158043,1.731062,313,23,-1, merged,0,0,0.0898657418902
42419,1000121,1,2039,1681,358,0.824424,0.175576,0.824424,334,24,2040,1682,358,0.82451,0.17549,0.82451,334,24,1, merged,0,0,0.0626754031083
42428,1000026,1,423,385,38,0.910165,0.089835,0.910165,36,2,425,386,39,0.908235,0.091765,0.908235,37,2,-1, merged,1,0,0.00913160319141
42433,1000108,2,136,113,23,0.830882,0.169118,1.641693,19,4,137,114,23,0.832117,0.167883,1.644951,19,4,1, merged,0,0,0.172458415885
42433,1000140,1,185,150,35,0.810811,0.189189,0.810811,31,4,187,152,35,0.812834,0.187166,0.812834,31,4,-1, merged,0,0,0.202426097023
42436,1000110,2,197,173,24,0.878173,0.121827,1.680642,22,2,199,174,25,0.874372,0.125628,1.67925,23,2,1, abandoned,1,1,0
42440,1000004,2,3075,2734,341,0.889106,0.110894,1.687493,265,76,3076,2735,341,0.889142,0.110858,1.690729,265,76,-1, merged,0,0,0.00128755556138
42445,1000003,1,1087,905,182,0.832567,0.167433,0.832567,164,18,1089,907,182,0.832874,0.167126,0.832874,164,18,1, merged,0,0,0.489739005839
42445,1000004,2,3076,2735,341,0.889142,0.110858,1.721708,265,76,3077,2735,342,0.888853,0.111147,1.721727,265,77,-1, merged,1,1,0.381968030273
42445,1000054,3,634,551,83,0.869085,0.130915,2.590794,67,16,635,552,83,0.869291,0.130709,2.591018,67,16,1, merged,0,0,0.418837061124
42455,1000105,2,515,400,115,0.776699,0.223301,1.674812,104,11,516,401,115,0.777132,0.222868,1.675628,104,11,1, merged,0,0,0.368806665033
42457,1000105,2,516,401,115,0.777132,0.222868,1.675628,104,11,517,402,115,0.777563,0.222437,1.676439,104,11,1, merged,0,0,0.426028778858
42458,1000054,1,636,553,83,0.869497,0.130503,0.869497,67,16,638,554,84,0.868339,0.131661,0.868339,68,16,1, merged,1,1,0.0149559525307
42460,1000054,1,638,554,84,0.868339,0.131661,0.868339,68,16,639,555,84,0.868545,0.131455,0.868545,68,16,1, merged,0,0,0.70905191782
42462,1000328,2,839,619,220,0.737783,0.262217,1.587377,196,24,840,620,220,0.738095,0.261905,1.584869,196,24,1, merged,0,0,0
42466,1000004,3,3077,2735,342,0.888853,0.111147,2.449913,265,77,3079,2736,343,0.8886,0.1114,2.356974,266,77,-1, abandoned,1,0,0.0304441609427
42467,1000592,3,653,557,96,0.852986,0.147014,2.489832,60,36,654,558,96,0.853211,0.146789,2.481204,60,36,-1, abandoned,0,0,0.179991340636
42470,1000329,2,2809,2189,620,0.779281,0.220719,1.610742,533,87,2810,2190,620,0.779359,0.220641,1.611762,533,87,1, merged,0,0,0
42472,1000005,1,436,354,82,0.811927,0.188073,0.811927,76,6,437,354,83,0.810069,0.189931,0.810069,77,6,1, merged,1,1,0
42472,1000054,2,642,557,85,0.867601,0.132399,1.679528,69,16,646,561,85,0.868421,0.131579,1.67849,69,16,-1, merged,0,0,0
42481,1000014,3,2126,1790,336,0.841957,0.158043,2.430253,313,23,2127,1791,336,0.842031,0.157969,2.45223,313,23,1, merged,0,0,0.107904902843
42484,1000592,4,654,558,96,0.853211,0.146789,3.19022,60,36,655,559,96,0.853435,0.146565,3.196876,60,36,1, merged,0,0,0
42485,1000043,2,520,437,83,0.840385,0.159615,1.629746,70,13,521,438,83,0.840691,0.159309,1.6305,70,13,1, merged,0,0,0.547183098592
42489,1000328,1,840,620,220,0.738095,0.261905,0.738095,196,24,842,621,221,0.73753,0.26247,0.73753,197,24,1, merged,1,1,0.64370298732
42489,1000592,2,655,559,96,0.853435,0.146565,1.59153,60,36,656,560,96,0.853659,0.146341,1.591188,60,36,-1, merged,0,0,0.571733734793
42493,1000592,2,656,560,96,0.853659,0.146341,1.525087,60,36,657,560,97,0.852359,0.147641,1.514331,61,36,1, abandoned,1,1,0.331733376722
42499,1000132,2,385,344,41,0.893506,0.106494,1.550649,29,12,386,345,41,0.893782,0.106218,1.532671,29,12,1, merged,0,0,0.199160005785
42515,1000014,2,2127,1791,336,0.842031,0.157969,1.667055,313,23,2128,1792,336,0.842105,0.157895,1.667215,313,23,1, merged,0,0,0.326160684979
42515,1000121,1,2046,1688,358,0.825024,0.174976,0.825024,334,24,2047,1689,358,0.82511,0.17489,0.82511,334,24,1, merged,0,0,0.18107037875
42521,1000014,2,2128,1792,336,0.842105,0.157895,1.685479,313,23,2129,1793,336,0.842179,0.157821,1.686179,313,23,-1, merged,0,0,0
42533,1000023,1,950,836,114,0.88,0.12,0.88,103,11,951,837,114,0.880126,0.119874,0.880126,103,11,1, merged,0,0,0.26977858424
42541,1000026,1,426,387,39,0.908451,0.091549,0.908451,37,2,429,389,40,0.90676,0.09324,0.90676,38,2,1, merged,1,1,0
42541,1000054,3,654,569,85,0.870031,0.129969,2.629056,69,16,655,570,85,0.870229,0.129771,2.619686,69,16,1, merged,0,0,0
42545,1000120,3,1482,1271,211,0.857625,0.142375,2.504774,184,27,1483,1272,211,0.857721,0.142279,2.49744,184,27,1, merged,0,0,0.184100621962
42553,1000004,1,3083,2740,343,0.888745,0.111255,0.888745,266,77,3085,2742,343,0.888817,0.111183,0.888817,266,77,-1, merged,0,0,0.0090148979161
42553,1000120,2,1484,1273,211,0.857817,0.142183,1.746561,184,27,1485,1274,211,0.857912,0.142088,1.746729,184,27,1, merged,0,0,0.0171650694685
42555,1000003,3,1091,909,182,0.833181,0.166819,2.636841,164,18,1092,910,182,0.833333,0.166667,2.637143,164,18,1, merged,0,0,0.768328948337
42555,1000015,2,1924,1726,198,0.897089,0.102911,1.80366,180,18,1925,1727,198,0.897143,0.102857,1.80381,180,18,1, merged,0,0,0.934816741948
42555,1000153,1,974,883,91,0.906571,0.093429,0.906571,68,23,975,884,91,0.906667,0.093333,0.906667,68,23,-1, merged,0,0,1.05401218265
42561,1000329,2,2810,2190,620,0.779359,0.220641,1.294511,533,87,2811,2191,620,0.779438,0.220562,1.30885,533,87,1, merged,0,0,0
42567,1000004,2,3087,2744,343,0.888889,0.111111,1.888889,266,77,3089,2745,344,0.888637,0.111363,1.72197,267,77,1, merged,1,1,0
42571,1000004,2,3089,2745,344,0.888637,0.111363,1.746645,267,77,3090,2746,344,0.888673,0.111327,1.746777,267,77,1, merged,0,0,0.131469676169
42571,1000120,1,1486,1275,211,0.858008,0.141992,0.858008,184,27,1487,1276,211,0.858104,0.141896,0.858104,184,27,1, merged,0,0,0.085082677295
42574,1000023,2,952,837,115,0.879202,0.120798,1.692036,104,11,954,837,117,0.877358,0.122642,1.685869,106,11,1, abandoned,1,1,0
42574,1000140,1,187,152,35,0.812834,0.187166,0.812834,31,4,188,152,36,0.808511,0.191489,0.808511,32,4,1, abandoned,1,1,0
42576,1000130,1,384,317,67,0.825521,0.174479,0.825521,52,15,385,318,67,0.825974,0.174026,0.825974,52,15,1, merged,0,0,0
42586,1000023,2,955,838,117,0.877487,0.122513,1.784154,106,11,956,839,117,0.877615,0.122385,1.783353,106,11,1, merged,0,0,0.000624779066613
42586,1000153,1,975,884,91,0.906667,0.093333,0.906667,68,23,976,884,92,0.905738,0.094262,0.905738,69,23,1, merged,1,1,0.00104567352579
42587,1000130,1,385,318,67,0.825974,0.174026,0.825974,52,15,387,320,67,0.826873,0.173127,0.826873,52,15,1, merged,0,0,0
42588,1000130,1,387,320,67,0.826873,0.173127,0.826873,52,15,388,321,67,0.82732,0.17268,0.82732,52,15,1, merged,0,0,0
42592,1000054,2,657,572,85,0.870624,0.129376,1.870624,69,16,658,573,85,0.870821,0.129179,1.870821,69,16,1, merged,0,0,0
42592,1000121,3,2049,1691,358,0.825281,0.174719,2.695905,334,24,2050,1692,358,0.825366,0.174634,2.696187,334,24,1, merged,0,0,0
42598,1000004,2,3090,2746,344,0.888673,0.111327,1.715993,267,77,3091,2747,344,0.888709,0.111291,1.71435,267,77,1, merged,0,0,0
42598,1000130,1,388,321,67,0.82732,0.17268,0.82732,52,15,390,322,68,0.825641,0.174359,0.825641,53,15,1, merged,1,1,0
42601,1000004,1,3091,2747,344,0.888709,0.111291,0.888709,267,77,3093,2748,345,0.888458,0.111542,0.888458,268,77,1, merged,1,1,0.0345656401212
42603,1000153,1,977,885,92,0.905834,0.094166,0.905834,69,23,980,888,92,0.906122,0.093878,0.906122,69,23,-1, merged,0,0,0.923076095519
42604,1000014,2,2130,1794,336,0.842254,0.157746,1.640703,313,23,2133,1796,337,0.842007,0.157993,1.629885,314,23,-1, merged,1,0,0.326338407848
42604,1000121,5,2050,1692,358,0.825366,0.174634,4.162187,334,24,2051,1693,358,0.825451,0.174549,4.122003,334,24,1, merged,0,0,0.181089732345
42607,1000003,1,1092,910,182,0.833333,0.166667,0.833333,164,18,1093,911,182,0.833486,0.166514,0.833486,164,18,1, merged,0,0,0.0229965809564
42607,1000109,3,482,410,72,0.850622,0.149378,2.488237,67,5,483,411,72,0.850932,0.149068,2.489296,67,5,1, merged,0,0,0.0414800514801
42627,1000014,1,2133,1796,337,0.842007,0.157993,0.842007,314,23,2134,1796,338,0.841612,0.158388,0.841612,315,23,1, merged,1,1,0
42627,1000070,2,1141,984,157,0.862401,0.137599,1.704408,133,24,1142,985,157,0.862522,0.137478,1.704134,133,24,1, merged,0,0,0
42630,1000015,1,1925,1727,198,0.897143,0.102857,0.897143,180,18,1930,1730,200,0.896373,0.103627,0.896373,182,18,-1, abandoned,1,0,0
42630,1000054,2,665,579,86,0.870677,0.129323,1.76782,70,16,666,579,87,0.869369,0.130631,1.765742,71,16,1, abandoned,1,1,0.102086240586
42631,1000015,1,1930,1730,200,0.896373,0.103627,0.896373,182,18,1931,1731,200,0.896427,0.103573,0.896427,182,18,1, merged,0,0,0.0894588293501
42631,1000054,2,666,579,87,0.869369,0.130631,1.765742,71,16,667,580,87,0.869565,0.130435,1.765992,71,16,1, merged,0,0,0.083158407874
42645,1000592,2,658,561,97,0.852584,0.147416,1.642838,61,36,659,562,97,0.852807,0.147193,1.641391,61,36,1, merged,0,0,0.197298495742
42646,1000004,1,3093,2748,345,0.888458,0.111542,0.888458,268,77,3095,2749,346,0.888207,0.111793,0.888207,268,78,-1, merged,1,1,0.465922697344
42649,1000329,2,2814,2194,620,0.779673,0.220327,1.468562,533,87,2815,2195,620,0.779751,0.220249,1.475404,533,87,1, merged,0,0,0.00588051623647
42650,1000054,2,668,581,87,0.86976,0.13024,1.649031,71,16,671,583,88,0.868852,0.131148,1.648967,72,16,-1, merged,1,0,0.027825754425
42650,1000105,1,521,406,115,0.779271,0.220729,0.779271,104,11,523,408,115,0.780115,0.219885,0.780115,104,11,-1, merged,0,0,0.0130348003764
42654,1000329,1,2817,2197,620,0.779908,0.220092,0.779908,533,87,2818,2198,620,0.779986,0.220014,0.779986,533,87,1, merged,0,0,0.00650398043603
42661,1000014,1,2134,1796,338,0.841612,0.158388,0.841612,315,23,2136,1797,339,0.841292,0.158708,0.841292,316,23,1, merged,1,1,0.0601967012701
42669,1000005,2,458,373,85,0.81441,0.18559,1.594941,79,6,459,374,85,0.814815,0.185185,1.595423,79,6,1, merged,0,0,0.0187147688839
42669,1000329,1,2825,2205,620,0.780531,0.219469,0.780531,533,87,2826,2206,620,0.780609,0.219391,0.780609,533,87,1, merged,0,0,0.00837320574163
42672,1000153,1,980,888,92,0.906122,0.093878,0.906122,69,23,981,889,92,0.906218,0.093782,0.906218,69,23,-1, abandoned,0,0,0
42675,1000004,2,3096,2750,346,0.888243,0.111757,1.601953,268,78,3097,2751,346,0.888279,0.111721,1.599122,268,78,-1, abandoned,0,0,0.000723212873189
42678,1000043,2,525,441,84,0.84,0.16,1.506667,71,13,526,442,84,0.840304,0.159696,1.340304,71,13,-1, abandoned,0,0,0.689008815821
42680,1000043,3,526,442,84,0.840304,0.159696,2.486921,71,13,527,443,84,0.840607,0.159393,2.387616,71,13,-1, abandoned,0,0,0.031823165365
42686,1000130,2,391,323,68,0.826087,0.173913,1.621542,53,15,392,324,68,0.826531,0.173469,1.6225,53,15,1, merged,0,0,0.737292437506
42697,1000023,1,964,847,117,0.878631,0.121369,0.878631,106,11,965,848,117,0.878756,0.121244,0.878756,106,11,1, merged,0,0,0.000998422246327
42698,1000023,2,965,848,117,0.878756,0.121244,1.669386,106,11,966,849,117,0.878882,0.121118,1.669818,106,11,1, merged,0,0,0.00161882770578
42706,1000014,1,2136,1797,339,0.841292,0.158708,0.841292,316,23,2137,1798,339,0.841366,0.158634,0.841366,316,23,-1, abandoned,0,0,0.248250448238
42706,1000105,2,523,408,115,0.780115,0.219885,1.621407,104,11,524,409,115,0.780534,0.219466,1.621901,104,11,-1, abandoned,0,0,0.313520194601
42708,1002169,1,349,222,127,0.636103,0.363897,0.636103,121,6,362,235,127,0.649171,0.350829,0.649171,121,6,-1, merged,0,0,0
42712,1002169,2,362,235,127,0.649171,0.350829,1.493616,121,6,363,236,127,0.650138,0.349862,1.487094,121,6,-1, merged,0,0,0
42716,1000130,1,394,326,68,0.827411,0.172589,0.827411,53,15,396,328,68,0.828283,0.171717,0.828283,53,15,-1, merged,0,0,0.038972593529
42721,1000005,1,461,375,86,0.813449,0.186551,0.813449,80,6,462,376,86,0.813853,0.186147,0.813853,80,6,1, merged,0,0,0
42721,1000015,2,1931,1731,200,0.896427,0.103573,1.709876,182,18,1932,1732,200,0.89648,0.10352,1.710333,182,18,1, merged,0,0,0
42724,1000023,1,970,853,117,0.879381,0.120619,0.879381,106,11,971,853,118,0.878476,0.121524,0.878476,107,11,1, abandoned,1,1,0.297252563086
42724,1000091,2,498,385,113,0.773092,0.226908,1.652474,96,17,499,385,114,0.771543,0.228457,1.650019,97,17,1, abandoned,1,1,0.476002717231
42726,1000004,3,3097,2751,346,0.888279,0.111721,1.964469,268,78,3099,2753,346,0.888351,0.111649,2.131732,268,78,1, merged,0,0,0
42738,1000043,2,527,443,84,0.840607,0.159393,1.670539,71,13,528,444,84,0.840909,0.159091,1.67199,71,13,-1, abandoned,0,0,0.601612124427
42746,1000166,1,410,325,85,0.792683,0.207317,0.792683,81,4,412,325,87,0.788835,0.211165,0.788835,83,4,1, merged,1,1,0.0606021673018
42747,1000004,1,3099,2753,346,0.888351,0.111649,0.888351,268,78,3102,2754,348,0.887814,0.112186,0.887814,270,78,-1, merged,1,0,0.135889918526
42747,1000327,4,683,539,144,0.789165,0.210835,2.415668,111,33,684,540,144,0.789474,0.210526,2.414877,111,33,-1, merged,0,0,0.187581120402
42747,1000328,3,844,623,221,0.738152,0.261848,1.626503,197,24,846,624,222,0.737589,0.262411,1.625403,198,24,1, merged,1,1,0.141902231069
42748,1000005,1,463,377,86,0.814255,0.185745,0.814255,80,6,464,378,86,0.814655,0.185345,0.814655,80,6,-1, abandoned,0,0,0.00340289044888
42752,1000023,2,972,853,119,0.877572,0.122428,1.502572,108,11,973,854,119,0.877698,0.122302,1.544365,108,11,1, merged,0,0,0
42754,1000153,1,982,890,92,0.906314,0.093686,0.906314,69,23,984,891,93,0.905488,0.094512,0.905488,70,23,1, merged,1,1,0.0739475532558
42755,1000003,2,1093,911,182,0.833486,0.166514,1.686004,164,18,1094,912,182,0.833638,0.166362,1.686685,164,18,1, merged,0,0,0.100719970572
42755,1000014,3,2137,1798,339,0.841366,0.158634,2.52737,316,23,2138,1799,339,0.841441,0.158559,2.528125,316,23,1, merged,0,0,0.143935497446
42756,1000023,2,973,854,119,0.877698,0.122302,1.544365,108,11,974,855,119,0.877823,0.122177,1.577823,108,11,1, merged,0,0,0
42759,1000014,2,2138,1799,339,0.841441,0.158559,1.437185,316,23,2140,1801,339,0.841589,0.158411,1.433426,316,23,-1, merged,0,0,0.0786940702985
42767,1000054,2,677,589,88,0.870015,0.129985,1.730309,72,16,678,590,88,0.870206,0.129794,1.727871,72,16,1, merged,0,0,0
42770,1000004,1,3102,2754,348,0.887814,0.112186,0.887814,270,78,3103,2755,348,0.88785,0.11215,0.88785,270,78,1, merged,0,0,0.43735551933
42770,1000592,2,659,562,97,0.852807,0.147193,1.740622,61,36,660,563,97,0.85303,0.14697,1.740881,61,36,1, merged,0,0,0.603279476042
42778,1000015,2,1934,1734,200,0.896587,0.103413,1.803347,182,18,1935,1735,200,0.896641,0.103359,1.803618,182,18,1, merged,0,0,0
42778,1000026,1,429,389,40,0.90676,0.09324,0.90676,38,2,430,390,40,0.906977,0.093023,0.906977,38,2,1, merged,0,0,0
42780,1000043,2,528,444,84,0.840909,0.159091,1.635909,71,13,529,445,84,0.84121,0.15879,1.636721,71,13,1, merged,0,0,0.609915990376
42784,1000014,2,2140,1801,339,0.841589,0.158411,0.841589,316,23,2142,1803,339,0.841737,0.158263,0.841737,316,23,-1, merged,0,0,0
42797,1000014,2,2144,1804,340,0.841418,0.158582,1.622027,317,23,2145,1805,340,0.841492,0.158508,1.622256,317,23,1, merged,0,0,0.505120469025
42797,1000329,1,2826,2206,620,0.780609,0.219391,0.780609,533,87,2828,2208,620,0.780764,0.219236,0.780764,533,87,-1, merged,0,0,0.487302598033
42799,1000070,2,1144,987,157,0.862762,0.137238,1.64054,133,24,1145,988,157,0.862882,0.137118,1.636605,133,24,1, merged,0,0,0.0414987580593
42800,1000023,2,976,857,119,0.878074,0.121926,1.729005,108,11,977,858,119,0.878199,0.121801,1.729438,108,11,1, merged,0,0,0.000191808049639
42800,1000109,1,483,411,72,0.850932,0.149068,0.850932,67,5,484,412,72,0.85124,0.14876,0.85124,67,5,1, merged,0,0,0.000875001943906
42809,1000004,2,3103,2755,348,0.88785,0.11215,1.38785,270,78,3104,2756,348,0.887887,0.112113,1.487887,270,78,1, merged,0,0,0.046063355799
42815,1000105,2,524,409,115,0.780534,0.219466,1.605985,104,11,525,410,115,0.780952,0.219048,1.606488,104,11,1, merged,0,0,0.00246153846154
42815,1000121,1,2051,1693,358,0.825451,0.174549,0.825451,334,24,2052,1694,358,0.825536,0.174464,0.825536,334,24,1, merged,0,0,0.00129599254804
42819,1000023,2,978,859,119,0.878323,0.121677,1.77238,108,11,979,860,119,0.878447,0.121553,1.772777,108,11,1, merged,0,0,0
42819,1000132,1,387,346,41,0.894057,0.105943,0.894057,29,12,388,347,41,0.89433,0.10567,0.89433,29,12,1, merged,0,0,0
42824,1000091,2,499,385,114,0.771543,0.228457,1.545266,97,17,500,386,114,0.772,0.228,1.547362,97,17,1, merged,0,0,0.46249152892
42836,1000003,1,1095,913,182,0.83379,0.16621,0.83379,164,18,1096,914,182,0.833942,0.166058,0.833942,164,18,1, merged,0,0,0.482769397339
42836,1000109,2,485,413,72,0.851546,0.148454,1.685336,67,5,486,414,72,0.851852,0.148148,1.685793,67,5,1, merged,0,0,0.147495029694
42837,1000014,2,2146,1806,340,0.841566,0.158434,1.69986,317,23,2147,1807,340,0.841639,0.158361,1.699453,317,23,1, merged,0,0,0.163380740874
42837,1000120,1,1489,1278,211,0.858294,0.141706,0.858294,184,27,1491,1279,212,0.857814,0.142186,0.857814,185,27,1, merged,1,1,0.119951764324
42837,1000199,3,398,338,60,0.849246,0.150754,2.549106,54,6,399,339,60,0.849624,0.150376,2.549077,54,6,1, merged,0,0,0.0581583544802
42839,1000026,1,430,390,40,0.906977,0.093023,0.906977,38,2,431,391,40,0.907193,0.092807,0.907193,38,2,1, merged,0,0,0.256002923759
42839,1000199,2,399,339,60,0.849624,0.150376,1.756601,54,6,400,340,60,0.85,0.15,1.757193,54,6,1, merged,0,0,0.0859544972528
42847,1000003,1,1096,914,182,0.833942,0.166058,0.833942,164,18,1098,916,182,0.834244,0.165756,0.834244,164,18,-1, merged,0,0,0.0138517135958
42847,1000026,2,431,391,40,0.907193,0.092807,1.741134,38,2,432,392,40,0.907407,0.092593,1.741651,38,2,1, merged,0,0,0.04190413338
42853,1000054,2,678,590,88,0.870206,0.129794,1.659041,72,16,679,591,88,0.870398,0.129602,1.659744,72,16,1, merged,0,0,0.592345474349
42853,1000166,1,412,325,87,0.788835,0.211165,0.788835,83,4,413,326,87,0.789346,0.210654,0.789346,83,4,1, merged,0,0,0.427201407516
42857,1000054,3,679,591,88,0.870398,0.129602,2.811574,72,16,680,592,88,0.870588,0.129412,2.815033,72,16,1, merged,0,0,0.208455737344
42859,1000004,2,3105,2757,348,0.887923,0.112077,1.745736,270,78,3107,2759,348,0.887995,0.112005,1.745233,270,78,-1, merged,0,0,0.00780683822455
42859,1000015,3,1939,1739,200,0.896854,0.103146,2.64259,182,18,1940,1740,200,0.896907,0.103093,2.642141,182,18,1, merged,0,0,0.00425050716401
42859,1000120,1,1491,1279,212,0.857814,0.142186,0.857814,185,27,1492,1279,213,0.857239,0.142761,0.857239,186,27,1, merged,1,1,0.00637075373716
42860,1000054,3,680,592,88,0.870588,0.129412,2.259934,72,16,681,593,88,0.870778,0.129222,2.3273,72,16,1, merged,0,0,0.129899232793
42860,1000166,1,413,326,87,0.789346,0.210654,0.789346,83,4,414,327,87,0.789855,0.210145,0.789855,83,4,1, merged,0,0,0.0980358102184
42862,1000054,2,681,593,88,0.870778,0.129222,1.660633,72,16,683,595,88,0.871157,0.128843,1.657214,72,16,-1, merged,0,0,0
42862,1000166,1,414,327,87,0.789855,0.210145,0.789855,83,4,416,327,89,0.786058,0.213942,0.786058,85,4,1, merged,1,1,0
42869,1000014,1,2147,1807,340,0.841639,0.158361,0.841639,317,23,2149,1809,340,0.841787,0.158213,0.841787,317,23,-1, merged,0,0,0
42869,1000110,3,200,175,25,0.875,0.125,2.492002,23,2,201,176,25,0.875622,0.124378,2.494387,23,2,1, merged,0,0,0
42881,1000130,1,402,334,68,0.830846,0.169154,0.830846,53,15,406,336,70,0.827586,0.172414,0.827586,55,15,1, merged,1,1,0.651759184528
42883,1000005,3,472,384,88,0.813559,0.186441,2.360568,82,6,473,385,88,0.813953,0.186047,2.399668,82,6,1, merged,0,0,0.315663814567
42885,1000014,2,2149,1809,340,0.841787,0.158213,1.433624,317,23,2150,1809,341,0.841395,0.158605,1.429631,318,23,1, abandoned,1,1,0.0937456464975
42887,1000153,2,986,893,93,0.90568,0.09432,1.703845,70,23,988,895,93,0.90587,0.09413,1.702223,70,23,-1, merged,0,0,0.200939080781
42888,1000003,2,1098,916,182,0.834244,0.165756,1.666244,164,18,1100,918,182,0.834545,0.165455,1.665956,164,18,-1, merged,0,0,0.379339483892
42888,1000009,1,1125,936,189,0.832,0.168,0.832,170,19,1127,937,190,0.831411,0.168589,0.831411,171,19,1, merged,1,1,0.577634713279
42889,1000105,4,525,410,115,0.780952,0.219048,3.297202,104,11,528,413,115,0.782197,0.217803,3.301901,104,11,-1, merged,0,0,0.265771239492
42889,1000108,3,137,114,23,0.832117,0.167883,2.516249,19,4,138,115,23,0.833333,0.166667,2.519704,19,4,-1, merged,0,0,0.0951200328903
42889,1000110,1,201,176,25,0.875622,0.124378,0.875622,23,2,203,178,25,0.876847,0.123153,0.876847,23,2,-1, merged,0,0,0.210234162533
42889,1000130,5,407,337,70,0.82801,0.17199,4.125212,55,15,408,338,70,0.828431,0.171569,4.130333,55,15,1, merged,0,0,0.236615614345
42889,1000140,2,188,152,36,0.808511,0.191489,1.684133,32,4,189,153,36,0.809524,0.190476,1.686371,32,4,-1, merged,0,0,0.121953989344
42902,1000004,1,3107,2759,348,0.887995,0.112005,0.887995,270,78,3110,2760,350,0.88746,0.11254,0.88746,272,78,1, merged,1,1,0.0189485762463
42903,1000004,2,3110,2760,350,0.88746,0.11254,1.48746,272,78,3111,2761,350,0.887496,0.112504,1.458925,272,78,-1, abandoned,0,0,0.0445788284752
42911,1000054,2,683,595,88,0.871157,0.128843,1.728395,72,16,684,596,88,0.871345,0.128655,1.728678,72,16,1, merged,0,0,0.191755419399
42911,1000120,1,1499,1285,214,0.857238,0.142762,0.857238,187,27,1500,1286,214,0.857333,0.142667,0.857333,187,27,1, merged,0,0,0.0691761176213
42932,1000120,2,1517,1303,214,0.858932,0.141068,1.738562,187,27,1518,1304,214,0.859025,0.140975,1.739759,187,27,1, merged,0,0,0.384679554023
42941,1000005,2,474,386,88,0.814346,0.185654,1.647679,82,6,475,387,88,0.814737,0.185263,1.649174,82,6,1, merged,0,0,0.0406417525087
42947,1000014,3,2153,1812,341,0.841616,0.158384,2.68777,318,23,2154,1813,341,0.84169,0.15831,2.498833,318,23,1, merged,0,0,0.191735611083
42950,1000004,1,3113,2763,350,0.887568,0.112432,0.887568,272,78,3114,2764,350,0.887604,0.112396,0.887604,272,78,1, merged,0,0,0.000479592848415
42950,1000120,2,1530,1316,214,0.860131,0.139869,1.747699,187,27,1531,1317,214,0.860222,0.139778,1.747826,187,27,1, merged,0,0,0.000404459368556
42953,1000014,1,2154,1813,341,0.84169,0.15831,0.84169,318,23,2157,1816,341,0.84191,0.15809,0.84191,318,23,-1, merged,0,0,0.107732967158
42957,1000004,1,3114,2764,350,0.887604,0.112396,0.887604,272,78,3115,2764,351,0.887319,0.112681,0.887319,273,78,1, abandoned,1,1,0
42960,1000105,2,528,413,115,0.782197,0.217803,1.563116,104,11,530,414,116,0.781132,0.218868,1.562128,105,11,1, merged,1,1,0
42960,1000329,1,2830,2210,620,0.780919,0.219081,0.780919,533,87,2831,2211,620,0.780996,0.219004,0.780996,533,87,-1, merged,0,0,0
42961,1000121,5,2052,1694,358,0.825536,0.174464,4.013006,334,24,2053,1694,359,0.825134,0.174866,4.008139,334,25,-1, merged,1,1,0
42961,1000329,4,2831,2211,620,0.780996,0.219004,3.18747,533,87,2832,2211,621,0.78072,0.21928,3.183005,533,88,-1, merged,1,1,0
42966,1000005,1,476,388,88,0.815126,0.184874,0.815126,82,6,477,388,89,0.813417,0.186583,0.813417,83,6,1, merged,1,1,0.0689211842978
42966,1000014,2,2157,1816,341,0.84191,0.15809,1.657036,318,23,2158,1817,341,0.841983,0.158017,1.655401,318,23,1, merged,0,0,0.217410186523
42970,1000014,2,2158,1817,341,0.841983,0.158017,1.683881,318,23,2159,1818,341,0.842057,0.157943,1.684576,318,23,1, merged,0,0,0.683783235018
42973,1000009,2,1127,937,190,0.831411,0.168589,1.553432,171,19,1128,938,190,0.83156,0.16844,1.554965,171,19,1, merged,0,0,0.168270802713
42973,1000534,1,277,200,77,0.722022,0.277978,0.722022,71,6,282,204,78,0.723404,0.276596,0.723404,72,6,-1, merged,1,0,0.160775489276
42986,1000004,2,3115,2764,351,0.887319,0.112681,1.747541,273,78,3116,2765,351,0.887356,0.112644,1.747669,273,78,1, merged,0,0,0
42986,1000120,1,1531,1317,214,0.860222,0.139778,0.860222,187,27,1532,1318,214,0.860313,0.139687,0.860313,187,27,-1, merged,0,0,0
42990,1000070,2,1145,988,157,0.862882,0.137118,1.51302,133,24,1146,988,158,0.862129,0.137871,1.513228,134,24,1, merged,1,1,0.0441431399826
42990,1000105,3,530,414,116,0.781132,0.218868,2.294152,105,11,531,415,116,0.781544,0.218456,2.294772,105,11,1, merged,0,0,0.0392440440345
42990,1002169,1,363,236,127,0.650138,0.349862,0.650138,121,6,364,237,127,0.651099,0.348901,0.651099,121,6,-1, merged,0,0,0
43001,1000014,1,2159,1818,341,0.842057,0.157943,0.842057,318,23,2160,1819,341,0.84213,0.15787,0.84213,318,23,1, merged,0,0,0.190914472862
43002,1000014,1,2160,1819,341,0.84213,0.15787,0.84213,318,23,2161,1819,342,0.84174,0.15826,0.84174,319,23,1, merged,1,1,0.503004937495
43002,1000120,2,1532,1318,214,0.860313,0.139687,1.702443,187,27,1533,1318,215,0.859752,0.140248,1.701492,188,27,1, merged,1,1,0.359659990418
43007,1000026,1,432,392,40,0.907407,0.092593,0.907407,38,2,433,393,40,0.907621,0.092379,0.907621,38,2,1, merged,0,0,0.199425375618
43007,1000054,2,684,596,88,0.871345,0.128655,1.778752,72,16,685,597,88,0.871533,0.128467,1.779154,72,16,1, merged,0,0,0.165596474825
43014,1000329,3,2834,2213,621,0.780875,0.219125,1.499438,533,88,2835,2214,621,0.780952,0.219048,2.50119,533,88,1, merged,0,0,0.241071630991
43016,1000012,1,552,478,74,0.865942,0.134058,0.865942,72,2,553,479,74,0.866184,0.133816,0.866184,72,2,1, merged,0,0,0.000585784951835
43017,1000004,2,3117,2766,351,0.887392,0.112608,1.784405,273,78,3118,2767,351,0.887428,0.112572,1.784494,273,78,1, merged,0,0,0
43017,1000015,1,1942,1742,200,0.897013,0.102987,0.897013,182,18,1943,1743,200,0.897066,0.102934,0.897066,182,18,1, merged,0,0,0
43019,1000026,1,433,393,40,0.907621,0.092379,0.907621,38,2,434,394,40,0.907834,0.092166,0.907834,38,2,1, merged,0,0,0.563896083771
43019,1000054,2,685,597,88,0.871533,0.128467,1.779154,72,16,686,598,88,0.87172,0.12828,1.779554,72,16,1, merged,0,0,0.345144235459
43022,1000003,1,1100,918,182,0.834545,0.165455,0.834545,164,18,1103,920,183,0.834089,0.165911,0.834089,165,18,-1, merged,1,0,0.226781707926
43022,1000014,2,2161,1819,342,0.84174,0.15826,1.676285,319,23,2163,1821,342,0.841886,0.158114,1.675975,319,23,-1, merged,0,0,0.217628422332
43028,1000026,1,434,394,40,0.907834,0.092166,0.907834,38,2,436,396,40,0.908257,0.091743,0.908257,38,2,1, merged,0,0,0.206645794625
43028,1000153,2,988,895,93,0.90587,0.09413,1.813705,70,23,989,896,93,0.905966,0.094034,1.814223,70,23,1, merged,0,0,0.107247094837
43032,1000003,3,1103,920,183,0.834089,0.165911,2.393009,165,18,1104,920,184,0.833333,0.166667,2.388094,166,18,1, merged,1,1,0.390461652327
43032,1000005,2,481,392,89,0.814969,0.185031,1.55892,83,6,482,392,90,0.813278,0.186722,1.554761,84,6,1, merged,1,1,0.13668833583
43032,1000014,4,2164,1822,342,0.841959,0.158041,3.234969,319,23,2166,1824,342,0.842105,0.157895,3.2302,319,23,-1, merged,0,0,0.378118861274
43034,1000121,1,2057,1698,359,0.825474,0.174526,0.825474,334,25,2058,1699,359,0.825559,0.174441,0.825559,334,25,-1, merged,0,0,0.183326874291
43036,1000043,1,535,450,85,0.841121,0.158879,0.841121,72,13,536,451,85,0.841418,0.158582,0.841418,72,13,1, merged,0,0,0.599806327537
43041,1000043,2,537,452,85,0.841713,0.158287,1.678315,72,13,538,453,85,0.842007,0.157993,1.67967,72,13,1, merged,0,0,0.648822386504
43050,1000105,2,531,415,116,0.781544,0.218456,1.641193,105,11,532,416,116,0.781955,0.218045,1.646362,105,11,1, merged,0,0,0
43051,1000004,1,3119,2768,351,0.887464,0.112536,0.887464,273,78,3122,2770,352,0.887252,0.112748,0.887252,274,78,1, merged,1,1,0
43051,1000091,2,500,386,114,0.772,0.228,1.659464,97,17,502,388,114,0.772908,0.227092,1.66016,97,17,1, merged,0,0,0
43051,1000329,3,2835,2214,621,0.780952,0.219048,2.440416,533,88,2836,2215,621,0.78103,0.21897,2.44119,533,88,1, merged,0,0,0
43055,1000091,1,502,388,114,0.772908,0.227092,0.772908,97,17,503,389,114,0.77336,0.22664,0.77336,97,17,1, merged,0,0,0.590077261021
43055,1000329,2,2836,2215,621,0.78103,0.21897,1.553938,533,88,2837,2216,621,0.781107,0.218893,1.554467,533,88,1, merged,0,0,0.677973265068
43057,1000121,1,2059,1700,359,0.825644,0.174356,0.825644,334,25,2060,1701,359,0.825728,0.174272,0.825728,334,25,1, merged,0,0,0.0697966203061
43057,1000329,2,2838,2217,621,0.781184,0.218816,1.606827,533,88,2839,2218,621,0.781261,0.218739,1.606989,533,88,1, merged,0,0,0.122041084557
43058,1000014,2,2166,1824,342,0.842105,0.157895,1.701857,319,23,2167,1825,342,0.842178,0.157822,1.702022,319,23,1, merged,0,0,0.177053503849
43058,1000120,1,1533,1318,215,0.859752,0.140248,0.859752,188,27,1534,1319,215,0.859844,0.140156,0.859844,188,27,1, merged,0,0,0.11759992116
43059,1000009,2,1128,938,190,0.83156,0.16844,1.728627,171,19,1129,939,190,0.831709,0.168291,1.728314,171,19,-1, abandoned,0,0,0
43059,1000015,1,1943,1743,200,0.897066,0.102934,0.897066,182,18,1944,1743,201,0.896605,0.103395,0.896605,183,18,1, abandoned,1,1,0
43068,1000004,1,3123,2771,352,0.887288,0.112712,0.887288,274,78,3125,2773,352,0.88736,0.11264,0.88736,274,78,-1, abandoned,0,0,0.0202710879075
43068,1000329,3,2839,2218,621,0.781261,0.218739,2.43778,533,88,2840,2219,621,0.781338,0.218662,2.454412,533,88,-1, abandoned,0,0,0.0338048033481
43070,1000004,1,3125,2773,352,0.88736,0.11264,0.88736,274,78,3126,2774,352,0.887396,0.112604,0.887396,274,78,1, merged,0,0,0.143224584965
43070,1000132,2,393,352,41,0.895674,0.104326,1.783034,29,12,394,353,41,0.895939,0.104061,1.783335,29,12,1, merged,0,0,0.260583576811
43077,1000329,2,2840,2219,621,0.781338,0.218662,1.522821,533,88,2841,2220,621,0.781415,0.218585,1.523415,533,88,1, merged,0,0,0.243020637227
43079,1000121,2,2060,1701,359,0.825728,0.174272,1.607143,334,25,2061,1702,359,0.825813,0.174187,1.607305,334,25,1, merged,0,0,0.00247970688852
43079,1000329,1,2841,2220,621,0.781415,0.218585,0.781415,533,88,2842,2221,621,0.781492,0.218508,0.781492,533,88,1, merged,0,0,0.00897535667964
43080,1000121,2,2061,1702,359,0.825813,0.174187,1.607305,334,25,2062,1703,359,0.825897,0.174103,1.607466,334,25,1, merged,0,0,0.00252016639171
43080,1000329,1,2842,2221,621,0.781492,0.218508,0.781492,533,88,2843,2222,621,0.781569,0.218431,0.781569,533,88,1, merged,0,0,0.00918240298817
43081,1000121,2,2062,1703,359,0.825897,0.174103,1.607466,334,25,2063,1704,359,0.825982,0.174018,1.607627,334,25,1, merged,0,0,0.00256062507591
43081,1000329,1,2843,2222,621,0.781569,0.218431,0.781569,533,88,2844,2223,621,0.781646,0.218354,0.781646,533,88,1, merged,0,0,0.00938942781553
43082,1000121,2,2063,1704,359,0.825982,0.174018,1.607627,334,25,2064,1705,359,0.826066,0.173934,1.607788,334,25,1, merged,0,0,0.00260108294115
43082,1000329,1,2844,2223,621,0.781646,0.218354,0.781646,533,88,2845,2224,621,0.781722,0.218278,0.781722,533,88,1, merged,0,0,0.00959643116506
43083,1000329,2,2845,2224,621,0.781722,0.218278,1.722899,533,88,2846,2225,621,0.781799,0.218201,1.724107,533,88,1, merged,0,0,0.0098034130401
43085,1000121,2,2064,1705,359,0.826066,0.173934,1.607942,334,25,2065,1706,359,0.82615,0.17385,1.608102,334,25,1, merged,0,0,0.00268199621484
43085,1000329,1,2847,2226,621,0.781876,0.218124,0.781876,533,88,2848,2227,621,0.781952,0.218048,0.781952,533,88,1, merged,0,0,0.010010373444
43086,1000121,2,2065,1706,359,0.82615,0.17385,1.608102,334,25,2066,1707,359,0.826234,0.173766,1.608263,334,25,1, merged,0,0,0.00272245162335
43086,1000329,1,2848,2227,621,0.781952,0.218048,0.781952,533,88,2849,2228,621,0.782029,0.217971,0.782029,533,88,1, merged,0,0,0.0102173123801
43088,1000121,2,2066,1707,359,0.826234,0.173766,1.60834,334,25,2067,1708,359,0.826318,0.173682,1.6085,334,25,1, merged,0,0,0.00280335998381
43088,1000329,1,2850,2229,621,0.782105,0.217895,0.782105,533,88,2851,2230,621,0.782182,0.217818,0.782182,533,88,1, merged,0,0,0.0106311258622
43089,1000121,2,2067,1708,359,0.826318,0.173682,1.6085,334,25,2068,1709,359,0.826402,0.173598,1.60866,334,25,1, merged,0,0,0.00284381293581
43089,1000329,1,2851,2230,621,0.782182,0.217818,0.782182,533,88,2852,2231,621,0.782258,0.217742,0.782258,533,88,1, merged,0,0,0.0108380004149
43090,1000121,2,2068,1709,359,0.826402,0.173598,1.60866,334,25,2069,1710,359,0.826486,0.173514,1.608821,334,25,1, merged,0,0,0.00288426506902
43090,1000329,1,2852,2231,621,0.782258,0.217742,0.782258,533,88,2853,2232,621,0.782334,0.217666,0.782334,533,88,1, merged,0,0,0.0110448535131
43095,1000329,1,2854,2233,621,0.782411,0.217589,0.782411,533,88,2855,2234,621,0.782487,0.217513,0.782487,533,88,-1, abandoned,0,0,0.25168397236
43117,1000004,2,3128,2776,352,0.887468,0.112532,1.714289,274,78,3129,2777,352,0.887504,0.112496,1.71401,274,78,-1, merged,0,0,0
43117,1000121,1,2073,1714,359,0.826821,0.173179,0.826821,334,25,2075,1715,360,0.826506,0.173494,0.826506,335,25,1, merged,1,1,0
43120,1000004,2,3129,2777,352,0.887504,0.112496,1.713382,274,78,3130,2778,352,0.88754,0.11246,1.713105,274,78,-1, merged,0,0,0.188079017566
43120,1000121,1,2079,1717,362,0.825878,0.174122,0.825878,337,25,2081,1718,363,0.825565,0.174435,0.825565,338,25,1, merged,1,1,0.193102766708
43123,1000023,2,1010,889,121,0.880198,0.119802,0.880198,110,11,1011,890,121,0.880317,0.119683,1.880317,110,11,1, merged,0,0,0.0667224875566
43130,1000043,2,538,453,85,0.842007,0.157993,1.555155,72,13,539,454,85,0.842301,0.157699,1.556586,72,13,1, merged,0,0,0.69207172636
43132,1000004,1,3131,2779,352,0.887576,0.112424,0.887576,274,78,3132,2780,352,0.887612,0.112388,0.887612,274,78,1, merged,0,0,0.391669273888
43132,1000011,2,695,639,56,0.919424,0.080576,1.807,51,5,696,640,56,0.91954,0.08046,1.807152,51,5,1, merged,0,0,0.622317584849
43144,1000004,1,3133,2781,352,0.887648,0.112352,0.887648,274,78,3134,2781,353,0.887364,0.112636,0.887364,275,78,1, merged,1,1,0.00593164796964
43144,1000011,2,696,640,56,0.91954,0.08046,1.807188,51,5,698,641,57,0.918338,0.081662,1.805702,52,5,1, merged,1,1,0.0142692758757
43145,1000004,1,3134,2781,353,0.887364,0.112636,0.887364,275,78,3135,2781,354,0.887081,0.112919,0.887081,276,78,1, merged,1,1,0.00399897495533
43145,1000011,2,698,641,57,0.918338,0.081662,1.805702,52,5,700,642,58,0.917143,0.082857,1.804224,53,5,1, merged,1,1,0.00975172516716
43146,1000014,1,2167,1825,342,0.842178,0.157822,0.842178,319,23,2169,1826,343,0.841863,0.158137,0.841863,320,23,1, merged,1,1,0.000271613951083
43147,1000023,1,1011,890,121,0.880317,0.119683,0.880317,110,11,1012,891,121,0.880435,0.119565,0.880435,110,11,1, merged,0,0,0.0141587181743
43156,1000004,2,3135,2781,354,0.887081,0.112919,1.553748,276,78,3139,2785,354,0.887225,0.112775,1.558458,276,78,-1, merged,0,0,0.312674989299
43156,1000329,3,2856,2235,621,0.782563,0.217437,2.336311,533,88,2857,2235,622,0.782289,0.217711,2.340747,534,88,1, merged,1,1,0.310012225823
43161,1000592,2,662,565,97,0.853474,0.146526,1.533746,61,36,665,566,99,0.851128,0.148872,1.543938,61,38,-1, merged,1,1,0.546664503394
43163,1000023,2,1012,891,121,0.880435,0.119565,1.776374,110,11,1014,892,122,0.879684,0.120316,1.773624,111,11,1, merged,1,1,0.141878107107
43163,1000132,1,394,353,41,0.895939,0.104061,0.895939,29,12,396,354,42,0.893939,0.106061,0.893939,30,12,1, merged,1,1,0.251963515256
43167,1000005,1,486,396,90,0.814815,0.185185,0.814815,84,6,487,397,90,0.815195,0.184805,0.815195,84,6,1, merged,0,0,0.000188460519145
43167,1000121,2,2084,1721,363,0.825816,0.174184,1.640631,338,25,2085,1722,363,0.825899,0.174101,1.641094,338,25,1, merged,0,0,1.04627852194e-05
43173,1000003,1,1108,923,185,0.833032,0.166968,0.833032,166,19,1109,924,185,0.833183,0.166817,0.833183,166,19,-1, merged,0,0,0.00185436164927
43173,1000015,2,1944,1743,201,0.896605,0.103395,1.729637,183,18,1945,1744,201,0.896658,0.103342,1.729841,183,18,1, merged,0,0,0.00174902501747
43177,1000003,1,1109,924,185,0.833183,0.166817,0.833183,166,19,1110,924,186,0.832432,0.167568,0.832432,167,19,1, merged,1,1,0.501844090253
43177,1000054,2,689,601,88,0.872279,0.127721,1.705462,72,16,690,602,88,0.872464,0.127536,1.704896,72,16,1, merged,0,0,0.427809174338
43185,1000121,2,2090,1727,363,0.826316,0.173684,1.562052,338,25,2091,1728,363,0.826399,0.173601,1.562926,338,25,1, merged,0,0,0.014496156034
43192,1000004,2,3146,2791,355,0.887158,0.112842,1.220492,277,78,3149,2794,355,0.887266,0.112734,1.387266,277,78,1, merged,0,0,0.0128864442656
43193,1000070,1,1146,988,158,0.862129,0.137871,0.862129,134,24,1147,988,159,0.861378,0.138622,0.861378,135,24,1, abandoned,1,1,0.791533436479
43206,1000327,2,684,540,144,0.789474,0.210526,1.657895,111,33,685,541,144,0.789781,0.210219,1.659911,111,33,1, merged,0,0,0.088167776071
43212,1000023,1,1015,893,122,0.879803,0.120197,0.879803,111,11,1016,894,122,0.879921,0.120079,0.879921,111,11,1, merged,0,0,0.0119509024996
43217,1000004,2,3150,2795,355,0.887302,0.112698,1.669667,277,78,3152,2797,355,0.887373,0.112627,1.669465,277,78,-1, merged,0,0,0.312695899399
43217,1000329,1,2858,2236,622,0.782365,0.217635,0.782365,534,88,2859,2236,623,0.782092,0.217908,0.782092,535,88,1, merged,1,1,0.310074865739
43224,1000121,2,2092,1729,363,0.826482,0.173518,1.696047,338,25,2093,1730,363,0.826565,0.173435,1.659898,338,25,1, merged,0,0,0.0703049034551
43229,1000014,1,2170,1827,343,0.841935,0.158065,0.841935,320,23,2171,1828,343,0.842008,0.157992,0.842008,320,23,-1, abandoned,0,0,0.00762127920699
43240,1000004,1,3152,2797,355,0.887373,0.112627,0.887373,277,78,3154,2799,355,0.887445,0.112555,0.887445,277,78,-1, abandoned,0,0,0.125152920664
43247,1000110,2,205,180,25,0.878049,0.121951,1.687573,23,2,206,181,25,0.878641,0.121359,1.679688,23,2,1, merged,0,0,0.649703521255
43247,1000140,1,189,153,36,0.809524,0.190476,0.809524,32,4,191,153,38,0.801047,0.198953,0.801047,32,6,-1, merged,1,1,0.604838232066
43249,1000007,2,1336,1081,255,0.809132,0.190868,1.641139,226,29,1338,1083,255,0.809417,0.190583,1.640838,226,29,-1, merged,0,0,1.31374637742
43249,1000009,1,1131,941,190,0.832007,0.167993,0.832007,171,19,1133,942,191,0.831421,0.168579,0.831421,172,19,1, merged,1,1,1.25413387305
43252,1000023,3,1020,896,124,0.878431,0.121569,2.353013,113,11,1021,897,124,0.87855,0.12145,2.372022,113,11,1, merged,0,0,0.0605963526456
43252,1000166,1,418,329,89,0.787081,0.212919,0.787081,85,4,419,330,89,0.787589,0.212411,0.787589,85,4,1, merged,0,0,0.0933536580475
43256,1000153,2,993,900,93,0.906344,0.093656,1.629749,70,23,994,901,93,0.906439,0.093561,1.63082,70,23,1, merged,0,0,0.919699019216
43256,1000534,1,282,204,78,0.723404,0.276596,0.723404,72,6,283,205,78,0.724382,0.275618,0.724382,72,6,1, merged,0,0,0.977178782325
43259,1000015,2,1946,1745,201,0.896711,0.103289,1.812134,183,18,1947,1746,201,0.896764,0.103236,1.812606,183,18,1, merged,0,0,0.46833549508
43260,1000005,1,488,398,90,0.815574,0.184426,0.815574,84,6,489,399,90,0.815951,0.184049,0.815951,84,6,1, merged,0,0,0.0184592771236
43261,1000004,1,3155,2800,355,0.88748,0.11252,0.88748,277,78,3156,2801,355,0.887516,0.112484,0.887516,277,78,1, merged,0,0,0.217250506386
43261,1000329,2,2859,2236,623,0.782092,0.217908,1.669572,535,88,2860,2237,623,0.782168,0.217832,1.669684,535,88,1, merged,0,0,0.312286643033
43262,1000004,1,3156,2801,355,0.887516,0.112484,0.887516,277,78,3158,2803,355,0.887587,0.112413,0.887587,277,78,-1, abandoned,0,0,0
43262,1000026,2,439,398,41,0.906606,0.093394,1.794122,39,2,440,399,41,0.906818,0.093182,1.794405,39,2,-1, abandoned,0,0,0
43263,1000023,1,1021,897,124,0.87855,0.12145,0.87855,113,11,1023,899,124,0.878788,0.121212,0.878788,113,11,-1, abandoned,0,0,0.000121517677448
43265,1000014,2,2172,1829,343,0.842081,0.157919,1.557496,320,23,2176,1832,344,0.841912,0.158088,1.555637,321,23,-1, merged,1,0,0.0889154933498
43265,1000592,3,665,566,99,0.851128,0.148872,2.408624,61,38,666,567,99,0.851351,0.148649,2.406989,61,38,-1, merged,0,0,0.180652495972
43268,1000014,1,2176,1832,344,0.841912,0.158088,0.841912,321,23,2177,1833,344,0.841984,0.158016,0.841984,321,23,-1, abandoned,0,0,0
43268,1000121,4,2096,1732,364,0.826336,0.173664,3.306343,339,25,2097,1733,364,0.826419,0.173581,3.22249,339,25,-1, abandoned,0,0,0
43271,1000121,2,2097,1733,364,0.826419,0.173581,1.35583,339,25,2098,1734,364,0.826501,0.173499,1.369359,339,25,1, merged,0,0,0.195700126954
43275,1000130,1,413,342,71,0.828087,0.171913,0.828087,56,15,414,342,72,0.826087,0.173913,0.826087,57,15,1, merged,1,1,0
43277,1000121,2,2098,1734,364,0.826501,0.173499,1.608669,339,25,2099,1735,364,0.826584,0.173416,1.608828,339,25,1, merged,0,0,0.328072873848
43277,1000329,1,2860,2237,623,0.782168,0.217832,0.782168,535,88,2861,2238,623,0.782244,0.217756,0.782244,535,88,1, merged,0,0,0.299584748659
43278,1000121,2,2099,1735,364,0.826584,0.173416,1.608828,339,25,2100,1736,364,0.826667,0.173333,1.608987,339,25,1, merged,0,0,0.00301213952877
43278,1000329,1,2861,2238,623,0.782244,0.217756,0.782244,535,88,2862,2239,623,0.78232,0.21768,0.78232,535,88,1, merged,0,0,0.0119053781252
43280,1000004,2,3165,2810,355,0.887836,0.112164,1.387836,277,78,3167,2812,355,0.887907,0.112093,1.487907,277,78,1, merged,0,0,0.0129144968673
43282,1000043,1,541,456,85,0.842884,0.157116,0.842884,72,13,544,458,86,0.841912,0.158088,0.841912,73,13,1, merged,1,1,0.35217580451
43283,1000004,1,3167,2812,355,0.887907,0.112093,0.887907,277,78,3171,2815,356,0.887733,0.112267,0.887733,278,78,-1, merged,1,0,0
43283,1000329,2,2862,2239,623,0.78232,0.21768,1.670227,535,88,2865,2242,623,0.782548,0.217452,1.670281,535,88,-1, merged,0,0,0
43288,1000329,3,2867,2244,623,0.7827,0.2173,2.222382,535,88,2869,2245,624,0.782503,0.217497,2.223587,535,89,1, merged,1,0,0
43288,1002169,1,364,237,127,0.651099,0.348901,0.651099,121,6,365,238,127,0.652055,0.347945,0.652055,121,6,-1, merged,0,0,0
43292,1000121,1,2101,1737,364,0.826749,0.173251,0.826749,339,25,2102,1737,365,0.826356,0.173644,0.826356,340,25,1, abandoned,1,1,0
43292,1000328,2,860,633,227,0.736047,0.263953,1.562796,203,24,861,633,228,0.735192,0.264808,1.561547,204,24,1, abandoned,1,1,0
43293,1000004,1,3172,2816,356,0.887768,0.112232,0.887768,278,78,3173,2816,357,0.887488,0.112512,0.887488,278,79,-1, merged,1,1,0
43293,1000121,3,2102,1737,365,0.826356,0.173644,2.38079,340,25,2103,1738,365,0.826438,0.173562,2.463927,340,25,1, merged,0,0,0
43297,1000091,3,504,390,114,0.77381,0.22619,2.247236,97,17,505,391,114,0.774257,0.225743,2.250183,97,17,1, merged,0,0,0
43297,1000328,2,861,633,228,0.735192,0.264808,1.473427,204,24,863,634,229,0.734647,0.265353,1.475926,205,24,1, merged,1,1,0
43298,1000592,1,666,567,99,0.851351,0.148649,0.851351,61,38,667,568,99,0.851574,0.148426,0.851574,61,38,-1, merged,0,0,0
43300,1000592,2,667,568,99,0.851574,0.148426,1.718241,61,38,668,569,99,0.851796,0.148204,1.734149,61,38,1, merged,0,0,0
43305,1000328,2,863,634,229,0.734647,0.265353,1.475926,205,24,864,635,229,0.734954,0.265046,1.476983,205,24,1, merged,0,0,0
43306,1000329,2,2869,2245,624,0.782503,0.217497,1.524532,535,89,2870,2246,624,0.782578,0.217422,1.525353,535,89,1, merged,0,0,0.032151549456
43307,1000328,2,864,635,229,0.734954,0.265046,1.477728,205,24,866,636,230,0.734411,0.265589,1.472917,206,24,1, merged,1,1,0.211318226115
43308,1000004,1,3173,2816,357,0.887488,0.112512,0.887488,278,79,3174,2817,357,0.887524,0.112476,0.887524,278,79,-1, merged,0,0,0
43308,1000327,2,686,542,144,0.790087,0.209913,1.677576,111,33,687,543,144,0.790393,0.209607,1.677917,111,33,1, merged,0,0,0
43312,1000004,2,3174,2817,357,0.887524,0.112476,1.729508,278,79,3178,2821,357,0.887665,0.112335,1.728564,278,79,-1, merged,0,0,0.0286177634358
43312,1000014,1,2177,1833,344,0.841984,0.158016,0.841984,321,23,2181,1834,347,0.840899,0.159101,0.840899,324,23,1, merged,1,1,0.00983852645245
43312,1000120,5,1535,1320,215,0.859935,0.140065,3.313824,188,27,1536,1321,215,0.860026,0.139974,3.311397,188,27,1, merged,0,0,0.0798828094563
43312,1000534,3,283,205,78,0.724382,0.275618,2.45389,72,6,285,206,79,0.722807,0.277193,2.451371,73,6,1, merged,1,1,0.00171781951443
43315,1000120,2,1536,1321,215,0.860026,0.139974,1.687612,188,27,1537,1322,215,0.860117,0.139883,1.688689,188,27,1, merged,0,0,0
43325,1000004,2,3182,2825,357,0.887806,0.112194,1.675685,278,79,3183,2826,357,0.887842,0.112158,1.681959,278,79,-1, abandoned,0,0,0.00657745221976
43335,1000014,1,2181,1834,347,0.840899,0.159101,0.840899,324,23,2182,1835,347,0.840972,0.159028,0.840972,324,23,-1, abandoned,0,0,0.559293653369
43335,1000015,3,1947,1746,201,0.896764,0.103236,2.616304,183,18,1948,1746,202,0.896304,0.103696,2.616503,184,18,1, abandoned,1,1,0.535749979393
43335,1000110,2,206,181,25,0.878641,0.121359,1.719539,23,2,207,182,25,0.879227,0.120773,1.720199,23,2,-1, abandoned,0,0,0.647956415692
43342,1000014,1,2183,1836,347,0.841044,0.158956,0.841044,324,23,2185,1838,347,0.84119,0.15881,0.84119,324,23,-1, merged,0,0,0.00267947388245
43342,1000015,2,1948,1746,202,0.896304,0.103696,1.737348,184,18,1949,1747,202,0.896357,0.103643,1.737547,184,18,1, merged,0,0,0.00217531171072
43343,1000009,1,1133,942,191,0.831421,0.168579,0.831421,172,19,1134,943,191,0.83157,0.16843,0.83157,172,19,1, merged,0,0,1.25229828621
43346,1000023,1,1023,899,124,0.878788,0.121212,0.878788,113,11,1024,900,124,0.878906,0.121094,0.878906,113,11,1, merged,0,0,0.00116126921819
43351,1000004,2,3193,2836,357,0.888193,0.111807,1.714631,278,79,3194,2837,357,0.888228,0.111772,1.714749,278,79,-1, merged,0,0,0.0190684689946
43351,1000121,1,2103,1738,365,0.826438,0.173562,0.826438,340,25,2104,1739,365,0.826521,0.173479,0.826521,340,25,-1, merged,0,0,0.0188823534486
43351,1000329,3,2870,2246,624,0.782578,0.217422,2.49721,535,89,2871,2247,624,0.782654,0.217346,2.497403,535,89,1, merged,0,0,0.0221913350773
43352,1000003,1,1113,927,186,0.832884,0.167116,0.832884,167,19,1115,928,187,0.832287,0.167713,0.832287,168,19,1, merged,1,1,0.0638072230387
43352,1000014,3,2185,1838,347,0.84119,0.15881,2.674074,324,23,2186,1839,347,0.841263,0.158737,2.340216,324,23,1, merged,0,0,0.0618515520871
43355,1000328,3,866,636,230,0.734411,0.265589,2.254957,206,24,867,637,230,0.734717,0.265283,2.2569,206,24,-1, abandoned,0,0,0
43355,1000329,2,2871,2247,624,0.782654,0.217346,1.520546,535,89,2873,2249,624,0.782805,0.217195,1.522182,535,89,-1, abandoned,0,0,0
43357,1000108,4,139,116,23,0.834532,0.165468,3.228532,19,4,140,117,23,0.835714,0.164286,3.228751,19,4,1, merged,0,0,0.499630358076
43357,1000110,1,207,182,25,0.879227,0.120773,0.879227,23,2,208,182,26,0.875,0.125,0.875,24,2,1, merged,1,1,0.650564778757
43357,1000140,2,191,153,38,0.801047,0.198953,1.680274,32,6,192,154,38,0.802083,0.197917,1.677083,32,6,-1, merged,0,0,0.606458393922
43358,1000121,2,2104,1739,365,0.826521,0.173479,1.617762,340,25,2105,1740,365,0.826603,0.173397,1.616996,340,25,-1, abandoned,0,0,0
43360,1000004,1,3195,2838,357,0.888263,0.111737,0.888263,278,79,3198,2841,357,0.888368,0.111632,0.888368,278,79,-1, merged,0,0,0.0288115424662
43360,1000110,3,208,182,26,0.875,0.125,2.479216,24,2,209,183,26,0.875598,0.124402,2.478252,24,2,1, merged,0,0,0.006373486297
43365,1000014,1,2186,1839,347,0.841263,0.158737,0.841263,324,23,2187,1840,347,0.841335,0.158665,0.841335,324,23,1, merged,0,0,0.159247662184
43365,1000328,2,867,637,230,0.734717,0.265283,1.57598,206,24,868,638,230,0.735023,0.264977,1.576358,206,24,1, merged,0,0,0.635615989515
43366,1000014,1,2187,1840,347,0.841335,0.158665,0.841335,324,23,2190,1840,350,0.840183,0.159817,0.840183,327,23,1, merged,1,1,0.522728996977
43366,1000328,2,868,638,230,0.735023,0.264977,1.576358,206,24,872,639,233,0.732798,0.267202,1.572981,209,24,1, merged,1,1,0.67395644103
43376,1000110,2,210,184,26,0.87619,0.12381,1.678274,24,2,211,185,26,0.876777,0.123223,1.679886,24,2,1, merged,0,0,0.429842634284
43376,1000140,1,192,154,38,0.802083,0.197917,0.802083,32,6,193,155,38,0.803109,0.196891,0.803109,32,6,1, merged,0,0,0.24735364753
43377,1000012,2,556,482,74,0.866906,0.133094,1.73036,72,2,557,483,74,0.867145,0.132855,1.727703,72,2,1, merged,0,0,0.399318871554
43379,1000140,1,193,155,38,0.803109,0.196891,0.803109,32,6,194,156,38,0.804124,0.195876,0.804124,32,6,1, merged,0,0,0.360435717854
43386,1000004,1,3198,2841,357,0.888368,0.111632,0.888368,278,79,3199,2842,357,0.888403,0.111597,0.888403,278,79,-1, abandoned,0,0,0
43386,1000091,2,506,392,114,0.774704,0.225296,1.663071,97,17,507,393,114,0.775148,0.224852,1.663551,97,17,-1, abandoned,0,0,0
43400,1000110,2,211,185,26,0.876777,0.123223,1.706564,24,2,212,186,26,0.877358,0.122642,1.708937,24,2,1, merged,0,0,0.276147263426
43401,1000011,3,709,651,58,0.918195,0.081805,2.606203,53,5,710,652,58,0.91831,0.08169,2.587969,53,5,1, merged,0,0,0.0724001057676
43401,1000014,1,2190,1840,350,0.840183,0.159817,0.840183,327,23,2192,1841,351,0.839872,0.160128,0.839872,328,23,1, merged,1,1,0.0609834230458
43411,1000009,1,1134,943,191,0.83157,0.16843,0.83157,172,19,1135,944,191,0.831718,0.168282,0.831718,172,19,1, merged,0,0,0.584143123335
43412,1000110,1,212,186,26,0.877358,0.122642,0.877358,24,2,215,187,28,0.869767,0.130233,0.869767,26,2,1, merged,1,1,0.212054021064
43412,1000140,2,195,157,38,0.805128,0.194872,1.682487,32,6,197,159,38,0.807107,0.192893,1.676874,32,6,-1, merged,0,0,0.123534998919
43413,1000014,1,2192,1841,351,0.839872,0.160128,0.839872,328,23,2193,1842,351,0.839945,0.160055,0.839945,328,23,1, merged,0,0,0.142289516572
43413,1000054,3,690,602,88,0.872464,0.127536,2.572544,72,16,691,603,88,0.872648,0.127352,2.572893,72,16,1, merged,0,0,0.290458649073
43413,1000120,2,1538,1323,215,0.860208,0.139792,1.70008,188,27,1539,1324,215,0.860299,0.139701,1.700244,188,27,1, merged,0,0,0.101904150983
43424,1000023,1,1024,900,124,0.878906,0.121094,0.878906,113,11,1026,901,125,0.878168,0.121832,0.878168,114,11,1, abandoned,1,1,0.151698602131
43424,1000110,2,215,187,28,0.869767,0.130233,1.748674,26,2,216,188,28,0.87037,0.12963,1.748538,26,2,-1, abandoned,0,0,0.321784816714
43438,1000004,2,3204,2845,359,0.887953,0.112047,1.784628,279,80,3205,2846,359,0.887988,0.112012,1.7838,279,80,-1, merged,0,0,0
43438,1000015,1,1955,1753,202,0.896675,0.103325,0.896675,184,18,1958,1754,204,0.895812,0.104188,0.895812,186,18,1, merged,1,1,0
43439,1000328,2,875,642,233,0.733714,0.266286,1.523188,209,24,876,643,233,0.734018,0.265982,1.523934,209,24,1, merged,0,0,0
43440,1000328,2,876,643,233,0.734018,0.265982,1.523934,209,24,877,644,233,0.734322,0.265678,1.524678,209,24,1, merged,0,0,0
43441,1000327,4,687,543,144,0.790393,0.209607,2.967126,111,33,690,544,146,0.788406,0.211594,2.963394,113,33,1, merged,1,1,0
43441,1000328,3,877,644,233,0.734322,0.265678,2.176733,209,24,879,646,233,0.734926,0.265074,2.174988,209,24,-1, merged,0,0,0
43441,1002169,2,365,238,127,0.652055,0.347945,1.442411,121,6,366,239,127,0.653005,0.346995,1.440062,121,6,-1, merged,0,0,0
43443,1000023,1,1026,901,125,0.878168,0.121832,0.878168,114,11,1028,903,125,0.878405,0.121595,0.878405,114,11,1, merged,0,0,0.000710071957232
43448,1000004,1,3205,2846,359,0.887988,0.112012,0.887988,279,80,3206,2847,359,0.888022,0.111978,0.888022,279,80,1, merged,0,0,0.0164599878811
43448,1000329,2,2878,2254,624,0.783183,0.216817,1.67117,535,89,2879,2255,624,0.783258,0.216742,1.671281,535,89,1, merged,0,0,0.0296684909759
43456,1000121,2,2107,1742,365,0.826768,0.173232,1.576768,340,25,2108,1743,365,0.82685,0.17315,1.62685,340,25,1, merged,0,0,0.0936444521513
43457,1000004,1,3206,2847,359,0.888022,0.111978,0.888022,279,80,3207,2848,359,0.888057,0.111943,0.888057,279,80,1, merged,0,0,0.00389318822156
43457,1000120,2,1540,1325,215,0.86039,0.13961,1.748412,188,27,1541,1326,215,0.86048,0.13952,1.748538,188,27,1, merged,0,0,0.00317960989051
43462,1000014,1,2195,1844,351,0.840091,0.159909,0.840091,328,23,2197,1846,351,0.840237,0.159763,0.840237,328,23,-1, merged,0,0,0.330165074751
43462,1000054,4,691,603,88,0.872648,0.127352,2.496073,72,16,692,604,88,0.872832,0.127168,3.496478,72,16,1, merged,0,0,0.624581780469
43462,1000329,3,2880,2256,624,0.783333,0.216667,1.623424,535,89,2881,2257,624,0.783409,0.216591,2.623645,535,89,1, merged,0,0,0.310318156107
43475,1000026,2,441,400,41,0.907029,0.092971,1.548055,39,2,442,401,41,0.90724,0.09276,1.55724,39,2,1, merged,0,0,0.139311919652
43481,1000004,3,3210,2851,359,0.888162,0.111838,2.5999,279,80,3211,2852,359,0.888197,0.111803,2.623863,279,80,1, merged,0,0,0.00103635769487
43481,1000023,1,1028,903,125,0.878405,0.121595,0.878405,114,11,1029,904,125,0.878523,0.121477,0.878523,114,11,1, merged,0,0,0.00197474257103
43482,1000023,2,1029,904,125,0.878523,0.121477,1.623582,114,11,1030,905,125,0.878641,0.121359,1.624203,114,11,1, merged,0,0,0.000483425536445
43484,1000023,1,1030,905,125,0.878641,0.121359,0.878641,114,11,1031,906,125,0.878758,0.121242,0.878758,114,11,1, merged,0,0,0.00274643968328
43485,1000023,2,1031,906,125,0.878758,0.121242,1.778758,114,11,1032,907,125,0.878876,0.121124,1.787967,114,11,1, merged,0,0,0.0172154918959
43486,1000120,2,1542,1327,215,0.860571,0.139429,1.769662,188,27,1543,1328,215,0.860661,0.139339,1.777328,188,27,1, merged,0,0,0.0326212484975
43487,1000120,2,1543,1328,215,0.860661,0.139339,1.777328,188,27,1544,1329,215,0.860751,0.139249,1.783828,188,27,1, merged,0,0,0.0506836088849
43488,1000120,2,1544,1329,215,0.860751,0.139249,1.783828,188,27,1545,1330,215,0.860841,0.139159,1.789413,188,27,1, merged,0,0,0.36219595752
43489,1000120,2,1545,1330,215,0.860841,0.139159,1.789413,188,27,1546,1331,215,0.860931,0.139069,1.794265,188,27,1, merged,0,0,0.0169582094182
43490,1000120,3,1546,1331,215,0.860931,0.139069,2.579979,188,27,1547,1332,215,0.861021,0.138979,2.589219,188,27,1, merged,0,0,0.00617816326354
43491,1000120,2,1547,1332,215,0.861021,0.138979,1.798521,188,27,1548,1333,215,0.861111,0.138889,1.802288,188,27,1, merged,0,0,0.00524138513516
43492,1000023,1,1032,907,125,0.878876,0.121124,0.878876,114,11,1034,908,126,0.878143,0.121857,0.878143,115,11,1, merged,1,1,0.000640056574322
43493,1000023,1,1034,908,126,0.878143,0.121857,0.878143,115,11,1036,909,127,0.877413,0.122587,0.877413,116,11,1, merged,1,1,0.0345519901214
43494,1000023,2,1036,909,127,0.877413,0.122587,1.827413,116,11,1037,910,127,0.877531,0.122469,1.829912,116,11,1, merged,0,0,0.0962802884128
43495,1000023,1,1037,910,127,0.877531,0.122469,0.877531,116,11,1038,911,127,0.877649,0.122351,0.877649,116,11,1, merged,0,0,0.0251294228118
43496,1000004,3,3211,2852,359,0.888197,0.111803,2.842742,279,80,3212,2853,359,0.888232,0.111768,2.804898,279,80,1, merged,0,0,0.0105226840439
43497,1000120,2,1548,1333,215,0.861111,0.138889,1.777778,188,27,1549,1334,215,0.861201,0.138799,1.781201,188,27,1, merged,0,0,0.0102565508647
43499,1000023,1,1038,911,127,0.877649,0.122351,0.877649,116,11,1039,912,127,0.877767,0.122233,0.877767,116,11,1, merged,0,0,0.0725519069085
43500,1000023,1,1039,912,127,0.877767,0.122233,0.877767,116,11,1040,913,127,0.877885,0.122115,0.877885,116,11,1, merged,0,0,0.0893573976236
43510,1000329,1,2881,2257,624,0.783409,0.216591,0.783409,535,89,2883,2258,625,0.783212,0.216788,0.783212,535,90,-1, merged,1,0,0.0430506097847
43517,1000132,2,398,355,43,0.89196,0.10804,1.721747,31,12,399,356,43,0.892231,0.107769,1.704731,31,12,1, merged,0,0,0.500513213328
43518,1000329,2,2883,2258,625,0.783212,0.216788,0.783212,535,90,2884,2259,625,0.783287,0.216713,1.783287,535,90,1, merged,0,0,0
43519,1000120,2,1549,1334,215,0.861201,0.138799,1.789772,188,27,1550,1334,216,0.860645,0.139355,1.760645,189,27,1, abandoned,1,1,0
43525,1000015,1,1963,1759,204,0.896077,0.103923,0.896077,186,18,1964,1759,205,0.895621,0.104379,0.895621,187,18,1, abandoned,1,1,0
43525,1000120,2,1553,1336,217,0.86027,0.13973,1.756348,190,27,1554,1336,218,0.859717,0.140283,1.755338,191,27,1, abandoned,1,1,0
43526,1000328,1,880,647,233,0.735227,0.264773,0.735227,209,24,882,648,234,0.734694,0.265306,0.734694,210,24,1, merged,1,1,0.302865935536
43527,1000004,2,3213,2854,359,0.888266,0.111734,1.747983,279,80,3214,2855,359,0.888301,0.111699,1.748108,279,80,1, merged,0,0,0.0285332169929
43527,1000120,1,1554,1336,218,0.859717,0.140283,0.859717,191,27,1555,1337,218,0.859807,0.140193,0.859807,191,27,1, merged,0,0,0.0693969992927
43530,1000009,2,1135,944,191,0.831718,0.168282,1.554525,172,19,1136,945,191,0.831866,0.168134,1.552556,172,19,1, merged,0,0,0.236375751205
43530,1000534,1,285,206,79,0.722807,0.277193,0.722807,73,6,290,209,81,0.72069,0.27931,0.72069,75,6,-1, merged,1,0,0.225505202999
43532,1000023,2,1040,913,127,0.877885,0.122115,1.661322,116,11,1041,914,127,0.878002,0.121998,1.661589,116,11,1, merged,0,0,0.0211489799309
43532,1000329,1,2886,2261,625,0.783437,0.216563,0.783437,535,90,2888,2263,625,0.783587,0.216413,0.783587,535,90,-1, merged,0,0,0.019672905708
43539,1000003,1,1116,929,187,0.832437,0.167563,0.832437,168,19,1121,932,189,0.831401,0.168599,0.831401,170,19,-1, merged,1,0,0.0112789935177
43539,1000121,2,2109,1744,365,0.826932,0.173068,1.659369,340,25,2111,1745,366,0.826622,0.173378,1.658023,341,25,1, merged,1,1,0.0121788998057
43540,1000015,2,1964,1759,205,0.895621,0.104379,1.895621,187,18,1965,1760,205,0.895674,0.104326,1.895674,187,18,-1, merged,0,0,0
43546,1000004,3,3214,2855,359,0.888301,0.111699,2.475013,279,80,3215,2856,359,0.888336,0.111664,2.474077,279,80,1, merged,0,0,0.439251744486
43546,1000328,1,882,648,234,0.734694,0.265306,0.734694,210,24,883,649,234,0.734994,0.265006,0.734994,210,24,1, merged,0,0,0.71624942555
43546,1000329,4,2894,2269,625,0.784036,0.215964,3.259049,535,90,2896,2271,625,0.784185,0.215815,3.258262,535,90,1, merged,0,0,0.657795469305
43546,1000592,2,669,570,99,0.852018,0.147982,1.586712,61,38,670,570,100,0.850746,0.149254,1.585741,61,39,-1, merged,1,1,0
43553,1000004,1,3215,2856,359,0.888336,0.111664,0.888336,279,80,3217,2858,359,0.888405,0.111595,0.888405,279,80,-1, merged,0,0,0.0287755975846
43553,1000043,2,545,459,86,0.842202,0.157798,1.730538,73,13,547,460,87,0.840951,0.159049,1.729356,74,13,1, merged,1,1,0.0260497484365
43565,1000328,2,884,650,234,0.735294,0.264706,1.278151,210,24,885,651,234,0.735593,0.264407,1.276134,210,24,1, merged,0,0,0.215824360684
43573,1000121,2,2116,1750,366,0.827032,0.172968,1.627032,341,25,2117,1751,366,0.827114,0.172886,1.631462,341,25,1, merged,0,0,0.00137777106513
43582,1000153,2,995,902,93,0.906533,0.093467,1.627222,70,23,996,903,93,0.906627,0.093373,1.628276,70,23,1, merged,0,0,0.209299170211
43582,1000534,1,290,209,81,0.72069,0.27931,0.72069,75,6,291,210,81,0.721649,0.278351,0.721649,75,6,1, merged,0,0,0.22189636244
43594,1000004,1,3217,2858,359,0.888405,0.111595,0.888405,279,80,3219,2860,359,0.888475,0.111525,0.888475,279,80,-1, merged,0,0,0.0131142943595
43596,1000121,1,2122,1756,366,0.827521,0.172479,0.827521,341,25,2123,1757,366,0.827602,0.172398,0.827602,341,25,1, merged,0,0,0.401341480156
43596,1000329,2,2896,2271,625,0.784185,0.215815,1.611706,535,90,2897,2272,625,0.78426,0.21574,1.611862,535,90,1, merged,0,0,0.482840741446
43598,1000004,2,3219,2860,359,0.888475,0.111525,1.488475,279,80,3222,2863,359,0.888579,0.111421,1.460007,279,80,-1, merged,0,0,0.0129255315224
43601,1000015,2,1965,1760,205,0.895674,0.104326,1.545674,187,18,1967,1762,205,0.89578,0.10422,1.529927,187,18,1, merged,0,0,0.464649975953
43601,1000026,3,442,401,41,0.90724,0.09276,2.452914,39,2,443,402,41,0.907449,0.092551,2.437376,39,2,1, merged,0,0,0.446861823079
43606,1000004,2,3222,2863,359,0.888579,0.111421,1.728815,279,80,3224,2865,359,0.888648,0.111352,1.728575,279,80,-1, merged,0,0,0.0669455074481
43606,1000014,1,2197,1846,351,0.840237,0.159763,0.840237,328,23,2199,1847,352,0.839927,0.160073,0.839927,329,23,1, merged,1,1,0.0286083068271
43607,1000015,1,1967,1762,205,0.89578,0.10422,0.89578,187,18,1968,1763,205,0.895833,0.104167,0.895833,187,18,-1, merged,0,0,0
43607,1000108,4,140,117,23,0.835714,0.164286,3.500274,19,4,143,119,24,0.832168,0.167832,3.500129,20,4,1, merged,1,1,0
43607,1000121,3,2123,1757,366,0.827602,0.172398,2.664559,341,25,2124,1758,366,0.827684,0.172316,2.667961,341,25,-1, merged,0,0,0
43608,1000004,3,3224,2865,359,0.888648,0.111352,2.500591,279,80,3226,2867,359,0.888717,0.111283,2.500193,279,80,-1, merged,0,0,0
43608,1000121,1,2124,1758,366,0.827684,0.172316,0.827684,341,25,2128,1760,368,0.827068,0.172932,0.827068,343,25,1, merged,1,1,0
43608,1000329,2,2897,2272,625,0.78426,0.21574,1.611943,535,90,2899,2274,625,0.784408,0.215592,1.611476,535,90,-1, merged,0,0,0
43608,1002169,4,366,239,127,0.653005,0.346995,3.153596,121,6,368,241,127,0.654891,0.345109,3.155084,121,6,-1, merged,0,0,0
43611,1000014,2,2199,1847,352,0.839927,0.160073,1.464927,329,23,2200,1848,352,0.84,0.16,1.506667,329,23,1, merged,0,0,0.693190268767
43613,1000023,1,1042,915,127,0.878119,0.121881,0.878119,116,11,1044,916,128,0.877395,0.122605,0.877395,117,11,1, merged,1,1,0.27469719115
43617,1000007,2,1340,1085,255,0.809701,0.190299,1.641716,226,29,1342,1087,255,0.809985,0.190015,1.641416,226,29,1, merged,0,0,0.343674955953
43617,1000009,1,1137,946,191,0.832014,0.167986,0.832014,172,19,1139,947,192,0.831431,0.168569,0.831431,173,19,1, merged,1,1,0.325643796023
43620,1000043,2,548,461,87,0.841241,0.158759,1.672702,74,13,550,461,89,0.838182,0.161818,1.666911,76,13,1, merged,1,1,0.00853796078547
43626,1000009,2,1140,948,192,0.831579,0.168421,1.498246,173,19,1141,949,192,0.831727,0.168273,1.531727,173,19,1, merged,0,0,1.18311628806
43627,1000009,2,1141,949,192,0.831727,0.168273,1.531727,173,19,1142,950,192,0.831874,0.168126,1.559147,173,19,1, merged,0,0,1.19008171992
43634,1000004,1,3227,2867,360,0.888441,0.111559,0.888441,280,80,3229,2869,360,0.88851,0.11149,0.88851,280,80,-1, merged,0,0,0.0315391734311
43635,1000329,1,2899,2274,625,0.784408,0.215592,0.784408,535,90,2900,2275,625,0.784483,0.215517,0.784483,535,90,1, merged,0,0,0.436217232444
43636,1000014,1,2200,1848,352,0.84,0.16,0.84,329,23,2202,1849,353,0.839691,0.160309,0.839691,330,23,1, merged,1,1,0.346694107001
43636,1000329,2,2900,2275,625,0.784483,0.215517,1.624483,535,90,2901,2275,626,0.784212,0.215788,1.623904,536,90,1, merged,1,1,0.233701542779
43639,1000009,2,1147,955,192,0.832607,0.167393,1.55988,173,19,1149,956,193,0.832028,0.167972,1.498695,174,19,1, merged,1,1,0.393261903043
43640,1000329,1,2901,2275,626,0.784212,0.215788,0.784212,536,90,2903,2276,627,0.784017,0.215983,0.784017,536,91,-1, merged,1,0,0.676851505902
43652,1000121,2,2128,1760,368,0.827068,0.172932,1.611159,343,25,2129,1761,368,0.827149,0.172851,1.611314,343,25,-1, abandoned,0,0,0.418936090188
43652,1000329,1,2904,2277,627,0.784091,0.215909,0.784091,536,91,2905,2278,627,0.784165,0.215835,0.784165,536,91,-1, abandoned,0,0,0.615199810673
43653,1000015,1,1969,1764,205,0.895886,0.104114,0.895886,187,18,1970,1765,205,0.895939,0.104061,0.895939,187,18,1, merged,0,0,0.011413322505
43656,1000014,2,2203,1850,353,0.839764,0.160236,1.575953,330,23,2204,1851,353,0.839837,0.160163,1.576323,330,23,1, merged,0,0,0.164646144017
43656,1000328,1,887,653,234,0.736189,0.263811,0.736189,210,24,888,654,234,0.736486,0.263514,0.736486,210,24,1, merged,0,0,0.125799794905
43659,1000014,3,2207,1854,353,0.840054,0.159946,2.427287,330,23,2208,1855,353,0.840127,0.159873,2.4281,330,23,1, merged,0,0,0.330241548674
43659,1000328,2,888,654,234,0.736486,0.263514,1.587233,210,24,889,655,234,0.736783,0.263217,1.587973,210,24,1, merged,0,0,0.252300284071
43659,1000592,1,670,570,100,0.850746,0.149254,0.850746,61,39,672,572,100,0.85119,0.14881,0.85119,61,39,-1, merged,0,0,0.305914326126
43663,1000009,2,1149,956,193,0.832028,0.167972,1.498695,174,19,1151,957,194,0.831451,0.168549,1.446836,175,19,1, merged,1,1,1.19161843776
43665,1000014,1,2213,1859,354,0.840036,0.159964,0.840036,331,23,2214,1859,355,0.839657,0.160343,0.839657,332,23,1, merged,1,1,0.332875089927
43665,1000015,2,1970,1765,205,0.895939,0.104061,1.735975,187,18,1972,1767,205,0.896045,0.103955,1.735701,187,18,1, merged,0,0,0.351413854402
43666,1000023,1,1047,918,129,0.876791,0.123209,0.876791,118,11,1048,919,129,0.876908,0.123092,0.876908,118,11,1, merged,0,0,0.304775929574
43666,1000327,2,692,546,146,0.789017,0.210983,1.665808,113,33,693,547,146,0.789322,0.210678,1.66623,113,33,1, merged,0,0,0.59510250985
43670,1000592,2,672,572,100,0.85119,0.14881,1.682769,61,39,673,573,100,0.851412,0.148588,1.684745,61,39,1, merged,0,0,0.602999757595
43672,1000120,2,1556,1338,218,0.859897,0.140103,1.635407,191,27,1557,1339,218,0.859987,0.140013,1.638511,191,27,1, merged,0,0,0.00598061858669
43673,1000004,2,3229,2869,360,0.88851,0.11149,1.672676,280,80,3234,2873,361,0.888374,0.111626,1.672761,281,80,-1, merged,1,0,0.0766316826311
43673,1000329,1,2905,2278,627,0.784165,0.215835,0.784165,536,91,2908,2281,627,0.784388,0.215612,0.784388,536,91,-1, merged,0,0,0.168477421844
43677,1000014,2,2215,1859,356,0.839278,0.160722,1.735428,333,23,2216,1860,356,0.83935,0.16065,1.735553,333,23,1, merged,0,0,0.155324350757
43677,1000015,1,1974,1769,205,0.89615,0.10385,0.89615,187,18,1975,1770,205,0.896203,0.103797,0.896203,187,18,1, merged,0,0,0.211855576038
43679,1000014,2,2216,1860,356,0.83935,0.16065,1.735553,333,23,2217,1861,356,0.839423,0.160577,1.735224,333,23,1, merged,0,0,0.207220364037
43679,1000015,1,1975,1770,205,0.896203,0.103797,0.896203,187,18,1977,1771,206,0.895802,0.104198,0.895802,188,18,1, merged,1,1,0.282509071103
43685,1000014,2,2217,1861,356,0.839423,0.160577,1.559661,333,23,2218,1862,356,0.839495,0.160505,1.561389,333,23,1, merged,0,0,0.585737285936
43686,1000328,2,889,655,234,0.736783,0.263217,1.263099,210,24,890,656,234,0.737079,0.262921,1.27554,210,24,1, merged,0,0,0.432785214647
43687,1000004,3,3235,2874,361,0.888408,0.111592,2.623705,281,80,3240,2879,361,0.88858,0.11142,2.622668,281,80,-1, merged,0,0,0.0297208951002
43687,1000014,2,2218,1862,356,0.839495,0.160505,1.735297,333,23,2220,1862,358,0.838739,0.161261,1.734088,335,23,1, merged,1,1,0
43687,1000015,1,1977,1771,206,0.895802,0.104198,0.895802,188,18,1978,1771,207,0.895349,0.104651,0.895349,189,18,1, merged,1,1,0
43687,1000121,6,2129,1761,368,0.827149,0.172851,4.890133,343,25,2131,1762,369,0.826842,0.173158,4.890681,344,25,-1, merged,1,0,0.0346988386305
43687,1000329,5,2908,2281,627,0.784388,0.215612,4.062984,536,91,2913,2285,628,0.784415,0.215585,4.063839,537,91,-1, merged,1,0,0.0603310229268
43687,1002169,4,368,241,127,0.654891,0.345109,3.278596,121,6,370,243,127,0.656757,0.343243,3.279425,121,6,-1, merged,0,0,0
43703,1000132,1,403,359,44,0.890819,0.109181,0.890819,31,13,406,361,45,0.889163,0.110837,0.889163,32,13,-1, merged,1,0,0.0599738517827
43703,1002169,2,370,243,127,0.656757,0.343243,1.547576,121,6,371,244,127,0.657682,0.342318,1.546845,121,6,-1, merged,0,0,0
43705,1000003,2,1122,933,189,0.831551,0.168449,1.683036,170,19,1123,934,189,0.831701,0.168299,1.683553,170,19,1, merged,0,0,0.472819776838
43705,1000199,1,404,344,60,0.851485,0.148515,0.851485,54,6,405,345,60,0.851852,0.148148,0.851852,54,6,1, merged,0,0,0.199455711303
43707,1000014,2,2223,1865,358,0.838956,0.161044,1.734464,335,23,2224,1866,358,0.839029,0.160971,1.734589,335,23,1, merged,0,0,0.40936047619
43707,1000015,1,1981,1774,207,0.895507,0.104493,0.895507,189,18,1982,1775,207,0.89556,0.10444,0.89556,189,18,1, merged,0,0,0.393280110242
43715,1000121,2,2131,1762,369,0.826842,0.173158,1.611257,344,25,2132,1763,369,0.826923,0.173077,1.611486,344,25,-1, merged,0,0,0
43715,1000329,1,2913,2285,628,0.784415,0.215585,0.784415,537,91,2915,2287,628,0.784563,0.215437,0.784563,537,91,-1, merged,0,0,0
43718,1000014,1,2225,1867,358,0.839101,0.160899,0.839101,335,23,2231,1869,362,0.837741,0.162259,0.837741,339,23,-1, merged,1,0,0
43718,1000121,2,2132,1763,369,0.826923,0.173077,1.666024,344,25,2133,1764,369,0.827004,0.172996,1.664745,344,25,-1, merged,0,0,0
43718,1000592,6,673,573,100,0.851412,0.148588,4.577719,61,39,675,574,101,0.85037,0.14963,4.541218,62,39,1, merged,1,1,0
43718,1002169,3,371,244,127,0.657682,0.342318,2.323706,121,6,372,245,127,0.658602,0.341398,2.323347,121,6,-1, merged,0,0,0
43732,1000004,2,3240,2879,361,0.88858,0.11142,1.460009,281,80,3241,2880,361,0.888615,0.111385,1.388615,281,80,-1, abandoned,0,0,0.0132731949266
43734,1000328,2,890,656,234,0.737079,0.262921,1.604266,210,24,891,657,234,0.737374,0.262626,1.602239,210,24,1, merged,0,0,0.353953131678
43739,1000327,1,694,548,146,0.789625,0.210375,0.789625,113,33,696,549,147,0.788793,0.211207,0.788793,114,33,1, merged,1,1,0.188721985811
43740,1000014,2,2232,1870,362,0.837814,0.162186,1.697801,339,23,2233,1871,362,0.837886,0.162114,1.697963,339,23,1, merged,0,0,0.668887448656
43740,1000120,1,1557,1339,218,0.859987,0.140013,0.859987,191,27,1558,1340,218,0.860077,0.139923,0.860077,191,27,1, merged,0,0,0.332681230138
43742,1000023,1,1050,921,129,0.877143,0.122857,0.877143,118,11,1051,922,129,0.87726,0.12274,0.87726,118,11,1, merged,0,0,0.00502638770271
43743,1000070,3,1151,992,159,0.861859,0.138141,2.258013,135,24,1152,993,159,0.861979,0.138021,2.266417,135,24,1, merged,0,0,0.596425046135
43762,1000007,1,1342,1087,255,0.809985,0.190015,0.809985,226,29,1344,1089,255,0.810268,0.189732,0.810268,226,29,-1, merged,0,0,0.612777152653
43762,1000009,2,1151,957,194,0.831451,0.168549,1.641436,175,19,1152,958,194,0.831597,0.168403,1.641865,175,19,-1, merged,0,0,0.58184866772
43762,1000015,3,1990,1782,208,0.895477,0.104523,2.536913,190,18,1991,1783,208,0.89553,0.10447,2.537395,190,18,1, merged,0,0,0.465789173062
43772,1000023,2,1053,924,129,0.877493,0.122507,1.79416,118,11,1055,926,129,0.877725,0.122275,1.797725,118,11,1, merged,0,0,0
43773,1000023,1,1055,926,129,0.877725,0.122275,0.877725,118,11,1056,927,129,0.877841,0.122159,0.877841,118,11,1, merged,0,0,0
43773,1000121,2,2133,1764,369,0.827004,0.172996,1.704729,344,25,2134,1765,369,0.827085,0.172915,1.704926,344,25,1, merged,0,0,0
43776,1000023,2,1056,927,129,0.877841,0.122159,1.797841,118,11,1057,928,129,0.877956,0.122044,1.801033,118,11,1, merged,0,0,0
43777,1000023,2,1057,928,129,0.877956,0.122044,1.801033,118,11,1058,929,129,0.878072,0.121928,1.803998,118,11,1, merged,0,0,0
43779,1000023,2,1059,930,129,0.878187,0.121813,1.804113,118,11,1060,931,129,0.878302,0.121698,1.806873,118,11,1, merged,0,0,0
43781,1000023,2,1060,931,129,0.878302,0.121698,1.806873,118,11,1061,932,129,0.878417,0.121583,1.809451,118,11,1, merged,0,0,0
43782,1000023,2,1061,932,129,0.878417,0.121583,1.809451,118,11,1062,933,129,0.878531,0.121469,1.811864,118,11,1, merged,0,0,0
43784,1000023,2,1062,933,129,0.878531,0.121469,1.811864,118,11,1064,934,130,0.87782,0.12218,1.78407,119,11,1, merged,1,1,0
43785,1000023,2,1064,934,130,0.87782,0.12218,1.78407,119,11,1065,935,130,0.877934,0.122066,1.787025,119,11,1, merged,0,0,0
43786,1000023,2,1065,935,130,0.877934,0.122066,1.787025,119,11,1066,936,130,0.878049,0.121951,1.789813,119,11,1, merged,0,0,0
43787,1000004,2,3241,2880,361,0.888615,0.111385,1.800379,281,80,3242,2881,361,0.888649,0.111351,1.802935,281,80,1, merged,0,0,0
43787,1000023,3,1066,936,130,0.878049,0.121951,2.678428,119,11,1067,937,130,0.878163,0.121837,2.681098,119,11,1, merged,0,0,0
43789,1000005,2,489,399,90,0.815951,0.184049,1.730237,84,6,490,400,90,0.816327,0.183673,1.732993,84,6,1, merged,0,0,0
43790,1000023,2,1067,937,130,0.878163,0.121837,1.79483,119,11,1069,939,130,0.878391,0.121609,1.79731,119,11,1, merged,0,0,0
43792,1000023,1,1069,939,130,0.878391,0.121609,0.878391,119,11,1071,941,130,0.878618,0.121382,0.878618,119,11,1, merged,0,0,0
43793,1000108,4,143,119,24,0.832168,0.167832,2.94829,20,4,144,120,24,0.833333,0.166667,2.961824,20,4,1, merged,0,0,0
43793,1000121,2,2134,1765,369,0.827085,0.172915,1.62775,344,25,2135,1766,369,0.827166,0.172834,1.628491,344,25,-1, merged,0,0,0
43794,1000108,1,144,120,24,0.833333,0.166667,0.833333,20,4,146,122,24,0.835616,0.164384,0.835616,20,4,-1, merged,0,0,0
43794,1000121,2,2135,1766,369,0.827166,0.172834,1.6605,344,25,2136,1766,370,0.826779,0.173221,1.662395,345,25,1, merged,1,1,0
43796,1000110,1,233,205,28,0.879828,0.120172,0.879828,26,2,234,206,28,0.880342,0.119658,0.880342,26,2,1, merged,0,0,0
43796,1000130,2,425,351,74,0.825882,0.174118,1.705711,59,15,426,352,74,0.826291,0.173709,1.706633,59,15,1, merged,0,0,0
43797,1000121,4,2136,1766,370,0.826779,0.173221,3.095932,345,25,2137,1767,370,0.82686,0.17314,3.101943,345,25,1, merged,0,0,0
43797,1000329,2,2916,2288,628,0.784636,0.215364,1.418783,537,91,2917,2288,629,0.784368,0.215632,1.427225,537,92,-1, merged,1,1,0
43797,1000592,3,675,574,101,0.85037,0.14963,2.269153,62,39,677,574,103,0.847858,0.152142,2.275083,62,41,-1, merged,1,1,0
43798,1000023,1,1071,941,130,0.878618,0.121382,0.878618,119,11,1073,943,130,0.878844,0.121156,0.878844,119,11,1, merged,0,0,0
43801,1000592,2,677,574,103,0.847858,0.152142,1.659739,62,41,679,576,103,0.848306,0.151694,1.66384,62,41,-1, merged,0,0,0
43802,1000005,2,490,400,90,0.816327,0.183673,1.650551,84,6,491,401,90,0.816701,0.183299,1.642097,84,6,1, merged,0,0,0
43805,1000110,2,234,206,28,0.880342,0.119658,1.687448,26,2,235,206,29,0.876596,0.123404,1.680616,27,2,1, merged,1,1,0
43805,1000140,1,197,159,38,0.807107,0.192893,0.807107,32,6,199,160,39,0.80402,0.19598,0.80402,33,6,1, merged,1,1,0
43806,1000004,2,3244,2883,361,0.888718,0.111282,1.673085,281,80,3245,2884,361,0.888752,0.111248,1.672656,281,80,-1, abandoned,0,0,0
43806,1000329,1,2917,2288,629,0.784368,0.215632,0.784368,537,92,2920,2289,631,0.783904,0.216096,0.783904,539,92,-1, abandoned,1,0,0
43835,1000009,2,1153,959,194,0.831743,0.168257,1.553393,175,19,1154,960,194,0.831889,0.168111,1.554492,175,19,1, merged,0,0,0
43835,1000015,3,1994,1785,209,0.895186,0.104814,2.448578,191,18,1995,1786,209,0.895238,0.104762,2.44973,191,18,1, merged,0,0,0
43835,1000534,1,291,210,81,0.721649,0.278351,0.721649,75,6,292,211,81,0.722603,0.277397,0.722603,75,6,-1, merged,0,0,0
43841,1000023,1,1074,944,130,0.878957,0.121043,0.878957,119,11,1076,945,131,0.878253,0.121747,0.878253,120,11,1, merged,1,1,0
43853,1000091,2,511,397,114,0.776908,0.223092,1.603224,97,17,512,398,114,0.777344,0.222656,1.604569,97,17,1, merged,0,0,0
43855,1000592,2,681,577,104,0.847283,0.152717,1.68679,63,41,682,578,104,0.847507,0.152493,1.687671,63,41,1, merged,0,0,0
43856,1000015,4,1995,1786,209,0.895238,0.104762,3.263829,191,18,1996,1786,210,0.89479,0.10521,3.260819,192,18,1, merged,1,1,0
43856,1000328,2,891,657,234,0.737374,0.262626,1.584881,210,24,893,658,235,0.736842,0.263158,1.582098,211,24,-1, merged,1,0,0
43856,1000329,3,2922,2290,632,0.78371,0.21629,2.368591,540,92,2925,2293,632,0.783932,0.216068,2.366029,540,92,-1, merged,0,0,0
43856,1000592,1,682,578,104,0.847507,0.152493,0.847507,63,41,685,579,106,0.845255,0.154745,0.845255,65,41,1, merged,1,1,0
43859,1000091,2,512,398,114,0.777344,0.222656,1.603635,97,17,515,400,115,0.776699,0.223301,1.603802,98,17,-1, abandoned,1,0,0
43859,1000130,1,426,352,74,0.826291,0.173709,0.826291,59,15,428,354,74,0.827103,0.172897,0.827103,59,15,-1, abandoned,0,0,0
43859,1000592,3,685,579,106,0.845255,0.154745,2.44889,65,41,686,580,106,0.845481,0.154519,2.449283,65,41,-1, abandoned,0,0,0
43866,1000329,1,2928,2295,633,0.783811,0.216189,0.783811,541,92,2929,2296,633,0.783885,0.216115,0.783885,541,92,1, merged,0,0,0
43883,1000003,2,1123,934,189,0.831701,0.168299,1.695337,170,19,1127,938,189,0.832298,0.167702,1.692675,170,19,-1, merged,0,0,0
43885,1000132,1,409,364,45,0.889976,0.110024,0.889976,32,13,410,365,45,0.890244,0.109756,0.890244,32,13,1, merged,0,0,0
43896,1000054,4,699,607,92,0.868383,0.131617,3.040689,76,16,700,608,92,0.868571,0.131429,2.913529,76,16,1, merged,0,0,0
43904,1000592,2,686,580,106,0.845481,0.154519,1.661015,65,41,688,581,107,0.844477,0.155523,1.661784,66,41,1, merged,1,1,0
43908,1000009,2,1154,960,194,0.831889,0.168111,1.554492,175,19,1155,961,194,0.832035,0.167965,1.554069,175,19,1, merged,0,0,0
43908,1000534,1,292,211,81,0.722603,0.277397,0.722603,75,6,295,213,82,0.722034,0.277966,0.722034,76,6,1, merged,1,1,0
43915,1000121,2,2141,1771,370,0.827184,0.172816,1.563295,345,25,2142,1772,370,0.827264,0.172736,1.564106,345,25,1, merged,0,0,0
43934,1000009,1,1155,961,194,0.832035,0.167965,0.832035,175,19,1156,962,194,0.83218,0.16782,0.83218,175,19,1, merged,0,0,0
43950,1000023,3,1080,949,131,0.878704,0.121296,2.522254,120,11,1081,950,131,0.878816,0.121184,2.526897,120,11,1, merged,0,0,0
43961,1000070,2,1155,995,160,0.861472,0.138528,1.644896,136,24,1157,996,161,0.860847,0.139153,1.644078,137,24,1, merged,1,1,0
43961,1000329,1,2932,2297,635,0.783424,0.216576,0.783424,543,92,2934,2298,636,0.783231,0.216769,0.783231,544,92,-1, merged,1,0,0
43966,1000004,2,3245,2884,361,0.888752,0.111248,1.712281,281,80,3246,2885,361,0.888786,0.111214,1.688786,281,80,1, merged,0,0,0
43973,1000120,3,1565,1347,218,0.860703,0.139297,2.495179,191,27,1566,1348,218,0.860792,0.139208,2.490944,191,27,-1, abandoned,0,0,0
43973,1000534,2,295,213,82,0.722034,0.277966,1.634476,76,6,298,215,83,0.721477,0.278523,1.630152,77,6,-1, abandoned,1,0,0
43981,1000004,2,3246,2885,361,0.888786,0.111214,1.888786,281,80,3247,2886,361,0.88882,0.11118,1.88882,281,80,1, merged,0,0,0
43996,1000005,2,500,410,90,0.82,0.18,1.423774,84,6,502,412,90,0.820717,0.179283,1.438899,84,6,1, merged,0,0,0
44011,1000009,2,1156,962,194,0.83218,0.16782,1.553656,175,19,1158,963,195,0.831606,0.168394,1.547778,176,19,-1, merged,1,0,0
44011,1000534,1,298,215,83,0.721477,0.278523,0.721477,77,6,303,217,86,0.716172,0.283828,0.716172,80,6,-1, merged,1,0,0
44014,1000009,2,1158,963,195,0.831606,0.168394,1.547778,176,19,1160,965,195,0.831897,0.168103,1.547583,176,19,-1, merged,0,0,0
44014,1000534,1,303,217,86,0.716172,0.283828,0.716172,80,6,306,219,87,0.715686,0.284314,0.715686,81,6,1, merged,1,1,0
44016,1000023,4,1082,951,131,0.878928,0.121072,3.31866,120,11,1083,952,131,0.87904,0.12096,3.324289,120,11,-1, abandoned,0,0,0
44024,1002169,1,372,245,127,0.658602,0.341398,0.658602,121,6,375,248,127,0.661333,0.338667,0.661333,121,6,-1, merged,0,0,0
44026,1000009,2,1160,965,195,0.831897,0.168103,1.447281,176,19,1161,966,195,0.832041,0.167959,1.474898,176,19,1, merged,0,0,0
44027,1000329,2,2942,2304,638,0.783141,0.216859,0.783141,546,92,2945,2306,639,0.783022,0.216978,0.783022,547,92,-1, merged,1,0,0
44028,1000329,1,2945,2306,639,0.783022,0.216978,0.783022,547,92,2946,2307,639,0.783096,0.216904,0.783096,547,92,-1, merged,0,0,0
44028,1000592,2,688,581,107,0.844477,0.155523,1.627499,66,41,690,583,107,0.844928,0.155072,1.628023,66,41,-1, merged,0,0,0
44039,1000592,3,690,583,107,0.844928,0.155072,2.308241,66,41,692,585,107,0.845376,0.154624,2.310888,66,41,-1, merged,0,0,0
44039,1002169,2,375,248,127,0.661333,0.338667,1.463314,121,6,376,249,127,0.662234,0.337766,1.465513,121,6,-1, merged,0,0,0
44040,1000166,2,419,330,89,0.787589,0.212411,1.600089,85,4,420,331,89,0.788095,0.211905,1.584014,85,4,1, merged,0,0,0
44043,1000132,1,413,368,45,0.891041,0.108959,0.891041,32,13,414,369,45,0.891304,0.108696,0.891304,32,13,-1, abandoned,0,0,0
44045,1000023,2,1083,952,131,0.87904,0.12096,1.719204,120,11,1085,953,132,0.878341,0.121659,1.715076,121,11,1, merged,1,1,0
44049,1000014,1,2241,1879,362,0.838465,0.161535,0.838465,339,23,2242,1880,362,0.838537,0.161463,0.838537,339,23,1, merged,0,0,0
44051,1000005,1,502,412,90,0.820717,0.179283,0.820717,84,6,504,413,91,0.819444,0.180556,0.819444,84,7,-1, merged,1,0,0
44051,1000121,2,2148,1778,370,0.827747,0.172253,1.648464,345,25,2149,1779,370,0.827827,0.172173,1.647271,345,25,1, merged,0,0,0
44055,1000120,3,1566,1348,218,0.860792,0.139208,2.205489,191,27,1567,1349,218,0.860881,0.139119,2.222994,191,27,1, merged,0,0,0
44059,1000110,2,242,213,29,0.880165,0.119835,1.524233,27,2,243,214,29,0.880658,0.119342,1.530658,27,2,1, merged,0,0,0
44060,1000110,2,243,214,29,0.880658,0.119342,1.530658,27,2,244,215,29,0.881148,0.118852,1.536885,27,2,1, merged,0,0,0
44062,1000005,1,504,413,91,0.819444,0.180556,0.819444,84,7,505,414,91,0.819802,0.180198,0.819802,84,7,-1, merged,0,0,0
44067,1000004,2,3248,2887,361,0.888855,0.111145,1.688855,281,80,3249,2887,362,0.888581,0.111419,1.67979,282,80,1, abandoned,1,1,0
44070,1000120,2,1568,1350,218,0.860969,0.139031,0.860969,191,27,1569,1351,218,0.861058,0.138942,1.861058,191,27,1, merged,0,0,0
44071,1000132,1,414,369,45,0.891304,0.108696,0.891304,32,13,415,370,45,0.891566,0.108434,0.891566,32,13,1, merged,0,0,0
44073,1000004,2,3249,2887,362,0.888581,0.111419,1.740433,282,80,3252,2890,362,0.888684,0.111316,1.738438,282,80,-1, merged,0,0,0
44073,1000199,1,405,345,60,0.851852,0.148148,0.851852,54,6,406,345,61,0.849754,0.150246,0.849754,55,6,1, merged,1,1,0
44075,1000329,1,2946,2307,639,0.783096,0.216904,0.783096,547,92,2948,2308,640,0.782904,0.217096,0.782904,548,92,1, merged,1,1,0
44076,1000329,1,2948,2308,640,0.782904,0.217096,0.782904,548,92,2949,2309,640,0.782977,0.217023,0.782977,548,92,1, merged,0,0,0
44097,1000132,2,416,371,45,0.891827,0.108173,1.774586,32,13,417,372,45,0.892086,0.107914,1.775648,32,13,1, merged,0,0,0
44105,1000009,2,1162,967,195,0.832186,0.167814,1.67834,176,19,1163,968,195,0.83233,0.16767,1.64483,176,19,1, merged,0,0,0
44112,1000043,2,566,473,93,0.835689,0.164311,1.664803,80,13,567,474,93,0.835979,0.164021,1.659878,80,13,1, merged,0,0,0
44112,1000108,1,158,131,27,0.829114,0.170886,0.829114,23,4,159,131,28,0.823899,0.176101,0.823899,24,4,1, merged,1,1,0
44118,1000014,1,2243,1881,362,0.838609,0.161391,0.838609,339,23,2244,1882,362,0.838681,0.161319,0.838681,339,23,1, merged,0,0,0
44118,1000120,2,1570,1352,218,0.861146,0.138854,1.699756,191,27,1571,1353,218,0.861235,0.138765,1.699916,191,27,1, merged,0,0,0
44123,1000007,2,1345,1090,255,0.810409,0.189591,1.705619,226,29,1346,1090,256,0.809807,0.190193,1.70457,227,29,1, merged,1,1,0
44123,1000015,1,2004,1794,210,0.89521,0.10479,0.89521,192,18,2005,1794,211,0.894763,0.105237,0.894763,193,18,1, merged,1,1,0
44136,1000014,3,2244,1882,362,0.838681,0.161319,2.359747,339,23,2245,1883,362,0.838753,0.161247,2.360184,339,23,1, merged,0,0,0
44136,1000328,2,897,662,235,0.738016,0.261984,1.521066,211,24,898,663,235,0.738307,0.261693,1.521432,211,24,1, merged,0,0,0
44136,1000329,1,2950,2310,640,0.783051,0.216949,0.783051,548,92,2951,2311,640,0.783124,0.216876,0.783124,548,92,-1, merged,0,0,0
44148,1000004,1,3258,2896,362,0.888889,0.111111,0.888889,282,80,3259,2897,362,0.888923,0.111077,0.888923,282,80,-1, abandoned,0,0,0
44148,1000023,2,1086,954,132,0.878453,0.121547,1.767342,121,11,1087,954,133,0.877645,0.122355,1.766568,122,11,1, abandoned,1,1,0
44152,1000023,1,1087,954,133,0.877645,0.122355,0.877645,122,11,1088,955,133,0.877757,0.122243,0.877757,122,11,1, merged,0,0,0
44152,1000329,2,2951,2311,640,0.783124,0.216876,1.660769,548,92,2952,2312,640,0.783198,0.216802,1.660955,548,92,1, merged,0,0,0
44157,1000070,2,1173,1005,168,0.856777,0.143223,1.639975,144,24,1174,1006,168,0.856899,0.143101,1.640244,144,24,1, merged,0,0,0
44157,1000329,1,2952,2312,640,0.783198,0.216802,0.783198,548,92,2954,2314,640,0.783345,0.216655,0.783345,548,92,-1, merged,0,0,0
44161,1000070,2,1174,1006,168,0.856899,0.143101,1.640391,144,24,1175,1006,169,0.85617,0.14383,1.639735,145,24,1, abandoned,1,1,0
44161,1000329,1,2956,2316,640,0.783491,0.216509,0.783491,548,92,2957,2317,640,0.783564,0.216436,0.783564,548,92,-1, abandoned,0,0,0
44201,1000003,2,1127,938,189,0.832298,0.167702,1.670677,170,19,1128,939,189,0.832447,0.167553,1.669326,170,19,-1, merged,0,0,0
44201,1000014,1,2246,1883,363,0.838379,0.161621,0.838379,340,23,2256,1888,368,0.836879,0.163121,0.836879,345,23,-1, merged,1,0,0
44210,1000592,4,694,587,107,0.845821,0.154179,3.065796,66,41,695,588,107,0.846043,0.153957,3.067015,66,41,1, merged,0,0,0
44210,1002169,3,376,249,127,0.662234,0.337766,2.219975,121,6,377,250,127,0.66313,0.33687,2.220972,121,6,-1, merged,0,0,0
44212,1000110,2,244,215,29,0.881148,0.118852,1.544278,27,2,246,216,30,0.878049,0.121951,1.54207,28,2,1, abandoned,1,1,0
44212,1002169,1,377,250,127,0.66313,0.33687,0.66313,121,6,378,251,127,0.664021,0.335979,0.664021,121,6,-1, abandoned,0,0,0
44217,1000004,1,3262,2900,362,0.889025,0.110975,0.889025,282,80,3263,2900,363,0.888753,0.111247,0.888753,283,80,1, abandoned,1,1,0
44217,1000329,2,2957,2317,640,0.783564,0.216436,1.67259,548,92,2958,2318,640,0.783638,0.216362,1.67239,548,92,-1, abandoned,0,0,0
44219,1000009,1,1165,970,195,0.832618,0.167382,0.832618,176,19,1169,972,197,0.83148,0.16852,0.83148,178,19,1, merged,1,1,0
44219,1000015,2,2007,1796,211,0.894868,0.105132,1.727486,193,18,2008,1797,211,0.89492,0.10508,1.7264,193,18,1, merged,0,0,0
44223,1000004,2,3263,2900,363,0.888753,0.111247,1.684869,283,80,3269,2905,364,0.888651,0.111349,1.686728,284,80,-1, merged,1,0,0
44228,1000327,1,696,549,147,0.788793,0.211207,0.788793,114,33,697,550,147,0.789096,0.210904,0.789096,114,33,-1, merged,0,0,0
44242,1000023,3,1089,956,133,0.87787,0.12213,2.600947,122,11,1090,957,133,0.877982,0.122018,2.604508,122,11,1, merged,0,0,0
44243,1000023,3,1090,957,133,0.877982,0.122018,2.604508,122,11,1091,958,133,0.878093,0.121907,2.607953,122,11,1, merged,0,0,0
44245,1000023,3,1091,958,133,0.878093,0.121907,2.607953,122,11,1092,959,133,0.878205,0.121795,2.611288,122,11,1, merged,0,0,0
44246,1000023,3,1092,959,133,0.878205,0.121795,2.611288,122,11,1093,960,133,0.878317,0.121683,2.614519,122,11,1, merged,0,0,0
44247,1000023,3,1093,960,133,0.878317,0.121683,2.614519,122,11,1094,961,133,0.878428,0.121572,2.617653,122,11,1, merged,0,0,0
44249,1000023,3,1094,961,133,0.878428,0.121572,2.620585,122,11,1095,962,133,0.878539,0.121461,2.62354,122,11,1, merged,0,0,0
44250,1000023,3,1095,962,133,0.878539,0.121461,2.62354,122,11,1096,963,133,0.87865,0.12135,2.626414,122,11,1, merged,0,0,0
44251,1000023,3,1096,963,133,0.87865,0.12135,2.626414,122,11,1097,964,133,0.87876,0.12124,2.62921,122,11,1, merged,0,0,0
44252,1000004,2,3270,2906,364,0.888685,0.111315,1.701635,284,80,3271,2907,364,0.888719,0.111281,1.703005,284,80,1, merged,0,0,0
44253,1000005,3,515,424,91,0.823301,0.176699,2.575087,84,7,516,425,91,0.823643,0.176357,2.578022,84,7,1, merged,0,0,0
44254,1000005,3,516,425,91,0.823643,0.176357,2.578022,84,7,517,426,91,0.823985,0.176015,2.580886,84,7,1, merged,0,0,0
44255,1000023,3,1097,964,133,0.87876,0.12124,2.635662,122,11,1098,965,133,0.878871,0.121129,2.638229,122,11,1, merged,0,0,0
44258,1000023,3,1098,965,133,0.878871,0.121129,2.638229,122,11,1099,966,133,0.878981,0.121019,2.640733,122,11,1, merged,0,0,0
44270,1000023,1,1099,966,133,0.878981,0.121019,0.878981,122,11,1100,966,134,0.878182,0.121818,0.878182,123,11,1, merged,1,1,0
44270,1000091,2,523,407,116,0.778203,0.221797,1.657184,98,18,525,408,117,0.777143,0.222857,1.655325,99,18,1, merged,1,1,0
44273,1000023,2,1100,966,134,0.878182,0.121818,1.738054,123,11,1101,967,134,0.878292,0.121708,1.735435,123,11,1, merged,0,0,0
44277,1000023,1,1101,967,134,0.878292,0.121708,0.878292,123,11,1102,968,134,0.878403,0.121597,0.878403,123,11,1, merged,0,0,0
44283,1000004,2,3271,2907,364,0.888719,0.111281,1.796168,284,80,3276,2912,364,0.888889,0.111111,1.794507,284,80,-1, merged,0,0,0
44283,1000026,1,443,402,41,0.907449,0.092551,0.907449,39,2,445,403,42,0.905618,0.094382,0.905618,40,2,1, merged,1,1,0
44285,1000014,1,2257,1889,368,0.836952,0.163048,0.836952,345,23,2267,1893,374,0.835024,0.164976,0.835024,351,23,-1, merged,1,0,0
44285,1002169,2,378,251,127,0.664021,0.335979,1.500973,121,6,382,255,127,0.667539,0.332461,1.502564,121,6,-1, merged,0,0,0
44288,1000005,2,518,427,91,0.824324,0.175676,1.652551,84,7,521,429,92,0.823417,0.176583,1.651339,85,7,1, merged,1,1,0
44288,1000121,1,2154,1784,370,0.828227,0.171773,0.828227,345,25,2156,1785,371,0.827922,0.172078,0.827922,346,25,1, merged,1,1,0
44291,1000004,1,3276,2912,364,0.888889,0.111111,0.888889,284,80,3277,2913,364,0.888923,0.111077,0.888923,284,80,-1, merged,0,0,0
44291,1000120,2,1574,1356,218,0.861499,0.138501,1.750388,191,27,1575,1356,219,0.860952,0.139048,1.749875,192,27,1, merged,1,1,0
44303,1000054,3,701,609,92,0.868759,0.131241,1.731662,76,16,702,610,92,0.868946,0.131054,2.234025,76,16,1, merged,0,0,0
44304,1000004,2,3277,2913,364,0.888923,0.111077,1.67256,284,80,3278,2914,364,0.888957,0.111043,1.672329,284,80,1, merged,0,0,0
44304,1000329,1,2958,2318,640,0.783638,0.216362,0.783638,548,92,2959,2318,641,0.783373,0.216627,0.783373,549,92,1, merged,1,1,0
44305,1000023,2,1102,968,134,0.878403,0.121597,1.820711,123,11,1103,969,134,0.878513,0.121487,1.821909,123,11,1, merged,0,0,0
44306,1000009,1,1172,975,197,0.831911,0.168089,0.831911,178,19,1175,976,199,0.830638,0.169362,0.830638,180,19,-1, merged,1,0,0
44308,1000023,4,1103,969,134,0.878513,0.121487,3.424727,123,11,1104,970,134,0.878623,0.121377,3.426865,123,11,1, merged,0,0,0
44308,1000329,1,2959,2318,641,0.783373,0.216627,0.783373,549,92,2960,2318,642,0.783108,0.216892,0.783108,550,92,1, merged,1,1,0
44309,1000023,1,1104,970,134,0.878623,0.121377,0.878623,123,11,1106,971,135,0.877939,0.122061,0.877939,124,11,1, merged,1,1,0
44310,1000003,4,1128,939,189,0.832447,0.167553,3.224284,170,19,1129,940,189,0.832595,0.167405,3.233543,170,19,1, merged,0,0,0
44316,1000105,3,535,419,116,0.783178,0.216822,2.548312,105,11,536,420,116,0.783582,0.216418,2.525923,105,11,1, merged,0,0,0
44317,1000007,1,1352,1096,256,0.810651,0.189349,0.810651,227,29,1356,1098,258,0.809735,0.190265,0.809735,229,29,1, merged,1,1,0
44317,1000012,2,560,486,74,0.867857,0.132143,1.678508,72,2,561,486,75,0.86631,0.13369,1.676045,73,2,1, merged,1,1,0
44319,1000329,1,2960,2318,642,0.783108,0.216892,0.783108,550,92,2962,2320,642,0.783255,0.216745,0.783255,550,92,-1, merged,0,0,0
44331,1000105,2,536,420,116,0.783582,0.216418,0.783582,105,11,539,422,117,0.782931,0.217069,1.782931,105,12,1, merged,1,0,0
44332,1000105,2,539,422,117,0.782931,0.217069,1.782931,105,12,543,425,118,0.782689,0.217311,1.782689,105,13,1, merged,1,0,0
44338,1000054,2,702,610,92,0.868946,0.131054,1.528946,76,16,704,612,92,0.869318,0.130682,1.516377,76,16,-1, merged,0,0,0
44343,1000004,2,3279,2915,364,0.888991,0.111009,1.672245,284,80,3280,2916,364,0.889024,0.110976,1.672015,284,80,1, merged,0,0,0
44343,1000014,3,2268,1894,374,0.835097,0.164903,2.507342,351,23,2269,1895,374,0.83517,0.16483,2.507184,351,23,1, merged,0,0,0
44343,1000023,4,1107,972,135,0.878049,0.121951,3.385391,124,11,1108,973,135,0.878159,0.121841,3.385343,124,11,1, merged,0,0,0
44343,1000329,1,2962,2320,642,0.783255,0.216745,0.783255,550,92,2963,2320,643,0.78299,0.21701,0.78299,551,92,1, merged,1,1,0
44345,1000005,2,526,432,94,0.821293,0.178707,1.604283,87,7,527,433,94,0.821632,0.178368,1.604358,87,7,1, merged,0,0,0
44345,1000329,1,2963,2320,643,0.78299,0.21701,0.78299,551,92,2964,2320,644,0.782726,0.217274,0.782726,552,92,1, merged,1,1,0
44348,1000014,2,2269,1895,374,0.83517,0.16483,1.617896,351,23,2272,1896,376,0.834507,0.165493,1.616969,353,23,1, merged,1,1,0
44348,1000329,1,2964,2320,644,0.782726,0.217274,0.782726,552,92,2965,2320,645,0.782462,0.217538,0.782462,553,92,1, merged,1,1,0
44350,1000007,2,1356,1098,258,0.809735,0.190265,1.640373,229,29,1357,1098,259,0.809138,0.190862,1.63907,230,29,1, merged,1,1,0
44350,1000009,1,1175,976,199,0.830638,0.169362,0.830638,180,19,1176,976,200,0.829932,0.170068,0.829932,181,19,1, merged,1,1,0
44350,1000015,3,2009,1798,211,0.894973,0.105027,2.535345,193,18,2010,1798,212,0.894527,0.105473,2.533597,194,18,1, merged,1,1,0
44360,1000007,2,1357,1098,259,0.809138,0.190862,1.63907,230,29,1358,1099,259,0.809278,0.190722,1.639355,230,29,-1, abandoned,0,0,0
44360,1000009,1,1176,976,200,0.829932,0.170068,0.829932,181,19,1177,977,200,0.830076,0.169924,0.830076,181,19,-1, abandoned,0,0,0
44363,1000054,2,704,612,92,0.869318,0.130682,1.730359,76,16,705,613,92,0.869504,0.130496,1.730632,76,16,1, merged,0,0,0
44363,1000120,1,1576,1357,219,0.861041,0.138959,0.861041,192,27,1577,1358,219,0.861129,0.138871,0.861129,192,27,1, merged,0,0,0
44367,1000005,1,528,433,95,0.820076,0.179924,0.820076,88,7,529,434,95,0.820416,0.179584,0.820416,88,7,1, merged,0,0,0
44367,1000329,2,2965,2320,645,0.782462,0.217538,1.602538,553,92,2966,2321,645,0.782535,0.217465,1.602951,553,92,1, merged,0,0,0
44368,1000004,1,3280,2916,364,0.889024,0.110976,0.889024,284,80,3281,2917,364,0.889058,0.110942,0.889058,284,80,1, merged,0,0,0
44368,1000120,2,1577,1358,219,0.861129,0.138871,1.750153,192,27,1578,1359,219,0.861217,0.138783,1.750275,192,27,1, merged,0,0,0
44370,1000004,1,3281,2917,364,0.889058,0.110942,0.889058,284,80,3282,2918,364,0.889092,0.110908,0.889092,284,80,1, merged,0,0,0
44370,1000014,2,2273,1897,376,0.83458,0.16542,1.723638,353,23,2274,1898,376,0.834653,0.165347,1.723745,353,23,1, merged,0,0,0
44373,1000070,3,1182,1009,173,0.853638,0.146362,2.102187,149,24,1183,1010,173,0.853762,0.146238,2.114391,149,24,1, merged,0,0,0
44378,1000070,2,1183,1010,173,0.853762,0.146238,1.658762,149,24,1184,1011,173,0.853885,0.146115,1.659855,149,24,1, merged,0,0,0
44378,1000140,1,200,161,39,0.805,0.195,0.805,33,6,201,162,39,0.80597,0.19403,0.80597,33,6,1, merged,0,0,0
44385,1000015,1,2011,1799,212,0.89458,0.10542,0.89458,194,18,2012,1800,212,0.894632,0.105368,0.894632,194,18,1, merged,0,0,0
44385,1000120,2,1582,1363,219,0.861568,0.138432,1.756147,192,27,1583,1364,219,0.861655,0.138345,1.756287,192,27,1, merged,0,0,0
44386,1000015,1,2012,1800,212,0.894632,0.105368,0.894632,194,18,2013,1801,212,0.894685,0.105315,0.894685,194,18,1, merged,0,0,0
44386,1000120,2,1583,1364,219,0.861655,0.138345,1.756287,192,27,1584,1365,219,0.861742,0.138258,1.756427,192,27,1, merged,0,0,0
44387,1000015,1,2013,1801,212,0.894685,0.105315,0.894685,194,18,2014,1802,212,0.894737,0.105263,0.894737,194,18,1, merged,0,0,0
44387,1000120,2,1584,1365,219,0.861742,0.138258,1.756427,192,27,1585,1366,219,0.86183,0.13817,1.756566,192,27,1, merged,0,0,0
44400,1000328,2,904,668,236,0.738938,0.261062,1.406477,212,24,906,670,236,0.739514,0.260486,1.409644,212,24,-1, abandoned,0,0,0
44400,1000329,3,2966,2321,645,0.782535,0.217465,2.189013,553,92,2967,2322,645,0.782609,0.217391,2.192253,553,92,-1, abandoned,0,0,0
44400,1002169,1,382,255,127,0.667539,0.332461,0.667539,121,6,385,258,127,0.67013,0.32987,0.67013,121,6,-1, abandoned,0,0,0
44407,1000091,2,525,408,117,0.777143,0.222857,1.447273,99,18,527,410,117,0.777989,0.222011,1.450669,99,18,-1, merged,0,0,0
44407,1000329,3,2967,2322,645,0.782609,0.217391,2.229881,553,92,2969,2324,645,0.782755,0.217245,2.233424,553,92,-1, merged,0,0,0
44407,1002169,1,385,258,127,0.67013,0.32987,0.67013,121,6,388,261,127,0.67268,0.32732,0.67268,121,6,-1, merged,0,0,0
44410,1000014,1,2275,1899,376,0.834725,0.165275,0.834725,353,23,2281,1902,379,0.833845,0.166155,0.833845,356,23,-1, merged,1,0,0
44410,1000105,2,544,426,118,0.783088,0.216912,1.617814,105,13,546,427,119,0.782051,0.217949,1.615896,105,14,-1, merged,1,0,0
44412,1000132,2,418,373,45,0.892344,0.107656,1.565025,32,13,420,375,45,0.892857,0.107143,1.564652,32,13,-1, merged,0,0,0
44412,1002169,1,388,261,127,0.67268,0.32732,0.67268,121,6,390,262,128,0.671795,0.328205,0.671795,121,7,-1, merged,1,0,0
44415,1000023,1,1114,978,136,0.877917,0.122083,0.877917,125,11,1115,979,136,0.878027,0.121973,0.878027,125,11,1, merged,0,0,0
44419,1000110,2,254,224,30,0.88189,0.11811,1.782989,28,2,255,225,30,0.882353,0.117647,1.783813,28,2,-1, abandoned,0,0,0
44424,1000005,2,530,435,95,0.820755,0.179245,1.647526,88,7,532,437,95,0.821429,0.178571,1.64828,88,7,1, merged,0,0,0
44424,1000121,1,2159,1785,374,0.826772,0.173228,0.826772,349,25,2160,1786,374,0.826852,0.173148,0.826852,349,25,1, merged,0,0,0
44430,1000014,4,2281,1902,379,0.833845,0.166155,3.249034,356,23,2283,1904,379,0.83399,0.16601,3.259882,356,23,-1, merged,0,0,0
44430,1000015,6,2016,1804,212,0.894841,0.105159,4.92663,194,18,2018,1806,212,0.894945,0.105055,4.937802,194,18,-1, merged,0,0,0
44430,1000329,5,2969,2324,645,0.782755,0.217245,4.031789,553,92,2972,2327,645,0.782974,0.217026,4.042856,553,92,-1, merged,0,0,0
44430,1002169,1,390,262,128,0.671795,0.328205,0.671795,121,7,402,274,128,0.681592,0.318408,0.681592,121,7,-1, merged,0,0,0
44432,1000140,2,201,162,39,0.80597,0.19403,1.667509,33,6,203,163,40,0.802956,0.197044,1.660099,34,6,1, merged,1,1,0
44433,1000003,3,1129,940,189,0.832595,0.167405,2.526633,170,19,1130,940,190,0.831858,0.168142,2.506833,171,19,1, merged,1,1,0
44433,1000004,2,3284,2920,364,0.88916,0.11084,1.694038,284,80,3287,2923,364,0.889261,0.110739,1.674975,284,80,-1, merged,0,0,0
44433,1000023,4,1115,979,136,0.878027,0.121973,3.40466,125,11,1116,980,136,0.878136,0.121864,3.38497,125,11,1, merged,0,0,0
44434,1000130,2,431,357,74,0.828306,0.171694,1.687681,59,15,432,358,74,0.828704,0.171296,1.688517,59,15,1, merged,0,0,0
44439,1000003,1,1130,940,190,0.831858,0.168142,0.831858,171,19,1132,942,190,0.832155,0.167845,0.832155,171,19,1, merged,0,0,0
44439,1000011,2,711,653,58,0.918425,0.081575,1.750283,53,5,712,654,58,0.918539,0.081461,1.750695,53,5,1, merged,0,0,0
44440,1000014,2,2283,1904,379,0.83399,0.16601,1.712127,356,23,2285,1906,379,0.834136,0.165864,1.712381,356,23,-1, merged,0,0,0
44440,1000023,1,1116,980,136,0.878136,0.121864,0.878136,125,11,1117,981,136,0.878245,0.121755,0.878245,125,11,-1, merged,0,0,0
44448,1000121,2,2161,1787,374,0.826932,0.173068,1.522054,349,25,2162,1788,374,0.827012,0.172988,1.529393,349,25,-1, abandoned,0,0,0
44454,1000014,1,2286,1907,379,0.834208,0.165792,0.834208,356,23,2288,1908,380,0.833916,0.166084,0.833916,357,23,1, merged,1,1,0
44454,1000328,2,906,670,236,0.739514,0.260486,1.573723,212,24,909,672,237,0.739274,0.260726,1.57319,212,25,-1, merged,1,0,0
44457,1000009,3,1177,977,200,0.830076,0.169924,2.189546,181,19,1178,978,200,0.830221,0.169779,2.21442,181,19,1, merged,0,0,0
44457,1000534,1,307,220,87,0.716612,0.283388,0.716612,81,6,308,221,87,0.717532,0.282468,0.717532,81,6,-1, merged,0,0,0
44458,1000121,3,2163,1789,374,0.827092,0.172908,1.563505,349,25,2164,1790,374,0.827172,0.172828,2.564299,349,25,1, merged,0,0,0
44466,1000005,2,536,441,95,0.822761,0.177239,1.649933,88,7,537,442,95,0.823091,0.176909,1.650343,88,7,1, merged,0,0,0
44466,1000121,1,2164,1790,374,0.827172,0.172828,0.827172,349,25,2165,1791,374,0.827252,0.172748,0.827252,349,25,1, merged,0,0,0
44470,1000009,1,1178,978,200,0.830221,0.169779,0.830221,181,19,1184,982,202,0.829392,0.170608,0.829392,183,19,1, merged,1,1,0
44470,1000534,2,308,221,87,0.717532,0.282468,1.547753,81,6,314,226,88,0.719745,0.280255,1.549137,82,6,-1, merged,1,0,0
44475,1000014,2,2290,1910,380,0.834061,0.165939,1.695978,357,23,2291,1911,380,0.834134,0.165866,1.696137,357,23,1, merged,0,0,0
44475,1000120,1,1586,1367,219,0.861917,0.138083,0.861917,192,27,1587,1368,219,0.862004,0.137996,0.862004,192,27,1, merged,0,0,0
44476,1000121,1,2165,1791,374,0.827252,0.172748,0.827252,349,25,2166,1791,375,0.82687,0.17313,0.82687,350,25,1, merged,1,1,0
44476,1000328,2,909,672,237,0.739274,0.260726,1.566526,212,25,910,672,238,0.738462,0.261538,1.565331,213,25,1, merged,1,1,0
44476,1000329,3,2972,2327,645,0.782974,0.217026,2.3495,553,92,2973,2328,645,0.783047,0.216953,2.348379,553,92,-1, merged,0,0,0
44483,1000005,2,538,443,95,0.82342,0.17658,1.65029,88,7,539,444,95,0.823748,0.176252,1.650697,88,7,1, merged,0,0,0
44483,1000121,1,2166,1791,375,0.82687,0.17313,0.82687,350,25,2167,1792,375,0.82695,0.17305,0.82695,350,25,1, merged,0,0,0
44489,1000105,2,547,428,119,0.78245,0.21755,1.675307,105,14,548,429,119,0.782847,0.217153,1.675958,105,14,1, merged,0,0,0
44489,1000132,1,420,375,45,0.892857,0.107143,0.892857,32,13,421,376,45,0.893112,0.106888,0.893112,32,13,1, merged,0,0,0
44497,1000091,2,528,411,117,0.778409,0.221591,1.460001,99,18,529,412,117,0.778828,0.221172,1.46121,99,18,1, merged,0,0,0
44497,1002169,1,402,274,128,0.681592,0.318408,0.681592,121,7,403,275,128,0.682382,0.317618,0.682382,121,7,-1, merged,0,0,0
44500,1000023,1,1120,984,136,0.878571,0.121429,0.878571,125,11,1122,984,138,0.877005,0.122995,0.877005,127,11,1, merged,1,1,0
44500,1000109,3,489,417,72,0.852761,0.147239,2.533764,67,5,491,419,72,0.85336,0.14664,2.530366,67,5,-1, merged,0,0,0
44503,1000014,1,2291,1911,380,0.834134,0.165866,0.834134,357,23,2292,1912,380,0.834206,0.165794,0.834206,357,23,1, merged,0,0,0
44508,1000004,1,3290,2926,364,0.889362,0.110638,0.889362,284,80,3292,2928,364,0.889429,0.110571,0.889429,284,80,-1, merged,0,0,0
44508,1000007,2,1360,1101,259,0.809559,0.190441,1.698921,230,29,1361,1102,259,0.809699,0.190301,1.699128,230,29,1, merged,0,0,0
44512,1000329,2,2976,2331,645,0.783266,0.216734,1.587188,553,92,2979,2334,645,0.783484,0.216516,1.588045,553,92,-1, merged,0,0,0
44521,1000023,1,1122,984,138,0.877005,0.122995,0.877005,127,11,1126,987,139,0.876554,0.123446,0.876554,128,11,1, merged,1,1,0
44521,1000329,3,2979,2334,645,0.783484,0.216516,2.527156,553,92,2980,2335,645,0.783557,0.216443,2.527661,553,92,1, merged,0,0,0
44529,1000014,2,2292,1912,380,0.834206,0.165794,1.665785,357,23,2293,1912,381,0.833842,0.166158,1.656759,358,23,1, abandoned,1,1,0
44532,1000004,1,3293,2929,364,0.889462,0.110538,0.889462,284,80,3297,2931,366,0.88899,0.11101,0.88899,286,80,-1, merged,1,0,0
44532,1000592,3,696,589,107,0.846264,0.153736,2.510727,66,41,697,590,107,0.846485,0.153515,2.513253,66,41,1, merged,0,0,0
44534,1000003,2,1133,943,190,0.832304,0.167696,1.691509,171,19,1134,944,190,0.832451,0.167549,1.692164,171,19,1, merged,0,0,0
44538,1000043,2,568,475,93,0.836268,0.163732,1.492005,80,13,569,476,93,0.836555,0.163445,1.497846,80,13,1, merged,0,0,0
44538,1000070,3,1190,1015,175,0.852941,0.147059,2.344946,151,24,1191,1016,175,0.853065,0.146935,2.35091,151,24,1, merged,0,0,0
44540,1000130,2,432,358,74,0.828704,0.171296,1.534586,59,15,433,359,74,0.829099,0.170901,1.538402,59,15,1, merged,0,0,0
44543,1000005,2,541,446,95,0.824399,0.175601,1.650827,88,7,542,447,95,0.824723,0.175277,1.65123,88,7,1, merged,0,0,0
44543,1000121,1,2172,1795,377,0.826427,0.173573,0.826427,352,25,2173,1796,377,0.826507,0.173493,0.826507,352,25,1, merged,0,0,0
44550,1000109,1,491,419,72,0.85336,0.14664,0.85336,67,5,492,420,72,0.853659,0.146341,0.853659,67,5,-1, abandoned,0,0,0
44565,1000328,2,910,672,238,0.738462,0.261538,1.522019,213,25,911,673,238,0.738749,0.261251,1.522378,213,25,1, merged,0,0,0
44565,1000329,1,2980,2335,645,0.783557,0.216443,0.783557,553,92,2981,2336,645,0.78363,0.21637,0.78363,553,92,-1, merged,0,0,0
44572,1000004,1,3301,2935,366,0.889125,0.110875,0.889125,286,80,3302,2936,366,0.889158,0.110842,0.889158,286,80,-1, merged,0,0,0
44572,1000329,2,2981,2336,645,0.78363,0.21637,1.672754,553,92,2984,2338,646,0.783512,0.216488,1.67267,554,92,-1, merged,1,0,0
44582,1000023,1,1130,990,140,0.876106,0.123894,0.876106,129,11,1132,990,142,0.874558,0.125442,0.874558,129,13,-1, merged,1,1,0
44582,1000091,2,530,413,117,0.779245,0.220755,1.655351,99,18,531,414,117,0.779661,0.220339,1.654219,99,18,1, merged,0,0,0
44599,1000329,2,2984,2338,646,0.783512,0.216488,1.465894,554,92,2985,2339,646,0.783585,0.216415,1.466753,554,92,1, merged,0,0,0
44599,1002169,1,403,275,128,0.682382,0.317618,0.682382,121,7,404,276,128,0.683168,0.316832,0.683168,121,7,-1, merged,0,0,0
44600,1000003,4,1134,944,190,0.832451,0.167549,3.140801,171,19,1135,945,190,0.832599,0.167401,2.662916,171,19,1, merged,0,0,0
44602,1000592,3,697,590,107,0.846485,0.153515,2.529653,66,41,698,591,107,0.846705,0.153295,2.530655,66,41,-1, abandoned,0,0,0
44602,1002169,1,404,276,128,0.683168,0.316832,0.683168,121,7,405,277,128,0.683951,0.316049,0.683951,121,7,-1, abandoned,0,0,0
44604,1000054,3,706,614,92,0.869688,0.130312,2.203535,76,16,707,615,92,0.869873,0.130127,2.222558,76,16,1, merged,0,0,0
44618,1000014,5,2293,1912,381,0.833842,0.166158,3.77891,358,23,2296,1913,383,0.833188,0.166812,3.772137,360,23,-1, abandoned,1,0,0
44618,1000130,3,433,359,74,0.829099,0.170901,2.252297,59,15,435,360,75,0.827586,0.172414,2.256596,60,15,-1, abandoned,1,0,0
44618,1000140,7,203,163,40,0.802956,0.197044,5.422446,34,6,206,164,42,0.796117,0.203883,5.411111,36,6,1, abandoned,1,1,0
44618,1002169,2,405,277,128,0.683951,0.316049,1.423198,121,7,416,288,128,0.692308,0.307692,1.42901,121,7,-1, abandoned,0,0,0
44624,1000004,1,3305,2939,366,0.889259,0.110741,0.889259,286,80,3306,2940,366,0.889292,0.110708,0.889292,286,80,1, merged,0,0,0
44624,1000120,2,1589,1370,219,0.862177,0.137823,1.751436,192,27,1590,1371,219,0.862264,0.137736,1.751556,192,27,1, merged,0,0,0
44627,1000534,2,314,226,88,0.719745,0.280255,1.622658,82,6,316,227,89,0.718354,0.281646,1.615551,82,7,-1, merged,1,0,0
44633,1000009,2,1187,985,202,0.829823,0.170177,1.548178,183,19,1188,986,202,0.829966,0.170034,1.551841,183,19,1, merged,0,0,0
44633,1000534,1,316,227,89,0.718354,0.281646,0.718354,82,7,320,231,89,0.721875,0.278125,0.721875,82,7,-1, merged,0,0,0
44634,1000007,1,1364,1105,259,0.810117,0.189883,0.810117,230,29,1365,1106,259,0.810256,0.189744,0.810256,230,29,1, merged,0,0,0
44634,1000014,2,2303,1919,384,0.833261,0.166739,1.643378,361,23,2304,1920,384,0.833333,0.166667,1.64359,361,23,1, merged,0,0,0
44636,1000009,2,1188,986,202,0.829966,0.170034,1.551841,183,19,1191,988,203,0.829555,0.170445,1.556549,184,19,-1, merged,1,0,0
44636,1000534,1,320,231,89,0.721875,0.278125,0.721875,82,7,326,237,89,0.726994,0.273006,0.726994,82,7,-1, merged,0,0,0
44646,1000534,1,326,237,89,0.726994,0.273006,0.726994,82,7,327,238,89,0.727829,0.272171,0.727829,82,7,1, merged,0,0,0
44661,1000132,2,423,378,45,0.893617,0.106383,1.698177,32,13,425,380,45,0.894118,0.105882,1.699312,32,13,1, merged,0,0,0
44662,1000009,1,1192,989,203,0.829698,0.170302,0.829698,184,19,1194,990,204,0.829146,0.170854,0.829146,185,19,1, merged,1,1,0
44662,1000026,3,445,403,42,0.905618,0.094382,2.422816,40,2,446,403,43,0.903587,0.096413,2.379792,41,2,1, merged,1,1,0
44662,1000534,4,327,238,89,0.727829,0.272171,3.150645,82,7,328,238,90,0.72561,0.27439,3.105402,83,7,1, merged,1,1,0
44672,1000023,1,1137,995,142,0.87511,0.12489,0.87511,129,13,1138,996,142,0.87522,0.12478,0.87522,129,13,1, merged,0,0,0
44688,1000004,2,3306,2940,366,0.889292,0.110708,1.722626,286,80,3307,2941,366,0.889326,0.110674,1.72237,286,80,1, merged,0,0,0
44688,1000014,1,2304,1920,384,0.833333,0.166667,0.833333,361,23,2306,1921,385,0.833044,0.166956,0.833044,362,23,1, merged,1,1,0
44688,1000329,3,2985,2339,646,0.783585,0.216415,2.50621,554,92,2986,2340,646,0.783657,0.216343,2.506027,554,92,1, merged,0,0,0
44689,1000014,1,2306,1921,385,0.833044,0.166956,0.833044,362,23,2307,1921,386,0.832683,0.167317,0.832683,363,23,1, merged,1,1,0
44689,1000329,2,2986,2340,646,0.783657,0.216343,1.616701,554,92,2987,2341,646,0.783729,0.216271,1.616413,554,92,1, merged,0,0,0
44690,1000004,1,3307,2941,366,0.889326,0.110674,0.889326,286,80,3308,2941,367,0.889057,0.110943,0.889057,287,80,1, merged,1,1,0
44690,1000329,2,2987,2341,646,0.783729,0.216271,1.673055,554,92,2988,2342,646,0.783802,0.216198,1.672859,554,92,1, merged,0,0,0
44701,1000023,1,1139,997,142,0.875329,0.124671,0.875329,129,13,1140,998,142,0.875439,0.124561,0.875439,129,13,1, merged,0,0,0
44704,1000120,2,1592,1373,219,0.862437,0.137563,1.642579,192,27,1593,1374,219,0.862524,0.137476,1.644214,192,27,1, merged,0,0,0
44708,1000070,2,1193,1018,175,0.853311,0.146689,1.747429,151,24,1194,1019,175,0.853434,0.146566,1.7478,151,24,1, merged,0,0,0
44708,1000132,1,425,380,45,0.894118,0.105882,0.894118,32,13,426,381,45,0.894366,0.105634,0.894366,32,13,-1, merged,0,0,0
44709,1000014,2,2307,1921,386,0.832683,0.167317,1.708122,363,23,2308,1922,386,0.832756,0.167244,1.708412,363,23,1, merged,0,0,0
44709,1000023,1,1140,998,142,0.875439,0.124561,0.875439,129,13,1142,1000,142,0.875657,0.124343,0.875657,129,13,1, merged,0,0,0
44712,1000003,2,1135,945,190,0.832599,0.167401,1.50907,171,19,1136,946,190,0.832746,0.167254,1.513906,171,19,-1, abandoned,0,0,0
44714,1000004,2,3308,2941,367,0.889057,0.110943,1.786253,287,80,3309,2942,367,0.88909,0.11091,1.777979,287,80,1, merged,0,0,0
44715,1000070,2,1194,1019,175,0.853434,0.146566,1.665934,151,24,1195,1020,175,0.853556,0.146444,1.671738,151,24,1, merged,0,0,0
44720,1000023,1,1142,1000,142,0.875657,0.124343,0.875657,129,13,1143,1001,142,0.875766,0.124234,0.875766,129,13,1, merged,0,0,0
44722,1000327,2,697,550,147,0.789096,0.210904,1.522429,114,33,698,551,147,0.789398,0.210602,1.539398,114,33,1, merged,0,0,0
44735,1000003,2,1136,946,190,0.832746,0.167254,1.6952,171,19,1137,947,190,0.832894,0.167106,1.692153,171,19,-1, abandoned,0,0,0
44738,1000023,1,1145,1003,142,0.875983,0.124017,0.875983,129,13,1146,1004,142,0.876091,0.123909,0.876091,129,13,1, merged,0,0,0
44742,1000007,1,1366,1107,259,0.810395,0.189605,0.810395,230,29,1367,1108,259,0.810534,0.189466,0.810534,230,29,-1, abandoned,0,0,0
44746,1000007,3,1367,1108,259,0.810534,0.189466,2.400865,230,29,1368,1109,259,0.810673,0.189327,2.408351,230,29,1, merged,0,0,0
44746,1000014,1,2308,1922,386,0.832756,0.167244,0.832756,363,23,2311,1925,386,0.832973,0.167027,0.832973,363,23,-1, merged,0,0,0
44753,1000070,2,1195,1020,175,0.853556,0.146444,1.353556,151,24,1196,1021,175,0.853679,0.146321,1.367965,151,24,1, merged,0,0,0
44755,1000004,1,3310,2943,367,0.889124,0.110876,0.889124,287,80,3311,2944,367,0.889157,0.110843,0.889157,287,80,1, merged,0,0,0
44755,1000120,2,1595,1376,219,0.862696,0.137304,1.75182,192,27,1596,1377,219,0.862782,0.137218,1.751939,192,27,1, merged,0,0,0
44762,1000023,1,1146,1004,142,0.876091,0.123909,0.876091,129,13,1147,1005,142,0.876199,0.123801,0.876199,129,13,1, merged,0,0,0
44763,1000070,2,1196,1021,175,0.853679,0.146321,1.605113,151,24,1197,1022,175,0.853801,0.146199,1.604277,151,24,-1, abandoned,0,0,0
44771,1000110,1,257,227,30,0.883268,0.116732,0.883268,28,2,259,229,30,0.88417,0.11583,0.88417,28,2,1, merged,0,0,0
44778,1000014,3,2312,1926,386,0.833045,0.166955,2.149596,363,23,2315,1926,389,0.831965,0.168035,2.121517,366,23,1, abandoned,1,1,0
44778,1000054,5,707,615,92,0.869873,0.130127,3.742998,76,16,708,615,93,0.868644,0.131356,3.711091,77,16,1, abandoned,1,1,0
44780,1000070,2,1197,1022,175,0.853801,0.146199,1.604752,151,24,1198,1022,176,0.853088,0.146912,1.604982,152,24,1, merged,1,1,0
44780,1000121,3,2178,1798,380,0.825528,0.174472,2.43028,355,25,2179,1799,380,0.825608,0.174392,2.43059,355,25,1, merged,0,0,0
44782,1000070,2,1198,1022,176,0.853088,0.146912,1.678697,152,24,1199,1023,176,0.853211,0.146789,1.67844,152,24,1, merged,0,0,0
44782,1000121,1,2179,1799,380,0.825608,0.174392,0.825608,355,25,2180,1799,381,0.825229,0.174771,0.825229,356,25,1, merged,1,1,0
44783,1000070,4,1199,1023,176,0.853211,0.146789,3.175943,152,24,1200,1024,176,0.853333,0.146667,3.177514,152,24,1, merged,0,0,0
44783,1000121,3,2180,1799,381,0.825229,0.174771,2.322732,356,25,2181,1800,381,0.825309,0.174691,2.32418,356,25,1, merged,0,0,0
44783,1002169,1,416,288,128,0.692308,0.307692,0.692308,121,7,417,289,128,0.693046,0.306954,0.693046,121,7,-1, merged,0,0,0
44785,1000070,2,1200,1024,176,0.853333,0.146667,1.546379,152,24,1202,1025,177,0.852745,0.147255,1.546525,153,24,1, merged,1,1,0
44785,1002169,1,417,289,128,0.693046,0.306954,0.693046,121,7,418,290,128,0.69378,0.30622,0.69378,121,7,-1, merged,0,0,0
44786,1000105,4,550,430,120,0.781818,0.218182,2.792534,106,14,552,431,121,0.780797,0.219203,2.762487,107,14,1, merged,1,1,0
44786,1002169,3,418,290,128,0.69378,0.30622,2.010716,121,7,420,292,128,0.695238,0.304762,1.98169,121,7,-1, merged,0,0,0
44787,1000105,3,552,431,121,0.780797,0.219203,1.956035,107,14,554,432,122,0.779783,0.220217,1.957235,108,14,1, merged,1,1,0
44787,1002169,1,420,292,128,0.695238,0.304762,0.695238,121,7,422,294,128,0.696682,0.303318,0.696682,121,7,-1, merged,0,0,0
44788,1000105,2,554,432,122,0.779783,0.220217,1.260553,108,14,556,433,123,0.778777,0.221223,1.251504,109,14,1, merged,1,1,0
44790,1000108,4,165,137,28,0.830303,0.169697,3.249785,24,4,166,138,28,0.831325,0.168675,3.24994,24,4,1, merged,0,0,0
44790,1000110,3,259,229,30,0.88417,0.11583,2.419482,28,2,260,229,31,0.880769,0.119231,2.418615,29,2,1, merged,1,1,0
44790,1000130,2,438,361,77,0.824201,0.175799,1.535312,62,15,440,361,79,0.820455,0.179545,1.537846,64,15,1, merged,1,1,0
44793,1000110,2,260,229,31,0.880769,0.119231,1.677871,29,2,261,230,31,0.881226,0.118774,1.679303,29,2,1, merged,0,0,0
44793,1000140,1,207,165,42,0.797101,0.202899,0.797101,36,6,208,166,42,0.798077,0.201923,0.798077,36,6,1, merged,0,0,0
44794,1000004,1,3311,2944,367,0.889157,0.110843,0.889157,287,80,3313,2946,367,0.889224,0.110776,0.889224,287,80,-1, merged,0,0,0
44794,1000329,2,2989,2343,646,0.783874,0.216126,1.673032,554,92,2990,2344,646,0.783946,0.216054,1.673171,554,92,1, merged,0,0,0
44796,1000015,4,2036,1823,213,0.895383,0.104617,3.433493,195,18,2038,1824,214,0.894995,0.105005,3.435564,196,18,1, merged,1,1,0
44796,1000534,3,328,238,90,0.72561,0.27439,2.53811,83,7,330,239,91,0.724242,0.275758,2.540569,84,7,-1, merged,1,0,0
44810,1000004,2,3313,2946,367,0.889224,0.110776,1.628545,287,80,3314,2947,367,0.889258,0.110742,1.62777,287,80,1, merged,0,0,0
44810,1000121,3,2182,1801,381,0.82539,0.17461,2.453935,356,25,2183,1802,381,0.82547,0.17453,2.453239,356,25,1, merged,0,0,0
44810,1000328,1,913,675,238,0.739321,0.260679,0.739321,213,25,914,675,239,0.738512,0.261488,0.738512,214,25,1, merged,1,1,0
44813,1000014,1,2316,1927,389,0.832038,0.167962,0.832038,366,23,2318,1929,389,0.832183,0.167817,0.832183,366,23,-1, merged,0,0,0
44815,1000023,2,1148,1006,142,0.876307,0.123693,1.572989,129,13,1149,1007,142,0.876414,0.123586,1.574527,129,13,-1, abandoned,0,0,0
44815,1002169,1,422,294,128,0.696682,0.303318,0.696682,121,7,424,296,128,0.698113,0.301887,0.698113,121,7,-1, abandoned,0,0,0
44823,1000004,2,3314,2947,367,0.889258,0.110742,1.721441,287,80,3317,2950,367,0.889358,0.110642,1.721613,287,80,-1, merged,0,0,0
44823,1000014,1,2318,1929,389,0.832183,0.167817,0.832183,366,23,2319,1930,389,0.832255,0.167745,0.832255,366,23,-1, merged,0,0,0
44823,1000329,3,2994,2348,646,0.784235,0.215765,2.505676,554,92,2996,2349,647,0.784045,0.215955,2.505659,554,93,-1, merged,1,1,0
44829,1000054,1,708,615,93,0.868644,0.131356,0.868644,77,16,709,616,93,0.868829,0.131171,0.868829,77,16,1, merged,0,0,0
44830,1000004,2,3317,2950,367,0.889358,0.110642,1.752483,287,80,3318,2950,368,0.88909,0.11091,1.7523,288,80,1, merged,1,1,0
44830,1000120,1,1600,1381,219,0.863125,0.136875,0.863125,192,27,1601,1382,219,0.86321,0.13679,0.86321,192,27,-1, merged,0,0,0
44838,1000054,2,710,617,93,0.869014,0.130986,1.369014,77,16,711,618,93,0.869198,0.130802,1.39861,77,16,1, merged,0,0,0
44840,1000004,6,3319,2951,368,0.889123,0.110877,3.972285,288,80,3320,2952,368,0.889157,0.110843,3.95049,288,80,1, merged,0,0,0
44845,1000004,1,3320,2952,368,0.889157,0.110843,0.889157,288,80,3323,2955,368,0.889257,0.110743,0.889257,288,80,-1, merged,0,0,0
44845,1000070,2,1203,1026,177,0.852868,0.147132,1.742024,153,24,1204,1027,177,0.85299,0.14701,1.742247,153,24,1, merged,0,0,0
44852,1000007,1,1370,1110,260,0.810219,0.189781,0.810219,231,29,1371,1111,260,0.810357,0.189643,0.810357,231,29,1, merged,0,0,0
44864,1000070,1,1205,1028,177,0.853112,0.146888,0.853112,153,24,1207,1029,178,0.852527,0.147473,0.852527,154,24,1, merged,1,1,0
44864,1000329,2,2996,2349,647,0.784045,0.215955,1.637157,554,93,2997,2349,648,0.783784,0.216216,1.636311,555,93,1, merged,1,1,0
44868,1000091,2,531,414,117,0.779661,0.220339,1.518173,99,18,532,415,117,0.780075,0.219925,1.519158,99,18,1, merged,0,0,0
44868,1000328,1,914,675,239,0.738512,0.261488,0.738512,214,25,916,677,239,0.739083,0.260917,0.739083,214,25,-1, merged,0,0,0
44870,1000105,2,559,436,123,0.779964,0.220036,1.67433,109,14,561,437,124,0.778966,0.221034,1.673826,110,14,1, merged,1,1,0
44870,1000132,1,426,381,45,0.894366,0.105634,0.894366,32,13,428,383,45,0.89486,0.10514,0.89486,32,13,-1, merged,0,0,0
44871,1000054,2,712,619,93,0.869382,0.130618,1.369382,77,16,713,620,93,0.869565,0.130435,1.425121,77,16,1, merged,0,0,0
44878,1000023,3,1151,1009,142,0.876629,0.123371,2.214655,129,13,1152,1010,142,0.876736,0.123264,2.21646,129,13,1, merged,0,0,0
44881,1000132,1,428,383,45,0.89486,0.10514,0.89486,32,13,430,384,46,0.893023,0.106977,0.893023,33,13,1, merged,1,1,0
44882,1000014,1,2319,1930,389,0.832255,0.167745,0.832255,366,23,2321,1932,389,0.8324,0.1676,0.8324,366,23,-1, merged,0,0,0
44891,1000023,1,1152,1010,142,0.876736,0.123264,0.876736,129,13,1153,1011,142,0.876843,0.123157,0.876843,129,13,1, merged,0,0,0
44891,1000329,2,2998,2350,648,0.783856,0.216144,1.660592,555,93,2999,2351,648,0.783928,0.216072,1.660771,555,93,1, merged,0,0,0
44892,1000004,2,3323,2955,368,0.889257,0.110743,1.699614,288,80,3324,2956,368,0.88929,0.11071,1.699924,288,80,1, merged,0,0,0
44892,1000007,1,1371,1111,260,0.810357,0.189643,0.810357,231,29,1373,1113,260,0.810634,0.189366,0.810634,231,29,-1, merged,0,0,0
44893,1000009,1,1196,992,204,0.829431,0.170569,0.829431,185,19,1198,992,206,0.828047,0.171953,0.828047,187,19,1, merged,1,1,0
44893,1000014,2,2321,1932,389,0.8324,0.1676,1.661831,366,23,2322,1932,390,0.832041,0.167959,1.660088,367,23,1, merged,1,1,0
44896,1000109,1,495,423,72,0.854545,0.145455,0.854545,67,5,498,425,73,0.853414,0.146586,0.853414,68,5,1, merged,1,1,0
44912,1000011,1,716,658,58,0.918994,0.081006,0.918994,53,5,717,659,58,0.919107,0.080893,0.919107,53,5,1, merged,0,0,0
44912,1000015,2,2042,1827,215,0.894711,0.105289,1.813705,196,19,2043,1828,215,0.894763,0.105237,1.81387,196,19,1, merged,0,0,0
44919,1000014,2,2322,1932,390,0.832041,0.167959,1.569442,367,23,2324,1933,391,0.831756,0.168244,1.567205,368,23,1, merged,1,1,0
44924,1000023,2,1154,1012,142,0.87695,0.12305,1.675027,129,13,1155,1013,142,0.877056,0.122944,1.676099,129,13,1, merged,0,0,0
44924,1000091,3,532,415,117,0.780075,0.219925,2.455102,99,18,533,416,117,0.780488,0.219512,2.456587,99,18,1, merged,0,0,0
44924,1000140,1,208,166,42,0.798077,0.201923,0.798077,36,6,209,167,42,0.799043,0.200957,0.799043,36,6,1, merged,0,0,0
44926,1000023,1,1155,1013,142,0.877056,0.122944,0.877056,129,13,1156,1014,142,0.877163,0.122837,0.877163,129,13,1, merged,0,0,0
44940,1000004,1,3325,2957,368,0.889323,0.110677,0.889323,288,80,3327,2958,369,0.889089,0.110911,0.889089,289,80,-1, abandoned,1,0,0
44940,1000015,2,2043,1828,215,0.894763,0.105237,1.784086,196,19,2044,1829,215,0.894814,0.105186,1.783903,196,19,-1, abandoned,0,0,0
44941,1000004,1,3327,2958,369,0.889089,0.110911,0.889089,289,80,3328,2959,369,0.889123,0.110877,0.889123,289,80,-1, merged,0,0,0
44941,1000120,2,1605,1386,219,0.863551,0.136449,1.752641,192,27,1606,1387,219,0.863636,0.136364,1.752759,192,27,1, merged,0,0,0
44945,1000054,1,716,622,94,0.868715,0.131285,0.868715,78,16,717,623,94,0.868898,0.131102,0.868898,78,16,1, merged,0,0,0
44946,1000004,1,3328,2959,369,0.889123,0.110877,0.889123,289,80,3330,2960,370,0.888889,0.111111,0.888889,289,81,-1, merged,1,1,0
44946,1000120,2,1606,1387,219,0.863636,0.136364,1.752759,192,27,1607,1388,219,0.863721,0.136279,1.75261,192,27,1, merged,0,0,0
44949,1000023,1,1156,1014,142,0.877163,0.122837,0.877163,129,13,1158,1016,142,0.877375,0.122625,0.877375,129,13,1, merged,0,0,0
44950,1000534,2,330,239,91,0.724242,0.275758,1.618048,84,7,331,240,91,0.725076,0.274924,1.620728,84,7,-1, abandoned,0,0,0
44960,1000329,2,3000,2352,648,0.784,0.216,1.482113,555,93,3001,2353,648,0.784072,0.215928,1.485704,555,93,-1, abandoned,0,0,0
44960,1002169,1,424,296,128,0.698113,0.301887,0.698113,121,7,429,301,128,0.701632,0.298368,0.701632,121,7,-1, abandoned,0,0,0
44966,1000054,1,719,625,94,0.869263,0.130737,0.869263,78,16,721,626,95,0.868239,0.131761,0.868239,79,16,1, merged,1,1,0
44968,1000130,4,441,362,79,0.820862,0.179138,3.163253,64,15,442,363,79,0.821267,0.178733,3.208364,64,15,-1, abandoned,0,0,0
44970,1000009,2,1198,992,206,0.828047,0.171953,1.659875,187,19,1199,992,207,0.827356,0.172644,1.658899,188,19,1, abandoned,1,1,0
44970,1000014,1,2325,1934,391,0.831828,0.168172,0.831828,368,23,2327,1935,392,0.831543,0.168457,0.831543,369,23,1, abandoned,1,1,0
44975,1000105,2,565,440,125,0.778761,0.221239,1.671784,111,14,566,440,126,0.777385,0.222615,1.670657,112,14,1, abandoned,1,1,0
44975,1000132,1,430,384,46,0.893023,0.106977,0.893023,33,13,431,385,46,0.893271,0.106729,0.893271,33,13,-1, abandoned,0,0,0
44992,1000014,1,2330,1936,394,0.830901,0.169099,0.830901,371,23,2332,1936,396,0.830189,0.169811,0.830189,373,23,1, merged,1,1,0
44992,1000015,3,2045,1830,215,0.894866,0.105134,2.725767,196,19,2046,1831,215,0.894917,0.105083,2.452378,196,19,1, merged,0,0,0
44999,1000012,1,566,491,75,0.867491,0.132509,0.867491,73,2,568,492,76,0.866197,0.133803,0.866197,73,3,1, merged,1,0,0
44999,1000015,2,2047,1832,215,0.894968,0.105032,1.762459,196,19,2048,1833,215,0.89502,0.10498,1.761217,196,19,1, merged,0,0,0
45002,1000011,1,719,661,58,0.919332,0.080668,0.919332,53,5,721,662,59,0.918169,0.081831,0.918169,54,5,1, merged,1,1,0
45002,1000120,2,1607,1388,219,0.863721,0.136279,1.783054,192,27,1609,1390,219,0.863891,0.136109,1.78206,192,27,1, merged,0,0,0
45010,1000014,1,2332,1936,396,0.830189,0.169811,0.830189,373,23,2334,1936,398,0.829477,0.170523,0.829477,373,25,-1, merged,1,1,0
45010,1000120,3,1609,1390,219,0.863891,0.136109,2.476974,192,27,1610,1391,219,0.863975,0.136025,2.477766,192,27,1, merged,0,0,0
45011,1000009,2,1203,996,207,0.82793,0.17207,1.443315,188,19,1204,997,207,0.828073,0.171927,1.47093,188,19,1, merged,0,0,0
45015,1000004,2,3330,2960,370,0.888889,0.111111,1.742303,289,81,3331,2961,370,0.888922,0.111078,1.74263,289,81,1, merged,0,0,0
45015,1000109,1,498,425,73,0.853414,0.146586,0.853414,68,5,499,426,73,0.853707,0.146293,0.853707,68,5,1, merged,0,0,0
45016,1000003,3,1141,949,192,0.831727,0.168273,2.47833,173,19,1142,950,192,0.831874,0.168126,2.478273,173,19,-1, merged,0,0,0
45016,1000109,4,499,426,73,0.853707,0.146293,3.332037,68,5,500,427,73,0.854,0.146,3.332273,68,5,1, merged,0,0,0
45016,1000199,2,409,347,62,0.848411,0.151589,1.646604,56,6,410,348,62,0.84878,0.15122,1.6464,56,6,-1, merged,0,0,0
45027,1000007,2,1379,1119,260,0.811458,0.188542,1.536533,231,29,1380,1119,261,0.81087,0.18913,1.536773,231,30,-1, merged,1,1,0
45027,1000534,1,331,240,91,0.725076,0.274924,0.725076,84,7,332,241,91,0.725904,0.274096,0.725904,84,7,-1, merged,0,0,0
45031,1000015,2,2049,1834,215,0.895071,0.104929,1.75433,196,19,2050,1835,215,0.895122,0.104878,1.754901,196,19,1, merged,0,0,0
45038,1000121,2,2186,1805,381,0.825709,0.174291,1.527341,356,25,2187,1805,382,0.825332,0.174668,1.529035,357,25,1, merged,1,1,0
45038,1000329,3,3001,2353,648,0.784072,0.215928,2.311413,555,93,3004,2355,649,0.783955,0.216045,2.31299,556,93,-1, merged,1,0,0
45038,1002169,1,429,301,128,0.701632,0.298368,0.701632,121,7,432,304,128,0.703704,0.296296,0.703704,121,7,-1, merged,0,0,0
45040,1000004,2,3335,2964,371,0.888756,0.111244,1.759723,290,81,3338,2967,371,0.888856,0.111144,1.761467,290,81,-1, merged,0,0,0
45040,1000108,3,169,141,28,0.83432,0.16568,2.594043,24,4,170,142,28,0.835294,0.164706,2.596761,24,4,1, merged,0,0,0
45048,1000007,3,1381,1120,261,0.811007,0.188993,2.448603,231,30,1382,1121,261,0.811143,0.188857,2.457541,231,30,-1, merged,0,0,0
45048,1000009,2,1204,997,207,0.828073,0.171927,1.637597,188,19,1205,998,207,0.828216,0.171784,1.646398,188,19,-1, merged,0,0,0
45052,1000003,2,1144,950,194,0.83042,0.16958,1.698841,175,19,1145,951,194,0.830568,0.169432,1.699171,175,19,1, merged,0,0,0
45052,1000054,1,722,627,95,0.868421,0.131579,0.868421,79,16,723,628,95,0.868603,0.131397,0.868603,79,16,1, merged,0,0,0
45054,1000003,2,1145,951,194,0.830568,0.169432,1.628187,175,19,1146,952,194,0.830716,0.169284,1.628935,175,19,-1, abandoned,0,0,0
45065,1000054,2,723,628,95,0.868603,0.131397,1.53527,79,16,724,629,95,0.868785,0.131215,1.541512,79,16,1, merged,0,0,0
45069,1000005,1,568,472,96,0.830986,0.169014,0.830986,89,7,569,473,96,0.831283,0.168717,0.831283,89,7,-1, merged,0,0,0
45069,1000121,2,2187,1805,382,0.825332,0.174668,1.656317,357,25,2189,1807,382,0.825491,0.174509,1.656774,357,25,-1, merged,0,0,0
45071,1000121,2,2189,1807,382,0.825491,0.174509,1.643673,357,25,2190,1808,382,0.825571,0.174429,1.651658,357,25,1, merged,0,0,0
45073,1000023,3,1162,1020,142,0.877797,0.122203,2.419309,129,13,1164,1022,142,0.878007,0.121993,2.424165,129,13,-1, abandoned,0,0,0
45073,1000054,1,724,629,95,0.868785,0.131215,0.868785,79,16,725,629,96,0.867586,0.132414,0.867586,80,16,1, abandoned,1,1,0
45074,1000110,2,262,231,31,0.881679,0.118321,1.381679,29,2,263,232,31,0.882129,0.117871,1.548796,29,2,1, merged,0,0,0
45101,1000004,2,3339,2968,371,0.888889,0.111111,1.756657,290,81,3340,2969,371,0.888922,0.111078,1.756873,290,81,1, merged,0,0,0
45101,1000054,1,726,630,96,0.867769,0.132231,0.867769,80,16,727,631,96,0.86795,0.13205,0.86795,80,16,1, merged,0,0,0
45103,1000009,1,1208,999,209,0.826987,0.173013,0.826987,190,19,1209,999,210,0.826303,0.173697,0.826303,191,19,1, merged,1,1,0
45103,1000534,2,332,241,91,0.725904,0.274096,1.55289,84,7,333,242,91,0.726727,0.273273,1.553029,84,7,1, merged,0,0,0
45109,1000003,1,1148,954,194,0.83101,0.16899,0.83101,175,19,1149,955,194,0.831158,0.168842,0.831158,175,19,-1, merged,0,0,0
45117,1000007,1,1386,1125,261,0.811688,0.188312,0.811688,231,30,1387,1126,261,0.811824,0.188176,0.811824,231,30,1, merged,0,0,0
45117,1000009,2,1211,1000,211,0.825764,0.174236,1.637452,192,19,1212,1001,211,0.825908,0.174092,1.637732,192,19,1, merged,0,0,0
45118,1000004,1,3340,2969,371,0.888922,0.111078,0.888922,290,81,3344,2973,371,0.889055,0.110945,0.889055,290,81,-1, merged,0,0,0
45118,1000070,2,1211,1031,180,0.851363,0.148637,1.740285,156,24,1213,1032,181,0.850783,0.149217,1.739838,157,24,1, merged,1,1,0
45123,1000007,1,1387,1126,261,0.811824,0.188176,0.811824,231,30,1388,1127,261,0.81196,0.18804,0.81196,231,30,1, merged,0,0,0
45123,1000014,2,2337,1939,398,0.829696,0.170304,1.64152,373,25,2338,1940,398,0.829769,0.170231,1.641729,373,25,1, merged,0,0,0
45124,1000328,3,918,679,239,0.739651,0.260349,2.186136,214,25,919,680,239,0.739935,0.260065,2.190439,214,25,1, merged,0,0,0
45124,1000329,2,3005,2355,650,0.783694,0.216306,1.446485,556,94,3007,2357,650,0.783838,0.216162,1.450504,556,94,1, merged,0,0,0
45125,1000014,1,2338,1940,398,0.829769,0.170231,0.829769,373,25,2343,1941,402,0.828425,0.171575,0.828425,377,25,1, merged,1,1,0
45130,1000132,1,432,386,46,0.893519,0.106481,0.893519,33,13,433,386,47,0.891455,0.108545,0.891455,34,13,1, abandoned,1,1,0
45154,1000014,1,2343,1941,402,0.828425,0.171575,0.828425,377,25,2346,1943,403,0.828218,0.171782,0.828218,378,25,-1, merged,1,0,0
45154,1000015,2,2051,1836,215,0.895173,0.104827,1.723598,196,19,2052,1837,215,0.895224,0.104776,1.723442,196,19,1, merged,0,0,0
45174,1000009,1,1215,1004,211,0.826337,0.173663,0.826337,192,19,1217,1006,211,0.826623,0.173377,0.826623,192,19,-1, merged,0,0,0
45180,1000009,2,1217,1006,211,0.826623,0.173377,1.55335,192,19,1220,1007,213,0.82541,0.17459,1.554577,194,19,1, merged,1,1,0
45180,1000534,1,333,242,91,0.726727,0.273273,0.726727,84,7,336,245,91,0.729167,0.270833,0.729167,84,7,-1, merged,0,0,0
45188,1000003,3,1149,955,194,0.831158,0.168842,2.516178,175,19,1151,956,195,0.830582,0.169418,2.509786,176,19,1, merged,1,1,0
45188,1000023,2,1175,1032,143,0.878298,0.121702,1.685021,130,13,1176,1032,144,0.877551,0.122449,1.679204,131,13,1, merged,1,1,0
45189,1000011,2,721,662,59,0.918169,0.081831,1.584836,54,5,722,663,59,0.918283,0.081717,1.605783,54,5,1, merged,0,0,0
45190,1000070,1,1213,1032,181,0.850783,0.149217,0.850783,157,24,1214,1033,181,0.850906,0.149094,0.850906,157,24,1, merged,0,0,0
45191,1000070,2,1214,1033,181,0.850906,0.149094,1.571055,157,24,1215,1034,181,0.851029,0.148971,1.572218,157,24,1, merged,0,0,0
45209,1000009,1,1220,1007,213,0.82541,0.17459,0.82541,194,19,1221,1008,213,0.825553,0.174447,0.825553,194,19,1, merged,0,0,0
45209,1000015,2,2054,1839,215,0.895326,0.104674,1.720736,196,19,2055,1840,215,0.895377,0.104623,1.72093,196,19,1, merged,0,0,0
45216,1000003,2,1151,956,195,0.830582,0.169418,1.642812,176,19,1152,957,195,0.830729,0.169271,1.642511,176,19,-1, abandoned,0,0,0
45216,1000007,1,1390,1129,261,0.81223,0.18777,0.81223,231,30,1392,1130,262,0.811782,0.188218,0.811782,232,30,-1, abandoned,1,0,0
45221,1000014,2,2349,1944,405,0.827586,0.172414,1.53129,380,25,2353,1947,406,0.827454,0.172546,1.531842,381,25,-1, merged,1,0,0
45221,1000110,3,263,232,31,0.882129,0.117871,2.413419,29,2,265,234,31,0.883019,0.116981,2.414861,29,2,-1, merged,0,0,0
45221,1002169,1,432,304,128,0.703704,0.296296,0.703704,121,7,433,305,128,0.704388,0.295612,0.704388,121,7,-1, merged,0,0,0
45227,1000009,2,1221,1008,213,0.825553,0.174447,1.513053,194,19,1222,1009,213,0.825696,0.174304,1.531578,194,19,1, merged,0,0,0
45230,1000003,1,1152,957,195,0.830729,0.169271,0.830729,176,19,1155,958,197,0.829437,0.170563,0.829437,178,19,1, merged,1,1,0
45230,1000007,2,1392,1130,262,0.811782,0.188218,1.642511,232,30,1393,1131,262,0.811917,0.188083,1.641354,232,30,-1, merged,0,0,0
45235,1000004,1,3347,2975,372,0.888856,0.111144,0.888856,291,81,3350,2978,372,0.888955,0.111045,0.888955,291,81,-1, merged,0,0,0
45237,1000109,2,500,427,73,0.854,0.146,1.65341,68,5,501,428,73,0.854291,0.145709,1.652537,68,5,1, merged,0,0,0
45240,1000015,2,2056,1841,215,0.895428,0.104572,1.802055,196,19,2057,1842,215,0.895479,0.104521,1.802199,196,19,1, merged,0,0,0
45240,1000153,1,996,903,93,0.906627,0.093373,0.906627,70,23,997,904,93,0.90672,0.09328,0.90672,70,23,-1, merged,0,0,0
45246,1000003,1,1155,958,197,0.829437,0.170563,0.829437,178,19,1157,959,198,0.828868,0.171132,0.828868,179,19,1, merged,1,1,0
45250,1000004,1,3351,2979,372,0.888988,0.111012,0.888988,291,81,3353,2981,372,0.889055,0.110945,0.889055,291,81,-1, merged,0,0,0
45253,1000023,1,1178,1034,144,0.877759,0.122241,0.877759,131,13,1179,1035,144,0.877863,0.122137,0.877863,131,13,1, merged,0,0,0
45253,1000091,2,537,419,118,0.780261,0.219739,1.65802,100,18,538,420,118,0.780669,0.219331,1.658532,100,18,1, merged,0,0,0
45264,1000003,2,1157,959,198,0.828868,0.171132,1.706834,179,19,1158,960,198,0.829016,0.170984,1.707085,179,19,1, merged,0,0,0
45264,1000023,1,1180,1036,144,0.877966,0.122034,0.877966,131,13,1181,1037,144,0.878069,0.121931,0.878069,131,13,1, merged,0,0,0
45265,1000121,2,2194,1812,382,0.825889,0.174111,1.63234,357,25,2195,1813,382,0.825968,0.174032,1.630455,357,25,1, merged,0,0,0
45265,1000329,3,3008,2358,650,0.78391,0.21609,2.41625,556,94,3009,2359,650,0.783981,0.216019,2.414437,556,94,1, merged,0,0,0
45266,1000121,2,2195,1813,382,0.825968,0.174032,1.655236,357,25,2196,1814,382,0.826047,0.173953,1.656144,357,25,1, merged,0,0,0
45268,1000014,3,2353,1947,406,0.827454,0.172546,2.460414,381,25,2354,1948,406,0.827528,0.172472,2.463631,381,25,1, merged,0,0,0
45268,1002169,1,433,305,128,0.704388,0.295612,0.704388,121,7,434,306,128,0.705069,0.294931,0.705069,121,7,-1, merged,0,0,0
45270,1000534,1,336,245,91,0.729167,0.270833,0.729167,84,7,337,245,92,0.727003,0.272997,0.727003,85,7,1, merged,1,1,0
45271,1000329,2,3009,2359,650,0.783981,0.216019,1.450648,556,94,3011,2360,651,0.783793,0.216207,1.583793,557,94,1, merged,1,1,0
45273,1000054,2,731,633,98,0.865937,0.134063,1.558245,82,16,732,634,98,0.86612,0.13388,1.569824,82,16,1, merged,0,0,0
45275,1000091,2,538,420,118,0.780669,0.219331,1.521731,100,18,539,421,118,0.781076,0.218924,1.522418,100,18,1, merged,0,0,0
45275,1000328,1,923,684,239,0.741062,0.258938,0.741062,214,25,924,685,239,0.741342,0.258658,0.741342,214,25,1, merged,0,0,0
45278,1000009,2,1225,1012,213,0.826122,0.173878,1.473181,194,19,1226,1013,213,0.826264,0.173736,1.492931,194,19,-1, abandoned,0,0,0
45279,1000534,1,337,245,92,0.727003,0.272997,0.727003,85,7,338,246,92,0.727811,0.272189,0.727811,85,7,1, merged,0,0,0
45280,1000009,1,1226,1013,213,0.826264,0.173736,0.826264,194,19,1227,1014,213,0.826406,0.173594,0.826406,194,19,1, merged,0,0,0
45280,1000534,2,338,246,92,0.727811,0.272189,1.554075,85,7,339,247,92,0.728614,0.271386,1.555019,85,7,1, merged,0,0,0
45281,1000004,2,3354,2982,372,0.889088,0.110912,1.716615,291,81,3357,2985,372,0.889187,0.110813,1.715735,291,81,-1, merged,0,0,0
45281,1000014,1,2354,1948,406,0.827528,0.172472,0.827528,381,25,2358,1949,409,0.826548,0.173452,0.826548,384,25,1, merged,1,1,0
45281,1000328,3,924,685,239,0.741342,0.258658,2.457957,214,25,925,686,239,0.741622,0.258378,2.457356,214,25,1, merged,0,0,0
45283,1000130,2,446,366,80,0.820628,0.179372,1.555003,65,15,447,366,81,0.818792,0.181208,1.551953,66,15,1, merged,1,1,0
45287,1000592,2,698,591,107,0.846705,0.153295,1.581923,66,41,699,591,108,0.845494,0.154506,1.578827,67,41,1, abandoned,1,1,0
45293,1000054,2,732,634,98,0.86612,0.13388,1.36612,82,16,733,635,98,0.866303,0.133697,1.53297,82,16,1, merged,0,0,0
45294,1000004,2,3357,2985,372,0.889187,0.110813,1.630808,291,81,3358,2986,372,0.88922,0.11078,1.63112,291,81,-1, merged,0,0,0
45294,1000328,1,925,686,239,0.741622,0.258378,0.741622,214,25,926,687,239,0.741901,0.258099,0.741901,214,25,-1, merged,0,0,0
45295,1000328,2,926,687,239,0.741901,0.258099,1.546388,214,25,927,688,239,0.742179,0.257821,1.547291,214,25,-1, abandoned,0,0,0
45297,1000328,2,927,688,239,0.742179,0.257821,1.447248,214,25,928,689,239,0.742457,0.257543,1.448204,214,25,-1, abandoned,0,0,0
45297,1002169,1,434,306,128,0.705069,0.294931,0.705069,121,7,435,307,128,0.705747,0.294253,0.705747,121,7,-1, abandoned,0,0,0
45298,1000328,2,928,689,239,0.742457,0.257543,1.448204,214,25,929,690,239,0.742734,0.257266,1.449156,214,25,-1, abandoned,0,0,0
45298,1002169,1,435,307,128,0.705747,0.294253,0.705747,121,7,436,308,128,0.706422,0.293578,0.706422,121,7,-1, abandoned,0,0,0
45299,1000329,2,3011,2360,651,0.783793,0.216207,1.490215,557,94,3012,2361,651,0.783865,0.216135,1.492293,557,94,-1, merged,0,0,0
45299,1002169,1,436,308,128,0.706422,0.293578,0.706422,121,7,439,311,128,0.708428,0.291572,0.708428,121,7,-1, merged,0,0,0
45312,1000009,1,1227,1014,213,0.826406,0.173594,0.826406,194,19,1231,1016,215,0.825345,0.174655,0.825345,196,19,1, merged,1,1,0
45312,1000534,3,339,247,92,0.728614,0.271386,2.221686,85,7,341,249,92,0.730205,0.269795,2.164246,85,7,-1, merged,0,0,0
45326,1000108,3,171,143,28,0.836257,0.163743,1.578991,24,4,173,145,28,0.83815,0.16185,1.580363,24,4,-1, merged,0,0,0
45326,1000110,4,265,234,31,0.883019,0.116981,2.46201,29,2,266,235,31,0.883459,0.116541,2.463822,29,2,1, merged,0,0,0
45326,1000328,2,929,690,239,0.742734,0.257266,0.742734,214,25,931,691,240,0.742213,0.257787,0.742213,215,25,1, merged,1,1,0
45338,1000004,2,3359,2987,372,0.889253,0.110747,1.786689,291,81,3361,2989,372,0.889319,0.110681,1.788478,291,81,-1, merged,0,0,0
45340,1000004,4,3361,2989,372,0.889319,0.110681,3.284837,291,81,3362,2990,372,0.889352,0.110648,3.282119,291,81,-1, abandoned,0,0,0
45340,1000329,1,3012,2361,651,0.783865,0.216135,0.783865,557,94,3014,2362,652,0.783676,0.216324,0.783676,558,94,-1, abandoned,1,0,0
45340,1002169,2,439,311,128,0.708428,0.291572,1.492293,121,7,440,312,128,0.709091,0.290909,1.492767,121,7,-1, abandoned,0,0,0
45345,1000007,2,1393,1131,262,0.811917,0.188083,1.686917,232,30,1394,1132,262,0.812052,0.187948,1.68757,232,30,1, merged,0,0,0
45350,1000108,1,173,145,28,0.83815,0.16185,0.83815,24,4,174,146,28,0.83908,0.16092,0.83908,24,4,1, merged,0,0,0
45350,1000110,2,266,235,31,0.883459,0.116541,1.721609,29,2,267,236,31,0.883895,0.116105,1.722976,29,2,1, merged,0,0,0
45359,1000108,1,174,146,28,0.83908,0.16092,0.83908,24,4,175,147,28,0.84,0.16,0.84,24,4,1, merged,0,0,0
45359,1000110,2,267,236,31,0.883895,0.116105,1.722976,29,2,268,237,31,0.884328,0.115672,1.724328,29,2,1, merged,0,0,0
45367,1000014,2,2360,1951,409,0.826695,0.173305,1.692549,384,25,2361,1952,409,0.826768,0.173232,1.692804,384,25,1, merged,0,0,0
45367,1000054,1,738,639,99,0.865854,0.134146,0.865854,83,16,739,640,99,0.866035,0.133965,0.866035,83,16,1, merged,0,0,0
45372,1000003,2,1161,963,198,0.829457,0.170543,1.62366,179,19,1162,964,198,0.829604,0.170396,1.621512,179,19,1, merged,0,0,0
45407,1000009,1,1231,1016,215,0.825345,0.174655,0.825345,196,19,1232,1017,215,0.825487,0.174513,0.825487,196,19,1, merged,0,0,0
45408,1000014,1,2361,1952,409,0.826768,0.173232,0.826768,384,25,2362,1953,409,0.826842,0.173158,0.826842,384,25,1, merged,0,0,0
45411,1000004,1,3362,2990,372,0.889352,0.110648,0.889352,291,81,3370,2997,373,0.889318,0.110682,0.889318,292,81,-1, merged,1,0,0
45418,1000003,1,1163,965,198,0.829751,0.170249,0.829751,179,19,1166,968,198,0.830189,0.169811,0.830189,179,19,-1, merged,0,0,0
45419,1000023,1,1185,1041,144,0.878481,0.121519,0.878481,131,13,1186,1042,144,0.878583,0.121417,0.878583,131,13,1, merged,0,0,0
45422,1000014,1,2362,1953,409,0.826842,0.173158,0.826842,384,25,2364,1955,409,0.826988,0.173012,0.826988,384,25,1, merged,0,0,0
45422,1000110,3,268,237,31,0.884328,0.115672,2.578259,29,2,269,238,31,0.884758,0.115242,2.579671,29,2,1, merged,0,0,0
45431,1000054,2,740,641,99,0.866216,0.133784,1.566216,83,16,741,642,99,0.866397,0.133603,1.576074,83,16,1, merged,0,0,0
45432,1000003,1,1167,969,198,0.830334,0.169666,0.830334,179,19,1168,970,198,0.830479,0.169521,0.830479,179,19,1, merged,0,0,0
45432,1000009,2,1232,1017,215,0.825487,0.174513,1.655821,196,19,1233,1018,215,0.825629,0.174371,1.656108,196,19,1, merged,0,0,0
45446,1000023,1,1189,1044,145,0.878049,0.121951,0.878049,132,13,1190,1045,145,0.878151,0.121849,0.878151,132,13,1, merged,0,0,0
45454,1000004,1,3370,2997,373,0.889318,0.110682,0.889318,292,81,3371,2997,374,0.889054,0.110946,0.889054,293,81,1, merged,1,1,0
45454,1000015,2,2059,1844,215,0.89558,0.10442,1.784898,196,19,2060,1845,215,0.895631,0.104369,1.784685,196,19,1, merged,0,0,0
45461,1000003,1,1168,970,198,0.830479,0.169521,0.830479,179,19,1169,971,198,0.830624,0.169376,0.830624,179,19,1, merged,0,0,0
45461,1000009,2,1238,1023,215,0.826333,0.173667,1.656812,196,19,1239,1024,215,0.826473,0.173527,1.657097,196,19,1, merged,0,0,0
45463,1000054,1,741,642,99,0.866397,0.133603,0.866397,83,16,742,643,99,0.866577,0.133423,0.866577,83,16,-1, abandoned,0,0,0
45470,1000007,2,1399,1135,264,0.811294,0.188706,1.571294,234,30,1401,1137,264,0.811563,0.188437,1.570184,234,30,-1, merged,0,0,0
45476,1000329,1,3029,2367,662,0.781446,0.218554,0.781446,568,94,3034,2367,667,0.780158,0.219842,0.780158,573,94,1, abandoned,1,1,0
45479,1000329,1,3040,2367,673,0.778618,0.221382,0.778618,579,94,3045,2369,676,0.777997,0.222003,0.777997,582,94,-1, abandoned,1,0,0
45481,1000015,2,2062,1847,215,0.895732,0.104268,1.773986,196,19,2064,1848,216,0.895349,0.104651,1.772968,197,19,1, merged,1,1,0
45481,1000023,1,1191,1046,145,0.878254,0.121746,0.878254,132,13,1193,1047,146,0.877619,0.122381,0.877619,133,13,1, merged,1,1,0
45483,1000109,1,501,428,73,0.854291,0.145709,0.854291,68,5,502,429,73,0.854582,0.145418,0.854582,68,5,1, merged,0,0,0
45491,1000004,1,3374,3000,374,0.889152,0.110848,0.889152,293,81,3376,3002,374,0.889218,0.110782,0.889218,293,81,-1, merged,0,0,0
45491,1000120,2,1622,1403,219,0.864982,0.135018,1.754134,192,27,1623,1404,219,0.865065,0.134935,1.754283,192,27,1, merged,0,0,0
45495,1000007,3,1401,1137,264,0.811563,0.188437,2.537711,234,30,1404,1140,264,0.811966,0.188034,2.530444,234,30,-1, merged,0,0,0
45495,1000014,1,2364,1955,409,0.826988,0.173012,0.826988,384,25,2367,1956,411,0.826362,0.173638,0.826362,386,25,1, merged,1,1,0
45496,1000091,1,539,421,118,0.781076,0.218924,0.781076,100,18,540,422,118,0.781481,0.218519,0.781481,100,18,1, merged,0,0,0
45504,1000023,1,1195,1049,146,0.877824,0.122176,0.877824,133,13,1196,1050,146,0.877926,0.122074,0.877926,133,13,1, merged,0,0,0
45504,1000130,2,448,367,81,0.819196,0.180804,1.697021,66,15,450,367,83,0.815556,0.184444,1.693482,66,17,-1, merged,1,1,0
45505,1000009,2,1240,1025,215,0.826613,0.173387,1.435309,196,19,1241,1026,215,0.826753,0.173247,1.451753,196,19,1, merged,0,0,0
45506,1000009,2,1241,1026,215,0.826753,0.173247,1.556958,196,19,1242,1027,215,0.826892,0.173108,1.557886,196,19,1, merged,0,0,0
45506,1000534,1,341,249,92,0.730205,0.269795,0.730205,85,7,342,250,92,0.730994,0.269006,0.730994,85,7,-1, merged,0,0,0
45509,1000009,2,1242,1027,215,0.826892,0.173108,1.557886,196,19,1244,1028,216,0.826367,0.173633,1.556018,196,20,-1, merged,1,1,0
45509,1000534,1,342,250,92,0.730994,0.269006,0.730994,85,7,344,251,93,0.729651,0.270349,0.729651,86,7,1, merged,1,1,0
45514,1000009,1,1248,1032,216,0.826923,0.173077,0.826923,196,20,1249,1033,216,0.827062,0.172938,0.827062,196,20,1, merged,0,0,0
45524,1000009,1,1250,1034,216,0.8272,0.1728,0.8272,196,20,1251,1035,216,0.827338,0.172662,0.827338,196,20,-1, abandoned,0,0,0
45524,1000534,2,345,252,93,0.730435,0.269565,1.557635,86,7,346,253,93,0.731214,0.268786,1.558552,86,7,-1, abandoned,0,0,0
45525,1000091,1,540,422,118,0.781481,0.218519,0.781481,100,18,542,423,119,0.780443,0.219557,0.780443,101,18,1, merged,1,1,0
45525,1000328,2,931,691,240,0.742213,0.257787,1.523694,215,25,932,692,240,0.742489,0.257511,1.522932,215,25,1, merged,0,0,0
45526,1000023,2,1198,1052,146,0.87813,0.12187,1.744707,133,13,1199,1053,146,0.878232,0.121768,1.744988,133,13,1, merged,0,0,0
45526,1000054,1,742,643,99,0.866577,0.133423,0.866577,83,16,743,644,99,0.866756,0.133244,0.866756,83,16,1, merged,0,0,0
45529,1000004,1,3378,3004,374,0.889284,0.110716,0.889284,293,81,3383,3008,375,0.889152,0.110848,0.889152,294,81,-1, merged,1,0,0
45529,1000121,3,2203,1820,383,0.826146,0.173854,2.504828,358,25,2205,1821,384,0.82585,0.17415,2.502145,359,25,1, merged,1,1,0
45529,1000327,2,698,551,147,0.789398,0.210602,1.678682,114,33,700,551,149,0.787143,0.212857,1.676294,116,33,1, merged,1,1,0
45530,1000105,1,575,449,126,0.78087,0.21913,0.78087,112,14,577,450,127,0.779896,0.220104,0.779896,113,14,1, merged,1,1,0
45530,1000329,3,3045,2369,676,0.777997,0.222003,2.309796,582,94,3047,2370,677,0.777814,0.222186,2.30771,583,94,1, merged,1,1,0
45532,1000004,2,3383,3008,375,0.889152,0.110848,1.687274,294,81,3384,3009,375,0.889184,0.110816,1.689184,294,81,1, merged,0,0,0
45532,1000014,3,2367,1956,411,0.826362,0.173638,2.513636,386,25,2369,1957,412,0.826087,0.173913,2.515271,386,26,-1, merged,1,1,0
45534,1000105,1,577,450,127,0.779896,0.220104,0.779896,113,14,578,451,127,0.780277,0.219723,0.780277,113,14,1, merged,0,0,0
45558,1000023,1,1199,1053,146,0.878232,0.121768,0.878232,133,13,1203,1057,146,0.878637,0.121363,0.878637,133,13,-1, merged,0,0,0
45560,1000004,2,3391,3016,375,0.889413,0.110587,1.756527,294,81,3393,3018,375,0.889478,0.110522,1.756948,294,81,-1, merged,0,0,0
45560,1000054,1,745,646,99,0.867114,0.132886,0.867114,83,16,747,648,99,0.86747,0.13253,0.86747,83,16,-1, merged,0,0,0
45560,1000329,3,3048,2371,677,0.777887,0.222113,2.534414,583,94,3049,2372,677,0.77796,0.22204,2.534908,583,94,1, merged,0,0,0
45561,1000009,1,1251,1035,216,0.827338,0.172662,0.827338,196,20,1253,1035,218,0.826018,0.173982,0.826018,198,20,1, merged,1,1,0
45561,1000011,2,723,664,59,0.918396,0.081604,1.745734,54,5,724,665,59,0.918508,0.081492,1.744526,54,5,-1, merged,0,0,0
45563,1000108,1,176,148,28,0.840909,0.159091,0.840909,24,4,177,148,29,0.836158,0.163842,0.836158,25,4,1, abandoned,1,1,0
45563,1000592,2,699,591,108,0.845494,0.154506,1.686403,67,41,701,593,108,0.845934,0.154066,1.682093,67,41,-1, abandoned,0,0,0
45564,1000329,2,3049,2372,677,0.77796,0.22204,1.49915,583,94,3052,2375,677,0.778178,0.221822,1.494045,583,94,-1, merged,0,0,0
45566,1000328,3,932,692,240,0.742489,0.257511,2.256708,215,25,934,694,240,0.743041,0.256959,2.258738,215,25,-1, merged,0,0,0
45566,1000329,2,3052,2375,677,0.778178,0.221822,1.514219,583,94,3054,2377,677,0.778324,0.221676,1.515697,583,94,-1, merged,0,0,0
45567,1000091,1,543,424,119,0.780847,0.219153,0.780847,101,18,545,426,119,0.781651,0.218349,0.781651,101,18,-1, merged,0,0,0
45567,1000329,2,3054,2377,677,0.778324,0.221676,1.559171,583,94,3055,2378,677,0.778396,0.221604,1.560047,583,94,1, merged,0,0,0
45588,1000054,3,748,649,99,0.867647,0.132353,2.13288,83,16,749,650,99,0.867824,0.132176,2.186574,83,16,1, merged,0,0,0
45591,1000132,1,435,388,47,0.891954,0.108046,0.891954,34,13,436,389,47,0.892202,0.107798,0.892202,34,13,1, merged,0,0,0
45607,1000014,2,2370,1958,412,0.82616,0.17384,1.702193,386,26,2371,1959,412,0.826234,0.173766,1.702777,386,26,1, merged,0,0,0
45608,1000004,2,3393,3018,375,0.889478,0.110522,1.744024,294,81,3394,3019,375,0.889511,0.110489,1.73981,294,81,1, merged,0,0,0
45618,1000009,1,1256,1038,218,0.826433,0.173567,0.826433,198,20,1257,1039,218,0.826571,0.173429,0.826571,198,20,-1, abandoned,0,0,0
45626,1000007,2,1404,1140,264,0.811966,0.188034,1.586159,234,30,1405,1141,264,0.8121,0.1879,1.59335,234,30,1, merged,0,0,0
45632,1000004,1,3395,3020,375,0.889543,0.110457,0.889543,294,81,3398,3023,375,0.889641,0.110359,0.889641,294,81,-1, merged,0,0,0
45632,1000534,2,347,254,93,0.731988,0.268012,1.621532,86,7,348,255,93,0.732759,0.267241,1.6224,86,7,1, merged,0,0,0
45639,1000009,2,1257,1039,218,0.826571,0.173429,1.55933,198,20,1259,1041,218,0.826847,0.173153,1.562058,198,20,-1, merged,0,0,0
45639,1000534,1,348,255,93,0.732759,0.267241,0.732759,86,7,355,261,94,0.735211,0.264789,0.735211,87,7,-1, merged,1,0,0
45641,1000121,2,2207,1823,384,0.826008,0.173992,1.492675,359,25,2208,1824,384,0.826087,0.173913,1.40942,359,25,-1, merged,0,0,0
45642,1000108,3,178,149,29,0.837079,0.162921,2.142634,25,4,180,151,29,0.838889,0.161111,2.041592,25,4,-1, merged,0,0,0
45642,1000121,4,2208,1824,384,0.826087,0.173913,2.968721,359,25,2210,1825,385,0.825792,0.174208,2.867383,360,25,1, merged,1,1,0
45647,1000003,1,1172,974,198,0.831058,0.168942,0.831058,179,19,1174,976,198,0.831346,0.168654,0.831346,179,19,-1, merged,0,0,0
45647,1000109,2,505,432,73,0.855446,0.144554,1.686504,68,5,506,433,73,0.855731,0.144269,1.687077,68,5,1, merged,0,0,0
45647,1000199,3,410,348,62,0.84878,0.15122,2.535284,56,6,411,349,62,0.849148,0.150852,2.536225,56,6,1, merged,0,0,0
45656,1000023,1,1204,1058,146,0.878738,0.121262,0.878738,133,13,1205,1059,146,0.878838,0.121162,0.878838,133,13,1, merged,0,0,0
45668,1000009,1,1263,1044,219,0.826603,0.173397,0.826603,199,20,1264,1044,220,0.825949,0.174051,0.825949,200,20,1, merged,1,1,0
45668,1000014,2,2372,1960,412,0.826307,0.173693,1.65291,386,26,2374,1962,412,0.826453,0.173547,1.652403,386,26,-1, merged,0,0,0
45671,1000015,1,2066,1850,216,0.89545,0.10455,0.89545,197,19,2067,1851,216,0.895501,0.104499,0.895501,197,19,-1, merged,0,0,0
45680,1000070,2,1223,1042,181,0.852003,0.147997,1.602465,157,24,1224,1043,181,0.852124,0.147876,1.603047,157,24,1, merged,0,0,0
45681,1000070,2,1224,1043,181,0.852124,0.147876,1.603047,157,24,1225,1044,181,0.852245,0.147755,1.603626,157,24,1, merged,0,0,0
45682,1000070,1,1225,1044,181,0.852245,0.147755,0.852245,157,24,1226,1045,181,0.852365,0.147635,0.852365,157,24,-1, abandoned,0,0,0
45682,1000105,2,583,456,127,0.782161,0.217839,1.634406,113,14,584,457,127,0.782534,0.217466,1.6349,113,14,-1, abandoned,0,0,0
45689,1000070,1,1227,1046,181,0.852486,0.147514,0.852486,157,24,1229,1047,182,0.851912,0.148088,0.851912,158,24,1, merged,1,1,0
45694,1000070,2,1229,1047,182,0.851912,0.148088,1.774989,158,24,1230,1048,182,0.852033,0.147967,1.780604,158,24,1, merged,0,0,0
45695,1000014,2,2375,1963,412,0.826526,0.173474,1.536277,386,26,2377,1964,413,0.826252,0.173748,1.537313,387,26,-1, abandoned,1,0,0
45695,1002169,1,441,313,128,0.709751,0.290249,0.709751,121,7,443,315,128,0.711061,0.288939,0.711061,121,7,-1, abandoned,0,0,0
45712,1000534,1,355,261,94,0.735211,0.264789,0.735211,87,7,357,262,95,0.733894,0.266106,0.733894,88,7,1, merged,1,1,0
45714,1000007,1,1406,1142,264,0.812233,0.187767,0.812233,234,30,1407,1143,264,0.812367,0.187633,0.812367,234,30,-1, merged,0,0,0
45714,1000009,2,1266,1046,220,0.826224,0.173776,1.638458,200,20,1268,1048,220,0.826498,0.173502,1.638865,200,20,-1, merged,0,0,0
45714,1000534,3,357,262,95,0.733894,0.266106,2.372351,88,7,358,263,95,0.734637,0.265363,2.373502,88,7,1, merged,0,0,0
45728,1000026,1,451,407,44,0.902439,0.097561,0.902439,42,2,452,408,44,0.902655,0.097345,0.902655,42,2,1, merged,0,0,0
45728,1000120,2,1628,1409,219,0.865479,0.134521,1.767918,192,27,1629,1410,219,0.865562,0.134438,1.768217,192,27,1, merged,0,0,0
45730,1000003,3,1174,976,198,0.831346,0.168654,2.47012,179,19,1176,977,199,0.830782,0.169218,2.468868,179,20,-1, merged,1,1,0
45730,1000199,2,411,349,62,0.849148,0.150852,1.638774,56,6,412,350,62,0.849515,0.150485,1.638086,56,6,1, merged,0,0,0
45743,1000009,1,1268,1048,220,0.826498,0.173502,0.826498,200,20,1270,1049,221,0.825984,0.174016,0.825984,201,20,-1, abandoned,1,0,0
45748,1000054,1,750,651,99,0.868,0.132,0.868,83,16,751,652,99,0.868176,0.131824,0.868176,83,16,1, merged,0,0,0
45753,1000014,1,2377,1964,413,0.826252,0.173748,0.826252,387,26,2378,1965,413,0.826325,0.173675,0.826325,387,26,1, merged,0,0,0
45753,1000091,2,545,426,119,0.781651,0.218349,1.607903,101,18,546,427,119,0.782051,0.217949,1.608376,101,18,1, merged,0,0,0
45763,1000070,2,1241,1059,182,0.853344,0.146656,1.564405,158,24,1242,1060,182,0.853462,0.146538,1.565174,158,24,1, merged,0,0,0
45763,1002169,1,443,315,128,0.711061,0.288939,0.711061,121,7,444,316,128,0.711712,0.288288,0.711712,121,7,-1, merged,0,0,0
45765,1000012,2,569,493,76,0.866432,0.133568,1.726726,73,3,570,494,76,0.866667,0.133333,1.727473,73,3,1, merged,0,0,0
45773,1000004,2,3400,3025,375,0.889706,0.110294,1.743186,294,81,3401,3026,375,0.889738,0.110262,1.743753,294,81,1, merged,0,0,0
45781,1000015,1,2070,1854,216,0.895652,0.104348,0.895652,197,19,2071,1855,216,0.895703,0.104297,0.895703,197,19,1, merged,0,0,0
45781,1000120,2,1631,1412,219,0.865727,0.134273,1.761379,192,27,1632,1413,219,0.865809,0.134191,1.761511,192,27,1, merged,0,0,0
45782,1000327,1,700,551,149,0.787143,0.212857,0.787143,116,33,701,552,149,0.787447,0.212553,0.787447,116,33,1, merged,0,0,0
45783,1000121,3,2211,1825,386,0.825418,0.174582,2.337912,361,25,2212,1826,386,0.825497,0.174503,2.304045,361,25,-1, abandoned,0,0,0
45788,1000130,2,455,372,83,0.817582,0.182418,1.669568,66,17,456,373,83,0.817982,0.182018,1.6705,66,17,1, merged,0,0,0
45789,1000132,1,440,393,47,0.893182,0.106818,0.893182,34,13,441,394,47,0.893424,0.106576,0.893424,34,13,-1, merged,0,0,0
45790,1000132,2,441,394,47,0.893424,0.106576,1.674674,34,13,442,395,47,0.893665,0.106335,1.658371,34,13,-1, merged,0,0,0
45791,1000132,1,442,395,47,0.893665,0.106335,0.893665,34,13,448,396,52,0.883929,0.116071,0.883929,39,13,1, merged,1,1,0
45801,1000023,2,1211,1064,147,0.878613,0.121387,1.718307,134,13,1212,1065,147,0.878713,0.121287,1.719017,134,13,1, merged,0,0,0
45809,1000054,2,751,652,99,0.868176,0.131824,1.582461,83,16,752,653,99,0.868351,0.131649,1.587101,83,16,1, merged,0,0,0
45815,1000023,2,1213,1066,147,0.878813,0.121187,1.747339,134,13,1214,1067,147,0.878913,0.121087,1.747613,134,13,1, merged,0,0,0
45815,1000054,1,753,654,99,0.868526,0.131474,0.868526,83,16,754,655,99,0.8687,0.1313,0.8687,83,16,1, merged,0,0,0
45816,1000054,2,754,655,99,0.8687,0.1313,1.58745,83,16,755,656,99,0.868874,0.131126,1.591951,83,16,1, merged,0,0,0
45826,1000026,1,453,409,44,0.90287,0.09713,0.90287,42,2,454,410,44,0.903084,0.096916,0.903084,42,2,1, merged,0,0,0
45826,1000121,2,2212,1826,386,0.825497,0.174503,1.728367,361,25,2213,1827,386,0.825576,0.174424,1.72866,361,25,1, merged,0,0,0
45829,1000120,2,1634,1415,219,0.865973,0.134027,1.710496,192,27,1636,1417,219,0.866137,0.133863,1.711751,192,27,-1, merged,0,0,0
45835,1000004,4,3401,3026,375,0.889738,0.110262,2.534426,294,81,3402,3027,375,0.889771,0.110229,3.534612,294,81,1, merged,0,0,0
45835,1000120,3,1637,1418,219,0.866219,0.133781,1.644687,192,27,1638,1419,219,0.8663,0.1337,2.644841,192,27,1, merged,0,0,0
45835,1000329,1,3056,2379,677,0.778469,0.221531,0.778469,583,94,3057,2380,677,0.778541,0.221459,0.778541,583,94,1, merged,0,0,0
45836,1000120,3,1638,1419,219,0.8663,0.1337,2.644841,192,27,1639,1420,219,0.866382,0.133618,2.644995,192,27,1, merged,0,0,0
45836,1000329,1,3057,2380,677,0.778541,0.221459,0.778541,583,94,3058,2381,677,0.778613,0.221387,0.778613,583,94,1, merged,0,0,0
45843,1000026,1,456,411,45,0.901316,0.098684,0.901316,43,2,457,411,46,0.899344,0.100656,0.899344,44,2,1, merged,1,1,0
45843,1000120,2,1639,1420,219,0.866382,0.133618,1.767698,192,27,1641,1421,220,0.865935,0.134065,1.765279,193,27,1, merged,1,1,0
45844,1000054,3,756,657,99,0.869048,0.130952,2.342125,83,16,757,658,99,0.869221,0.130779,2.35325,83,16,1, merged,0,0,0
45848,1000007,3,1408,1144,264,0.8125,0.1875,2.477778,234,30,1409,1145,264,0.812633,0.187367,2.463641,234,30,-1, abandoned,0,0,0
45851,1000070,3,1244,1062,182,0.853698,0.146302,2.344023,158,24,1245,1063,182,0.853815,0.146185,2.346532,158,24,1, merged,0,0,0
45851,1000329,1,3058,2381,677,0.778613,0.221387,0.778613,583,94,3060,2382,678,0.778431,0.221569,0.778431,584,94,-1, merged,1,0,0
45851,1002169,2,444,316,128,0.711712,0.288288,1.490325,121,7,448,320,128,0.714286,0.285714,1.492717,121,7,-1, merged,0,0,0
45852,1000130,1,457,374,83,0.818381,0.181619,0.818381,66,17,458,375,83,0.818777,0.181223,0.818777,66,17,1, merged,0,0,0
45853,1000003,2,1177,978,199,0.830926,0.169074,1.657184,179,20,1179,980,199,0.831213,0.168787,1.656822,179,20,1, merged,0,0,0
45853,1000009,1,1272,1051,221,0.826258,0.173742,0.826258,201,20,1273,1051,222,0.825609,0.174391,0.825609,202,20,1, merged,1,1,0
45855,1000014,2,2381,1968,413,0.826543,0.173457,1.692479,387,26,2382,1969,413,0.826616,0.173384,1.692633,387,26,1, merged,0,0,0
45855,1000120,1,1641,1421,220,0.865935,0.134065,0.865935,193,27,1642,1422,220,0.866017,0.133983,0.866017,193,27,1, merged,0,0,0
45859,1000007,1,1409,1145,264,0.812633,0.187367,0.812633,234,30,1410,1145,265,0.812057,0.187943,0.812057,234,31,-1, merged,1,1,0
45859,1000026,2,457,411,46,0.899344,0.100656,1.711977,44,2,458,411,47,0.89738,0.10262,1.709437,44,3,-1, merged,1,1,0
45873,1000054,3,758,659,99,0.869393,0.130607,2.353423,83,16,759,660,99,0.869565,0.130435,2.364066,83,16,1, merged,0,0,0
45886,1000054,2,759,660,99,0.869565,0.130435,1.600909,83,16,760,661,99,0.869737,0.130263,1.605031,83,16,1, merged,0,0,0
45893,1000054,4,760,661,99,0.869737,0.130263,3.340104,83,16,761,662,99,0.869908,0.130092,3.327572,83,16,1, merged,0,0,0
45901,1000023,2,1216,1069,147,0.879112,0.120888,1.723939,134,13,1218,1071,147,0.87931,0.12069,1.724671,134,13,-1, abandoned,0,0,0
45902,1000329,3,3060,2382,678,0.778431,0.221569,2.336775,584,94,3062,2383,679,0.77825,0.22175,2.332666,585,94,1, merged,1,1,0
45903,1000015,3,2074,1858,216,0.895853,0.104147,2.523266,197,19,2075,1859,216,0.895904,0.104096,2.524244,197,19,1, merged,0,0,0
45903,1000091,2,546,427,119,0.782051,0.217949,1.627412,101,18,547,428,119,0.78245,0.21755,1.62834,101,18,1, merged,0,0,0
45905,1000091,2,547,428,119,0.78245,0.21755,1.628866,101,18,548,429,119,0.782847,0.217153,1.629785,101,18,1, merged,0,0,0
45906,1000091,2,548,429,119,0.782847,0.217153,1.629785,101,18,549,430,119,0.783242,0.216758,1.6307,101,18,1, merged,0,0,0
45909,1000005,4,596,496,100,0.832215,0.167785,3.398065,93,7,597,497,100,0.832496,0.167504,3.399321,93,7,-1, abandoned,0,0,0
45909,1000054,2,761,662,99,0.869908,0.130092,1.717366,83,16,762,662,100,0.868766,0.131234,1.713884,84,16,1, abandoned,1,1,0
45911,1000054,2,762,662,100,0.868766,0.131234,1.713884,84,16,763,663,100,0.868938,0.131062,1.714576,84,16,1, merged,0,0,0
45912,1000054,2,763,663,100,0.868938,0.131062,1.714576,84,16,764,664,100,0.86911,0.13089,1.715264,84,16,1, merged,0,0,0
45914,1000070,2,1245,1063,182,0.853815,0.146185,1.687149,158,24,1246,1064,182,0.853933,0.146067,1.568218,158,24,1, merged,0,0,0
45916,1000091,1,550,431,119,0.783636,0.216364,0.783636,101,18,551,432,119,0.784029,0.215971,0.784029,101,18,1, merged,0,0,0
45917,1000054,2,764,664,100,0.86911,0.13089,1.715264,84,16,765,665,100,0.869281,0.130719,1.715948,84,16,1, merged,0,0,0
45938,1000004,2,3406,3031,375,0.8899,0.1101,1.737076,294,81,3407,3032,375,0.889932,0.110068,1.737615,294,81,1, merged,0,0,0
45949,1000534,2,358,263,95,0.734637,0.265363,1.56797,88,7,360,264,96,0.733333,0.266667,1.590476,89,7,1, merged,1,1,0
45966,1000014,1,2382,1969,413,0.826616,0.173384,0.826616,387,26,2384,1970,414,0.826342,0.173658,0.826342,388,26,1, merged,1,1,0
45966,1000054,2,770,669,101,0.868831,0.131169,1.695447,85,16,771,670,101,0.869001,0.130999,1.695344,85,16,1, merged,0,0,0
45968,1000592,3,701,593,108,0.845934,0.154066,2.531329,67,41,702,594,108,0.846154,0.153846,2.494755,67,41,1, merged,0,0,0
45978,1000109,2,509,436,73,0.856582,0.143418,1.693703,68,5,512,437,75,0.853516,0.146484,1.687478,70,5,1, merged,1,1,0
45987,1000007,2,1419,1153,266,0.812544,0.187456,1.708448,235,31,1420,1153,267,0.811972,0.188028,1.707926,236,31,1, abandoned,1,1,0
45987,1000015,1,2075,1859,216,0.895904,0.104096,0.895904,197,19,2076,1860,216,0.895954,0.104046,0.895954,197,19,-1, abandoned,0,0,0
46000,1000004,4,3411,3036,375,0.890062,0.109938,3.381663,294,81,3412,3037,375,0.890094,0.109906,3.3788,294,81,1, merged,0,0,0
46000,1000109,2,512,437,75,0.853516,0.146484,1.642087,70,5,514,438,76,0.85214,0.14786,1.638465,71,5,-1, merged,1,0,0
46000,1000199,3,412,350,62,0.849515,0.150485,2.491602,56,6,414,352,62,0.850242,0.149758,2.488706,56,6,-1, merged,0,0,0
46001,1000109,2,514,438,76,0.85214,0.14786,1.638465,71,5,515,439,76,0.852427,0.147573,1.639359,71,5,1, merged,0,0,0
46005,1000011,3,727,668,59,0.918845,0.081155,2.308654,54,5,728,669,59,0.918956,0.081044,2.315053,54,5,1, merged,0,0,0
46005,1000534,1,361,265,96,0.734072,0.265928,0.734072,89,7,362,266,96,0.734807,0.265193,0.734807,89,7,1, merged,0,0,0
46016,1000009,2,1273,1051,222,0.825609,0.174391,1.825609,202,20,1274,1052,222,0.825746,0.174254,1.492412,202,20,1, merged,0,0,0
46017,1000003,1,1179,980,199,0.831213,0.168787,0.831213,179,20,1180,980,200,0.830508,0.169492,0.830508,180,20,1, merged,1,1,0
46017,1000328,2,935,695,240,0.743316,0.256684,1.574528,215,25,938,698,240,0.744136,0.255864,1.574645,215,25,-1, merged,0,0,0
46020,1000328,3,938,698,240,0.744136,0.255864,2.356866,215,25,939,698,241,0.743344,0.256656,2.353243,216,25,1, abandoned,1,1,0
46039,1000023,2,1225,1077,148,0.879184,0.120816,1.748693,135,13,1226,1078,148,0.879282,0.120718,1.747669,135,13,-1, abandoned,0,0,0
46039,1000054,1,774,673,101,0.869509,0.130491,0.869509,85,16,775,673,102,0.868387,0.131613,0.868387,86,16,1, abandoned,1,1,0
46040,1000005,2,601,501,100,0.833611,0.166389,1.659522,93,7,602,502,100,0.833887,0.166113,1.659954,93,7,1, merged,0,0,0
46040,1000121,1,2223,1836,387,0.825911,0.174089,0.825911,362,25,2225,1838,387,0.826067,0.173933,0.826067,362,25,-1, merged,0,0,0
46047,1000014,1,2386,1971,415,0.826069,0.173931,0.826069,388,27,2389,1973,416,0.825869,0.174131,0.825869,389,27,-1, merged,1,0,0
46049,1000007,1,1425,1157,268,0.81193,0.18807,0.81193,237,31,1426,1157,269,0.81136,0.18864,0.81136,238,31,1, merged,1,1,0
46057,1000026,2,458,411,47,0.89738,0.10262,1.763532,44,3,459,412,47,0.897603,0.102397,1.762642,44,3,-1, abandoned,0,0,0
46057,1000054,1,777,673,104,0.866152,0.133848,0.866152,88,16,778,673,105,0.865039,0.134961,0.865039,89,16,1, abandoned,1,1,0
46060,1000121,2,2225,1838,387,0.826067,0.173933,1.826067,362,25,2226,1839,387,0.826146,0.173854,1.826146,362,25,1, merged,0,0,0
46061,1000592,3,702,594,108,0.846154,0.153846,2.561076,67,41,703,595,108,0.846373,0.153627,2.561928,67,41,1, merged,0,0,0
46061,1002169,1,449,321,128,0.714922,0.285078,0.714922,121,7,450,322,128,0.715556,0.284444,0.715556,121,7,-1, merged,0,0,0
46078,1000004,1,3414,3039,375,0.890158,0.109842,0.890158,294,81,3415,3039,376,0.889898,0.110102,0.889898,294,82,-1, merged,1,1,0
46078,1000120,2,1648,1428,220,0.866505,0.133495,1.756663,193,27,1649,1428,221,0.865979,0.134021,1.755877,193,28,-1, merged,1,1,0
46080,1000091,1,563,444,119,0.788632,0.211368,0.788632,101,18,565,444,121,0.785841,0.214159,0.785841,101,20,-1, merged,1,1,0
46080,1000329,2,3065,2386,679,0.778467,0.221533,1.567099,585,94,3066,2387,679,0.778539,0.221461,1.56438,585,94,1, merged,0,0,0
46083,1000003,2,1180,980,200,0.830508,0.169492,1.573852,180,20,1181,981,200,0.830652,0.169348,1.574269,180,20,1, merged,0,0,0
46083,1000328,1,939,698,241,0.743344,0.256656,0.743344,216,25,940,699,241,0.743617,0.256383,0.743617,216,25,1, merged,0,0,0
46084,1000130,1,459,376,83,0.819172,0.180828,0.819172,66,17,460,377,83,0.819565,0.180435,0.819565,66,17,1, merged,0,0,0
46085,1000105,2,586,459,127,0.783276,0.216724,1.306004,113,14,587,460,127,0.783646,0.216354,1.316979,113,14,1, merged,0,0,0
46085,1000121,3,2226,1839,387,0.826146,0.173854,2.132149,362,25,2227,1840,387,0.826224,0.173776,2.143203,362,25,1, merged,0,0,0
46088,1000130,1,460,377,83,0.819565,0.180435,0.819565,66,17,461,377,84,0.817787,0.182213,0.817787,66,18,-1, merged,1,1,0
46090,1000023,1,1228,1080,148,0.879479,0.120521,0.879479,135,13,1229,1081,148,0.879577,0.120423,0.879577,135,13,1, merged,0,0,0
46101,1000014,1,2389,1973,416,0.825869,0.174131,0.825869,389,27,2390,1974,416,0.825941,0.174059,0.825941,389,27,1, merged,0,0,0
46101,1000105,2,587,460,127,0.783646,0.216354,1.609514,113,14,588,461,127,0.784014,0.215986,1.609955,113,14,1, merged,0,0,0
46109,1000003,1,1181,981,200,0.830652,0.169348,0.830652,180,20,1184,983,201,0.830236,0.169764,0.830236,181,20,1, merged,1,1,0
46109,1000534,2,362,266,96,0.734807,0.265193,1.565459,89,7,365,268,97,0.734247,0.265753,1.564483,89,8,-1, merged,1,0,0
46113,1000003,1,1184,983,201,0.830236,0.169764,0.830236,181,20,1185,984,201,0.83038,0.16962,0.83038,181,20,1, merged,0,0,0
46115,1000014,3,2390,1974,416,0.825941,0.174059,2.511507,389,27,2391,1975,416,0.826014,0.173986,2.506108,389,27,1, merged,0,0,0
46115,1000070,1,1246,1064,182,0.853933,0.146067,0.853933,158,24,1249,1065,184,0.852682,0.147318,0.852682,160,24,1, merged,1,1,0
46130,1000121,1,2228,1841,387,0.826302,0.173698,0.826302,362,25,2229,1841,388,0.825931,0.174069,0.825931,363,25,1, merged,1,1,0
46131,1000005,2,605,503,102,0.831405,0.168595,1.657336,95,7,606,504,102,0.831683,0.168317,1.657322,95,7,1, merged,0,0,0
46131,1000121,1,2229,1841,388,0.825931,0.174069,0.825931,363,25,2231,1842,389,0.825639,0.174361,0.825639,364,25,-1, merged,1,0,0
46133,1000140,2,214,171,43,0.799065,0.200935,1.676741,37,6,215,172,43,0.8,0.2,1.678049,37,6,1, merged,0,0,0
46140,1000070,1,1249,1065,184,0.852682,0.147318,0.852682,160,24,1250,1066,184,0.8528,0.1472,0.8528,160,24,-1, abandoned,0,0,0
46144,1000003,1,1186,985,201,0.830523,0.169477,0.830523,181,20,1187,986,201,0.830666,0.169334,0.830666,181,20,1, merged,0,0,0
46144,1000011,2,731,672,59,0.919289,0.080711,1.749811,54,5,732,673,59,0.919399,0.080601,1.750064,54,5,1, merged,0,0,0
46147,1000004,1,3415,3039,376,0.889898,0.110102,0.889898,294,82,3416,3040,376,0.88993,0.11007,0.88993,294,82,-1, abandoned,0,0,0
46148,1000004,2,3416,3040,376,0.88993,0.11007,1.694278,294,82,3417,3041,376,0.889962,0.110038,1.681629,294,82,-1, merged,0,0,0
46148,1000329,5,3067,2387,680,0.778285,0.221715,3.569606,586,94,3068,2388,680,0.778357,0.221643,3.581011,586,94,1, merged,0,0,0
46153,1000023,3,1234,1086,148,0.880065,0.119935,2.483693,135,13,1236,1086,150,0.878641,0.121359,2.483042,135,15,-1, merged,1,1,0
46153,1000091,2,565,444,121,0.785841,0.214159,1.603628,101,20,566,445,121,0.786219,0.213781,1.604401,101,20,1, merged,0,0,0
46153,1000130,1,461,377,84,0.817787,0.182213,0.817787,66,18,462,378,84,0.818182,0.181818,0.818182,66,18,1, merged,0,0,0
46155,1000003,3,1187,986,201,0.830666,0.169334,2.5633,181,20,1189,988,201,0.83095,0.16905,2.559858,181,20,-1, abandoned,0,0,0
46155,1000012,2,574,498,76,0.867596,0.132404,1.732634,73,3,575,498,77,0.866087,0.133913,1.728907,74,3,1, abandoned,1,1,0
46155,1000054,1,778,673,105,0.865039,0.134961,0.865039,89,16,780,673,107,0.862821,0.137179,0.862821,91,16,1, abandoned,1,1,0
46158,1000329,1,3068,2388,680,0.778357,0.221643,0.778357,586,94,3070,2390,680,0.778502,0.221498,0.778502,586,94,-1, merged,0,0,0
46166,1000014,1,2391,1975,416,0.826014,0.173986,0.826014,389,27,2392,1976,416,0.826087,0.173913,0.826087,389,27,1, merged,0,0,0
46166,1000120,2,1657,1436,221,0.866626,0.133374,1.692641,193,28,1658,1437,221,0.866707,0.133293,1.692794,193,28,1, merged,0,0,0
46168,1000007,2,1427,1158,269,0.811493,0.188507,1.574651,238,31,1428,1159,269,0.811625,0.188375,1.580855,238,31,1, merged,0,0,0
46172,1000007,2,1430,1161,269,0.811888,0.188112,1.701459,238,31,1435,1163,272,0.810453,0.189547,1.700361,241,31,1, merged,1,1,0
46172,1000009,3,1278,1056,222,0.826291,0.173709,2.52775,202,20,1282,1060,222,0.826833,0.173167,2.527194,202,20,-1, merged,0,0,0
46174,1000007,2,1440,1165,275,0.809028,0.190972,1.698936,244,31,1445,1168,277,0.808304,0.191696,1.698548,246,31,-1, merged,1,0,0
46176,1000007,1,1450,1170,280,0.806897,0.193103,0.806897,249,31,1454,1171,283,0.805365,0.194635,0.805365,252,31,-1, merged,1,0,0
46176,1000009,2,1282,1060,222,0.826833,0.173167,1.63373,202,20,1283,1061,222,0.826968,0.173032,1.632333,202,20,1, merged,0,0,0
46178,1000007,1,1459,1173,286,0.803975,0.196025,0.803975,255,31,1463,1175,288,0.803144,0.196856,0.803144,257,31,-1, merged,1,0,0
46178,1000009,2,1283,1061,222,0.826968,0.173032,1.630943,202,20,1284,1062,222,0.827103,0.172897,1.630247,202,20,1, merged,0,0,0
46179,1000007,1,1463,1175,288,0.803144,0.196856,0.803144,257,31,1468,1178,290,0.802452,0.197548,0.802452,259,31,-1, merged,1,0,0
46179,1000009,2,1284,1062,222,0.827103,0.172897,1.630247,202,20,1285,1063,222,0.827237,0.172763,1.62969,202,20,1, merged,0,0,0
46183,1000004,3,3417,3041,376,0.889962,0.110038,2.503565,294,82,3418,3042,376,0.889994,0.110006,2.505882,294,82,1, merged,0,0,0
46190,1000534,1,365,268,97,0.734247,0.265753,0.734247,89,8,368,268,100,0.728261,0.271739,0.728261,90,10,1, merged,1,1,0
46193,1000023,1,1236,1086,150,0.878641,0.121359,0.878641,135,15,1237,1087,150,0.878739,0.121261,0.878739,135,15,1, merged,0,0,0
46193,1000130,2,462,378,84,0.818182,0.181818,1.696823,66,18,463,379,84,0.818575,0.181425,1.697313,66,18,1, merged,0,0,0
46195,1000329,1,3071,2391,680,0.778574,0.221426,0.778574,586,94,3073,2392,681,0.778392,0.221608,0.778392,587,94,1, merged,1,1,0
46197,1000054,2,780,673,107,0.862821,0.137179,1.704756,91,16,781,674,107,0.862996,0.137004,1.705945,91,16,1, merged,0,0,0
46200,1000328,2,942,701,241,0.744161,0.255839,1.590534,216,25,943,702,241,0.744433,0.255567,1.591024,216,25,1, merged,0,0,0
46200,1000592,1,703,595,108,0.846373,0.153627,0.846373,67,41,704,596,108,0.846591,0.153409,0.846591,67,41,1, merged,0,0,0
46215,1000014,1,2395,1978,417,0.825887,0.174113,0.825887,390,27,2398,1980,418,0.825688,0.174312,0.825688,391,27,-1, abandoned,1,0,0
46215,1000070,2,1251,1067,184,0.852918,0.147082,1.678805,160,24,1252,1067,185,0.852236,0.147764,1.677924,161,24,1, abandoned,1,1,0
46219,1000023,2,1237,1087,150,0.878739,0.121261,1.719648,135,15,1238,1088,150,0.878837,0.121163,1.720346,135,15,1, merged,0,0,0
46227,1000109,2,515,439,76,0.852427,0.147573,1.639359,71,5,516,440,76,0.852713,0.147287,1.637416,71,5,-1, abandoned,0,0,0
46228,1000105,2,589,462,127,0.78438,0.21562,1.562773,113,14,591,464,127,0.78511,0.21489,1.563575,113,14,-1, merged,0,0,0
46228,1000328,3,943,702,241,0.744433,0.255567,2.307205,216,25,944,703,241,0.744703,0.255297,2.308278,216,25,1, merged,0,0,0
46228,1000329,1,3073,2392,681,0.778392,0.221608,0.778392,587,94,3074,2393,681,0.778465,0.221535,0.778465,587,94,-1, merged,0,0,0
46233,1000004,1,3418,3042,376,0.889994,0.110006,0.889994,294,82,3419,3043,376,0.890026,0.109974,0.890026,294,82,1, merged,0,0,0
46233,1000329,2,3074,2393,681,0.778465,0.221535,1.668459,587,94,3075,2394,681,0.778537,0.221463,1.668563,587,94,1, merged,0,0,0
46259,1000012,2,577,499,78,0.864818,0.135182,1.743655,75,3,578,500,78,0.865052,0.134948,1.743987,75,3,1, merged,0,0,0
46259,1000023,1,1238,1088,150,0.878837,0.121163,0.878837,135,15,1239,1089,150,0.878935,0.121065,0.878935,135,15,1, merged,0,0,0
46266,1000004,2,3419,3043,376,0.890026,0.109974,1.785131,294,82,3420,3044,376,0.890058,0.109942,1.782045,294,82,-1, abandoned,0,0,0
46267,1000005,2,613,511,102,0.833605,0.166395,1.659322,95,7,614,512,102,0.833876,0.166124,1.659301,95,7,1, merged,0,0,0
46267,1000121,1,2232,1843,389,0.825717,0.174283,0.825717,364,25,2234,1844,390,0.825425,0.174575,0.825425,365,25,-1, merged,1,0,0
46272,1000004,1,3420,3044,376,0.890058,0.109942,0.890058,294,82,3421,3045,376,0.890091,0.109909,0.890091,294,82,-1, merged,0,0,0
46273,1000054,1,784,677,107,0.86352,0.13648,0.86352,91,16,785,678,107,0.863694,0.136306,0.863694,91,16,1, merged,0,0,0
46273,1000120,2,1660,1439,221,0.866867,0.133133,1.730388,193,28,1661,1440,221,0.866948,0.133052,1.730642,193,28,1, merged,0,0,0
46297,1000004,3,3421,3045,376,0.890091,0.109909,2.483326,294,82,3424,3046,378,0.889603,0.110397,2.483737,294,84,-1, merged,1,0,0
46297,1000015,4,2081,1865,216,0.896204,0.103796,3.379529,197,19,2082,1865,217,0.895773,0.104227,3.379511,198,19,1, merged,1,1,0
46297,1000120,2,1661,1440,221,0.866948,0.133052,1.593235,193,28,1663,1442,221,0.867108,0.132892,1.594135,193,28,-1, merged,0,0,0
46297,1000534,1,369,268,101,0.726287,0.273713,0.726287,91,10,370,269,101,0.727027,0.272973,0.727027,91,10,-1, merged,0,0,0
46307,1000007,1,1473,1182,291,0.802444,0.197556,0.802444,260,31,1474,1182,292,0.8019,0.1981,0.8019,261,31,1, merged,1,1,0
46307,1000009,2,1290,1068,222,0.827907,0.172093,1.630351,202,20,1291,1069,222,0.82804,0.17196,1.62994,202,20,1, merged,0,0,0
46311,1000004,2,3424,3046,378,0.889603,0.110397,1.75671,294,84,3425,3047,378,0.889635,0.110365,1.756823,294,84,1, merged,0,0,0
46311,1000120,1,1663,1442,221,0.867108,0.132892,0.867108,193,28,1664,1443,221,0.867188,0.132812,0.867188,193,28,1, merged,0,0,0
46314,1000004,1,3425,3047,378,0.889635,0.110365,0.889635,294,84,3426,3048,378,0.889667,0.110333,0.889667,294,84,1, merged,0,0,0
46314,1000015,2,2083,1866,217,0.895823,0.104177,1.785458,198,19,2084,1867,217,0.895873,0.104127,1.785541,198,19,1, merged,0,0,0
46316,1000015,2,2084,1867,217,0.895873,0.104127,1.739623,198,19,2085,1868,217,0.895923,0.104077,1.74016,198,19,1, merged,0,0,0
46316,1000121,3,2234,1844,390,0.825425,0.174575,2.565049,365,25,2235,1845,390,0.825503,0.174497,2.565663,365,25,1, merged,0,0,0
46320,1000015,1,2085,1868,217,0.895923,0.104077,0.895923,198,19,2086,1868,218,0.895494,0.104506,0.895494,199,19,1, abandoned,1,1,0
46321,1000329,2,3076,2395,681,0.778609,0.221391,1.674835,587,94,3077,2396,681,0.778681,0.221319,1.675877,587,94,1, merged,0,0,0
46324,1000121,2,2235,1845,390,0.825503,0.174497,1.604184,365,25,2236,1845,391,0.825134,0.174866,1.603634,366,25,1, merged,1,1,0
46324,1000329,1,3077,2396,681,0.778681,0.221319,0.778681,587,94,3079,2397,682,0.7785,0.2215,0.7785,588,94,1, merged,1,1,0
46325,1000121,2,2236,1845,391,0.825134,0.174866,1.603634,366,25,2237,1845,392,0.824765,0.175235,1.603084,367,25,1, merged,1,1,0
46325,1000329,1,3079,2397,682,0.7785,0.2215,0.7785,588,94,3081,2398,683,0.778319,0.221681,0.778319,589,94,1, merged,1,1,0
46330,1000023,1,1240,1090,150,0.879032,0.120968,0.879032,135,15,1242,1092,150,0.879227,0.120773,0.879227,135,15,1, merged,0,0,0
46332,1000043,1,574,479,95,0.834495,0.165505,0.834495,82,13,575,479,96,0.833043,0.166957,0.833043,83,13,1, merged,1,1,0
46332,1000108,2,189,158,31,0.835979,0.164021,1.670474,27,4,190,159,31,0.836842,0.163158,1.669886,27,4,1, merged,0,0,0
46341,1000009,1,1292,1070,222,0.828173,0.171827,0.828173,202,20,1293,1071,222,0.828306,0.171694,0.828306,202,20,1, merged,0,0,0
46347,1000070,2,1254,1069,185,0.852472,0.147528,1.656888,161,24,1255,1070,185,0.85259,0.14741,1.657621,161,24,1, merged,0,0,0
46352,1000109,2,516,440,76,0.852713,0.147287,1.637416,71,5,517,441,76,0.852998,0.147002,1.638309,71,5,1, merged,0,0,0
46360,1000592,2,707,599,108,0.847242,0.152758,1.670251,67,41,708,600,108,0.847458,0.152542,1.672019,67,41,1, merged,0,0,0
46367,1000004,1,3426,3048,378,0.889667,0.110333,0.889667,294,84,3429,3050,379,0.889472,0.110528,0.889472,295,84,-1, merged,1,0,0
46380,1000015,1,2087,1869,218,0.895544,0.104456,0.895544,199,19,2088,1870,218,0.895594,0.104406,0.895594,199,19,1, merged,0,0,0
46383,1000105,3,591,464,127,0.78511,0.21489,2.082681,113,14,592,464,128,0.783784,0.216216,2.072545,114,14,1, merged,1,1,0
46383,1000121,1,2238,1846,392,0.824844,0.175156,0.824844,367,25,2239,1846,393,0.824475,0.175525,0.824475,368,25,1, merged,1,1,0
46386,1000109,1,517,441,76,0.852998,0.147002,0.852998,71,5,519,443,76,0.853565,0.146435,0.853565,71,5,-1, merged,0,0,0
46392,1000004,2,3429,3050,379,0.889472,0.110528,1.768699,295,84,3430,3051,379,0.889504,0.110496,1.768829,295,84,1, merged,0,0,0
46392,1000023,1,1242,1092,150,0.879227,0.120773,0.879227,135,15,1243,1093,150,0.879324,0.120676,0.879324,135,15,-1, merged,0,0,0
46396,1000109,3,519,443,76,0.853565,0.146435,2.491516,71,5,520,444,76,0.853846,0.146154,2.489832,71,5,1, merged,0,0,0
46396,1000199,2,414,352,62,0.850242,0.149758,1.637951,56,6,418,355,63,0.849282,0.150718,1.635986,57,6,-1, merged,1,0,0
46398,1000003,1,1192,991,201,0.831376,0.168624,0.831376,181,20,1194,993,201,0.831658,0.168342,0.831658,181,20,-1, merged,0,0,0
46399,1000054,2,817,699,118,0.855569,0.144431,1.674924,102,16,818,700,118,0.855746,0.144254,1.675488,102,16,1, merged,0,0,0
46399,1000130,1,465,381,84,0.819355,0.180645,0.819355,66,18,466,382,84,0.819742,0.180258,0.819742,66,18,1, merged,0,0,0
46400,1000003,2,1194,993,201,0.831658,0.168342,1.618951,181,20,1196,994,202,0.831104,0.168896,1.618982,181,21,-1, merged,1,1,0
46414,1000005,2,618,515,103,0.833333,0.166667,1.655743,96,7,620,516,104,0.832258,0.167742,1.655043,96,8,-1, merged,1,1,0
46414,1000130,1,473,389,84,0.82241,0.17759,0.82241,66,18,474,390,84,0.822785,0.177215,0.822785,66,18,1, merged,0,0,0
46415,1000014,1,2407,1989,418,0.82634,0.17366,0.82634,391,27,2411,1993,418,0.826628,0.173372,0.826628,391,27,-1, merged,0,0,0
46415,1000130,3,474,390,84,0.822785,0.177215,2.374839,66,18,475,391,84,0.823158,0.176842,2.377059,66,18,-1, merged,0,0,0
46416,1000014,1,2411,1993,418,0.826628,0.173372,0.826628,391,27,2414,1996,418,0.826843,0.173157,0.826843,391,27,-1, merged,0,0,0
46417,1000014,1,2414,1996,418,0.826843,0.173157,0.826843,391,27,2416,1998,418,0.826987,0.173013,0.826987,391,27,-1, merged,0,0,0
46418,1000014,1,2416,1998,418,0.826987,0.173013,0.826987,391,27,2418,2000,418,0.82713,0.17287,0.82713,391,27,-1, merged,0,0,0
46428,1000054,2,818,700,118,0.855746,0.144254,1.618904,102,16,820,702,118,0.856098,0.143902,1.625328,102,16,1, merged,0,0,0
46429,1000054,2,820,702,118,0.856098,0.143902,1.625328,102,16,821,702,119,0.855055,0.144945,1.586762,103,16,1, merged,1,1,0
46430,1000003,1,1197,995,202,0.831245,0.168755,0.831245,181,21,1200,998,202,0.831667,0.168333,0.831667,181,21,-1, merged,0,0,0
46430,1000014,2,2418,2000,418,0.82713,0.17287,1.658375,391,27,2420,2001,419,0.82686,0.17314,1.658526,392,27,1, merged,1,1,0
46430,1000329,3,3082,2399,683,0.778391,0.221609,2.436765,589,94,3083,2400,683,0.778463,0.221537,2.436989,589,94,1, merged,0,0,0
46434,1000009,2,1296,1074,222,0.828704,0.171296,1.724019,202,20,1297,1075,222,0.828836,0.171164,1.723723,202,20,1, merged,0,0,0
46434,1000015,1,2092,1873,219,0.895315,0.104685,0.895315,200,19,2093,1873,220,0.894888,0.105112,0.894888,201,19,1, merged,1,1,0
46437,1000004,1,3430,3051,379,0.889504,0.110496,0.889504,295,84,3434,3052,382,0.888759,0.111241,0.888759,298,84,1, merged,1,1,0
46437,1000592,3,708,600,108,0.847458,0.152542,2.549462,67,41,709,601,108,0.847673,0.152327,2.559962,67,41,1, merged,0,0,0
46448,1000004,2,3434,3052,382,0.888759,0.111241,1.388759,298,84,3435,3053,382,0.888792,0.111208,1.444347,298,84,1, merged,0,0,0
46449,1000014,2,2420,2001,419,0.82686,0.17314,1.668965,392,27,2422,2002,420,0.82659,0.17341,1.669873,392,28,-1, merged,1,1,0
46456,1000121,2,2239,1846,393,0.824475,0.175525,1.670629,368,25,2240,1847,393,0.824554,0.175446,1.671179,368,25,1, merged,0,0,0
46458,1000014,2,2422,2002,420,0.82659,0.17341,1.571293,392,28,2423,2003,420,0.826661,0.173339,1.570061,392,28,1, merged,0,0,0
46458,1000070,4,1255,1070,185,0.85259,0.14741,3.310004,161,24,1256,1071,185,0.852707,0.147293,3.309293,161,24,1, merged,0,0,0
46458,1000110,3,281,249,32,0.886121,0.113879,2.457414,30,2,282,250,32,0.886525,0.113475,2.456586,30,2,1, merged,0,0,0
46458,1000328,1,944,703,241,0.744703,0.255297,0.744703,216,25,947,704,243,0.7434,0.2566,0.7434,218,25,1, merged,1,1,0
46470,1000014,1,2423,2003,420,0.826661,0.173339,0.826661,392,28,2425,2004,421,0.826392,0.173608,0.826392,393,28,1, merged,1,1,0
46470,1000110,3,282,250,32,0.886525,0.113475,2.52872,30,2,283,251,32,0.886926,0.113074,2.524638,30,2,1, merged,0,0,0
46484,1000054,1,821,702,119,0.855055,0.144945,0.855055,103,16,822,703,119,0.855231,0.144769,0.855231,103,16,1, merged,0,0,0
46484,1000166,2,420,331,89,0.788095,0.211905,1.64315,85,4,421,332,89,0.788599,0.211401,1.64383,85,4,1, merged,0,0,0
46498,1000014,1,2425,2004,421,0.826392,0.173608,0.826392,393,28,2426,2004,422,0.826051,0.173949,0.826051,394,28,1, merged,1,1,0
46498,1000015,2,2095,1875,220,0.894988,0.105012,1.72138,201,19,2096,1876,220,0.895038,0.104962,1.721089,201,19,1, merged,0,0,0
46499,1000105,2,592,464,128,0.783784,0.216216,1.620626,114,14,593,465,128,0.784148,0.215852,1.621845,114,14,-1, abandoned,0,0,0
46499,1000108,1,190,159,31,0.836842,0.163158,0.836842,27,4,191,160,31,0.837696,0.162304,0.837696,27,4,-1, abandoned,0,0,0
46502,1000015,1,2096,1876,220,0.895038,0.104962,0.895038,201,19,2098,1877,221,0.894662,0.105338,0.894662,201,20,-1, merged,1,1,0
46505,1000054,4,822,703,119,0.855231,0.144769,3.053776,103,16,824,704,120,0.854369,0.145631,3.099721,104,16,1, merged,1,1,0
46505,1000166,5,421,332,89,0.788599,0.211401,3.842375,85,4,423,332,91,0.78487,0.21513,3.884591,87,4,1, merged,1,1,0
46505,1002169,1,450,322,128,0.715556,0.284444,0.715556,121,7,451,323,128,0.716186,0.283814,0.716186,121,7,-1, merged,0,0,0
46507,1000007,2,1479,1187,292,0.802569,0.197431,1.592043,261,31,1480,1188,292,0.802703,0.197297,1.594007,261,31,-1, abandoned,0,0,0
46513,1000120,2,1672,1451,221,0.867823,0.132177,1.655866,193,28,1673,1452,221,0.867902,0.132098,1.657091,193,28,1, merged,0,0,0
46518,1000005,2,621,517,104,0.832528,0.167472,1.65716,96,8,622,518,104,0.832797,0.167203,1.657508,96,8,1, merged,0,0,0
46518,1000121,1,2241,1848,393,0.824632,0.175368,0.824632,368,25,2242,1849,393,0.82471,0.17529,0.82471,368,25,1, merged,0,0,0
46536,1000110,2,283,251,32,0.886926,0.113074,1.724275,30,2,284,252,32,0.887324,0.112676,1.725162,30,2,1, merged,0,0,0
46537,1000004,2,3435,3053,382,0.888792,0.111208,1.756694,298,84,3436,3054,382,0.888824,0.111176,1.756805,298,84,1, merged,0,0,0
46537,1000120,1,1673,1452,221,0.867902,0.132098,0.867902,193,28,1674,1453,221,0.867981,0.132019,0.867981,193,28,1, merged,0,0,0
46541,1000132,2,457,405,52,0.886214,0.113786,1.886214,39,13,459,407,52,0.88671,0.11329,1.38671,39,13,-1, merged,0,0,0
46541,1002169,3,451,323,128,0.716186,0.283814,2.602401,121,7,452,323,129,0.714602,0.285398,2.101312,121,8,-1, merged,1,1,0
46544,1000054,1,825,705,120,0.854545,0.145455,0.854545,104,16,826,706,120,0.854722,0.145278,0.854722,104,16,1, merged,0,0,0
46545,1000054,2,826,706,120,0.854722,0.145278,1.586429,104,16,827,707,120,0.854897,0.145103,1.592992,104,16,1, merged,0,0,0
46552,1000004,1,3436,3054,382,0.888824,0.111176,0.888824,298,84,3441,3059,382,0.888986,0.111014,0.888986,298,84,-1, merged,0,0,0
46552,1002169,2,452,323,129,0.714602,0.285398,1.603426,121,8,453,324,129,0.715232,0.284768,1.604218,121,8,-1, merged,0,0,0
46561,1000007,2,1480,1188,292,0.802703,0.197297,1.697665,261,31,1481,1189,292,0.802836,0.197164,1.697848,261,31,1, merged,0,0,0
46561,1000015,1,2104,1883,221,0.894962,0.105038,0.894962,201,20,2105,1884,221,0.895012,0.104988,0.895012,201,20,1, merged,0,0,0
46562,1000007,2,1481,1189,292,0.802836,0.197164,1.530599,261,31,1482,1189,293,0.802294,0.197706,1.530789,262,31,1, merged,1,1,0
46562,1000015,3,2105,1884,221,0.895012,0.104988,2.425611,201,20,2106,1885,221,0.895062,0.104938,2.425851,201,20,1, merged,0,0,0
46562,1000534,1,371,270,101,0.727763,0.272237,0.727763,91,10,372,271,101,0.728495,0.271505,0.728495,91,10,-1, merged,0,0,0
46563,1000007,2,1482,1189,293,0.802294,0.197706,1.530789,262,31,1483,1190,293,0.802428,0.197572,1.53165,262,31,1, merged,0,0,0
46563,1000534,1,372,271,101,0.728495,0.271505,0.728495,91,10,373,272,101,0.729223,0.270777,0.729223,91,10,-1, merged,0,0,0
46564,1000007,1,1483,1190,293,0.802428,0.197572,0.802428,262,31,1484,1191,293,0.802561,0.197439,0.802561,262,31,-1, abandoned,0,0,0
46572,1000004,1,3441,3059,382,0.888986,0.111014,0.888986,298,84,3442,3060,382,0.889018,0.110982,0.889018,298,84,1, merged,0,0,0
46572,1000329,2,3086,2403,683,0.778678,0.221322,1.667664,589,94,3087,2404,683,0.77875,0.22125,1.667768,589,94,1, merged,0,0,0
46583,1000004,1,3443,3061,382,0.88905,0.11095,0.88905,298,84,3448,3066,382,0.889211,0.110789,0.889211,298,84,-1, merged,0,0,0
46583,1000014,2,2429,2007,422,0.826266,0.173734,1.715316,394,28,2431,2008,423,0.825998,0.174002,1.715209,395,28,-1, merged,1,0,0
46583,1000329,3,3089,2406,683,0.778893,0.221107,2.494209,589,94,3093,2409,684,0.778855,0.221145,2.494064,590,94,-1, merged,1,0,0
46584,1000023,2,1245,1095,150,0.879518,0.120482,1.719281,135,15,1246,1096,150,0.879615,0.120385,1.719851,135,15,1, merged,0,0,0
46585,1000121,1,2242,1849,393,0.82471,0.17529,0.82471,368,25,2244,1850,394,0.824421,0.175579,0.824421,369,25,1, merged,1,1,0
46585,1000329,2,3093,2409,684,0.778855,0.221145,1.603566,590,94,3095,2410,685,0.778675,0.221325,1.603096,591,94,1, merged,1,1,0
46593,1000534,1,373,272,101,0.729223,0.270777,0.729223,91,10,374,272,102,0.727273,0.272727,0.727273,92,10,1, merged,1,1,0
46598,1000015,2,2106,1885,221,0.895062,0.104938,1.622334,201,20,2107,1886,221,0.895112,0.104888,1.623112,201,20,1, merged,0,0,0
46598,1000534,1,374,272,102,0.727273,0.272727,0.727273,92,10,375,273,102,0.728,0.272,0.728,92,10,1, merged,0,0,0
46601,1000004,2,3448,3066,382,0.889211,0.110789,1.809211,298,84,3449,3066,383,0.888953,0.111047,1.810522,299,84,1, merged,1,1,0
46604,1000004,3,3449,3066,383,0.888953,0.111047,2.407289,299,84,3452,3068,384,0.88876,0.11124,2.402097,300,84,-1, merged,1,0,0
46604,1000009,4,1299,1077,222,0.829099,0.170901,3.236388,202,20,1300,1078,222,0.829231,0.170769,3.231328,202,20,1, merged,0,0,0
46604,1000120,1,1676,1454,222,0.867542,0.132458,0.867542,194,28,1679,1456,223,0.867183,0.132817,0.867183,195,28,-1, merged,1,0,0
46611,1000009,2,1300,1078,222,0.829231,0.170769,1.516731,202,20,1302,1080,222,0.829493,0.170507,1.513704,202,20,-1, merged,0,0,0
46616,1000091,5,569,448,121,0.787346,0.212654,3.694296,101,20,570,449,121,0.787719,0.212281,3.762255,101,20,1, merged,0,0,0
46616,1000105,1,595,467,128,0.784874,0.215126,0.784874,114,14,596,468,128,0.785235,0.214765,0.785235,114,14,-1, merged,0,0,0
46616,1000328,2,947,704,243,0.7434,0.2566,1.528274,218,25,950,707,243,0.744211,0.255789,1.529445,218,25,-1, merged,0,0,0
46616,1000329,4,3095,2410,685,0.778675,0.221325,2.906949,591,94,3096,2410,686,0.778424,0.221576,2.974536,591,95,-1, merged,1,1,0
46628,1000012,3,580,502,78,0.865517,0.134483,2.623927,75,3,581,503,78,0.865749,0.134251,2.621239,75,3,1, merged,0,0,0
46628,1000026,2,459,412,47,0.897603,0.102397,1.758409,44,3,460,413,47,0.897826,0.102174,1.75549,44,3,1, merged,0,0,0
46630,1000132,1,461,409,52,0.887202,0.112798,0.887202,39,13,462,410,52,0.887446,0.112554,0.887446,39,13,-1, merged,0,0,0
46640,1000004,1,3453,3069,384,0.888792,0.111208,0.888792,300,84,3454,3070,384,0.888825,0.111175,0.888825,300,84,1, merged,0,0,0
46640,1000120,2,1679,1456,223,0.867183,0.132817,1.755975,195,28,1680,1457,223,0.867262,0.132738,1.756086,195,28,1, merged,0,0,0
46650,1000011,2,737,678,59,0.919946,0.080054,1.815057,54,5,738,679,59,0.920054,0.079946,1.815215,54,5,1, merged,0,0,0
46650,1000015,1,2107,1886,221,0.895112,0.104888,0.895112,201,20,2108,1887,221,0.895161,0.104839,0.895161,201,20,1, merged,0,0,0
46658,1000005,2,624,520,104,0.833333,0.166667,1.661616,96,8,625,521,104,0.8336,0.1664,1.662746,96,8,1, merged,0,0,0
46662,1000120,1,1682,1459,223,0.86742,0.13258,0.86742,195,28,1683,1460,223,0.867499,0.132501,0.867499,195,28,1, merged,0,0,0
46662,1000329,2,3096,2410,686,0.778424,0.221576,1.645844,591,95,3097,2411,686,0.778495,0.221505,1.645994,591,95,1, merged,0,0,0
46663,1000120,1,1683,1460,223,0.867499,0.132501,0.867499,195,28,1684,1461,223,0.867577,0.132423,0.867577,195,28,1, merged,0,0,0
46663,1000329,2,3097,2411,686,0.778495,0.221505,1.645994,591,95,3098,2412,686,0.778567,0.221433,1.646144,591,95,1, merged,0,0,0
46676,1000015,2,2108,1887,221,0.895161,0.104839,1.622434,201,20,2109,1888,221,0.895211,0.104789,1.645211,201,20,1, merged,0,0,0
46679,1000109,2,521,445,76,0.854127,0.145873,1.703409,71,5,522,446,76,0.854406,0.145594,1.704048,71,5,1, merged,0,0,0
46679,1000199,1,418,355,63,0.849282,0.150718,0.849282,57,6,419,356,63,0.849642,0.150358,0.849642,57,6,1, merged,0,0,0
46680,1000003,1,1207,1005,202,0.832643,0.167357,0.832643,181,21,1208,1006,202,0.832781,0.167219,0.832781,181,21,1, merged,0,0,0
46680,1000199,2,419,356,63,0.849642,0.150358,1.682285,57,6,420,357,63,0.85,0.15,1.682781,57,6,1, merged,0,0,0
46683,1000132,1,463,411,52,0.887689,0.112311,0.887689,39,13,464,411,53,0.885776,0.114224,0.885776,40,13,1, merged,1,1,0
46684,1000004,2,3455,3071,384,0.888857,0.111143,1.667424,300,84,3456,3072,384,0.888889,0.111111,1.667527,300,84,1, merged,0,0,0
46684,1000329,1,3098,2412,686,0.778567,0.221433,0.778567,591,95,3099,2413,686,0.778638,0.221362,0.778638,591,95,1, merged,0,0,0
46691,1000014,1,2435,2012,423,0.826283,0.173717,0.826283,395,28,2436,2013,423,0.826355,0.173645,0.826355,395,28,1, merged,0,0,0
46693,1000026,1,460,413,47,0.897826,0.102174,0.897826,44,3,461,413,48,0.895879,0.104121,0.895879,45,3,1, merged,1,1,0
46704,1000003,1,1208,1006,202,0.832781,0.167219,0.832781,181,21,1209,1007,202,0.83292,0.16708,0.83292,181,21,1, merged,0,0,0
46705,1000329,2,3099,2413,686,0.778638,0.221362,1.687729,591,95,3101,2415,686,0.778781,0.221219,1.664495,591,95,-1, merged,0,0,0
46705,1002169,3,453,324,129,0.715232,0.284768,2.402961,121,8,454,325,129,0.715859,0.284141,2.380354,121,8,-1, merged,0,0,0
46706,1000108,1,193,162,31,0.839378,0.160622,0.839378,27,4,194,163,31,0.840206,0.159794,0.840206,27,4,1, merged,0,0,0
46706,1000110,2,286,254,32,0.888112,0.111888,1.72749,30,2,287,255,32,0.888502,0.111498,1.728708,30,2,1, merged,0,0,0
46715,1000004,2,3457,3073,384,0.888921,0.111079,1.888921,300,84,3458,3074,384,0.888953,0.111047,1.888953,300,84,1, merged,0,0,0
46720,1000108,2,196,165,31,0.841837,0.158163,1.654921,27,4,197,165,32,0.837563,0.162437,1.643119,28,4,1, abandoned,1,1,0
46736,1002169,1,482,353,129,0.732365,0.267635,0.732365,121,8,487,357,130,0.73306,0.26694,0.73306,121,9,-1, merged,1,0,0
46750,1002169,1,512,382,130,0.746094,0.253906,0.746094,121,9,516,385,131,0.746124,0.253876,0.746124,121,10,-1, merged,1,0,0
46751,1002169,1,516,385,131,0.746124,0.253876,0.746124,121,10,520,388,132,0.746154,0.253846,0.746154,121,11,-1, merged,1,0,0
46756,1002169,1,528,396,132,0.75,0.25,0.75,121,11,532,399,133,0.75,0.25,0.75,121,12,-1, merged,1,0,0
46757,1002169,1,532,399,133,0.75,0.25,0.75,121,12,536,402,134,0.75,0.25,0.75,121,13,-1, merged,1,0,0
46768,1000004,1,3460,3076,384,0.889017,0.110983,0.889017,300,84,3461,3077,384,0.889049,0.110951,0.889049,300,84,-1, merged,0,0,0
46768,1000026,2,461,413,48,0.895879,0.104121,1.784896,45,3,462,414,48,0.896104,0.103896,1.785153,45,3,1, merged,0,0,0
46770,1000004,3,3461,3077,384,0.889049,0.110951,2.653276,300,84,3464,3080,384,0.889145,0.110855,2.650811,300,84,-1, merged,0,0,0
46770,1000132,1,465,412,53,0.886022,0.113978,0.886022,40,13,466,413,53,0.886266,0.113734,0.886266,40,13,-1, merged,0,0,0
46771,1000004,2,3464,3080,384,0.889145,0.110855,1.775412,300,84,3465,3081,384,0.889177,0.110823,1.773793,300,84,1, merged,0,0,0
46771,1000132,1,466,413,53,0.886266,0.113734,0.886266,40,13,468,414,54,0.884615,0.115385,0.884615,41,13,1, merged,1,1,0
46772,1000004,2,3465,3081,384,0.889177,0.110823,1.773793,300,84,3466,3081,385,0.888921,0.111079,1.770025,301,84,1, abandoned,1,1,0
46772,1000132,1,468,414,54,0.884615,0.115385,0.884615,41,13,471,415,56,0.881104,0.118896,0.881104,43,13,-1, abandoned,1,0,0
46772,1000329,3,3101,2415,686,0.778781,0.221219,2.552574,591,95,3102,2416,686,0.778852,0.221148,2.548877,591,95,-1, abandoned,0,0,0
46773,1000534,1,375,273,102,0.728,0.272,0.728,92,10,376,274,102,0.728723,0.271277,0.728723,92,10,-1, merged,0,0,0
46782,1000014,2,2437,2014,423,0.826426,0.173574,1.694395,395,28,2438,2015,423,0.826497,0.173503,1.694622,395,28,1, merged,0,0,0
46782,1000120,1,1689,1466,223,0.867969,0.132031,0.867969,195,28,1691,1468,223,0.868125,0.131875,0.868125,195,28,1, merged,0,0,0
46785,1000054,2,828,708,120,0.855072,0.144928,1.712215,104,16,829,709,120,0.855247,0.144753,1.70686,104,16,1, merged,0,0,0
46787,1000043,2,578,482,96,0.83391,0.16609,1.667243,83,13,579,482,97,0.83247,0.16753,1.58247,83,14,-1, merged,1,1,0
46794,1000121,4,2244,1850,394,0.824421,0.175579,3.339663,369,25,2245,1851,394,0.824499,0.175501,3.340982,369,25,-1, abandoned,0,0,0
46794,1002169,1,545,411,134,0.754128,0.245872,0.754128,121,13,546,412,134,0.754579,0.245421,0.754579,121,13,-1, abandoned,0,0,0
46795,1000132,2,471,415,56,0.881104,0.118896,1.68203,43,13,472,416,56,0.881356,0.118644,1.683199,43,13,1, merged,0,0,0
46795,1000140,1,216,173,43,0.800926,0.199074,0.800926,37,6,217,174,43,0.801843,0.198157,0.801843,37,6,1, merged,0,0,0
46809,1000054,3,832,711,121,0.854567,0.145433,1.799012,105,16,833,711,122,0.853541,0.146459,1.782113,106,16,1, merged,1,1,0
46815,1000003,1,1209,1007,202,0.83292,0.16708,0.83292,181,21,1211,1008,203,0.83237,0.16763,0.83237,181,22,-1, merged,1,0,0
46815,1000015,2,2111,1890,221,0.89531,0.10469,1.72823,201,20,2112,1891,221,0.89536,0.10464,1.72773,201,20,1, merged,0,0,0
46821,1000004,2,3469,3084,385,0.889017,0.110983,1.694573,301,84,3470,3085,385,0.889049,0.110951,1.687214,301,84,1, merged,0,0,0
46822,1000109,2,522,446,76,0.854406,0.145594,1.705117,71,5,523,447,76,0.854685,0.145315,1.705748,71,5,1, merged,0,0,0
46822,1000199,1,422,359,63,0.850711,0.149289,0.850711,57,6,423,360,63,0.851064,0.148936,0.851064,57,6,-1, merged,0,0,0
46826,1000109,2,524,448,76,0.854962,0.145038,1.645847,71,5,525,449,76,0.855238,0.144762,1.646682,71,5,1, merged,0,0,0
46830,1000003,1,1211,1008,203,0.83237,0.16763,0.83237,181,22,1212,1008,204,0.831683,0.168317,0.831683,181,23,-1, merged,1,1,0
46830,1000109,2,528,452,76,0.856061,0.143939,1.688431,71,5,529,453,76,0.856333,0.143667,1.688016,71,5,1, merged,0,0,0
46831,1000003,1,1212,1008,204,0.831683,0.168317,0.831683,181,23,1213,1008,205,0.830998,0.169002,0.830998,181,24,-1, merged,1,1,0
46831,1000109,2,529,453,76,0.856333,0.143667,1.688016,71,5,530,454,76,0.856604,0.143396,1.687601,71,5,1, merged,0,0,0
46832,1000109,2,530,454,76,0.856604,0.143396,1.648048,71,5,531,455,76,0.856874,0.143126,1.648874,71,5,1, merged,0,0,0
46833,1000109,2,531,455,76,0.856874,0.143126,1.648874,71,5,532,456,76,0.857143,0.142857,1.649696,71,5,1, merged,0,0,0
46859,1000004,2,3470,3085,385,0.889049,0.110951,1.674763,301,84,3471,3086,385,0.889081,0.110919,1.673429,301,84,-1, abandoned,0,0,0
46859,1000091,1,574,451,123,0.785714,0.214286,0.785714,103,20,575,451,124,0.784348,0.215652,0.784348,104,20,1, abandoned,1,1,0
46862,1000023,1,1250,1100,150,0.88,0.12,0.88,135,15,1251,1100,151,0.879297,0.120703,0.879297,136,15,1, merged,1,1,0
46866,1000004,1,3471,3086,385,0.889081,0.110919,0.889081,301,84,3473,3087,386,0.888857,0.111143,0.888857,302,84,1, merged,1,1,0
46866,1000091,3,576,452,124,0.784722,0.215278,2.415739,104,20,577,453,124,0.785095,0.214905,2.414051,104,20,1, merged,0,0,0
46867,1000004,1,3473,3087,386,0.888857,0.111143,0.888857,302,84,3475,3089,386,0.888921,0.111079,0.888921,302,84,-1, merged,0,0,0
46867,1000009,2,1302,1080,222,0.829493,0.170507,1.71835,202,20,1303,1081,222,0.829624,0.170376,1.718545,202,20,1, merged,0,0,0
46874,1000003,2,1213,1008,205,0.830998,0.169002,1.727326,181,24,1214,1009,205,0.831137,0.168863,1.727688,181,24,1, merged,0,0,0
46874,1000026,1,463,415,48,0.896328,0.103672,0.896328,45,3,464,416,48,0.896552,0.103448,0.896552,45,3,1, merged,0,0,0
46876,1000023,1,1251,1100,151,0.879297,0.120703,0.879297,136,15,1253,1101,152,0.878691,0.121309,0.878691,136,16,-1, merged,1,0,0
46879,1000014,1,2439,2016,423,0.826568,0.173432,0.826568,395,28,2441,2016,425,0.825891,0.174109,0.825891,397,28,1, abandoned,1,1,0
46879,1000070,2,1268,1083,185,0.854101,0.145899,1.680669,161,24,1269,1083,186,0.853428,0.146572,1.679319,162,24,1, abandoned,1,1,0
46881,1000329,2,3107,2420,687,0.778886,0.221114,1.533465,592,95,3109,2421,688,0.778707,0.221293,1.533734,593,95,1, merged,1,1,0
46881,1000592,3,710,602,108,0.847887,0.152113,2.381352,67,41,711,603,108,0.848101,0.151899,2.381836,67,41,1, merged,0,0,0
46881,1002169,1,546,412,134,0.754579,0.245421,0.754579,121,13,547,413,134,0.755027,0.244973,0.755027,121,13,-1, merged,0,0,0
46882,1000091,4,577,453,124,0.785095,0.214905,3.166931,104,20,578,454,124,0.785467,0.214533,3.168105,104,20,1, merged,0,0,0
46882,1000329,2,3109,2421,688,0.778707,0.221293,1.533734,593,95,3111,2423,688,0.778849,0.221151,1.534324,593,95,-1, merged,0,0,0
46882,1000592,3,711,603,108,0.848101,0.151899,2.381836,67,41,712,604,108,0.848315,0.151685,2.382638,67,41,1, merged,0,0,0
46882,1002169,1,547,413,134,0.755027,0.244973,0.755027,121,13,548,414,134,0.755474,0.244526,0.755474,121,13,-1, merged,0,0,0
46883,1000014,1,2441,2016,425,0.825891,0.174109,0.825891,397,28,2442,2017,425,0.825962,0.174038,0.825962,397,28,1, merged,0,0,0
46883,1000070,2,1269,1083,186,0.853428,0.146572,1.679319,162,24,1270,1084,186,0.853543,0.146457,1.679506,162,24,1, merged,0,0,0
46905,1000132,2,473,417,56,0.881607,0.118393,1.659385,43,13,474,418,56,0.881857,0.118143,1.663675,43,13,1, merged,0,0,0
46910,1000328,3,950,707,243,0.744211,0.255789,2.333625,218,25,951,708,243,0.744479,0.255521,2.3393,218,25,-1, merged,0,0,0
46910,1002169,4,548,414,134,0.755474,0.244526,3.089099,121,13,549,415,134,0.75592,0.24408,3.09522,121,13,-1, merged,0,0,0
46911,1000329,2,3112,2424,688,0.77892,0.22108,1.422232,593,95,3114,2425,689,0.778741,0.221259,1.420251,594,95,1, merged,1,1,0
46913,1000121,2,2245,1851,394,0.824499,0.175501,1.60324,369,25,2247,1853,394,0.824655,0.175345,1.603467,369,25,-1, merged,0,0,0
46913,1000329,1,3114,2425,689,0.778741,0.221259,0.778741,594,95,3115,2426,689,0.778812,0.221188,0.778812,594,95,-1, merged,0,0,0
46916,1000004,2,3477,3090,387,0.888697,0.111303,1.644617,303,84,3478,3091,387,0.888729,0.111271,1.64372,303,84,-1, merged,0,0,0
46916,1002169,1,549,415,134,0.75592,0.24408,0.75592,121,13,551,416,135,0.754991,0.245009,0.754991,121,14,-1, merged,1,0,0
46917,1000014,3,2443,2018,425,0.826034,0.173966,2.372436,397,28,2444,2019,425,0.826105,0.173895,2.377238,397,28,1, merged,0,0,0
46917,1002169,1,551,416,135,0.754991,0.245009,0.754991,121,14,556,421,135,0.757194,0.242806,0.757194,121,14,-1, merged,0,0,0
46918,1000004,2,3478,3091,387,0.888729,0.111271,1.645923,303,84,3479,3092,387,0.888761,0.111239,1.646826,303,84,-1, abandoned,0,0,0
46918,1002169,1,556,421,135,0.757194,0.242806,0.757194,121,14,558,423,135,0.758065,0.241935,0.758065,121,14,-1, abandoned,0,0,0
46923,1000121,2,2247,1853,394,0.824655,0.175345,1.532447,369,25,2248,1854,394,0.824733,0.175267,1.533471,369,25,1, merged,0,0,0
46930,1000014,2,2444,2019,425,0.826105,0.173895,1.679763,397,28,2445,2020,425,0.826176,0.173824,1.679279,397,28,1, merged,0,0,0
46930,1000070,1,1271,1085,186,0.853659,0.146341,0.853659,162,24,1273,1086,187,0.853103,0.146897,0.853103,163,24,1, merged,1,1,0
46930,1000105,3,602,473,129,0.785714,0.214286,2.465478,114,15,603,474,129,0.78607,0.21393,2.465348,114,15,1, merged,0,0,0
46940,1000105,2,603,474,129,0.78607,0.21393,1.660283,114,15,604,475,129,0.786424,0.213576,1.661032,114,15,1, merged,0,0,0
46950,1000007,2,1490,1195,295,0.802013,0.197987,1.596885,264,31,1491,1195,296,0.801476,0.198524,1.571967,265,31,1, merged,1,1,0
46954,1000110,2,296,262,34,0.885135,0.114865,1.691441,32,2,297,263,34,0.885522,0.114478,1.692697,32,2,1, merged,0,0,0
46954,1000140,1,222,179,43,0.806306,0.193694,0.806306,37,6,223,180,43,0.807175,0.192825,0.807175,37,6,1, merged,0,0,0
46976,1000004,4,3480,3093,387,0.888793,0.111207,3.3239,303,84,3483,3096,387,0.888889,0.111111,3.32583,303,84,-1, merged,0,0,0
46976,1000070,2,1273,1086,187,0.853103,0.146897,1.727711,163,24,1274,1087,187,0.853218,0.146782,1.728608,163,24,-1, merged,0,0,0
46976,1000121,5,2249,1855,394,0.824811,0.175189,4.148711,369,25,2252,1856,396,0.824156,0.175844,4.149986,371,25,1, merged,1,1,0
46980,1000014,2,2445,2020,425,0.826176,0.173824,1.694845,397,28,2446,2021,425,0.826247,0.173753,1.694993,397,28,1, merged,0,0,0
46980,1000120,1,1698,1475,223,0.868669,0.131331,0.868669,195,28,1699,1476,223,0.868746,0.131254,0.868746,195,28,1, merged,0,0,0
46981,1000003,2,1220,1015,205,0.831967,0.168033,1.710755,181,24,1224,1018,206,0.831699,0.168301,1.709088,182,24,1, merged,1,1,0
46981,1000023,1,1254,1102,152,0.878788,0.121212,0.878788,136,16,1256,1102,154,0.877389,0.122611,0.877389,138,16,1, merged,1,1,0
46983,1000004,3,3483,3096,387,0.888889,0.111111,2.644781,303,84,3484,3097,387,0.888921,0.111079,2.642739,303,84,1, merged,0,0,0
46983,1000132,2,477,420,57,0.880503,0.119497,1.755893,44,13,478,421,57,0.880753,0.119247,1.753818,44,13,1, merged,0,0,0
46984,1000004,3,3484,3097,387,0.888921,0.111079,2.470319,303,84,3487,3100,387,0.889016,0.110984,2.470799,303,84,-1, merged,0,0,0
46984,1000132,4,478,421,57,0.880753,0.119247,3.351072,44,13,479,422,57,0.881002,0.118998,3.351801,44,13,1, merged,0,0,0
46993,1000054,3,837,715,122,0.854241,0.145759,2.377207,106,16,838,716,122,0.854415,0.145585,2.365217,106,16,1, merged,0,0,0
46993,1000166,2,423,332,91,0.78487,0.21513,1.522965,87,4,425,333,92,0.783529,0.216471,1.510802,87,5,-1, merged,1,0,0
47005,1000015,2,2115,1894,221,0.895508,0.104492,1.764332,201,20,2116,1895,221,0.895558,0.104442,1.764458,201,20,1, merged,0,0,0
47005,1000120,1,1700,1477,223,0.868824,0.131176,0.868824,195,28,1701,1478,223,0.868901,0.131099,0.868901,195,28,1, merged,0,0,0
47015,1000015,1,2116,1895,221,0.895558,0.104442,0.895558,201,20,2117,1896,221,0.895607,0.104393,0.895607,201,20,1, merged,0,0,0
47023,1000012,1,592,514,78,0.868243,0.131757,0.868243,75,3,593,514,79,0.866779,0.133221,0.866779,76,3,1, abandoned,1,1,0
47033,1000329,1,3120,2430,690,0.778846,0.221154,0.778846,594,96,3121,2431,690,0.778917,0.221083,0.778917,594,96,1, merged,0,0,0
47034,1000004,4,3487,3100,387,0.889016,0.110984,3.343476,303,84,3488,3101,387,0.889048,0.110952,3.343941,303,84,-1, merged,0,0,0
47034,1000120,2,1710,1487,223,0.869591,0.130409,1.627655,195,28,1713,1489,224,0.869235,0.130765,1.627733,196,28,1, merged,1,1,0
47034,1000130,3,485,401,84,0.826804,0.173196,2.454459,66,18,486,402,84,0.82716,0.17284,2.454893,66,18,-1, merged,0,0,0
47034,1002169,1,558,423,135,0.758065,0.241935,0.758065,121,14,559,424,135,0.758497,0.241503,0.758497,121,14,-1, merged,0,0,0
47035,1000004,2,3488,3101,387,0.889048,0.110952,1.647545,303,84,3492,3104,388,0.888889,0.111111,1.647754,304,84,-1, merged,1,0,0
47035,1002169,1,559,424,135,0.758497,0.241503,0.758497,121,14,564,428,136,0.758865,0.241135,0.758865,121,15,-1, merged,1,0,0
47036,1000004,2,3492,3104,388,0.888889,0.111111,1.647754,304,84,3495,3106,389,0.888698,0.111302,1.649262,305,84,-1, merged,1,0,0
47036,1002169,1,564,428,136,0.758865,0.241135,0.758865,121,15,568,432,136,0.760563,0.239437,0.760563,121,15,-1, merged,0,0,0
47037,1000014,2,2448,2023,425,0.826389,0.173611,1.586952,397,28,2449,2024,425,0.82646,0.17354,1.588281,397,28,1, merged,0,0,0
47037,1002169,1,568,432,136,0.760563,0.239437,0.760563,121,15,571,435,136,0.761821,0.238179,0.761821,121,15,-1, merged,0,0,0
47038,1000014,3,2449,2024,425,0.82646,0.17354,2.367198,397,28,2450,2025,425,0.826531,0.173469,2.366426,397,28,1, merged,0,0,0
47038,1000329,2,3121,2431,690,0.778917,0.221083,1.540738,594,96,3122,2432,690,0.778988,0.221012,1.539895,594,96,-1, merged,0,0,0
47038,1002169,1,571,435,136,0.761821,0.238179,0.761821,121,15,573,436,137,0.760908,0.239092,0.760908,121,16,-1, merged,1,0,0
47039,1000120,2,1713,1489,224,0.869235,0.130765,1.630143,196,28,1714,1490,224,0.869312,0.130688,1.629312,196,28,1, merged,0,0,0
47039,1002169,1,573,436,137,0.760908,0.239092,0.760908,121,16,575,437,138,0.76,0.24,0.76,121,17,-1, merged,1,0,0
47043,1000004,2,3496,3107,389,0.88873,0.11127,1.782713,305,84,3497,3108,389,0.888762,0.111238,1.778592,305,84,-1, merged,0,0,0
47052,1000003,2,1224,1018,206,0.831699,0.168301,1.624253,182,24,1225,1019,206,0.831837,0.168163,1.620755,182,24,-1, abandoned,0,0,0
47053,1000110,2,297,263,34,0.885522,0.114478,1.693558,32,2,299,265,34,0.886288,0.113712,1.690732,32,2,1, merged,0,0,0
47053,1000140,1,224,181,43,0.808036,0.191964,0.808036,37,6,225,181,44,0.804444,0.195556,0.804444,38,6,1, merged,1,1,0
47069,1000004,1,3498,3109,389,0.888794,0.111206,0.888794,305,84,3500,3111,389,0.888857,0.111143,0.888857,305,84,-1, merged,0,0,0
47069,1000132,2,479,422,57,0.881002,0.118998,1.769796,44,13,480,423,57,0.88125,0.11875,1.770107,44,13,1, merged,0,0,0
47072,1000003,1,1225,1019,206,0.831837,0.168163,0.831837,182,24,1230,1023,207,0.831707,0.168293,0.831707,183,24,-1, merged,1,0,0
47072,1000014,2,2451,2026,425,0.826601,0.173399,1.658438,397,28,2452,2027,425,0.826672,0.173328,1.658379,397,28,1, merged,0,0,0
47077,1000007,2,1501,1205,296,0.802798,0.197202,1.530311,265,31,1502,1206,296,0.802929,0.197071,1.531162,265,31,1, merged,0,0,0
47077,1000015,3,2120,1897,223,0.894811,0.105189,2.425123,203,20,2121,1898,223,0.894861,0.105139,2.426023,203,20,1, merged,0,0,0
47077,1000534,1,378,275,103,0.727513,0.272487,0.727513,93,10,379,276,103,0.728232,0.271768,0.728232,93,10,-1, merged,0,0,0
47079,1000329,1,3122,2432,690,0.778988,0.221012,0.778988,594,96,3123,2433,690,0.779059,0.220941,0.779059,594,96,1, merged,0,0,0
47081,1000105,1,605,476,129,0.786777,0.213223,0.786777,114,15,607,477,130,0.785832,0.214168,0.785832,115,15,1, merged,1,1,0
47083,1000003,1,1230,1023,207,0.831707,0.168293,0.831707,183,24,1232,1025,207,0.831981,0.168019,0.831981,183,24,-1, merged,0,0,0
47083,1000121,2,2252,1856,396,0.824156,0.175844,1.655864,371,25,2253,1857,396,0.824234,0.175766,1.656215,371,25,1, merged,0,0,0
47088,1000329,1,3123,2433,690,0.779059,0.220941,0.779059,594,96,3124,2434,690,0.779129,0.220871,0.779129,594,96,1, merged,0,0,0
47093,1000004,1,3501,3112,389,0.888889,0.111111,0.888889,305,84,3502,3113,389,0.888921,0.111079,0.888921,305,84,1, merged,0,0,0
47093,1000120,2,1714,1490,224,0.869312,0.130688,1.7582,196,28,1715,1491,224,0.869388,0.130612,1.758308,196,28,1, merged,0,0,0
47094,1000004,1,3502,3113,389,0.888921,0.111079,0.888921,305,84,3503,3114,389,0.888952,0.111048,0.888952,305,84,1, merged,0,0,0
47094,1000120,2,1715,1491,224,0.869388,0.130612,1.758308,196,28,1716,1492,224,0.869464,0.130536,1.758416,196,28,1, merged,0,0,0
47095,1000004,1,3503,3114,389,0.888952,0.111048,0.888952,305,84,3504,3115,389,0.888984,0.111016,0.888984,305,84,1, merged,0,0,0
47095,1000120,2,1716,1492,224,0.869464,0.130536,1.758416,196,28,1717,1493,224,0.86954,0.13046,1.758524,196,28,1, merged,0,0,0
47100,1000009,1,1313,1090,223,0.83016,0.16984,0.83016,202,21,1314,1091,223,0.830289,0.169711,0.830289,202,21,1, merged,0,0,0
47100,1000534,2,380,277,103,0.728947,0.271053,1.559107,93,10,381,278,103,0.729659,0.270341,1.559948,93,10,1, merged,0,0,0
47103,1000328,2,952,709,243,0.744748,0.255252,1.535446,218,25,953,710,243,0.745016,0.254984,1.536017,218,25,-1, abandoned,0,0,0
47108,1000004,1,3504,3115,389,0.888984,0.111016,0.888984,305,84,3506,3117,389,0.889047,0.110953,0.889047,305,84,-1, merged,0,0,0
47108,1000166,2,426,334,92,0.784038,0.215962,1.673022,87,5,427,335,92,0.784543,0.215457,1.673591,87,5,1, merged,0,0,0
47109,1000054,3,841,719,122,0.854935,0.145065,2.399895,106,16,842,720,122,0.855107,0.144893,2.400085,106,16,1, merged,0,0,0
47109,1000166,2,427,335,92,0.784543,0.215457,1.54496,87,5,428,336,92,0.785047,0.214953,1.544978,87,5,1, merged,0,0,0
47109,1002169,1,576,438,138,0.760417,0.239583,0.760417,121,17,579,440,139,0.759931,0.240069,0.759931,121,18,-1, merged,1,0,0
47111,1000329,2,3124,2434,690,0.779129,0.220871,1.612463,594,96,3126,2436,690,0.779271,0.220729,1.636413,594,96,1, merged,0,0,0
47112,1000003,1,1232,1025,207,0.831981,0.168019,0.831981,183,24,1233,1026,207,0.832117,0.167883,0.832117,183,24,-1, merged,0,0,0
47112,1000015,2,2121,1898,223,0.894861,0.105139,1.726841,203,20,2122,1899,223,0.89491,0.10509,1.727027,203,20,1, merged,0,0,0
47117,1000004,3,3506,3117,389,0.889047,0.110953,2.64439,305,84,3508,3119,389,0.889111,0.110889,2.639756,305,84,-1, merged,0,0,0
47117,1000132,1,481,424,57,0.881497,0.118503,0.881497,44,13,482,425,57,0.881743,0.118257,0.881743,44,13,-1, merged,0,0,0
47122,1000105,2,608,478,130,0.786184,0.213816,1.612055,115,15,609,479,130,0.786535,0.213465,1.613268,115,15,1, merged,0,0,0
47123,1000003,3,1233,1026,207,0.832117,0.167883,2.478178,183,24,1234,1027,207,0.832253,0.167747,2.479404,183,24,-1, abandoned,0,0,0
47123,1000109,2,532,456,76,0.857143,0.142857,1.646061,71,5,534,458,76,0.857678,0.142322,1.647152,71,5,-1, abandoned,0,0,0
47124,1000011,2,743,683,60,0.919246,0.080754,1.78749,55,5,744,684,60,0.919355,0.080645,1.788042,55,5,1, merged,0,0,0
47126,1000004,1,3508,3119,389,0.889111,0.110889,0.889111,305,84,3509,3120,389,0.889142,0.110858,0.889142,305,84,1, merged,0,0,0
47135,1000328,3,953,710,243,0.745016,0.254984,2.336017,218,25,957,711,246,0.742947,0.257053,2.337331,221,25,1, merged,1,1,0
47136,1000108,2,202,170,32,0.841584,0.158416,1.646029,28,4,203,171,32,0.842365,0.157635,1.648532,28,4,-1, merged,0,0,0
47136,1000140,1,225,181,44,0.804444,0.195556,0.804444,38,6,227,183,44,0.806167,0.193833,0.806167,38,6,-1, merged,0,0,0
47145,1000014,3,2453,2028,425,0.826743,0.173257,2.366301,397,28,2454,2029,425,0.826813,0.173187,2.368811,397,28,1, merged,0,0,0
47153,1000014,1,2454,2029,425,0.826813,0.173187,0.826813,397,28,2455,2030,425,0.826884,0.173116,0.826884,397,28,1, merged,0,0,0
47155,1000132,1,484,427,57,0.882231,0.117769,0.882231,44,13,485,427,58,0.880412,0.119588,0.880412,45,13,1, merged,1,1,0
47156,1000132,1,485,427,58,0.880412,0.119588,0.880412,45,13,486,427,59,0.878601,0.121399,0.878601,46,13,1, merged,1,1,0
47157,1000132,1,486,427,59,0.878601,0.121399,0.878601,46,13,487,428,59,0.87885,0.12115,0.87885,46,13,1, merged,0,0,0
47158,1000007,1,1503,1207,296,0.803061,0.196939,0.803061,265,31,1504,1207,297,0.802527,0.197473,0.802527,266,31,1, merged,1,1,0
47158,1000009,2,1314,1091,223,0.830289,0.169711,1.63335,202,21,1315,1092,223,0.830418,0.169582,1.632945,202,21,1, merged,0,0,0
47166,1000004,1,3514,3125,389,0.8893,0.1107,0.8893,305,84,3515,3126,389,0.889331,0.110669,0.889331,305,84,1, merged,0,0,0
47174,1000004,2,3515,3126,389,0.889331,0.110669,1.758947,305,84,3516,3127,389,0.889363,0.110637,1.759055,305,84,1, merged,0,0,0
47174,1000120,1,1718,1494,224,0.869616,0.130384,0.869616,196,28,1719,1495,224,0.869692,0.130308,0.869692,196,28,1, merged,0,0,0
47193,1000054,2,843,721,122,0.855279,0.144721,1.582551,106,16,844,722,122,0.85545,0.14455,1.566561,106,16,1, merged,0,0,0
47199,1000004,1,3516,3127,389,0.889363,0.110637,0.889363,305,84,3517,3128,389,0.889394,0.110606,0.889394,305,84,-1, merged,0,0,0
47199,1000120,2,1719,1495,224,0.869692,0.130308,1.759055,196,28,1720,1496,224,0.869767,0.130233,1.759162,196,28,1, merged,0,0,0
47214,1000014,2,2455,2030,425,0.826884,0.173116,1.541673,397,28,2457,2032,425,0.827025,0.172975,1.539306,397,28,-1, merged,0,0,0
47216,1000070,3,1276,1089,187,0.853448,0.146552,2.446584,163,24,1278,1090,188,0.852895,0.147105,2.447485,164,24,1, merged,1,1,0
47216,1000105,2,610,480,130,0.786885,0.213115,1.593135,115,15,612,481,131,0.785948,0.214052,1.59459,116,15,-1, merged,1,0,0
47219,1000328,2,957,711,246,0.742947,0.257053,1.510168,221,25,958,712,246,0.743215,0.256785,1.510988,221,25,1, merged,0,0,0
47222,1000070,3,1278,1090,188,0.852895,0.147105,2.411986,164,24,1279,1091,188,0.85301,0.14699,2.410655,164,24,1, merged,0,0,0
47224,1000070,2,1280,1092,188,0.853125,0.146875,1.604021,164,24,1281,1093,188,0.85324,0.14676,1.604581,164,24,1, merged,0,0,0
47227,1000070,3,1282,1094,188,0.853354,0.146646,2.364627,164,24,1283,1095,188,0.853468,0.146532,2.363875,164,24,1, merged,0,0,0
47227,1002169,1,579,440,139,0.759931,0.240069,0.759931,121,18,580,440,140,0.758621,0.241379,0.758621,121,19,-1, merged,1,1,0
47228,1000070,2,1283,1095,188,0.853468,0.146532,1.605254,164,24,1285,1096,189,0.852918,0.147082,1.603364,165,24,1, merged,1,1,0
47229,1000070,4,1285,1096,189,0.852918,0.147082,3.39757,165,24,1286,1097,189,0.853033,0.146967,3.391421,165,24,-1, merged,0,0,0
47230,1000592,2,712,604,108,0.848315,0.151685,1.626092,67,41,713,605,108,0.848527,0.151473,1.629015,67,41,1, merged,0,0,0
47231,1000592,2,713,605,108,0.848527,0.151473,1.629015,67,41,714,606,108,0.848739,0.151261,1.631872,67,41,1, merged,0,0,0
47233,1000004,1,3517,3128,389,0.889394,0.110606,0.889394,305,84,3518,3129,389,0.889426,0.110574,0.889426,305,84,-1, abandoned,0,0,0
47233,1000007,2,1506,1209,297,0.802789,0.197211,1.692183,266,31,1507,1210,297,0.80292,0.19708,1.692346,266,31,-1, abandoned,0,0,0
47234,1002169,1,580,440,140,0.758621,0.241379,0.758621,121,19,584,444,140,0.760274,0.239726,0.760274,121,19,-1, abandoned,0,0,0
47242,1000105,2,612,481,131,0.785948,0.214052,1.536393,116,15,613,482,131,0.786297,0.213703,1.537187,116,15,1, merged,0,0,0
47243,1000004,2,3518,3129,389,0.889426,0.110574,1.83387,305,84,3519,3130,389,0.889457,0.110543,1.835403,305,84,1, merged,0,0,0
47262,1000007,2,1507,1210,297,0.80292,0.19708,1.573412,266,31,1508,1211,297,0.80305,0.19695,1.575408,266,31,1, merged,0,0,0
47266,1000012,1,595,516,79,0.867227,0.132773,0.867227,76,3,596,516,80,0.865772,0.134228,0.865772,77,3,1, merged,1,1,0
47266,1000015,2,2124,1901,223,0.895009,0.104991,1.762236,203,20,2125,1902,223,0.895059,0.104941,1.760831,203,20,1, merged,0,0,0
47268,1000004,1,3519,3130,389,0.889457,0.110543,0.889457,305,84,3520,3130,390,0.889205,0.110795,0.889205,306,84,1, merged,1,1,0
47268,1000007,3,1508,1211,297,0.80305,0.19695,2.464865,266,31,1509,1212,297,0.803181,0.196819,2.460385,266,31,1, merged,0,0,0
47273,1000014,2,2459,2034,425,0.827166,0.172834,1.613462,397,28,2461,2036,425,0.827306,0.172694,1.612672,397,28,-1, merged,0,0,0
47273,1000105,1,613,482,131,0.786297,0.213703,0.786297,116,15,615,483,132,0.785366,0.214634,0.785366,117,15,1, merged,1,1,0
47286,1000130,3,487,402,85,0.825462,0.174538,2.40582,66,19,488,402,86,0.82377,0.17623,2.400172,66,20,-1, merged,1,1,0
47286,1002169,1,584,444,140,0.760274,0.239726,0.760274,121,19,585,444,141,0.758974,0.241026,0.758974,121,20,-1, merged,1,1,0
47291,1000132,1,491,431,60,0.8778,0.1222,0.8778,47,13,493,432,61,0.876268,0.123732,0.876268,48,13,1, merged,1,1,0
47292,1000132,1,493,432,61,0.876268,0.123732,0.876268,48,13,494,433,61,0.876518,0.123482,0.876518,48,13,1, merged,0,0,0
47295,1000132,2,494,433,61,0.876518,0.123482,1.676518,48,13,496,434,62,0.875,0.125,1.661885,49,13,1, merged,1,1,0
47296,1000120,2,1721,1497,224,0.869843,0.130157,1.711542,196,28,1722,1498,224,0.869919,0.130081,1.709613,196,28,1, merged,0,0,0
47302,1000015,2,2125,1902,223,0.895059,0.104941,1.681944,203,20,2126,1903,223,0.895108,0.104892,1.685431,203,20,1, merged,0,0,0
47309,1000009,1,1317,1093,224,0.829916,0.170084,0.829916,203,21,1319,1095,224,0.830174,0.169826,0.830174,203,21,-1, merged,0,0,0
47309,1000026,2,467,419,48,0.897216,0.102784,1.727133,45,3,468,420,48,0.897436,0.102564,1.72761,45,3,1, merged,0,0,0
47312,1000121,3,2262,1866,396,0.824934,0.175066,2.488037,371,25,2263,1867,396,0.825011,0.174989,2.492474,371,25,-1, merged,0,0,0
47318,1000015,1,2126,1903,223,0.895108,0.104892,0.895108,203,20,2127,1904,223,0.895157,0.104843,0.895157,203,20,1, merged,0,0,0
47321,1000011,2,745,685,60,0.919463,0.080537,1.746839,55,5,746,686,60,0.919571,0.080429,1.747017,55,5,1, merged,0,0,0
47321,1000014,1,2462,2037,425,0.827376,0.172624,0.827376,397,28,2463,2038,425,0.827446,0.172554,0.827446,397,28,1, merged,0,0,0
47322,1000109,1,535,459,76,0.857944,0.142056,0.857944,71,5,537,461,76,0.858473,0.141527,0.858473,71,5,-1, merged,0,0,0
47322,1000199,2,426,362,64,0.849765,0.150235,1.707709,57,7,427,363,64,0.850117,0.149883,1.70859,57,7,-1, merged,0,0,0
47327,1000132,2,500,438,62,0.876,0.124,1.672875,49,13,501,439,62,0.876248,0.123752,1.676248,49,13,1, merged,0,0,0
47335,1000007,1,1510,1213,297,0.803311,0.196689,0.803311,266,31,1511,1213,298,0.80278,0.19722,0.80278,267,31,1, merged,1,1,0
47335,1000026,2,468,420,48,0.897436,0.102564,1.700747,45,3,469,421,48,0.897655,0.102345,1.700434,45,3,1, merged,0,0,0
47344,1000054,2,844,722,122,0.85545,0.14455,1.708014,106,16,846,723,123,0.85461,0.14539,1.701744,107,16,1, merged,1,1,0
47349,1000043,2,585,488,97,0.834188,0.165812,1.641206,83,14,586,489,97,0.834471,0.165529,1.642331,83,14,-1, abandoned,0,0,0
47349,1000140,1,228,184,44,0.807018,0.192982,0.807018,38,6,229,185,44,0.80786,0.19214,0.80786,38,6,-1, abandoned,0,0,0
47350,1000004,1,3523,3133,390,0.889299,0.110701,0.889299,306,84,3526,3135,391,0.889109,0.110891,0.889109,307,84,1, merged,1,1,0
47350,1000329,4,3129,2439,690,0.779482,0.220518,3.339749,594,96,3130,2440,690,0.779553,0.220447,3.347465,594,96,1, merged,0,0,0
47352,1000011,1,747,687,60,0.919679,0.080321,0.919679,55,5,749,689,60,0.919893,0.080107,0.919893,55,5,-1, merged,0,0,0
47352,1000120,2,1724,1500,224,0.87007,0.12993,1.789748,196,28,1725,1501,224,0.870145,0.129855,1.790038,196,28,-1, merged,0,0,0
47353,1000009,3,1321,1097,224,0.830431,0.169569,2.502753,203,21,1322,1098,224,0.83056,0.16944,2.50338,203,21,1, merged,0,0,0
47353,1000014,2,2463,2038,425,0.827446,0.172554,1.672322,397,28,2464,2039,425,0.827516,0.172484,1.67282,397,28,1, merged,0,0,0
47357,1000054,2,846,723,123,0.85461,0.14539,1.613584,107,16,847,724,123,0.854782,0.145218,1.614167,107,16,-1, merged,0,0,0
47357,1000070,4,1287,1098,189,0.853147,0.146853,3.252097,165,24,1288,1099,189,0.853261,0.146739,3.251519,165,24,1, merged,0,0,0
47357,1000105,3,615,483,132,0.785366,0.214634,2.39895,117,15,616,483,133,0.784091,0.215909,2.398258,118,15,1, merged,1,1,0
47357,1002169,1,585,444,141,0.758974,0.241026,0.758974,121,20,586,445,141,0.759386,0.240614,0.759386,121,20,-1, merged,0,0,0
47358,1000003,4,1234,1027,207,0.832253,0.167747,3.111387,183,24,1235,1028,207,0.832389,0.167611,3.113136,183,24,1, merged,0,0,0
47358,1000329,3,3130,2440,690,0.779553,0.220447,2.279134,594,96,3131,2441,690,0.779623,0.220377,2.280747,594,96,1, merged,0,0,0
47358,1002169,2,586,445,141,0.759386,0.240614,1.499582,121,20,588,447,141,0.760204,0.239796,1.501124,121,20,-1, merged,0,0,0
47359,1000014,2,2465,2040,425,0.827586,0.172414,1.652597,397,28,2467,2041,426,0.827321,0.172679,1.652409,397,29,-1, merged,1,1,0
47359,1000121,1,2263,1867,396,0.825011,0.174989,0.825011,371,25,2264,1868,396,0.825088,0.174912,0.825088,371,25,1, merged,0,0,0
47367,1000004,2,3526,3135,391,0.889109,0.110891,1.757697,307,84,3527,3136,391,0.889141,0.110859,1.757805,307,84,1, merged,0,0,0
47367,1000120,1,1735,1507,228,0.868588,0.131412,0.868588,200,28,1736,1508,228,0.868664,0.131336,0.868664,200,28,1, merged,0,0,0
47368,1000120,1,1736,1508,228,0.868664,0.131336,0.868664,200,28,1737,1509,228,0.868739,0.131261,0.868739,200,28,1, merged,0,0,0
47368,1000329,2,3131,2441,690,0.779623,0.220377,1.648287,594,96,3132,2442,690,0.779693,0.220307,1.648433,594,96,1, merged,0,0,0
47370,1000004,2,3527,3136,391,0.889141,0.110859,1.757956,307,84,3528,3137,391,0.889172,0.110828,1.758063,307,84,1, merged,0,0,0
47370,1000120,1,1738,1510,228,0.868815,0.131185,0.868815,200,28,1739,1511,228,0.86889,0.13111,0.86889,200,28,1, merged,0,0,0
47372,1002169,1,588,447,141,0.760204,0.239796,0.760204,121,20,589,447,142,0.758913,0.241087,0.758913,121,21,-1, merged,1,1,0
47379,1000004,2,3528,3137,391,0.889172,0.110828,1.734902,307,84,3529,3137,392,0.88892,0.11108,1.732327,308,84,1, abandoned,1,1,0
47382,1000004,3,3529,3137,392,0.88892,0.11108,2.569153,308,84,3532,3140,392,0.889015,0.110985,2.231982,308,84,-1, merged,0,0,0
47386,1000132,2,502,440,62,0.876494,0.123506,1.656188,49,13,503,441,62,0.87674,0.12326,1.656184,49,13,1, merged,0,0,0
47386,1000329,1,3132,2442,690,0.779693,0.220307,0.779693,594,96,3133,2442,691,0.779445,0.220555,0.779445,595,96,1, merged,1,1,0
47388,1000132,1,503,441,62,0.87674,0.12326,0.87674,49,13,504,442,62,0.876984,0.123016,0.876984,49,13,1, merged,0,0,0
47389,1000004,2,3532,3140,392,0.889015,0.110985,1.66853,308,84,3537,3144,393,0.888889,0.111111,1.668155,309,84,-1, merged,1,0,0
47389,1000329,1,3134,2443,691,0.779515,0.220485,0.779515,595,96,3135,2443,692,0.779266,0.220734,0.779266,596,96,1, merged,1,1,0
47395,1000329,3,3135,2443,692,0.779266,0.220734,2.477565,596,96,3136,2444,692,0.779337,0.220663,2.478689,596,96,1, merged,0,0,0
47396,1000004,2,3537,3144,393,0.888889,0.111111,1.668226,309,84,3539,3146,393,0.888952,0.111048,1.668181,309,84,-1, merged,0,0,0
47396,1000329,1,3136,2444,692,0.779337,0.220663,0.779337,596,96,3139,2446,693,0.779229,0.220771,0.779229,597,96,-1, merged,1,0,0
47397,1000329,1,3139,2446,693,0.779229,0.220771,0.779229,597,96,3140,2447,693,0.779299,0.220701,0.779299,597,96,1, merged,0,0,0
47398,1000329,1,3140,2447,693,0.779299,0.220701,0.779299,597,96,3142,2449,693,0.77944,0.22056,0.77944,597,96,-1, merged,0,0,0
47399,1000108,2,206,174,32,0.84466,0.15534,1.71341,28,4,207,175,32,0.845411,0.154589,1.714976,28,4,1, merged,0,0,0
47401,1000328,1,958,712,246,0.743215,0.256785,0.743215,221,25,959,712,247,0.74244,0.25756,0.74244,222,25,1, abandoned,1,1,0
47401,1000329,2,3142,2449,693,0.77944,0.22056,1.522655,597,96,3143,2449,694,0.779192,0.220808,1.521632,598,96,1, abandoned,1,1,0
47402,1000329,2,3143,2449,694,0.779192,0.220808,1.538105,598,96,3144,2449,695,0.778944,0.221056,1.538266,599,96,1, abandoned,1,1,0
47402,1002169,1,589,447,142,0.758913,0.241087,0.758913,121,21,590,448,142,0.759322,0.240678,0.759322,121,21,-1, abandoned,0,0,0
47403,1000328,1,959,712,247,0.74244,0.25756,0.74244,222,25,960,713,247,0.742708,0.257292,0.742708,222,25,-1, abandoned,0,0,0
47403,1000329,2,3144,2449,695,0.778944,0.221056,1.521384,599,96,3145,2450,695,0.779014,0.220986,1.521723,599,96,-1, abandoned,0,0,0
47404,1000009,2,1322,1098,224,0.83056,0.16944,1.563027,203,21,1324,1099,225,0.83006,0.16994,1.563911,203,22,-1, merged,1,1,0
47404,1000534,1,385,282,103,0.732468,0.267532,0.732468,93,10,387,284,103,0.73385,0.26615,0.73385,93,10,-1, merged,0,0,0
47407,1000007,2,1512,1214,298,0.80291,0.19709,1.53676,267,31,1514,1216,298,0.80317,0.19683,1.537706,267,31,1, merged,0,0,0
47407,1000534,1,387,284,103,0.73385,0.26615,0.73385,93,10,388,285,103,0.734536,0.265464,0.734536,93,10,1, merged,0,0,0
47408,1000328,1,960,713,247,0.742708,0.257292,0.742708,222,25,963,715,248,0.742471,0.257529,0.742471,223,25,1, merged,1,1,0
47408,1000329,2,3145,2450,695,0.779014,0.220986,1.521723,599,96,3146,2451,695,0.779085,0.220915,1.521556,599,96,1, merged,0,0,0
47409,1000328,1,963,715,248,0.742471,0.257529,0.742471,223,25,964,716,248,0.742739,0.257261,0.742739,223,25,1, merged,0,0,0
47409,1000329,2,3146,2451,695,0.779085,0.220915,1.521556,599,96,3147,2452,695,0.779155,0.220845,1.521893,599,96,1, merged,0,0,0
47412,1000329,2,3147,2452,695,0.779155,0.220845,1.538477,599,96,3148,2453,695,0.779225,0.220775,1.53936,599,96,-1, merged,0,0,0
47412,1002169,1,590,448,142,0.759322,0.240678,0.759322,121,21,592,450,142,0.760135,0.239865,0.760135,121,21,-1, merged,0,0,0
47429,1000007,2,1514,1216,298,0.80317,0.19683,1.698426,267,31,1515,1217,298,0.8033,0.1967,1.698136,267,31,1, merged,0,0,0
47429,1000015,1,2129,1906,223,0.895256,0.104744,0.895256,203,20,2130,1906,224,0.894836,0.105164,0.894836,204,20,1, merged,1,1,0
47443,1000121,2,2264,1868,396,0.825088,0.174912,1.501389,371,25,2265,1869,396,0.825166,0.174834,1.503326,371,25,1, merged,0,0,0
47446,1000121,3,2265,1869,396,0.825166,0.174834,2.282551,371,25,2266,1870,396,0.825243,0.174757,2.284538,371,25,1, merged,0,0,0
47446,1000329,1,3148,2453,695,0.779225,0.220775,0.779225,599,96,3149,2454,695,0.779295,0.220705,0.779295,599,96,-1, merged,0,0,0
47453,1000004,1,3541,3148,393,0.889014,0.110986,0.889014,309,84,3542,3148,394,0.888763,0.111237,0.888763,310,84,1, merged,1,1,0
47453,1000007,3,1517,1219,298,0.80356,0.19644,2.519839,267,31,1520,1222,298,0.803947,0.196053,2.520046,267,31,-1, merged,0,0,0
47453,1000014,2,2472,2045,427,0.827265,0.172735,1.71628,398,29,2473,2046,427,0.827335,0.172665,1.716099,398,29,-1, merged,0,0,0
47453,1000015,4,2132,1908,224,0.894934,0.105066,3.414774,204,20,2133,1909,224,0.894984,0.105016,3.41503,204,20,1, merged,0,0,0
47458,1000014,1,2473,2046,427,0.827335,0.172665,0.827335,398,29,2474,2047,427,0.827405,0.172595,0.827405,398,29,-1, abandoned,0,0,0
47458,1000328,2,964,716,248,0.742739,0.257261,1.570074,223,25,965,717,248,0.743005,0.256995,1.57041,223,25,-1, abandoned,0,0,0
47462,1000003,2,1235,1028,207,0.832389,0.167611,1.721999,183,24,1239,1031,208,0.832123,0.167877,1.72209,184,24,-1, merged,1,0,0
47462,1000110,1,308,274,34,0.88961,0.11039,0.88961,32,2,309,275,34,0.889968,0.110032,0.889968,32,2,-1, merged,0,0,0
47463,1000132,1,506,444,62,0.87747,0.12253,0.87747,49,13,507,445,62,0.877712,0.122288,0.877712,49,13,1, merged,0,0,0
47466,1000004,2,3542,3148,394,0.888763,0.111237,1.343309,310,84,3544,3150,394,0.888826,0.111174,1.350365,310,84,-1, merged,0,0,0
47467,1002169,1,592,450,142,0.760135,0.239865,0.760135,121,21,594,451,143,0.759259,0.240741,0.759259,121,22,-1, merged,1,0,0
47471,1000003,2,1239,1031,208,0.832123,0.167877,1.69039,184,24,1241,1032,209,0.831587,0.168413,1.687984,185,24,-1, merged,1,0,0
47474,1000592,3,714,606,108,0.848739,0.151261,2.391131,67,41,715,607,108,0.848951,0.151049,2.394329,67,41,1, merged,0,0,0
47474,1002169,1,594,451,143,0.759259,0.240741,0.759259,121,22,595,452,143,0.759664,0.240336,0.759664,121,22,-1, merged,0,0,0
47475,1000592,2,715,607,108,0.848951,0.151049,1.634665,67,41,716,608,108,0.849162,0.150838,1.637397,67,41,1, merged,0,0,0
47476,1000592,3,716,608,108,0.849162,0.150838,2.460927,67,41,718,609,109,0.848189,0.151811,2.416733,68,41,1, merged,1,1,0
47480,1000004,2,3546,3152,394,0.888889,0.111111,1.762088,310,84,3547,3153,394,0.88892,0.11108,1.75961,310,84,-1, abandoned,0,0,0
47481,1000005,2,627,523,104,0.834131,0.165869,1.545242,96,8,628,523,105,0.832803,0.167197,1.528455,97,8,1, merged,1,1,0
47481,1000054,3,847,724,123,0.854782,0.145218,2.400023,107,16,849,726,123,0.855124,0.144876,2.383578,107,16,-1, merged,0,0,0
47482,1000004,1,3547,3153,394,0.88892,0.11108,0.88892,310,84,3548,3153,395,0.88867,0.11133,0.88867,310,85,-1, merged,1,1,0
47482,1000120,2,1741,1513,228,0.869041,0.130959,1.757961,200,28,1742,1514,228,0.869116,0.130884,1.757786,200,28,1, merged,0,0,0
47494,1000003,1,1241,1032,209,0.831587,0.168413,0.831587,185,24,1242,1033,209,0.831723,0.168277,0.831723,185,24,1, merged,0,0,0
47494,1000026,3,470,422,48,0.897872,0.102128,2.513314,45,3,471,423,48,0.898089,0.101911,2.514228,45,3,1, merged,0,0,0
47495,1000109,2,538,462,76,0.858736,0.141264,1.643152,71,5,539,463,76,0.858998,0.141002,1.641944,71,5,1, merged,0,0,0
47501,1000007,1,1520,1222,298,0.803947,0.196053,0.803947,267,31,1521,1222,299,0.803419,0.196581,0.803419,268,31,1, abandoned,1,1,0
47501,1000009,2,1328,1103,225,0.830572,0.169428,1.63452,203,22,1329,1104,225,0.8307,0.1693,1.634119,203,22,-1, abandoned,0,0,0
47509,1000014,1,2476,2049,427,0.827544,0.172456,0.827544,398,29,2477,2050,427,0.827614,0.172386,0.827614,398,29,1, merged,0,0,0
47513,1000132,1,510,448,62,0.878431,0.121569,0.878431,49,13,511,448,63,0.876712,0.123288,0.876712,50,13,1, merged,1,1,0
47514,1000166,1,428,336,92,0.785047,0.214953,0.785047,87,5,429,336,93,0.783217,0.216783,0.783217,88,5,1, merged,1,1,0
47516,1000132,1,511,448,63,0.876712,0.123288,0.876712,50,13,512,448,64,0.875,0.125,0.875,51,13,1, abandoned,1,1,0
47516,1000329,2,3149,2454,695,0.779295,0.220705,1.656007,599,96,3150,2455,695,0.779365,0.220635,1.654365,599,96,-1, abandoned,0,0,0
47522,1000132,2,512,448,64,0.875,0.125,1.719828,51,13,513,449,64,0.875244,0.124756,1.720958,51,13,1, merged,0,0,0
47535,1000108,1,208,176,32,0.846154,0.153846,0.846154,28,4,210,177,33,0.842857,0.157143,0.842857,29,4,-1, merged,1,0,0
47535,1000140,2,234,190,44,0.811966,0.188034,1.65812,38,6,235,191,44,0.812766,0.187234,1.655623,38,6,1, merged,0,0,0
47538,1000015,1,2137,1913,224,0.89518,0.10482,0.89518,204,20,2138,1913,225,0.894761,0.105239,0.894761,205,20,1, merged,1,1,0
47539,1002169,1,595,452,143,0.759664,0.240336,0.759664,121,22,596,452,144,0.758389,0.241611,0.758389,121,23,-1, merged,1,1,0
47544,1000109,2,540,464,76,0.859259,0.140741,1.642205,71,5,542,465,77,0.857934,0.142066,1.639425,72,5,1, merged,1,1,0
47551,1000004,1,3558,3162,396,0.888702,0.111298,0.888702,311,85,3559,3163,396,0.888733,0.111267,0.888733,311,85,1, merged,0,0,0
47551,1000329,2,3150,2455,695,0.779365,0.220635,1.668067,599,96,3151,2456,695,0.779435,0.220565,1.668168,599,96,1, merged,0,0,0
47555,1000120,2,1742,1514,228,0.869116,0.130884,1.663055,200,28,1743,1515,228,0.869191,0.130809,1.65961,200,28,-1, abandoned,0,0,0
47556,1000004,2,3559,3163,396,0.888733,0.111267,1.679152,311,85,3560,3164,396,0.888764,0.111236,1.674478,311,85,-1, merged,0,0,0
47556,1000120,3,1743,1515,228,0.869191,0.130809,2.548343,200,28,1744,1516,228,0.869266,0.130734,2.543744,200,28,1, merged,0,0,0
47557,1000120,2,1744,1516,228,0.869266,0.130734,1.65498,200,28,1748,1518,230,0.868421,0.131579,1.644892,202,28,1, merged,1,1,0
47559,1000004,2,3560,3164,396,0.888764,0.111236,1.757411,311,85,3561,3165,396,0.888795,0.111205,1.757666,311,85,-1, merged,0,0,0
47559,1000120,1,1751,1521,230,0.868646,0.131354,0.868646,202,28,1754,1524,230,0.868871,0.131129,0.868871,202,28,-1, merged,0,0,0
47560,1000004,1,3561,3165,396,0.888795,0.111205,0.888795,311,85,3562,3166,396,0.888827,0.111173,0.888827,311,85,-1, merged,0,0,0
47560,1000120,3,1754,1524,230,0.868871,0.131129,2.516056,202,28,1755,1525,230,0.868946,0.131054,2.514891,202,28,1, merged,0,0,0
47560,1002169,2,596,452,144,0.758389,0.241611,1.647185,121,23,597,452,145,0.757119,0.242881,1.645945,121,24,-1, merged,1,1,0
47561,1000120,2,1755,1525,230,0.868946,0.131054,1.626065,202,28,1756,1526,230,0.869021,0.130979,1.624873,202,28,1, merged,0,0,0
47561,1002169,1,597,452,145,0.757119,0.242881,0.757119,121,24,598,452,146,0.755853,0.244147,0.755853,121,25,-1, merged,1,1,0
47562,1000004,1,3562,3166,396,0.888827,0.111173,0.888827,311,85,3563,3167,396,0.888858,0.111142,0.888858,311,85,-1, merged,0,0,0
47562,1000120,2,1756,1526,230,0.869021,0.130979,1.757847,202,28,1757,1527,230,0.869095,0.130905,1.757953,202,28,1, merged,0,0,0
47563,1000004,1,3563,3167,396,0.888858,0.111142,0.888858,311,85,3565,3168,397,0.88864,0.11136,0.88864,312,85,-1, merged,1,0,0
47563,1000120,2,1757,1527,230,0.869095,0.130905,1.757953,202,28,1759,1528,231,0.868675,0.131325,1.757315,203,28,1, merged,1,1,0
47575,1000329,2,3151,2456,695,0.779435,0.220565,1.535288,599,96,3152,2457,695,0.779505,0.220495,1.534096,599,96,1, merged,0,0,0
47575,1002169,1,598,452,146,0.755853,0.244147,0.755853,121,25,599,452,147,0.754591,0.245409,0.754591,121,26,-1, merged,1,1,0
47581,1000140,2,235,191,44,0.812766,0.187234,1.567357,38,6,236,192,44,0.813559,0.186441,1.568559,38,6,1, merged,0,0,0
47581,1000166,4,429,336,93,0.783217,0.216783,3.046226,88,5,430,337,93,0.783721,0.216279,3.054408,88,5,1, merged,0,0,0
47581,1002169,1,599,452,147,0.754591,0.245409,0.754591,121,26,600,453,147,0.755,0.245,0.755,121,26,-1, merged,0,0,0
47596,1000105,2,617,484,133,0.784441,0.215559,1.539441,118,15,618,485,133,0.78479,0.21521,1.540197,118,15,-1, abandoned,0,0,0
47596,1002169,1,600,453,147,0.755,0.245,0.755,121,26,601,454,147,0.755408,0.244592,0.755408,121,26,-1, abandoned,0,0,0
47598,1000014,2,2477,2050,427,0.827614,0.172386,1.522058,398,29,2479,2052,427,0.827753,0.172247,1.503429,398,29,1, merged,0,0,0
47602,1000108,2,210,177,33,0.842857,0.157143,1.598265,29,4,211,178,33,0.843602,0.156398,1.597755,29,4,1, merged,0,0,0
47602,1002169,1,601,454,147,0.755408,0.244592,0.755408,121,26,602,454,148,0.754153,0.245847,0.754153,121,27,-1, merged,1,1,0
47603,1000011,3,749,689,60,0.919893,0.080107,2.425856,55,5,750,690,60,0.92,0.08,2.439367,55,5,1, merged,0,0,0
47604,1000004,1,3567,3170,397,0.888702,0.111298,0.888702,312,85,3571,3174,397,0.888827,0.111173,0.888827,312,85,-1, merged,0,0,0
47605,1000004,2,3571,3174,397,0.888827,0.111173,1.757773,312,85,3572,3175,397,0.888858,0.111142,1.758176,312,85,1, merged,0,0,0
47607,1000109,2,542,465,77,0.857934,0.142066,1.704445,72,5,543,466,77,0.858195,0.141805,1.705063,72,5,1, merged,0,0,0
47607,1000199,1,430,364,66,0.846512,0.153488,0.846512,59,7,431,365,66,0.846868,0.153132,0.846868,59,7,1, merged,0,0,0
47623,1000329,1,3152,2457,695,0.779505,0.220495,0.779505,599,96,3153,2457,696,0.779258,0.220742,0.779258,600,96,1, merged,1,1,0
47632,1000328,1,966,718,248,0.743271,0.256729,0.743271,223,25,967,719,248,0.743537,0.256463,0.743537,223,25,1, merged,0,0,0
47632,1000329,2,3153,2457,696,0.779258,0.220742,1.522529,600,96,3154,2458,696,0.779328,0.220672,1.522865,600,96,1, merged,0,0,0
47633,1000328,1,967,719,248,0.743537,0.256463,0.743537,223,25,970,720,250,0.742268,0.257732,0.742268,225,25,1, merged,1,1,0
47633,1000329,2,3154,2458,696,0.779328,0.220672,1.522865,600,96,3157,2461,696,0.779538,0.220462,1.521806,600,96,-1, merged,0,0,0
47641,1000009,4,1330,1105,225,0.830827,0.169173,3.132802,203,22,1333,1107,226,0.830458,0.169542,3.084233,204,22,-1, merged,1,0,0
47642,1000023,2,1257,1103,154,0.877486,0.122514,1.732436,138,16,1258,1104,154,0.877583,0.122417,1.732645,138,16,-1, abandoned,0,0,0
47642,1000070,1,1303,1114,189,0.85495,0.14505,0.85495,165,24,1304,1115,189,0.855061,0.144939,0.855061,165,24,-1, abandoned,0,0,0
47647,1000015,2,2142,1916,226,0.894491,0.105509,1.697308,206,20,2143,1917,226,0.89454,0.10546,1.700096,206,20,1, merged,0,0,0
47657,1000199,1,431,365,66,0.846868,0.153132,0.846868,59,7,433,367,66,0.847575,0.152425,0.847575,59,7,-1, merged,0,0,0
47658,1000199,1,433,367,66,0.847575,0.152425,0.847575,59,7,435,369,66,0.848276,0.151724,0.848276,59,7,-1, merged,0,0,0
47660,1000108,1,211,178,33,0.843602,0.156398,0.843602,29,4,212,179,33,0.84434,0.15566,0.84434,29,4,-1, merged,0,0,0
47660,1000140,2,236,192,44,0.813559,0.186441,1.657161,38,6,237,193,44,0.814346,0.185654,1.658686,38,6,1, merged,0,0,0
47665,1000120,2,1769,1536,233,0.868287,0.131713,1.62244,205,28,1771,1538,233,0.868436,0.131564,1.622996,205,28,-1, merged,0,0,0
47665,1002169,1,602,454,148,0.754153,0.245847,0.754153,121,27,603,455,148,0.754561,0.245439,0.754561,121,27,-1, merged,0,0,0
47673,1000199,2,435,369,66,0.848276,0.151724,1.631439,59,7,436,370,66,0.848624,0.151376,1.63035,59,7,1, merged,0,0,0
47674,1000014,1,2483,2056,427,0.828031,0.171969,0.828031,398,29,2484,2057,427,0.8281,0.1719,0.8281,398,29,1, merged,0,0,0
47675,1000005,3,630,525,105,0.833333,0.166667,2.438958,97,8,631,526,105,0.833597,0.166403,2.440639,97,8,1, merged,0,0,0
47675,1000329,2,3157,2461,696,0.779538,0.220462,1.605624,600,96,3158,2461,697,0.779291,0.220709,1.607042,601,96,1, merged,1,1,0
47682,1000004,1,3573,3176,397,0.888889,0.111111,0.888889,312,85,3574,3177,397,0.88892,0.11108,0.88892,312,85,1, merged,0,0,0
47689,1000026,1,475,426,49,0.896842,0.103158,0.896842,46,3,476,427,49,0.897059,0.102941,0.897059,46,3,1, merged,0,0,0
47689,1000054,3,849,726,123,0.855124,0.144876,2.680537,107,16,850,727,123,0.855294,0.144706,2.685686,107,16,1, merged,0,0,0
47698,1000004,1,3576,3179,397,0.888982,0.111018,0.888982,312,85,3577,3179,398,0.888734,0.111266,0.888734,312,86,-1, merged,1,1,0
47698,1000014,2,2486,2059,427,0.828238,0.171762,1.71722,398,29,2487,2059,428,0.827905,0.172095,1.716639,398,30,-1, merged,1,1,0
47700,1000014,2,2487,2059,428,0.827905,0.172095,1.383461,398,30,2488,2060,428,0.827974,0.172026,1.395542,398,30,1, merged,0,0,0
47702,1000007,2,1528,1228,300,0.803665,0.196335,1.642951,269,31,1529,1229,300,0.803793,0.196207,1.645899,269,31,1, merged,0,0,0
47703,1000004,2,3577,3179,398,0.888734,0.111266,0.888734,312,86,3580,3180,400,0.888268,0.111732,1.554935,314,86,1, merged,1,1,0
47705,1000043,2,586,489,97,0.834471,0.165529,1.67538,83,14,587,490,97,0.834753,0.165247,1.676561,83,14,1, merged,0,0,0
47707,1000070,3,1304,1115,189,0.855061,0.144939,2.142955,165,24,1307,1116,191,0.853864,0.146136,2.139443,166,25,1, merged,1,1,0
47707,1002169,1,603,455,148,0.754561,0.245439,0.754561,121,27,604,456,148,0.754967,0.245033,0.754967,121,27,-1, merged,0,0,0
47709,1000328,2,970,720,250,0.742268,0.257732,1.521559,225,25,971,721,250,0.742533,0.257467,1.521894,225,25,1, merged,0,0,0
47709,1000329,1,3158,2461,697,0.779291,0.220709,0.779291,601,96,3159,2462,697,0.779361,0.220639,0.779361,601,96,1, merged,0,0,0
47719,1000328,2,971,721,250,0.742533,0.257467,1.522312,225,25,972,722,250,0.742798,0.257202,1.522647,225,25,1, merged,0,0,0
47719,1000329,1,3165,2468,697,0.779779,0.220221,0.779779,601,96,3166,2469,697,0.779848,0.220152,0.779848,601,96,1, merged,0,0,0
47727,1000014,1,2488,2060,428,0.827974,0.172026,0.827974,398,30,2489,2061,428,0.828043,0.171957,0.828043,398,30,1, merged,0,0,0
47727,1000070,2,1307,1116,191,0.853864,0.146136,1.681838,166,25,1308,1117,191,0.853976,0.146024,1.682019,166,25,1, merged,0,0,0
47733,1000592,1,718,609,109,0.848189,0.151811,0.848189,68,41,719,609,110,0.84701,0.15299,0.84701,68,42,-1, merged,1,1,0
47740,1000004,2,3581,3180,401,0.88802,0.11198,1.733898,314,87,3582,3181,401,0.888051,0.111949,1.730909,314,87,1, merged,0,0,0
47744,1000004,1,3582,3181,401,0.888051,0.111949,0.888051,314,87,3583,3182,401,0.888083,0.111917,0.888083,314,87,1, merged,0,0,0
47745,1000132,1,520,456,64,0.876923,0.123077,0.876923,51,13,521,456,65,0.87524,0.12476,0.87524,52,13,1, abandoned,1,1,0
47745,1000329,2,3166,2469,697,0.779848,0.220152,1.656771,601,96,3167,2470,697,0.779918,0.220082,1.655158,601,96,-1, abandoned,0,0,0
47746,1000132,1,521,456,65,0.87524,0.12476,0.87524,52,13,522,456,66,0.873563,0.126437,0.873563,53,13,1, merged,1,1,0
47746,1000329,2,3167,2470,697,0.779918,0.220082,1.655158,601,96,3169,2471,698,0.779741,0.220259,1.653304,602,96,1, merged,1,1,0
47747,1000132,1,522,456,66,0.873563,0.126437,0.873563,53,13,524,457,67,0.872137,0.127863,0.872137,54,13,1, merged,1,1,0
47754,1000014,2,2491,2063,428,0.828181,0.171819,1.669989,398,30,2493,2064,429,0.827918,0.172082,1.671494,399,30,-1, abandoned,1,0,0
47754,1000070,3,1308,1117,191,0.853976,0.146024,2.523965,166,25,1309,1117,192,0.853323,0.146677,2.524817,167,25,1, abandoned,1,1,0
47756,1000014,2,2493,2064,429,0.827918,0.172082,1.722606,399,30,2494,2065,429,0.827987,0.172013,1.722724,399,30,1, merged,0,0,0
47756,1000015,1,2146,1920,226,0.894688,0.105312,0.894688,206,20,2147,1921,226,0.894737,0.105263,0.894737,206,20,1, merged,0,0,0
47757,1000091,1,578,454,124,0.785467,0.214533,0.785467,104,20,579,455,124,0.785838,0.214162,0.785838,104,20,1, merged,0,0,0
47757,1000592,2,719,609,110,0.84701,0.15299,1.632477,68,42,720,610,110,0.847222,0.152778,1.63306,68,42,1, merged,0,0,0
47759,1000004,1,3583,3182,401,0.888083,0.111917,0.888083,314,87,3584,3183,401,0.888114,0.111886,0.888114,314,87,-1, abandoned,0,0,0
47760,1000199,2,436,370,66,0.848624,0.151376,1.63035,59,7,438,372,66,0.849315,0.150685,1.629062,59,7,-1, merged,0,0,0
47770,1000199,2,438,372,66,0.849315,0.150685,1.629062,59,7,439,373,66,0.849658,0.150342,1.629961,59,7,1, merged,0,0,0
47781,1000009,1,1342,1115,227,0.830849,0.169151,0.830849,205,22,1345,1116,229,0.82974,0.17026,0.82974,207,22,1, merged,1,1,0
47781,1000026,2,477,428,49,0.897275,0.102725,1.728124,46,3,478,429,49,0.89749,0.10251,1.727229,46,3,1, merged,0,0,0
47802,1000004,2,3588,3186,402,0.88796,0.11204,1.760687,315,87,3590,3188,402,0.888022,0.111978,1.747671,315,87,-1, merged,0,0,0
47802,1000120,3,1776,1543,233,0.868806,0.131194,2.629493,205,28,1777,1544,233,0.86888,0.13112,2.616552,205,28,1, merged,0,0,0
47815,1000014,1,2494,2065,429,0.827987,0.172013,0.827987,399,30,2496,2065,431,0.827324,0.172676,0.827324,401,30,1, abandoned,1,1,0
47815,1000070,2,1309,1117,192,0.853323,0.146677,1.68131,167,25,1310,1117,193,0.852672,0.147328,1.679995,168,25,1, abandoned,1,1,0
47823,1000015,2,2149,1923,226,0.894835,0.105165,1.764835,206,20,2150,1924,226,0.894884,0.105116,1.765745,206,20,1, merged,0,0,0
47824,1000121,1,2267,1871,396,0.82532,0.17468,0.82532,371,25,2268,1872,396,0.825397,0.174603,0.825397,371,25,1, merged,0,0,0
47825,1000121,2,2268,1872,396,0.825397,0.174603,1.514286,371,25,2269,1873,396,0.825474,0.174526,1.516082,371,25,1, merged,0,0,0
47826,1000003,2,1244,1035,209,0.831994,0.168006,1.612297,185,24,1245,1035,210,0.831325,0.168675,1.609663,185,25,-1, merged,1,1,0
47826,1000109,3,544,467,77,0.858456,0.141544,2.470752,72,5,545,468,77,0.858716,0.141284,2.468378,72,5,1, merged,0,0,0
47828,1000329,2,3169,2471,698,0.779741,0.220259,1.779741,602,96,3170,2472,698,0.779811,0.220189,1.779811,602,96,1, merged,0,0,0
47831,1000003,4,1245,1035,210,0.831325,0.168675,3.416213,185,25,1249,1039,210,0.831865,0.168135,3.416509,185,25,-1, merged,0,0,0
47831,1000004,1,3590,3188,402,0.888022,0.111978,0.888022,315,87,3591,3189,402,0.888053,0.111947,0.888053,315,87,-1, merged,0,0,0
47831,1000009,3,1346,1116,230,0.829123,0.170877,2.584888,208,22,1348,1117,231,0.828635,0.171365,2.584643,209,22,-1, merged,1,0,0
47831,1000012,2,620,538,82,0.867742,0.132258,1.755764,79,3,621,539,82,0.867955,0.132045,1.756008,79,3,-1, merged,0,0,0
47841,1000004,1,3591,3189,402,0.888053,0.111947,0.888053,315,87,3592,3189,403,0.887806,0.112194,0.887806,316,87,1, abandoned,1,1,0
47841,1000329,4,3171,2473,698,0.77988,0.22012,3.423146,602,96,3172,2474,698,0.77995,0.22005,3.425651,602,96,-1, abandoned,0,0,0
47846,1000014,1,2499,2068,431,0.827531,0.172469,0.827531,401,30,2500,2069,431,0.8276,0.1724,0.8276,401,30,1, merged,0,0,0
47846,1000105,2,620,487,133,0.785484,0.214516,1.613015,118,15,621,488,133,0.785829,0.214171,1.613429,118,15,1, merged,0,0,0
47850,1000004,1,3592,3189,403,0.887806,0.112194,0.887806,316,87,3593,3189,404,0.887559,0.112441,0.887559,317,87,1, merged,1,1,0
47851,1000004,2,3593,3189,404,0.887559,0.112441,1.715159,317,87,3594,3190,404,0.88759,0.11241,1.715259,317,87,1, merged,0,0,0
47851,1000014,1,2500,2069,431,0.8276,0.1724,0.8276,401,30,2501,2070,431,0.827669,0.172331,0.827669,401,30,1, merged,0,0,0
47852,1000005,1,637,532,105,0.835165,0.164835,0.835165,97,8,638,533,105,0.835423,0.164577,0.835423,97,8,1, merged,0,0,0
47852,1000130,2,490,404,86,0.82449,0.17551,1.659655,66,20,492,406,86,0.825203,0.174797,1.660626,66,20,1, merged,0,0,0
47854,1000105,2,621,488,133,0.785829,0.214171,1.631624,118,15,622,488,134,0.784566,0.215434,1.626426,119,15,1, abandoned,1,1,0
47854,1000108,1,214,181,33,0.845794,0.154206,0.845794,29,4,215,181,34,0.84186,0.15814,0.84186,30,4,1, abandoned,1,1,0
47857,1000005,3,638,533,105,0.835423,0.164577,2.249457,97,8,639,534,105,0.835681,0.164319,2.243502,97,8,-1, abandoned,0,0,0
47866,1000004,1,3594,3190,404,0.88759,0.11241,0.88759,317,87,3597,3193,404,0.887684,0.112316,0.887684,317,87,-1, merged,0,0,0
47866,1000120,2,1778,1545,233,0.868954,0.131046,1.756544,205,28,1779,1546,233,0.869028,0.130972,1.756712,205,28,1, merged,0,0,0
47870,1000054,2,851,728,123,0.855464,0.144536,1.639185,107,16,852,729,123,0.855634,0.144366,1.639857,107,16,1, merged,0,0,0
47870,1000166,1,430,337,93,0.783721,0.216279,0.783721,88,5,431,338,93,0.784223,0.215777,0.784223,88,5,1, merged,0,0,0
47884,1000014,1,2502,2071,431,0.827738,0.172262,0.827738,401,30,2503,2072,431,0.827807,0.172193,0.827807,401,30,1, merged,0,0,0
47884,1000120,2,1780,1547,233,0.869101,0.130899,1.696839,205,28,1781,1548,233,0.869175,0.130825,1.696981,205,28,1, merged,0,0,0
47900,1000015,1,2151,1925,226,0.894933,0.105067,0.894933,206,20,2152,1926,226,0.894981,0.105019,0.894981,206,20,1, merged,0,0,0
47917,1000004,1,3597,3193,404,0.887684,0.112316,0.887684,317,87,3598,3194,404,0.887715,0.112285,0.887715,317,87,1, merged,0,0,0
47917,1000120,2,1781,1548,233,0.869175,0.130825,1.756859,205,28,1782,1549,233,0.869248,0.130752,1.756963,205,28,1, merged,0,0,0
47925,1000009,2,1353,1122,231,0.829268,0.170732,1.565841,209,22,1354,1123,231,0.829394,0.170606,1.566639,209,22,-1, merged,0,0,0
47925,1000534,1,391,288,103,0.736573,0.263427,0.736573,93,10,392,289,103,0.737245,0.262755,0.737245,93,10,-1, merged,0,0,0
47930,1000026,2,478,429,49,0.89749,0.10251,1.619712,46,3,479,430,49,0.897704,0.102296,1.610032,46,3,1, merged,0,0,0
47933,1000026,1,479,430,49,0.897704,0.102296,0.897704,46,3,480,431,49,0.897917,0.102083,0.897917,46,3,1, merged,0,0,0
47933,1000054,2,853,730,123,0.855803,0.144197,1.753507,107,16,854,731,123,0.855972,0.144028,1.753889,107,16,1, merged,0,0,0
47934,1000054,2,854,731,123,0.855972,0.144028,1.640195,107,16,855,732,123,0.85614,0.14386,1.640863,107,16,1, merged,0,0,0
47934,1000166,1,431,338,93,0.784223,0.215777,0.784223,88,5,432,339,93,0.784722,0.215278,0.784722,88,5,1, merged,0,0,0
47935,1000015,2,2152,1926,226,0.894981,0.105019,1.579764,206,20,2153,1927,226,0.89503,0.10497,1.583202,206,20,1, merged,0,0,0
47937,1000009,1,1354,1123,231,0.829394,0.170606,0.829394,209,22,1355,1123,232,0.828782,0.171218,0.828782,210,22,1, merged,1,1,0
47937,1000534,2,392,289,103,0.737245,0.262755,1.566639,93,10,393,290,103,0.737913,0.262087,1.566696,93,10,1, merged,0,0,0
47970,1000091,1,579,455,124,0.785838,0.214162,0.785838,104,20,580,456,124,0.786207,0.213793,0.786207,104,20,-1, abandoned,0,0,0
47971,1000009,2,1355,1123,232,0.828782,0.171218,1.726699,210,22,1356,1124,232,0.828909,0.171091,1.723099,210,22,1, merged,0,0,0
47971,1000026,1,480,431,49,0.897917,0.102083,0.897917,46,3,482,431,51,0.894191,0.105809,0.894191,48,3,1, merged,1,1,0
47982,1000121,3,2270,1874,396,0.825551,0.174449,2.44969,371,25,2271,1875,396,0.825627,0.174373,2.472402,371,25,-1, abandoned,0,0,0
47988,1000014,2,2505,2074,431,0.827944,0.172056,1.627944,401,30,2507,2075,432,0.827682,0.172318,1.661016,402,30,1, abandoned,1,1,0
47988,1000329,4,3173,2475,698,0.780019,0.219981,3.254737,602,96,3174,2476,698,0.780088,0.219912,3.28991,602,96,-1, abandoned,0,0,0
48002,1000120,3,1783,1550,233,0.869321,0.130679,2.361876,205,28,1784,1551,233,0.869395,0.130605,2.36207,205,28,1, merged,0,0,0
48020,1000130,2,492,406,86,0.825203,0.174797,1.56621,66,20,493,407,86,0.825558,0.174442,1.567185,66,20,1, merged,0,0,0
48027,1000004,1,3601,3197,404,0.887809,0.112191,0.887809,317,87,3605,3199,406,0.887379,0.112621,0.887379,319,87,1, merged,1,1,0
48027,1000329,3,3176,2478,698,0.780227,0.219773,2.423003,602,96,3177,2478,699,0.779981,0.220019,2.422732,603,96,1, merged,1,1,0
48027,1002169,2,604,456,148,0.754967,0.245033,1.642776,121,27,605,457,148,0.755372,0.244628,1.642751,121,27,-1, merged,0,0,0
48029,1000004,2,3607,3200,407,0.887164,0.112836,1.733318,320,87,3609,3200,409,0.886672,0.113328,1.728202,322,87,1, merged,1,1,0
48029,1000329,3,3177,2478,699,0.779981,0.220019,2.513299,603,96,3179,2479,700,0.779805,0.220195,2.508007,604,96,1, merged,1,1,0
48030,1000004,1,3609,3200,409,0.886672,0.113328,0.886672,322,87,3611,3200,411,0.886181,0.113819,0.886181,324,87,1, merged,1,1,0
48031,1000004,1,3611,3200,411,0.886181,0.113819,0.886181,324,87,3615,3203,412,0.88603,0.11397,0.88603,325,87,-1, merged,1,0,0
48031,1000329,2,3179,2479,700,0.779805,0.220195,1.665986,604,96,3181,2479,702,0.779315,0.220685,1.665345,606,96,1, merged,1,1,0
48043,1000140,1,246,202,44,0.821138,0.178862,0.821138,38,6,247,203,44,0.821862,0.178138,0.821862,38,6,1, merged,0,0,0
48047,1000014,2,2510,2077,433,0.82749,0.17251,1.541776,402,31,2512,2079,433,0.827627,0.172373,1.517283,402,31,1, merged,0,0,0
48055,1000009,2,1358,1126,232,0.829161,0.170839,1.723351,210,22,1359,1127,232,0.829286,0.170714,1.723696,210,22,1, merged,0,0,0
48055,1000026,1,482,431,51,0.894191,0.105809,0.894191,48,3,483,432,51,0.89441,0.10559,0.89441,48,3,1, merged,0,0,0
48056,1000015,2,2156,1930,226,0.895176,0.104824,1.68465,206,20,2157,1931,226,0.895225,0.104775,1.690097,206,20,1, merged,0,0,0
48056,1000132,3,527,460,67,0.872865,0.127135,2.557515,54,13,529,460,69,0.869565,0.130435,2.559662,54,15,-1, merged,1,1,0
48065,1000110,2,334,299,35,0.89521,0.10479,1.754033,33,2,338,301,37,0.890533,0.109467,1.744334,35,2,1, merged,1,1,0
48067,1000004,1,3616,3203,413,0.885785,0.114215,0.885785,326,87,3617,3204,413,0.885817,0.114183,0.885817,326,87,1, merged,0,0,0
48068,1000004,1,3617,3204,413,0.885817,0.114183,0.885817,326,87,3618,3204,414,0.885572,0.114428,0.885572,327,87,1, merged,1,1,0
48071,1000009,2,1359,1127,232,0.829286,0.170714,1.725008,210,22,1360,1128,232,0.829412,0.170588,1.725688,210,22,1, merged,0,0,0
48072,1000132,1,529,460,69,0.869565,0.130435,0.869565,54,15,531,460,71,0.86629,0.13371,0.86629,54,17,-1, merged,1,1,0
48077,1000014,3,2512,2079,433,0.827627,0.172373,2.261562,402,31,2513,2080,433,0.827696,0.172304,2.273643,402,31,1, merged,0,0,0
48085,1000108,1,222,188,34,0.846847,0.153153,0.846847,30,4,224,190,34,0.848214,0.151786,0.848214,30,4,-1, merged,0,0,0
48085,1000110,2,340,303,37,0.891176,0.108824,1.738023,35,2,341,303,38,0.888563,0.111437,1.736777,36,2,1, merged,1,1,0
48086,1000110,3,341,303,38,0.888563,0.111437,2.475882,36,2,342,304,38,0.888889,0.111111,2.479898,36,2,1, merged,0,0,0
48086,1000121,1,2273,1877,396,0.825781,0.174219,0.825781,371,25,2274,1878,396,0.825858,0.174142,0.825858,371,25,-1, merged,0,0,0
48087,1000329,2,3181,2479,702,0.779315,0.220685,1.613416,606,96,3183,2479,704,0.778825,0.221175,1.614441,608,96,1, merged,1,1,0
48088,1000004,1,3618,3204,414,0.885572,0.114428,0.885572,327,87,3619,3205,414,0.885604,0.114396,0.885604,327,87,-1, merged,0,0,0
48088,1000329,2,3183,2479,704,0.778825,0.221175,1.664397,608,96,3185,2479,706,0.778336,0.221664,1.66394,610,96,1, merged,1,1,0
48089,1000009,3,1361,1129,232,0.829537,0.170463,2.157229,210,22,1362,1130,232,0.829662,0.170338,2.172087,210,22,-1, abandoned,0,0,0
48094,1000007,2,1530,1230,300,0.803922,0.196078,1.699195,269,31,1531,1231,300,0.80405,0.19595,1.699372,269,31,1, merged,0,0,0
48094,1000015,1,2158,1932,226,0.895273,0.104727,0.895273,206,20,2159,1933,226,0.895322,0.104678,0.895322,206,20,1, merged,0,0,0
48106,1000007,2,1531,1231,300,0.80405,0.19595,1.450203,269,31,1533,1233,300,0.804305,0.195695,1.446096,269,31,-1, merged,0,0,0
48113,1000007,1,1536,1235,301,0.804036,0.195964,0.804036,270,31,1541,1238,303,0.803374,0.196626,0.803374,272,31,-1, merged,1,0,0
48118,1000091,1,580,456,124,0.786207,0.213793,0.786207,104,20,584,458,126,0.784247,0.215753,0.784247,106,20,-1, merged,1,0,0
48123,1000007,2,1545,1242,303,0.803883,0.196117,1.670174,272,31,1546,1243,303,0.80401,0.19599,1.670552,272,31,1, merged,0,0,0
48123,1000132,1,531,460,71,0.86629,0.13371,0.86629,54,17,532,461,71,0.866541,0.133459,0.866541,54,17,-1, merged,0,0,0
48127,1000329,3,3197,2484,713,0.776978,0.223022,2.222958,617,96,3199,2486,713,0.777118,0.222882,2.219707,617,96,-1, merged,0,0,0
48127,1002169,1,605,457,148,0.755372,0.244628,0.755372,121,27,606,458,148,0.755776,0.244224,0.755776,121,27,-1, merged,0,0,0
48128,1000329,3,3199,2486,713,0.777118,0.222882,2.219707,617,96,3201,2488,713,0.777257,0.222743,2.213184,617,96,-1, merged,0,0,0
48128,1002169,1,606,458,148,0.755776,0.244224,0.755776,121,27,608,460,148,0.756579,0.243421,0.756579,121,27,-1, merged,0,0,0
48133,1000004,2,3620,3206,414,0.885635,0.114365,1.735376,327,87,3621,3207,414,0.885667,0.114333,1.735796,327,87,-1, abandoned,0,0,0
48145,1000004,2,3621,3207,414,0.885667,0.114333,1.642246,327,87,3624,3208,416,0.88521,0.11479,1.642587,329,87,-1, merged,1,0,0
48145,1000329,3,3202,2489,713,0.777327,0.222673,2.419573,617,96,3203,2490,713,0.777396,0.222604,2.419983,617,96,-1, merged,0,0,0
48145,1002169,1,608,460,148,0.756579,0.243421,0.756579,121,27,610,462,148,0.757377,0.242623,0.757377,121,27,-1, merged,0,0,0
48152,1000014,3,2515,2082,433,0.827833,0.172167,2.511296,402,31,2525,2091,434,0.828119,0.171881,2.488542,403,31,-1, merged,1,0,0
48152,1000120,5,1788,1555,233,0.869687,0.130313,3.380982,205,28,1789,1555,234,0.869201,0.130799,4.02441,206,28,1, merged,1,1,0
48164,1000014,2,2525,2091,434,0.828119,0.171881,1.637643,403,31,2528,2093,435,0.827927,0.172073,1.646109,403,32,-1, merged,1,1,0
48171,1000007,1,1546,1243,303,0.80401,0.19599,0.80401,272,31,1547,1244,303,0.804137,0.195863,0.804137,272,31,1, merged,0,0,0
48172,1000004,1,3625,3209,416,0.885241,0.114759,0.885241,329,87,3626,3210,416,0.885273,0.114727,0.885273,329,87,1, merged,0,0,0
48173,1000004,1,3626,3210,416,0.885273,0.114727,0.885273,329,87,3627,3211,416,0.885305,0.114695,0.885305,329,87,-1, abandoned,0,0,0
48173,1000329,2,3206,2493,713,0.777604,0.222396,1.662878,617,96,3207,2494,713,0.777674,0.222326,1.662978,617,96,-1, abandoned,0,0,0
48175,1000070,3,1310,1117,193,0.852672,0.147328,2.504837,168,25,1311,1118,193,0.852784,0.147216,2.50271,168,25,1, merged,0,0,0
48175,1000105,1,629,494,135,0.785374,0.214626,0.785374,120,15,631,494,137,0.782884,0.217116,0.782884,120,17,-1, merged,1,1,0
48175,1000132,2,533,462,71,0.866792,0.133208,1.652165,54,17,534,463,71,0.867041,0.132959,1.649926,54,17,1, merged,0,0,0
48178,1000015,2,2160,1934,226,0.89537,0.10463,1.740198,206,20,2161,1935,226,0.895419,0.104581,1.733026,206,20,1, merged,0,0,0
48184,1000014,2,2528,2093,435,0.827927,0.172073,1.612241,403,32,2529,2094,435,0.827995,0.172005,1.616457,403,32,1, merged,0,0,0
48185,1000004,4,3627,3211,416,0.885305,0.114695,3.34886,329,87,3629,3213,416,0.885368,0.114632,3.349343,329,87,-1, abandoned,0,0,0
48185,1000015,1,2161,1935,226,0.895419,0.104581,0.895419,206,20,2162,1936,226,0.895467,0.104533,0.895467,206,20,-1, abandoned,0,0,0
48185,1000329,3,3207,2494,713,0.777674,0.222326,2.463555,617,96,3208,2495,713,0.777743,0.222257,2.463975,617,96,-1, abandoned,0,0,0
48191,1000140,1,247,203,44,0.821862,0.178138,0.821862,38,6,248,204,44,0.822581,0.177419,0.822581,38,6,1, merged,0,0,0
48193,1000007,1,1548,1245,303,0.804264,0.195736,0.804264,272,31,1549,1246,303,0.80439,0.19561,0.80439,272,31,1, merged,0,0,0
48193,1000009,2,1374,1139,235,0.828967,0.171033,1.63323,213,22,1375,1140,235,0.829091,0.170909,1.633481,213,22,1, merged,0,0,0
48198,1000121,3,2274,1878,396,0.825858,0.174142,2.282948,371,25,2275,1879,396,0.825934,0.174066,2.284828,371,25,1, merged,0,0,0
48198,1000329,1,3208,2495,713,0.777743,0.222257,0.777743,617,96,3209,2496,713,0.777812,0.222188,0.777812,617,96,1, merged,0,0,0
48202,1000132,2,536,465,71,0.867537,0.132463,1.741193,54,17,537,466,71,0.867784,0.132216,1.741779,54,17,1, merged,0,0,0
48203,1000132,2,537,466,71,0.867784,0.132216,1.741779,54,17,538,467,71,0.86803,0.13197,1.742361,54,17,1, merged,0,0,0
48209,1000004,2,3629,3213,416,0.885368,0.114632,1.637999,329,87,3630,3214,416,0.885399,0.114601,1.638464,329,87,-1, abandoned,0,0,0
48215,1000108,2,224,190,34,0.848214,0.151786,1.742365,30,4,225,191,34,0.848889,0.151111,1.740556,30,4,1, merged,0,0,0
48215,1000110,1,359,321,38,0.89415,0.10585,0.89415,36,2,360,321,39,0.891667,0.108333,0.891667,36,3,-1, merged,1,1,0
48217,1000054,2,858,735,123,0.856643,0.143357,1.641366,107,16,859,736,123,0.85681,0.14319,1.64203,107,16,1, merged,0,0,0
48217,1000166,1,432,339,93,0.784722,0.215278,0.784722,88,5,433,340,93,0.785219,0.214781,0.785219,88,5,1, merged,0,0,0
48219,1000004,2,3630,3214,416,0.885399,0.114601,1.745144,329,87,3632,3215,417,0.885187,0.114813,1.743883,330,87,-1, merged,1,0,0
48219,1000109,1,549,472,77,0.859745,0.140255,0.859745,72,5,552,474,78,0.858696,0.141304,0.858696,73,5,-1, merged,1,0,0
48220,1000005,2,645,539,106,0.835659,0.164341,1.635659,98,8,646,540,106,0.835913,0.164087,1.669247,98,8,1, merged,0,0,0
48226,1000534,1,394,291,103,0.738579,0.261421,0.738579,93,10,396,292,104,0.737374,0.262626,0.737374,94,10,1, merged,1,1,0
48227,1000091,2,584,458,126,0.784247,0.215753,1.527045,106,20,585,459,126,0.784615,0.215385,1.52665,106,20,1, merged,0,0,0
48227,1000328,1,972,722,250,0.742798,0.257202,0.742798,225,25,973,722,251,0.742035,0.257965,0.742035,226,25,1, merged,1,1,0
48229,1000003,2,1251,1041,210,0.832134,0.167866,1.611583,185,25,1255,1043,212,0.831076,0.168924,1.611624,187,25,-1, merged,1,0,0
48229,1000109,3,552,474,78,0.858696,0.141304,2.470279,73,5,553,475,78,0.858951,0.141049,2.470576,73,5,1, merged,0,0,0
48230,1000091,2,585,459,126,0.784615,0.215385,1.541992,106,20,590,464,126,0.786441,0.213559,1.549641,106,20,-1, merged,0,0,0
48230,1002169,1,610,462,148,0.757377,0.242623,0.757377,121,27,625,477,148,0.7632,0.2368,0.7632,121,27,-1, merged,0,0,0
48231,1000009,4,1375,1140,235,0.829091,0.170909,2.9429,213,22,1379,1143,236,0.828861,0.171139,2.896677,214,22,-1, merged,1,0,0
48232,1000329,1,3209,2496,713,0.777812,0.222188,0.777812,617,96,3210,2496,714,0.77757,0.22243,0.77757,617,97,-1, merged,1,1,0
48236,1000004,2,3633,3216,417,0.885219,0.114781,1.75398,330,87,3635,3218,417,0.885282,0.114718,1.752685,330,87,-1, merged,0,0,0
48236,1000132,1,541,470,71,0.868762,0.131238,0.868762,54,17,543,471,72,0.867403,0.132597,0.867403,55,17,1, merged,1,1,0
48250,1000014,1,2537,2102,435,0.828538,0.171462,0.828538,403,32,2538,2102,436,0.828211,0.171789,0.828211,404,32,1, merged,1,1,0
48253,1000007,2,1551,1247,304,0.803997,0.196003,1.671644,273,31,1552,1248,304,0.804124,0.195876,1.672014,273,31,1, merged,0,0,0
48253,1000132,1,544,472,72,0.867647,0.132353,0.867647,55,17,545,473,72,0.86789,0.13211,0.86789,55,17,1, merged,0,0,0
48272,1000120,4,1792,1558,234,0.86942,0.13058,3.305932,206,28,1794,1559,235,0.869008,0.130992,3.268137,207,28,1, merged,1,1,0
48272,1000329,1,3210,2496,714,0.77757,0.22243,0.77757,617,97,3211,2497,714,0.777639,0.222361,0.777639,617,97,-1, merged,0,0,0
48273,1000009,2,1379,1143,236,0.828861,0.171139,1.69808,214,22,1380,1143,237,0.828261,0.171739,1.694716,215,22,1, merged,1,1,0
48273,1000012,1,627,545,82,0.869219,0.130781,0.869219,79,3,629,545,84,0.866455,0.133545,0.866455,81,3,1, merged,1,1,0
48276,1000110,2,366,327,39,0.893443,0.106557,1.697364,36,3,367,328,39,0.893733,0.106267,1.682195,36,3,1, merged,0,0,0
48281,1000004,1,3637,3220,417,0.885345,0.114655,0.885345,330,87,3639,3222,417,0.885408,0.114592,0.885408,330,87,-1, merged,0,0,0
48281,1000009,2,1380,1143,237,0.828261,0.171739,1.713606,215,22,1381,1144,237,0.828385,0.171615,1.713793,215,22,1, merged,0,0,0
48282,1000108,1,228,194,34,0.850877,0.149123,0.850877,30,4,229,195,34,0.851528,0.148472,0.851528,30,4,-1, merged,0,0,0
48282,1000110,2,367,328,39,0.893733,0.106267,1.74461,36,3,369,330,39,0.894309,0.105691,1.745837,36,3,-1, merged,0,0,0
48283,1000009,3,1381,1144,237,0.828385,0.171615,2.460169,215,22,1384,1146,238,0.828035,0.171965,2.458853,216,22,1, merged,1,1,0
48283,1000026,2,483,432,51,0.89441,0.10559,1.631784,48,3,485,433,52,0.892784,0.107216,1.630819,49,3,1, merged,1,1,0
48283,1000534,1,396,292,104,0.737374,0.262626,0.737374,94,10,397,293,104,0.738035,0.261965,0.738035,94,10,-1, merged,0,0,0
48290,1000009,4,1384,1146,238,0.828035,0.171965,3.06309,216,22,1385,1147,238,0.828159,0.171841,3.016755,216,22,1, merged,0,0,0
48292,1000004,2,3639,3222,417,0.885408,0.114592,1.566489,330,87,3641,3224,417,0.885471,0.114529,1.559268,330,87,-1, merged,0,0,0
48293,1000121,2,2276,1880,396,0.826011,0.173989,1.499807,371,25,2277,1881,396,0.826087,0.173913,1.505034,371,25,1, merged,0,0,0
48299,1000015,1,2164,1938,226,0.895564,0.104436,0.895564,206,20,2165,1938,227,0.89515,0.10485,0.89515,207,20,1, abandoned,1,1,0
48302,1000140,1,251,207,44,0.824701,0.175299,0.824701,38,6,252,207,45,0.821429,0.178571,0.821429,39,6,1, abandoned,1,1,0
48303,1000015,2,2165,1938,227,0.89515,0.10485,1.633185,207,20,2166,1939,227,0.895199,0.104801,1.633892,207,20,1, merged,0,0,0
48303,1000534,1,397,293,104,0.738035,0.261965,0.738035,94,10,398,294,104,0.738693,0.261307,0.738693,94,10,1, merged,0,0,0
48307,1000004,1,3641,3224,417,0.885471,0.114529,0.885471,330,87,3642,3224,418,0.885228,0.114772,0.885228,331,87,1, merged,1,1,0
48307,1000014,2,2541,2103,438,0.827627,0.172373,1.713098,406,32,2542,2104,438,0.827695,0.172305,1.712923,406,32,1, merged,0,0,0
48316,1000009,2,1385,1147,238,0.828159,0.171841,1.74842,216,22,1387,1149,238,0.828407,0.171593,1.747467,216,22,-1, merged,0,0,0
48316,1000011,1,765,704,61,0.920261,0.079739,0.920261,56,5,766,704,62,0.91906,0.08094,0.91906,57,5,1, merged,1,1,0
48317,1000054,2,859,736,123,0.85681,0.14319,1.704912,107,16,860,737,123,0.856977,0.143023,1.706033,107,16,1, merged,0,0,0
48321,1000011,1,766,704,62,0.91906,0.08094,0.91906,57,5,767,705,62,0.919166,0.080834,0.919166,57,5,1, merged,0,0,0
48321,1000026,2,485,433,52,0.892784,0.107216,1.811844,49,3,486,434,52,0.893004,0.106996,1.81217,49,3,1, merged,0,0,0
48324,1000004,2,3642,3224,418,0.885228,0.114772,1.712733,331,87,3643,3225,418,0.885259,0.114741,1.712507,331,87,1, merged,0,0,0
48324,1000014,1,2545,2106,439,0.827505,0.172495,0.827505,407,32,2547,2107,440,0.827248,0.172752,0.827248,408,32,1, merged,1,1,0
48325,1000004,2,3643,3225,418,0.885259,0.114741,1.712507,331,87,3646,3227,419,0.88508,0.11492,1.712071,332,87,1, merged,1,1,0
48325,1000014,1,2547,2107,440,0.827248,0.172752,0.827248,408,32,2549,2108,441,0.826991,0.173009,0.826991,409,32,1, merged,1,1,0
48326,1000003,1,1258,1046,212,0.831479,0.168521,0.831479,187,25,1259,1047,212,0.831612,0.168388,0.831612,187,25,1, merged,0,0,0
48326,1000109,2,553,475,78,0.858951,0.141049,1.69043,73,5,554,476,78,0.859206,0.140794,1.690818,73,5,1, merged,0,0,0
48328,1000121,3,2277,1881,396,0.826087,0.173913,2.484342,371,25,2278,1882,396,0.826163,0.173837,2.487459,371,25,1, merged,0,0,0
48328,1000132,1,546,474,72,0.868132,0.131868,0.868132,55,17,548,476,72,0.868613,0.131387,0.868613,55,17,-1, merged,0,0,0
48333,1000132,1,548,476,72,0.868613,0.131387,0.868613,55,17,550,476,74,0.865455,0.134545,0.865455,57,17,1, merged,1,1,0
48334,1000004,4,3646,3227,419,0.88508,0.11492,3.167501,332,87,3650,3231,419,0.885205,0.114795,3.170965,332,87,-1, merged,0,0,0
48334,1000121,5,2278,1882,396,0.826163,0.173837,3.993665,371,25,2281,1883,398,0.825515,0.174485,3.99648,373,25,-1, merged,1,0,0
48334,1000329,9,3211,2497,714,0.777639,0.222361,7.180547,617,97,3214,2499,715,0.777536,0.222464,7.172633,618,97,-1, merged,1,0,0
48334,1002169,3,625,477,148,0.7632,0.2368,2.282422,121,27,628,480,148,0.764331,0.235669,2.28576,121,27,-1, merged,0,0,0
48337,1000004,1,3650,3231,419,0.885205,0.114795,0.885205,332,87,3651,3232,419,0.885237,0.114763,0.885237,332,87,1, merged,0,0,0
48337,1000105,2,632,495,137,0.783228,0.216772,1.668433,120,17,633,496,137,0.78357,0.21643,1.668807,120,17,1, merged,0,0,0
48350,1000003,2,1259,1047,212,0.831612,0.168388,1.690818,187,25,1261,1049,212,0.831879,0.168121,1.689537,187,25,-1, merged,0,0,0
48350,1000109,1,554,476,78,0.859206,0.140794,0.859206,73,5,555,476,79,0.857658,0.142342,0.857658,74,5,1, merged,1,1,0
48354,1000109,1,555,476,79,0.857658,0.142342,0.857658,74,5,556,476,80,0.856115,0.143885,0.856115,75,5,1, abandoned,1,1,0
48357,1000009,2,1387,1149,238,0.828407,0.171593,1.495073,216,22,1388,1149,239,0.82781,0.17219,1.484953,217,22,1, abandoned,1,1,0
48357,1000153,4,997,904,93,0.90672,0.09328,3.151793,70,23,998,905,93,0.906814,0.093186,3.136733,70,23,-1, abandoned,0,0,0
48358,1000109,2,556,476,80,0.856115,0.143885,1.705773,75,5,557,477,80,0.856373,0.143627,1.706373,75,5,1, merged,0,0,0
48358,1000199,1,439,373,66,0.849658,0.150342,0.849658,59,7,440,374,66,0.85,0.15,0.85,59,7,-1, merged,0,0,0
48366,1000003,2,1262,1050,212,0.832013,0.167987,1.727211,187,25,1263,1051,212,0.832146,0.167854,1.72698,187,25,-1, merged,0,0,0
48366,1000015,1,2166,1939,227,0.895199,0.104801,0.895199,207,20,2168,1940,228,0.894834,0.105166,0.894834,208,20,1, merged,1,1,0
48370,1000003,1,1263,1051,212,0.832146,0.167854,0.832146,187,25,1264,1052,212,0.832278,0.167722,0.832278,187,25,-1, merged,0,0,0
48370,1000121,2,2281,1883,398,0.825515,0.174485,1.657661,373,25,2282,1884,398,0.825592,0.174408,1.65787,373,25,1, merged,0,0,0
48371,1000026,3,487,435,52,0.893224,0.106776,2.524318,49,3,488,436,52,0.893443,0.106557,2.521904,49,3,1, merged,0,0,0
48371,1000199,1,440,374,66,0.85,0.15,0.85,59,7,443,376,67,0.848758,0.151242,0.848758,60,7,-1, merged,1,0,0
48372,1000026,3,488,436,52,0.893443,0.106557,2.521904,49,3,489,437,52,0.893661,0.106339,2.519177,49,3,1, merged,0,0,0
48372,1000199,1,443,376,67,0.848758,0.151242,0.848758,60,7,445,377,68,0.847191,0.152809,0.847191,61,7,1, merged,1,1,0
48378,1000120,2,1795,1560,235,0.869081,0.130919,1.58049,207,28,1796,1561,235,0.869154,0.130846,1.581528,207,28,1, merged,0,0,0
48379,1000004,3,3652,3233,419,0.885268,0.114732,2.564643,332,87,3656,3237,419,0.885394,0.114606,2.552741,332,87,-1, merged,0,0,0
48379,1000026,2,489,437,52,0.893661,0.106339,1.679375,49,3,490,437,53,0.891837,0.108163,1.667347,50,3,1, merged,1,1,0
48379,1000166,1,434,341,93,0.785714,0.214286,0.785714,88,5,441,342,99,0.77551,0.22449,0.77551,94,5,1, merged,1,1,0
48379,1002169,5,628,480,148,0.764331,0.235669,4.021282,121,27,632,484,148,0.765823,0.234177,3.961421,121,27,-1, merged,0,0,0
48381,1000130,2,493,407,86,0.825558,0.174442,1.604129,66,20,494,408,86,0.825911,0.174089,1.606053,66,20,1, merged,0,0,0
48386,1000329,2,3214,2499,715,0.777536,0.222464,1.685228,618,97,3216,2501,715,0.777674,0.222326,1.679189,618,97,-1, merged,0,0,0
48388,1000004,2,3656,3237,419,0.885394,0.114606,1.750848,332,87,3658,3239,419,0.885457,0.114543,1.74934,332,87,-1, merged,0,0,0
48388,1000132,1,550,476,74,0.865455,0.134545,0.865455,57,17,551,476,75,0.863884,0.136116,0.863884,58,17,1, merged,1,1,0
48389,1000592,2,721,610,111,0.846047,0.153953,1.625117,69,42,722,611,111,0.84626,0.15374,1.62787,69,42,1, merged,0,0,0
48392,1000004,2,3658,3239,419,0.885457,0.114543,1.74934,332,87,3660,3241,419,0.885519,0.114481,1.747838,332,87,-1, merged,0,0,0
48392,1000132,1,551,476,75,0.863884,0.136116,0.863884,58,17,552,476,76,0.862319,0.137681,0.862319,59,17,1, merged,1,1,0
48396,1000004,2,3660,3241,419,0.885519,0.114481,1.747838,332,87,3661,3242,419,0.88555,0.11445,1.748118,332,87,1, merged,0,0,0
48396,1000132,1,552,476,76,0.862319,0.137681,0.862319,59,17,553,477,76,0.862568,0.137432,0.862568,59,17,1, merged,0,0,0
48403,1000026,2,490,437,53,0.891837,0.108163,1.837783,50,3,491,438,53,0.892057,0.107943,1.838724,50,3,1, merged,0,0,0
48404,1000110,2,371,332,39,0.894879,0.105121,1.716307,36,3,372,333,39,0.895161,0.104839,1.717296,36,3,1, merged,0,0,0
48404,1000140,1,252,207,45,0.821429,0.178571,0.821429,39,6,253,208,45,0.822134,0.177866,0.822134,39,6,1, merged,0,0,0
48405,1000110,2,372,333,39,0.895161,0.104839,1.717296,36,3,373,334,39,0.895442,0.104558,1.718277,36,3,1, merged,0,0,0
48405,1000140,1,253,208,45,0.822134,0.177866,0.822134,39,6,254,209,45,0.822835,0.177165,0.822835,39,6,1, merged,0,0,0
48408,1000003,3,1265,1053,212,0.832411,0.167589,2.457927,187,25,1266,1054,212,0.832543,0.167457,2.459288,187,25,-1, abandoned,0,0,0
48408,1000199,1,445,377,68,0.847191,0.152809,0.847191,61,7,447,379,68,0.847875,0.152125,0.847875,61,7,-1, abandoned,0,0,0
48409,1000004,2,3661,3242,419,0.88555,0.11445,1.756603,332,87,3662,3243,419,0.885582,0.114418,1.757309,332,87,1, merged,0,0,0
48410,1000132,2,553,477,76,0.862568,0.137432,1.734296,59,17,554,478,76,0.862816,0.137184,1.732268,59,17,1, merged,0,0,0
48411,1000105,1,634,497,137,0.783912,0.216088,0.783912,120,17,636,498,138,0.783019,0.216981,0.783019,121,17,1, merged,1,1,0
48414,1000199,1,447,379,68,0.847875,0.152125,0.847875,61,7,449,381,68,0.848552,0.151448,0.848552,61,7,-1, merged,0,0,0
48417,1000132,1,554,478,76,0.862816,0.137184,0.862816,59,17,555,478,77,0.861261,0.138739,0.861261,60,17,1, abandoned,1,1,0
48423,1000009,3,1389,1150,239,0.827934,0.172066,2.34653,217,22,1390,1151,239,0.828058,0.171942,2.332491,217,22,-1, abandoned,0,0,0
48425,1000110,3,374,335,39,0.895722,0.104278,2.574574,36,3,376,336,40,0.893617,0.106383,2.572932,37,3,1, merged,1,1,0
48425,1000130,2,494,408,86,0.825911,0.174089,1.678852,66,20,495,408,87,0.824242,0.175758,1.679315,67,20,1, merged,1,1,0
48426,1000004,3,3662,3243,419,0.885582,0.114418,2.499727,332,87,3663,3243,420,0.88534,0.11466,2.497901,333,87,1, merged,1,1,0
48426,1000014,2,2560,2118,442,0.827344,0.172656,1.614146,410,32,2562,2119,443,0.827088,0.172912,1.612561,411,32,1, merged,1,1,0
48426,1000091,1,591,465,126,0.786802,0.213198,0.786802,106,20,592,465,127,0.785473,0.214527,0.785473,107,20,1, merged,1,1,0
48428,1000026,2,491,438,53,0.892057,0.107943,1.67753,50,3,492,438,54,0.890244,0.109756,1.671757,51,3,1, merged,1,1,0
48428,1000091,1,592,465,127,0.785473,0.214527,0.785473,107,20,595,465,130,0.781513,0.218487,0.781513,110,20,1, merged,1,1,0
48428,1000328,4,974,723,251,0.7423,0.2577,3.197642,226,25,976,724,252,0.741803,0.258197,3.190958,227,25,1, merged,1,1,0
48428,1000329,3,3218,2503,715,0.777812,0.222188,2.455342,618,97,3221,2504,717,0.777398,0.222602,2.449155,620,97,1, merged,1,1,0
48429,1000054,3,860,737,123,0.856977,0.143023,2.447042,107,16,861,738,123,0.857143,0.142857,2.448669,107,16,1, merged,0,0,0
48429,1000130,2,495,408,87,0.824242,0.175758,1.590065,67,20,496,409,87,0.824597,0.175403,1.591526,67,20,-1, merged,0,0,0
48429,1002169,1,632,484,148,0.765823,0.234177,0.765823,121,27,635,487,148,0.766929,0.233071,0.766929,121,27,-1, merged,0,0,0
48431,1000003,2,1266,1054,212,0.832543,0.167457,1.717883,187,25,1267,1055,212,0.832676,0.167324,1.718047,187,25,-1, abandoned,0,0,0
48431,1000004,1,3663,3243,420,0.88534,0.11466,0.88534,333,87,3664,3244,420,0.885371,0.114629,0.885371,333,87,-1, abandoned,0,0,0
48435,1000110,2,377,337,40,0.893899,0.106101,1.7477,37,3,378,338,40,0.89418,0.10582,1.748831,37,3,1, merged,0,0,0
48442,1000132,2,555,478,77,0.861261,0.138739,1.731053,60,17,556,479,77,0.861511,0.138489,1.729728,60,17,1, merged,0,0,0
48447,1000009,2,1391,1152,239,0.828181,0.171819,1.469972,217,22,1392,1153,239,0.828305,0.171695,1.475363,217,22,1, merged,0,0,0
48451,1000054,1,861,738,123,0.857143,0.142857,0.857143,107,16,862,739,123,0.857309,0.142691,0.857309,107,16,1, merged,0,0,0
48451,1000166,3,442,343,99,0.776018,0.223982,2.327039,94,5,443,344,99,0.776524,0.223476,2.333832,94,5,1, merged,0,0,0
48453,1000004,2,3664,3244,420,0.885371,0.114629,1.6523,333,87,3667,3247,420,0.885465,0.114535,1.652761,333,87,-1, merged,0,0,0
48453,1002169,1,635,487,148,0.766929,0.233071,0.766929,121,27,636,488,148,0.767296,0.232704,0.767296,121,27,-1, merged,0,0,0
48454,1000007,1,1552,1248,304,0.804124,0.195876,0.804124,273,31,1556,1250,306,0.803342,0.196658,0.803342,275,31,-1, merged,1,0,0
48454,1000026,2,492,438,54,0.890244,0.109756,1.694368,51,3,494,440,54,0.890688,0.109312,1.69403,51,3,-1, merged,0,0,0
48466,1000110,1,387,347,40,0.896641,0.103359,0.896641,37,3,389,348,41,0.894602,0.105398,0.894602,38,3,1, merged,1,1,0
48466,1000140,2,255,209,46,0.819608,0.180392,1.716249,40,6,257,210,47,0.817121,0.182879,1.711722,41,6,1, merged,1,1,0
48474,1000004,2,3667,3247,420,0.885465,0.114535,1.780067,333,87,3668,3248,420,0.885496,0.114504,1.780368,333,87,1, merged,0,0,0
48474,1000110,1,389,348,41,0.894602,0.105398,0.894602,38,3,390,349,41,0.894872,0.105128,0.894872,38,3,1, merged,0,0,0
48474,1000132,3,556,479,77,0.861511,0.138489,2.641577,60,17,557,480,77,0.861759,0.138241,2.642127,60,17,1, merged,0,0,0
48476,1000004,2,3668,3248,420,0.885496,0.114504,1.765974,333,87,3669,3249,420,0.885527,0.114473,1.76648,333,87,1, merged,0,0,0
48478,1000108,2,235,201,34,0.855319,0.144681,1.750191,30,4,237,202,35,0.852321,0.147679,1.745178,31,4,1, merged,1,1,0
48478,1000110,1,390,349,41,0.894872,0.105128,0.894872,38,3,392,350,42,0.892857,0.107143,0.892857,39,3,1, merged,1,1,0
48482,1000003,2,1273,1060,213,0.832679,0.167321,1.681231,188,25,1274,1061,213,0.83281,0.16719,1.682368,188,25,-1, merged,0,0,0
48482,1000199,1,449,381,68,0.848552,0.151448,0.848552,61,7,452,384,68,0.849558,0.150442,0.849558,61,7,-1, merged,0,0,0
48485,1000009,2,1393,1154,239,0.828428,0.171572,1.719116,217,22,1395,1155,240,0.827957,0.172043,1.717293,218,22,1, merged,1,1,0
48485,1000026,1,494,440,54,0.890688,0.109312,0.890688,51,3,497,442,55,0.889336,0.110664,0.889336,52,3,-1, merged,1,0,0
48489,1000043,2,593,496,97,0.836425,0.163575,1.641735,83,14,594,497,97,0.8367,0.1633,1.643718,83,14,1, merged,0,0,0
48492,1000004,2,3669,3249,420,0.885527,0.114473,1.804798,333,87,3670,3250,420,0.885559,0.114441,1.804934,333,87,1, merged,0,0,0
48492,1000011,1,768,706,62,0.919271,0.080729,0.919271,57,5,769,707,62,0.919376,0.080624,0.919376,57,5,1, merged,0,0,0
48496,1000070,2,1317,1124,193,0.853455,0.146545,1.606498,168,25,1318,1125,193,0.853566,0.146434,1.607465,168,25,1, merged,0,0,0
48510,1000009,2,1397,1157,240,0.828203,0.171797,1.590915,218,22,1398,1158,240,0.828326,0.171674,1.582425,218,22,-1, abandoned,0,0,0
48513,1000120,1,1797,1562,235,0.869226,0.130774,0.869226,207,28,1798,1563,235,0.869299,0.130701,0.869299,207,28,1, merged,0,0,0
48513,1000534,2,401,297,104,0.740648,0.259352,1.609875,94,10,402,298,104,0.741294,0.258706,1.610593,94,10,1, merged,0,0,0
48514,1000108,2,239,204,35,0.853556,0.146444,1.668941,31,4,240,205,35,0.854167,0.145833,1.670259,31,4,1, merged,0,0,0
48514,1000140,1,260,212,48,0.815385,0.184615,0.815385,42,6,261,213,48,0.816092,0.183908,0.816092,42,6,1, merged,0,0,0
48533,1000009,2,1398,1158,240,0.828326,0.171674,1.422076,218,22,1399,1159,240,0.828449,0.171551,1.416684,218,22,1, merged,0,0,0
48534,1000108,1,240,205,35,0.854167,0.145833,0.854167,31,4,241,206,35,0.854772,0.145228,0.854772,31,4,-1, merged,0,0,0
48534,1000140,2,261,213,48,0.816092,0.183908,1.670259,42,6,263,214,49,0.813688,0.186312,1.66846,43,6,1, merged,1,1,0
48537,1000007,1,1556,1250,306,0.803342,0.196658,0.803342,275,31,1558,1251,307,0.802953,0.197047,0.802953,276,31,1, merged,1,1,0
48540,1000121,3,2282,1884,398,0.825592,0.174408,2.361292,373,25,2283,1885,398,0.825668,0.174332,2.350817,373,25,1, merged,0,0,0
48541,1000005,2,657,550,107,0.837139,0.162861,1.591038,99,8,658,551,107,0.837386,0.162614,1.591711,99,8,1, merged,0,0,0
48543,1000043,1,594,497,97,0.8367,0.1633,0.8367,83,14,595,498,97,0.836975,0.163025,0.836975,83,14,1, merged,0,0,0
48546,1000004,3,3670,3250,420,0.885559,0.114441,2.649241,333,87,3671,3251,420,0.88559,0.11441,2.630361,333,87,-1, abandoned,0,0,0
48556,1000004,3,3671,3251,420,0.88559,0.11441,2.651215,333,87,3672,3252,420,0.885621,0.114379,2.65317,333,87,1, merged,0,0,0
48557,1000004,3,3672,3252,420,0.885621,0.114379,2.65317,333,87,3674,3253,421,0.885411,0.114589,2.655612,333,88,-1, merged,1,1,0
48571,1000153,2,998,905,93,0.906814,0.093186,1.650235,70,23,999,906,93,0.906907,0.093093,1.645469,70,23,-1, abandoned,0,0,0
48575,1000110,2,398,356,42,0.894472,0.105528,1.751615,39,3,400,357,43,0.8925,0.1075,1.751257,40,3,1, merged,1,1,0
48578,1000329,2,3223,2506,717,0.777536,0.222464,1.459828,620,97,3224,2507,717,0.777605,0.222395,1.461543,620,97,1, merged,0,0,0
48584,1000132,1,558,481,77,0.862007,0.137993,0.862007,60,17,559,482,77,0.862254,0.137746,0.862254,60,17,-1, merged,0,0,0
48586,1000054,2,862,739,123,0.857309,0.142691,1.557309,107,16,863,740,123,0.857474,0.142526,1.563356,107,16,1, merged,0,0,0
48597,1000004,1,3677,3256,421,0.885504,0.114496,0.885504,333,88,3678,3257,421,0.885536,0.114464,0.885536,333,88,-1, merged,0,0,0
48597,1000130,2,497,410,87,0.82495,0.17505,1.710454,67,20,499,412,87,0.825651,0.174349,1.711187,67,20,-1, merged,0,0,0
48598,1000110,1,400,357,43,0.8925,0.1075,0.8925,40,3,401,357,44,0.890274,0.109726,0.890274,41,3,1, merged,1,1,0
48600,1000110,3,401,357,44,0.890274,0.109726,2.535025,41,3,402,358,44,0.890547,0.109453,2.5375,41,3,1, merged,0,0,0
48600,1000140,2,264,215,49,0.814394,0.185606,1.644751,43,6,265,216,49,0.815094,0.184906,1.646953,43,6,1, merged,0,0,0
48604,1000004,1,3678,3257,421,0.885536,0.114464,0.885536,333,88,3680,3259,421,0.885598,0.114402,0.885598,333,88,-1, merged,0,0,0
48608,1000130,2,499,412,87,0.825651,0.174349,1.671594,67,20,500,413,87,0.826,0.174,1.672154,67,20,-1, abandoned,0,0,0
48608,1000592,1,727,615,112,0.845942,0.154058,0.845942,69,43,728,616,112,0.846154,0.153846,0.846154,69,43,-1, abandoned,0,0,0
48614,1000109,2,558,478,80,0.856631,0.143369,1.729595,75,5,559,479,80,0.856887,0.143113,1.727017,75,5,-1, abandoned,0,0,0
48616,1000005,2,658,551,107,0.837386,0.162614,1.663054,99,8,659,551,108,0.836115,0.163885,1.661936,100,8,1, merged,1,1,0
48616,1000121,1,2283,1885,398,0.825668,0.174332,0.825668,373,25,2285,1887,398,0.825821,0.174179,0.825821,373,25,-1, merged,0,0,0
48626,1000026,2,504,448,56,0.888889,0.111111,1.638889,53,3,507,451,56,0.889546,0.110454,1.489546,53,3,-1, merged,0,0,0
48626,1000199,3,453,385,68,0.84989,0.15011,2.488779,61,7,454,385,69,0.848018,0.151982,2.337564,62,7,1, merged,1,1,0
48629,1000108,1,242,207,35,0.855372,0.144628,0.855372,31,4,243,208,35,0.855967,0.144033,0.855967,31,4,1, merged,0,0,0
48629,1000110,2,402,358,44,0.890547,0.109453,1.745919,41,3,403,359,44,0.890819,0.109181,1.746786,41,3,1, merged,0,0,0
48631,1000003,2,1278,1062,216,0.830986,0.169014,1.716584,190,26,1279,1063,216,0.831118,0.168882,1.716747,190,26,1, merged,0,0,0
48631,1000004,1,3680,3259,421,0.885598,0.114402,0.885598,333,88,3681,3260,421,0.885629,0.114371,0.885629,333,88,1, merged,0,0,0
48639,1000110,1,403,359,44,0.890819,0.109181,0.890819,41,3,405,360,45,0.888889,0.111111,0.888889,42,3,1, merged,1,1,0
48639,1000327,3,702,553,149,0.787749,0.212251,2.548133,116,33,704,554,150,0.786932,0.213068,2.543168,116,34,-1, merged,1,0,0
48640,1000108,2,243,208,35,0.855967,0.144033,1.547456,31,4,244,208,36,0.852459,0.147541,1.550376,32,4,1, merged,1,1,0
48640,1000140,3,266,217,49,0.815789,0.184211,2.363246,43,6,267,218,49,0.816479,0.183521,2.366855,43,6,1, merged,0,0,0
48641,1000043,2,596,499,97,0.837248,0.162752,1.620947,83,14,597,500,97,0.837521,0.162479,1.621558,83,14,1, merged,0,0,0
48641,1000105,1,638,500,138,0.783699,0.216301,0.783699,121,17,639,501,138,0.784038,0.215962,0.784038,121,17,1, merged,0,0,0
48645,1000108,2,244,208,36,0.852459,0.147541,1.550376,32,4,245,209,36,0.853061,0.146939,1.546939,32,4,1, merged,0,0,0
48651,1000110,1,405,360,45,0.888889,0.111111,0.888889,42,3,407,362,45,0.889435,0.110565,0.889435,42,3,-1, merged,0,0,0
48652,1000105,2,639,501,138,0.784038,0.215962,1.248323,121,17,640,502,138,0.784375,0.215625,1.258059,121,17,1, merged,0,0,0
48654,1000070,1,1321,1128,193,0.853899,0.146101,0.853899,168,25,1322,1129,193,0.854009,0.145991,0.854009,168,25,1, merged,0,0,0
48654,1000105,2,641,503,138,0.784711,0.215289,1.63861,121,17,642,504,138,0.785047,0.214953,1.639056,121,17,1, merged,0,0,0
48655,1000014,3,2568,2125,443,0.827492,0.172508,2.466548,411,32,2569,2126,443,0.827559,0.172441,2.46706,411,32,1, merged,0,0,0
48655,1000070,1,1322,1129,193,0.854009,0.145991,0.854009,168,25,1323,1130,193,0.854119,0.145881,0.854119,168,25,1, merged,0,0,0
48655,1000105,2,642,504,138,0.785047,0.214953,1.639056,121,17,643,505,138,0.785381,0.214619,1.6395,121,17,1, merged,0,0,0
48657,1000070,1,1324,1131,193,0.85423,0.14577,0.85423,168,25,1325,1132,193,0.85434,0.14566,0.85434,168,25,1, merged,0,0,0
48657,1000105,3,643,505,138,0.785381,0.214619,2.393936,121,17,644,506,138,0.785714,0.214286,2.394803,121,17,1, merged,0,0,0
48659,1000105,1,645,506,139,0.784496,0.215504,0.784496,122,17,646,506,140,0.783282,0.216718,0.783282,123,17,1, merged,1,1,0
48659,1000121,3,2285,1887,398,0.825821,0.174179,2.365066,373,25,2286,1888,398,0.825897,0.174103,2.363474,373,25,1, merged,0,0,0
48660,1000070,6,1325,1132,193,0.85434,0.14566,4.668562,168,25,1326,1133,193,0.854449,0.145551,4.656937,168,25,1, merged,0,0,0
48660,1000105,2,646,506,140,0.783282,0.216718,1.537577,123,17,648,507,141,0.782407,0.217593,1.533685,124,17,1, merged,1,1,0
48660,1002169,5,636,488,148,0.767296,0.232704,3.814222,121,27,637,489,148,0.767661,0.232339,3.802487,121,27,-1, merged,0,0,0
48662,1000014,1,2570,2127,443,0.827626,0.172374,0.827626,411,32,2573,2130,443,0.827827,0.172173,0.827827,411,32,-1, merged,0,0,0
48662,1000015,2,2170,1942,228,0.894931,0.105069,1.722557,208,20,2171,1943,228,0.894979,0.105021,1.722807,208,20,-1, merged,0,0,0
48665,1000003,2,1279,1063,216,0.831118,0.168882,1.61214,190,26,1281,1065,216,0.831382,0.168618,1.609695,190,26,-1, merged,0,0,0
48671,1000592,2,728,616,112,0.846154,0.153846,1.635628,69,43,729,617,112,0.846365,0.153635,1.646365,69,43,1, merged,0,0,0
48674,1000108,2,245,209,36,0.853061,0.146939,1.853061,32,4,247,210,37,0.850202,0.149798,1.850202,33,4,-1, merged,1,0,0
48674,1000130,4,500,413,87,0.826,0.174,3.373506,67,20,501,414,87,0.826347,0.173653,3.379252,67,20,1, merged,0,0,0
48676,1000108,2,247,210,37,0.850202,0.149798,1.739637,33,4,248,211,37,0.850806,0.149194,1.740512,33,4,1, merged,0,0,0
48676,1000110,1,407,362,45,0.889435,0.110565,0.889435,42,3,408,363,45,0.889706,0.110294,0.889706,42,3,-1, merged,0,0,0
48676,1000140,3,267,218,49,0.816479,0.183521,2.556117,43,6,268,219,49,0.817164,0.182836,2.557677,43,6,1, merged,0,0,0
48681,1000014,2,2574,2131,443,0.827894,0.172106,1.569962,411,32,2575,2132,443,0.827961,0.172039,1.570292,411,32,1, merged,0,0,0
48681,1000328,1,977,725,252,0.742068,0.257932,0.742068,227,25,978,726,252,0.742331,0.257669,0.742331,227,25,1, merged,0,0,0
48685,1000004,2,3683,3262,421,0.885691,0.114309,1.711588,333,88,3684,3263,421,0.885722,0.114278,1.711334,333,88,1, merged,0,0,0
48685,1000121,1,2286,1888,398,0.825897,0.174103,0.825897,373,25,2288,1889,399,0.825612,0.174388,0.825612,374,25,1, merged,1,1,0
48687,1000004,2,3684,3263,421,0.885722,0.114278,1.713683,333,88,3685,3264,421,0.885753,0.114247,1.713848,333,88,1, merged,0,0,0
48687,1000014,1,2575,2132,443,0.827961,0.172039,0.827961,411,32,2577,2134,443,0.828095,0.171905,0.828095,411,32,-1, merged,0,0,0
48688,1000329,1,3224,2507,717,0.777605,0.222395,0.777605,620,97,3225,2507,718,0.777364,0.222636,0.777364,621,97,1, merged,1,1,0
48698,1000004,1,3686,3265,421,0.885784,0.114216,0.885784,333,88,3690,3269,421,0.885908,0.114092,0.885908,333,88,-1, merged,0,0,0
48698,1000120,2,1800,1565,235,0.869444,0.130556,1.755228,207,28,1802,1567,235,0.869589,0.130411,1.755497,207,28,-1, merged,0,0,0
48703,1000003,1,1283,1067,216,0.831645,0.168355,0.831645,190,26,1285,1068,217,0.831128,0.168872,0.831128,190,27,-1, merged,1,1,0
48703,1000012,2,629,545,84,0.866455,0.133545,1.698099,81,3,630,546,84,0.866667,0.133333,1.697795,81,3,1, merged,0,0,0
48710,1000003,2,1285,1068,217,0.831128,0.168872,1.679146,190,27,1286,1069,217,0.83126,0.16874,1.678087,190,27,-1, abandoned,0,0,0
48710,1000199,1,454,385,69,0.848018,0.151982,0.848018,62,7,457,387,70,0.846827,0.153173,0.846827,63,7,-1, abandoned,1,0,0
48715,1000004,1,3690,3269,421,0.885908,0.114092,0.885908,333,88,3691,3270,421,0.885939,0.114061,0.885939,333,88,1, merged,0,0,0
48715,1000070,3,1326,1133,193,0.854449,0.145551,2.472201,168,25,1327,1134,193,0.854559,0.145441,2.473831,168,25,1, merged,0,0,0
48720,1000015,2,2171,1943,228,0.894979,0.105021,1.784743,208,20,2172,1943,229,0.894567,0.105433,1.779333,209,20,1, merged,1,1,0
48720,1000026,1,508,452,56,0.889764,0.110236,0.889764,53,3,512,453,59,0.884766,0.115234,0.884766,56,3,1, merged,1,1,0
48722,1000009,1,1410,1169,241,0.829078,0.170922,0.829078,219,22,1411,1169,242,0.82849,0.17151,0.82849,220,22,1, abandoned,1,1,0
48729,1000004,1,3692,3271,421,0.88597,0.11403,0.88597,333,88,3693,3272,421,0.886001,0.113999,0.886001,333,88,1, merged,0,0,0
48729,1000007,2,1559,1252,307,0.803079,0.196921,1.689049,276,31,1560,1253,307,0.803205,0.196795,1.689206,276,31,1, merged,0,0,0
48730,1000009,2,1411,1169,242,0.82849,0.17151,1.82849,220,22,1412,1170,242,0.828612,0.171388,1.828612,220,22,1, merged,0,0,0
48768,1000109,2,560,480,80,0.857143,0.142857,1.70397,75,5,561,480,81,0.855615,0.144385,1.70311,76,5,1, merged,1,1,0
48768,1000199,1,457,387,70,0.846827,0.153173,0.846827,63,7,459,389,70,0.847495,0.152505,0.847495,63,7,-1, merged,0,0,0
48771,1000108,1,250,213,37,0.852,0.148,0.852,33,4,252,214,38,0.849206,0.150794,0.849206,34,4,1, merged,1,1,0
48771,1000110,2,409,364,45,0.889976,0.110024,1.741976,42,3,410,365,45,0.890244,0.109756,1.73945,42,3,1, merged,0,0,0
48777,1000132,2,564,487,77,0.863475,0.136525,1.631136,60,17,565,488,77,0.863717,0.136283,1.630174,60,17,1, merged,0,0,0
48777,1002169,1,637,489,148,0.767661,0.232339,0.767661,121,27,638,489,149,0.766458,0.233542,0.766458,121,28,-1, merged,1,1,0
48778,1000153,2,999,906,93,0.906907,0.093093,1.648842,70,23,1000,907,93,0.907,0.093,1.649574,70,23,-1, abandoned,0,0,0
48778,1000534,1,403,299,104,0.741935,0.258065,0.741935,94,10,404,300,104,0.742574,0.257426,0.742574,94,10,-1, abandoned,0,0,0
48779,1000009,1,1412,1170,242,0.828612,0.171388,0.828612,220,22,1413,1171,242,0.828733,0.171267,0.828733,220,22,-1, abandoned,0,0,0
48779,1000153,4,1000,907,93,0.907,0.093,3.13036,70,23,1001,908,93,0.907093,0.092907,3.145703,70,23,-1, abandoned,0,0,0
48779,1000534,2,404,300,104,0.742574,0.257426,1.571186,94,10,405,301,104,0.74321,0.25679,1.571943,94,10,-1, abandoned,0,0,0
48782,1000007,2,1560,1253,307,0.803205,0.196795,1.681158,276,31,1561,1254,307,0.803331,0.196669,1.681763,276,31,1, merged,0,0,0
48785,1000054,1,863,740,123,0.857474,0.142526,0.857474,107,16,865,742,123,0.857803,0.142197,0.857803,107,16,1, merged,0,0,0
48786,1000004,1,3693,3272,421,0.886001,0.113999,0.886001,333,88,3695,3273,422,0.885792,0.114208,0.885792,334,88,-1, abandoned,1,0,0
48786,1000007,4,1561,1254,307,0.803331,0.196669,3.260582,276,31,1562,1255,307,0.803457,0.196543,3.258348,276,31,-1, abandoned,0,0,0
48786,1000014,2,2582,2138,444,0.82804,0.17196,1.714041,412,32,2583,2138,445,0.82772,0.17228,1.713511,413,32,1, abandoned,1,1,0
48786,1000534,3,405,301,104,0.74321,0.25679,2.457251,94,10,406,301,105,0.741379,0.258621,2.454891,95,10,1, abandoned,1,1,0
48789,1000007,2,1562,1255,307,0.803457,0.196543,1.543717,276,31,1563,1256,307,0.803583,0.196417,1.545518,276,31,-1, abandoned,0,0,0
48790,1000004,1,3695,3273,422,0.885792,0.114208,0.885792,334,88,3697,3274,423,0.885583,0.114417,0.885583,335,88,-1, abandoned,1,0,0
48790,1000007,4,1563,1256,307,0.803583,0.196417,3.438108,276,31,1564,1257,307,0.803708,0.196292,3.436253,276,31,-1, abandoned,0,0,0
48790,1000009,3,1413,1171,242,0.828733,0.171267,2.634525,220,22,1414,1171,243,0.828147,0.171853,2.632544,221,22,1, abandoned,1,1,0
48790,1000011,2,775,713,62,0.92,0.08,1.805792,57,5,776,713,63,0.918814,0.081186,1.804397,58,5,1, abandoned,1,1,0
48794,1000007,2,1565,1258,307,0.803834,0.196166,1.631981,276,31,1567,1258,309,0.802808,0.197192,1.631198,278,31,1, merged,1,1,0
48794,1000009,1,1414,1171,243,0.828147,0.171853,0.828147,221,22,1416,1173,243,0.82839,0.17161,0.82839,221,22,-1, merged,0,0,0
48796,1000110,3,410,365,45,0.890244,0.109756,2.545926,42,3,411,366,45,0.890511,0.109489,2.543254,42,3,1, merged,0,0,0
48796,1000140,1,269,220,49,0.817844,0.182156,0.817844,43,6,270,221,49,0.818519,0.181481,0.818519,43,6,-1, merged,0,0,0
48798,1000110,3,411,366,45,0.890511,0.109489,2.69789,42,3,412,367,45,0.890777,0.109223,2.683766,42,3,1, merged,0,0,0
48798,1000132,2,565,488,77,0.863717,0.136283,1.807379,60,17,567,489,78,0.862434,0.137566,1.792989,61,17,1, merged,1,1,0
48800,1000166,1,444,345,99,0.777027,0.222973,0.777027,94,5,445,345,100,0.775281,0.224719,0.775281,95,5,1, abandoned,1,1,0
48801,1000004,1,3697,3274,423,0.885583,0.114417,0.885583,335,88,3698,3275,423,0.885614,0.114386,0.885614,335,88,-1, abandoned,0,0,0
48801,1000026,2,512,453,59,0.884766,0.115234,1.770349,56,3,513,454,59,0.88499,0.11501,1.770604,56,3,-1, abandoned,0,0,0
48801,1000054,3,865,742,123,0.857803,0.142197,2.628152,107,16,866,743,123,0.857968,0.142032,2.628572,107,16,-1, abandoned,0,0,0
48802,1000166,1,445,345,100,0.775281,0.224719,0.775281,95,5,448,346,102,0.772321,0.227679,0.772321,97,5,1, merged,1,1,0
48805,1000108,1,254,216,38,0.850394,0.149606,0.850394,34,4,256,217,39,0.847656,0.152344,0.847656,35,4,-1, merged,1,0,0
48805,1000140,2,270,221,49,0.818519,0.181481,1.668912,43,6,271,222,49,0.819188,0.180812,1.666844,43,6,1, merged,0,0,0
48806,1000004,2,3698,3275,423,0.885614,0.114386,1.712329,335,88,3699,3276,423,0.885645,0.114355,1.713602,335,88,-1, merged,0,0,0
48806,1000014,3,2583,2138,445,0.82772,0.17228,2.540048,413,32,2584,2139,445,0.827786,0.172214,2.541388,413,32,1, merged,0,0,0
48807,1000004,4,3699,3276,423,0.885645,0.114355,3.323848,335,88,3701,3278,423,0.885707,0.114293,3.319338,335,88,-1, merged,0,0,0
48807,1000043,3,597,500,97,0.837521,0.162479,2.438203,83,14,598,500,98,0.83612,0.16388,2.433631,84,14,1, merged,1,1,0
48807,1000121,5,2288,1889,399,0.825612,0.174388,4.14946,374,25,2291,1890,401,0.824967,0.175033,4.144305,376,25,-1, merged,1,0,0
48807,1002169,1,638,489,149,0.766458,0.233542,0.766458,121,28,639,490,149,0.766823,0.233177,0.766823,121,28,-1, merged,0,0,0
48810,1000004,2,3701,3278,423,0.885707,0.114293,1.722711,335,88,3702,3278,424,0.885467,0.114533,1.718801,336,88,1, abandoned,1,1,0
48811,1000328,1,978,726,252,0.742331,0.257669,0.742331,227,25,980,727,253,0.741837,0.258163,0.741837,228,25,1, merged,1,1,0
48816,1000070,1,1327,1134,193,0.854559,0.145441,0.854559,168,25,1328,1135,193,0.854669,0.145331,0.854669,168,25,1, merged,0,0,0
48816,1000110,2,413,368,45,0.891041,0.108959,1.7456,42,3,414,369,45,0.891304,0.108696,1.745973,42,3,1, merged,0,0,0
48822,1000121,2,2292,1891,401,0.825044,0.174956,1.633999,376,25,2293,1892,401,0.82512,0.17488,1.634644,376,25,-1, merged,0,0,0
48822,1000329,3,3225,2507,718,0.777364,0.222636,2.411363,621,97,3226,2508,718,0.777433,0.222567,2.412077,621,97,1, merged,0,0,0
48835,1000132,1,568,490,78,0.862676,0.137324,0.862676,61,17,569,491,78,0.862917,0.137083,0.862917,61,17,1, merged,0,0,0
48836,1000121,2,2293,1892,401,0.82512,0.17488,1.688037,376,25,2296,1895,401,0.825348,0.174652,1.689223,376,25,-1, merged,0,0,0
48836,1000132,1,569,491,78,0.862917,0.137083,0.862917,61,17,573,495,78,0.863874,0.136126,0.863874,61,17,-1, merged,0,0,0
48843,1000070,4,1328,1135,193,0.854669,0.145331,3.350737,168,25,1330,1136,194,0.854135,0.145865,3.297155,169,25,1, merged,1,1,0
48843,1000328,3,981,728,253,0.7421,0.2579,2.496068,228,25,983,728,255,0.74059,0.25941,2.443019,230,25,1, merged,1,1,0
48856,1000054,2,866,743,123,0.857968,0.142032,1.712103,107,16,867,744,123,0.858131,0.141869,1.711735,107,16,1, merged,0,0,0
48856,1000070,1,1330,1136,194,0.854135,0.145865,0.854135,169,25,1332,1137,195,0.853604,0.146396,0.853604,170,25,1, merged,1,1,0
48856,1000110,3,414,369,45,0.891304,0.108696,2.603407,42,3,415,370,45,0.891566,0.108434,2.603301,42,3,1, merged,0,0,0
48861,1000014,2,2584,2139,445,0.827786,0.172214,1.605289,413,32,2585,2140,445,0.827853,0.172147,1.605424,413,32,1, merged,0,0,0
48861,1000329,1,3227,2509,718,0.777502,0.222498,0.777502,621,97,3228,2510,718,0.777571,0.222429,0.777571,621,97,1, merged,0,0,0
48866,1000070,2,1332,1137,195,0.853604,0.146396,1.636011,170,25,1334,1138,196,0.853073,0.146927,1.634612,170,26,-1, merged,1,0,0
48866,1000105,1,648,507,141,0.782407,0.217593,0.782407,124,17,650,508,142,0.781538,0.218462,0.781538,125,17,1, merged,1,1,0
48867,1000004,3,3702,3278,424,0.885467,0.114533,2.569756,336,88,3703,3279,424,0.885498,0.114502,2.571035,336,88,-1, merged,0,0,0
48867,1000014,1,2585,2140,445,0.827853,0.172147,0.827853,413,32,2589,2142,447,0.827346,0.172654,0.827346,415,32,1, merged,1,1,0
48876,1000015,2,2175,1946,229,0.894713,0.105287,1.82249,209,20,2176,1946,230,0.894301,0.105699,1.81278,210,20,1, merged,1,1,0
48876,1000026,3,513,454,59,0.88499,0.11501,2.707481,56,3,515,455,60,0.883495,0.116505,2.696275,57,3,1, merged,1,1,0
48879,1000132,2,573,495,78,0.863874,0.136126,1.728196,61,17,575,497,78,0.864348,0.135652,1.726848,61,17,-1, merged,0,0,0
48881,1000004,1,3704,3279,425,0.885259,0.114741,0.885259,336,89,3705,3280,425,0.88529,0.11471,0.88529,336,89,1, merged,0,0,0
48881,1000592,2,729,617,112,0.846365,0.153635,1.731624,69,43,730,618,112,0.846575,0.153425,1.731865,69,43,1, merged,0,0,0
48882,1000004,1,3705,3280,425,0.88529,0.11471,0.88529,336,89,3707,3282,425,0.885352,0.114648,0.885352,336,89,-1, merged,0,0,0
48882,1000592,2,730,618,112,0.846575,0.153425,1.731865,69,43,731,619,112,0.846785,0.153215,1.732137,69,43,1, merged,0,0,0
48892,1000009,1,1420,1176,244,0.828169,0.171831,0.828169,221,23,1421,1177,244,0.82829,0.17171,0.82829,221,23,1, merged,0,0,0
48892,1000120,2,1803,1568,235,0.869662,0.130338,1.697831,207,28,1804,1569,235,0.869734,0.130266,1.698024,207,28,1, merged,0,0,0
48893,1000132,2,575,497,78,0.864348,0.135652,1.726848,61,17,576,498,78,0.864583,0.135417,1.727426,61,17,1, merged,0,0,0
48894,1000132,1,576,498,78,0.864583,0.135417,0.864583,61,17,577,499,78,0.864818,0.135182,0.864818,61,17,1, merged,0,0,0
48897,1000054,1,867,744,123,0.858131,0.141869,0.858131,107,16,870,745,125,0.856322,0.143678,0.856322,109,16,1, merged,1,1,0
48899,1000004,2,3707,3282,425,0.885352,0.114648,1.748536,336,89,3708,3283,425,0.885383,0.114617,1.749244,336,89,1, merged,0,0,0
48902,1000121,1,2296,1895,401,0.825348,0.174652,0.825348,376,25,2297,1896,401,0.825424,0.174576,0.825424,376,25,1, merged,0,0,0
48905,1000121,2,2297,1896,401,0.825424,0.174576,1.430688,376,25,2299,1897,402,0.825141,0.174859,1.425141,377,25,-1, abandoned,1,0,0
48908,1000140,1,273,223,50,0.81685,0.18315,0.81685,44,6,274,224,50,0.817518,0.182482,0.817518,44,6,1, merged,0,0,0
48909,1000004,1,3708,3283,425,0.885383,0.114617,0.885383,336,89,3710,3284,426,0.885175,0.114825,0.885175,337,89,-1, merged,1,0,0
48909,1000132,3,578,500,78,0.865052,0.134948,2.643292,61,17,579,501,78,0.865285,0.134715,2.583794,61,17,1, merged,0,0,0
48911,1000004,1,3710,3284,426,0.885175,0.114825,0.885175,337,89,3712,3286,426,0.885237,0.114763,0.885237,337,89,-1, abandoned,0,0,0
48911,1000121,2,2299,1897,402,0.825141,0.174859,1.710317,377,25,2300,1897,403,0.824783,0.175217,1.71002,378,25,1, abandoned,1,1,0
48915,1000004,2,3715,3289,426,0.88533,0.11467,1.750615,337,89,3717,3291,426,0.885391,0.114609,1.749653,337,89,-1, merged,0,0,0
48915,1000132,1,579,501,78,0.865285,0.134715,0.865285,61,17,582,503,79,0.864261,0.135739,0.864261,62,17,1, merged,1,1,0
48916,1000009,2,1422,1178,244,0.828411,0.171589,1.747225,221,23,1423,1179,244,0.828531,0.171469,1.747658,221,23,-1, merged,0,0,0
48916,1000011,1,776,713,63,0.918814,0.081186,0.918814,58,5,779,716,63,0.919127,0.080873,0.919127,58,5,-1, merged,0,0,0
48921,1000004,2,3717,3291,426,0.885391,0.114609,1.749653,337,89,3718,3292,426,0.885422,0.114578,1.749916,337,89,1, merged,0,0,0
48921,1000132,1,582,503,79,0.864261,0.135739,0.864261,62,17,583,504,79,0.864494,0.135506,0.864494,62,17,1, merged,0,0,0
48924,1000014,1,2594,2147,447,0.827679,0.172321,0.827679,415,32,2595,2147,448,0.82736,0.17264,0.82736,416,32,1, merged,1,1,0
48924,1000043,9,598,500,98,0.83612,0.16388,7.297294,84,14,599,501,98,0.836394,0.163606,7.282213,84,14,1, merged,0,0,0
48924,1000070,2,1334,1138,196,0.853073,0.146927,1.680753,170,26,1335,1138,197,0.852434,0.147566,1.679795,171,26,1, merged,1,1,0
48924,1000091,5,595,465,130,0.781513,0.218487,4.047529,110,20,596,465,131,0.780201,0.219799,4.042396,111,20,1, merged,1,1,0
48924,1000329,3,3228,2510,718,0.777571,0.222429,2.458324,621,97,3230,2510,720,0.77709,0.22291,2.456885,623,97,1, merged,1,1,0
48932,1000004,2,3720,3294,426,0.885484,0.114516,1.74509,337,89,3721,3295,426,0.885515,0.114485,1.745466,337,89,1, merged,0,0,0
48939,1000003,1,1288,1071,217,0.831522,0.168478,0.831522,190,27,1289,1072,217,0.831652,0.168348,0.831652,190,27,-1, merged,0,0,0
48939,1000109,4,564,483,81,0.856383,0.143617,3.315304,76,5,566,485,81,0.85689,0.14311,3.313101,76,5,-1, merged,0,0,0
48939,1000199,2,459,389,70,0.847495,0.152505,1.679016,63,7,461,390,71,0.845987,0.154013,1.677639,64,7,1, merged,1,1,0
48949,1000199,2,461,390,71,0.845987,0.154013,1.624558,64,7,462,391,71,0.84632,0.15368,1.618621,64,7,-1, merged,0,0,0
48955,1000534,2,406,301,105,0.741379,0.258621,1.660298,95,10,407,302,105,0.742015,0.257985,1.656908,95,10,1, merged,0,0,0
48967,1000199,1,462,391,71,0.84632,0.15368,0.84632,64,7,463,391,72,0.844492,0.155508,0.844492,65,7,1, abandoned,1,1,0
48974,1000153,1,1002,909,93,0.907186,0.092814,0.907186,70,23,1005,912,93,0.907463,0.092537,0.907463,70,23,-1, merged,0,0,0
48980,1000003,2,1290,1073,217,0.831783,0.168217,1.598606,190,27,1292,1074,218,0.831269,0.168731,1.59882,191,27,-1, merged,1,0,0
48980,1000329,3,3230,2510,720,0.77709,0.22291,2.375696,623,97,3231,2511,720,0.777159,0.222841,2.375979,623,97,-1, merged,0,0,0
48980,1002169,1,639,490,149,0.766823,0.233177,0.766823,121,28,641,492,149,0.767551,0.232449,0.767551,121,28,-1, merged,0,0,0
48985,1000534,1,408,303,105,0.742647,0.257353,0.742647,95,10,409,304,105,0.743276,0.256724,0.743276,95,10,1, merged,0,0,0
48987,1000014,2,2595,2147,448,0.82736,0.17264,1.594911,416,32,2596,2148,448,0.827427,0.172573,1.59534,416,32,1, merged,0,0,0
48987,1000105,3,650,508,142,0.781538,0.218462,2.376449,125,17,651,509,142,0.781874,0.218126,2.377214,125,17,1, merged,0,0,0
48987,1002169,1,641,492,149,0.767551,0.232449,0.767551,121,28,642,493,149,0.767913,0.232087,0.767913,121,28,-1, merged,0,0,0
48989,1000004,3,3725,3299,426,0.885638,0.114362,2.610082,337,89,3726,3300,426,0.885668,0.114332,2.606759,337,89,1, merged,0,0,0
48989,1000132,1,583,504,79,0.864494,0.135506,0.864494,62,17,585,505,80,0.863248,0.136752,0.863248,63,17,1, merged,1,1,0
48991,1000004,1,3726,3300,426,0.885668,0.114332,0.885668,337,89,3727,3301,426,0.885699,0.114301,0.885699,337,89,1, merged,0,0,0
48991,1000132,2,586,506,80,0.863481,0.136519,1.74915,63,17,587,507,80,0.863714,0.136286,1.749413,63,17,1, merged,0,0,0
48992,1000004,1,3727,3301,426,0.885699,0.114301,0.885699,337,89,3728,3302,426,0.88573,0.11427,0.88573,337,89,1, merged,0,0,0
48993,1000014,2,2596,2148,448,0.827427,0.172573,1.721728,416,32,2597,2148,449,0.827108,0.172892,1.721048,417,32,1, merged,1,1,0
48993,1000015,1,2176,1946,230,0.894301,0.105699,0.894301,210,20,2178,1947,231,0.893939,0.106061,0.893939,211,20,1, merged,1,1,0
48995,1000004,1,3728,3302,426,0.88573,0.11427,0.88573,337,89,3729,3303,426,0.88576,0.11424,0.88576,337,89,-1, abandoned,0,0,0
48995,1000153,2,1005,912,93,0.907463,0.092537,1.793192,70,23,1007,914,93,0.907646,0.092354,1.793407,70,23,-1, abandoned,0,0,0
48996,1000004,1,3729,3303,426,0.88576,0.11424,0.88576,337,89,3730,3304,426,0.885791,0.114209,0.885791,337,89,1, merged,0,0,0
48996,1000153,2,1007,914,93,0.907646,0.092354,1.793407,70,23,1008,915,93,0.907738,0.092262,1.793529,70,23,1, merged,0,0,0
48997,1000004,1,3730,3304,426,0.885791,0.114209,0.885791,337,89,3731,3304,427,0.885553,0.114447,0.885553,338,89,1, abandoned,1,1,0
48997,1000153,2,1008,915,93,0.907738,0.092262,1.793529,70,23,1010,917,93,0.907921,0.092079,1.793474,70,23,-1, abandoned,0,0,0
48998,1000015,2,2178,1947,231,0.893939,0.106061,1.80186,211,20,2180,1949,231,0.894037,0.105963,1.802139,211,20,-1, abandoned,0,0,0
48998,1000153,1,1010,917,93,0.907921,0.092079,0.907921,70,23,1012,919,93,0.908103,0.091897,0.908103,70,23,-1, abandoned,0,0,0
49005,1000110,1,422,376,46,0.890995,0.109005,0.890995,43,3,423,377,46,0.891253,0.108747,0.891253,43,3,-1, merged,0,0,0
49005,1000140,2,275,225,50,0.818182,0.181818,1.709177,44,6,276,226,50,0.818841,0.181159,1.710094,44,6,1, merged,0,0,0
49006,1000130,1,502,415,87,0.826693,0.173307,0.826693,67,20,503,416,87,0.827038,0.172962,0.827038,67,20,1, merged,0,0,0
49006,1000329,2,3233,2512,721,0.776987,0.223013,1.603681,624,97,3234,2513,721,0.777056,0.222944,1.604094,624,97,1, merged,0,0,0
49008,1000153,2,1014,921,93,0.908284,0.091716,1.823628,70,23,1015,922,93,0.908374,0.091626,1.824605,70,23,1, merged,0,0,0
49010,1000004,3,3732,3305,427,0.885584,0.114416,2.54118,338,89,3733,3306,427,0.885615,0.114385,2.528873,338,89,1, merged,0,0,0
49013,1000023,4,1258,1104,154,0.877583,0.122417,3.417558,138,16,1259,1105,154,0.877681,0.122319,3.43978,138,16,1, merged,0,0,0
49022,1000329,1,3234,2513,721,0.777056,0.222944,0.777056,624,97,3236,2515,721,0.777194,0.222806,0.777194,624,97,-1, merged,0,0,0
49023,1000109,2,566,485,81,0.85689,0.14311,1.70489,76,5,567,486,81,0.857143,0.142857,1.706349,76,5,1, merged,0,0,0
49027,1000199,1,464,392,72,0.844828,0.155172,0.844828,65,7,466,393,73,0.843348,0.156652,0.843348,66,7,1, merged,1,1,0
49035,1000329,3,3250,2529,721,0.778154,0.221846,2.484508,624,97,3251,2530,721,0.778222,0.221778,2.486242,624,97,1, merged,0,0,0
49051,1000004,2,3734,3307,427,0.885645,0.114355,1.664615,338,89,3735,3308,427,0.885676,0.114324,1.664714,338,89,1, merged,0,0,0
49051,1000329,1,3262,2541,721,0.77897,0.22103,0.77897,624,97,3263,2542,721,0.779038,0.220962,0.779038,624,97,1, merged,0,0,0
49052,1000005,2,664,556,108,0.837349,0.162651,1.616387,100,8,665,557,108,0.837594,0.162406,1.616699,100,8,1, merged,0,0,0
49052,1000329,1,3263,2542,721,0.779038,0.220962,0.779038,624,97,3264,2543,721,0.779105,0.220895,0.779105,624,97,1, merged,0,0,0
49053,1000004,2,3735,3308,427,0.885676,0.114324,1.750083,338,89,3736,3308,428,0.885439,0.114561,1.748615,339,89,1, merged,1,1,0
49053,1000105,3,651,509,142,0.781874,0.218126,2.531957,125,17,652,509,143,0.780675,0.219325,2.529289,126,17,1, merged,1,1,0
49053,1000132,1,590,510,80,0.864407,0.135593,0.864407,63,17,592,511,81,0.863176,0.136824,0.863176,64,17,1, merged,1,1,0
49074,1000004,3,3742,3314,428,0.885623,0.114377,2.529584,339,89,3743,3315,428,0.885653,0.114347,2.526021,339,89,1, merged,0,0,0
49077,1000091,2,596,465,131,0.780201,0.219799,1.55951,111,20,597,466,131,0.78057,0.21943,1.559945,111,20,1, merged,0,0,0
49077,1000329,1,3267,2546,721,0.779308,0.220692,0.779308,624,97,3268,2547,721,0.779376,0.220624,0.779376,624,97,1, merged,0,0,0
49079,1000005,1,665,557,108,0.837594,0.162406,0.837594,100,8,666,558,108,0.837838,0.162162,0.837838,100,8,1, merged,0,0,0
49080,1000004,2,3743,3315,428,0.885653,0.114347,1.748069,339,89,3744,3316,428,0.885684,0.114316,1.74833,339,89,1, merged,0,0,0
49080,1000132,1,596,514,82,0.862416,0.137584,0.862416,65,17,597,515,82,0.862647,0.137353,0.862647,65,17,1, merged,0,0,0
49082,1000003,1,1293,1075,218,0.8314,0.1686,0.8314,191,27,1294,1076,218,0.83153,0.16847,0.83153,191,27,1, merged,0,0,0
49082,1000120,2,1806,1571,235,0.869878,0.130122,1.701278,207,28,1807,1572,235,0.86995,0.13005,1.70148,207,28,1, merged,0,0,0
49083,1000120,2,1807,1572,235,0.86995,0.13005,1.649326,207,28,1808,1573,235,0.870022,0.129978,1.649465,207,28,1, merged,0,0,0
49083,1000329,1,3268,2547,721,0.779376,0.220624,0.779376,624,97,3269,2548,721,0.779443,0.220557,0.779443,624,97,1, merged,0,0,0
49103,1000026,2,517,456,61,0.882012,0.117988,1.739154,58,3,518,457,61,0.882239,0.117761,1.739634,58,3,1, merged,0,0,0
49103,1000109,1,567,486,81,0.857143,0.142857,0.857143,76,5,568,487,81,0.857394,0.142606,0.857394,76,5,1, merged,0,0,0
49112,1000054,1,874,749,125,0.856979,0.143021,0.856979,109,16,875,750,125,0.857143,0.142857,0.857143,109,16,1, merged,0,0,0
49112,1000329,2,3269,2548,721,0.779443,0.220557,1.636423,624,97,3270,2549,721,0.779511,0.220489,1.636654,624,97,1, merged,0,0,0
49122,1000003,1,1294,1076,218,0.83153,0.16847,0.83153,191,27,1295,1077,218,0.83166,0.16834,0.83166,191,27,-1, abandoned,0,0,0
49122,1000199,2,466,393,73,0.843348,0.156652,1.674878,66,7,467,394,73,0.843683,0.156317,1.675343,66,7,-1, abandoned,0,0,0
49123,1000003,1,1295,1077,218,0.83166,0.16834,0.83166,191,27,1298,1080,218,0.832049,0.167951,0.832049,191,27,-1, merged,0,0,0
49123,1000199,2,467,394,73,0.843683,0.156317,1.675343,66,7,471,397,74,0.842887,0.157113,1.674937,67,7,-1, merged,1,0,0
49127,1000004,1,3744,3316,428,0.885684,0.114316,0.885684,339,89,3745,3317,428,0.885714,0.114286,0.885714,339,89,1, merged,0,0,0
49128,1000007,2,1575,1263,312,0.801905,0.198095,1.66501,281,31,1576,1264,312,0.80203,0.19797,1.665591,281,31,-1, merged,0,0,0
49128,1000132,1,599,517,82,0.863105,0.136895,0.863105,65,17,601,519,82,0.863561,0.136439,0.863561,65,17,-1, merged,0,0,0
49128,1000153,3,1015,922,93,0.908374,0.091626,2.573384,70,23,1016,923,93,0.908465,0.091535,2.574056,70,23,1, merged,0,0,0
49130,1000009,1,1433,1186,247,0.827634,0.172366,0.827634,223,24,1434,1187,247,0.827755,0.172245,0.827755,223,24,1, merged,0,0,0
49134,1000132,2,601,519,82,0.863561,0.136439,1.715589,65,17,602,520,82,0.863787,0.136213,1.716168,65,17,1, merged,0,0,0
49135,1000004,3,3745,3317,428,0.885714,0.114286,2.582464,339,89,3746,3317,429,0.885478,0.114522,2.512623,340,89,1, abandoned,1,1,0
49138,1000014,4,2597,2148,449,0.827108,0.172892,3.150571,417,32,2598,2149,449,0.827175,0.172825,3.206296,417,32,1, merged,0,0,0
49139,1000014,2,2598,2149,449,0.827175,0.172825,1.541929,417,32,2599,2150,449,0.827241,0.172759,1.53966,417,32,1, merged,0,0,0
49145,1000121,1,2303,1900,403,0.825011,0.174989,0.825011,378,25,2305,1901,404,0.824729,0.175271,0.824729,379,25,-1, abandoned,1,0,0
49149,1000015,1,2181,1950,231,0.894085,0.105915,0.894085,211,20,2182,1951,231,0.894134,0.105866,0.894134,211,20,-1, abandoned,0,0,0
49149,1000153,2,1017,924,93,0.908555,0.091445,1.80264,70,23,1018,925,93,0.908644,0.091356,1.802778,70,23,-1, abandoned,0,0,0
49150,1000012,2,630,546,84,0.866667,0.133333,1.693908,81,3,631,547,84,0.866878,0.133122,1.694186,81,3,1, merged,0,0,0
49150,1000014,1,2599,2150,449,0.827241,0.172759,0.827241,417,32,2600,2151,449,0.827308,0.172692,0.827308,417,32,1, merged,0,0,0
49151,1000153,3,1018,925,93,0.908644,0.091356,2.545298,70,23,1019,925,94,0.907753,0.092247,2.541927,71,23,1, merged,1,1,0
49151,1000329,1,3270,2549,721,0.779511,0.220489,0.779511,624,97,3273,2550,723,0.779102,0.220898,0.779102,625,98,-1, merged,1,0,0
49152,1000014,1,2600,2151,449,0.827308,0.172692,0.827308,417,32,2602,2153,449,0.82744,0.17256,0.82744,417,32,-1, abandoned,0,0,0
49152,1000153,2,1019,925,94,0.907753,0.092247,1.73506,71,23,1020,926,94,0.907843,0.092157,1.735284,71,23,-1, abandoned,0,0,0
49156,1000110,3,428,382,46,0.892523,0.107477,2.564625,43,3,429,383,46,0.892774,0.107226,2.567107,43,3,1, merged,0,0,0
49156,1000140,2,276,226,50,0.818841,0.181159,1.672101,44,6,277,227,50,0.819495,0.180505,1.674333,44,6,1, merged,0,0,0
49157,1000004,1,3748,3319,429,0.885539,0.114461,0.885539,340,89,3750,3321,429,0.8856,0.1144,0.8856,340,89,-1, abandoned,0,0,0
49157,1000130,2,503,416,87,0.827038,0.172962,1.712577,67,20,504,417,87,0.827381,0.172619,1.712981,67,20,-1, abandoned,0,0,0
49162,1000003,2,1298,1080,218,0.832049,0.167951,1.714516,191,27,1299,1080,219,0.831409,0.168591,1.712178,192,27,1, merged,1,1,0
49162,1000026,1,519,458,61,0.882466,0.117534,0.882466,58,3,520,458,62,0.880769,0.119231,0.880769,59,3,1, merged,1,1,0
49162,1000199,4,471,397,74,0.842887,0.157113,3.331376,67,7,473,398,75,0.841438,0.158562,3.326858,68,7,-1, merged,1,0,0
49163,1000026,1,520,458,62,0.880769,0.119231,0.880769,59,3,523,460,63,0.879541,0.120459,0.879541,60,3,-1, merged,1,0,0
49176,1000026,1,523,460,63,0.879541,0.120459,0.879541,60,3,526,461,65,0.876426,0.123574,0.876426,62,3,1, merged,1,1,0
49176,1000534,2,409,304,105,0.743276,0.256724,1.622817,95,10,412,307,105,0.745146,0.254854,1.621571,95,10,-1, merged,0,0,0
49181,1002169,1,642,493,149,0.767913,0.232087,0.767913,121,28,643,493,150,0.766719,0.233281,0.766719,121,29,-1, merged,1,1,0
49195,1000003,3,1299,1080,219,0.831409,0.168591,2.279607,192,27,1302,1082,220,0.831029,0.168971,2.284815,193,27,-1, merged,1,0,0
49197,1000015,1,2182,1951,231,0.894134,0.105866,0.894134,211,20,2183,1952,231,0.894182,0.105818,0.894182,211,20,1, merged,0,0,0
49206,1000140,1,277,227,50,0.819495,0.180505,0.819495,44,6,278,228,50,0.820144,0.179856,0.820144,44,6,-1, merged,0,0,0
49211,1000105,2,654,511,143,0.781346,0.218654,1.625452,126,17,655,512,143,0.781679,0.218321,1.626376,126,17,1, merged,0,0,0
49211,1000108,1,263,222,41,0.844106,0.155894,0.844106,37,4,264,223,41,0.844697,0.155303,0.844697,37,4,1, merged,0,0,0
49216,1000109,1,568,487,81,0.857394,0.142606,0.857394,76,5,570,488,82,0.85614,0.14386,0.85614,77,5,1, merged,1,1,0
49216,1000199,3,473,398,75,0.841438,0.158562,2.468407,68,7,474,399,75,0.841772,0.158228,2.468514,68,7,1, merged,0,0,0
49217,1000003,2,1302,1082,220,0.831029,0.168971,1.707455,193,27,1303,1083,220,0.831159,0.168841,1.707819,193,27,1, merged,0,0,0
49217,1000026,1,526,461,65,0.876426,0.123574,0.876426,62,3,527,462,65,0.87666,0.12334,0.87666,62,3,1, merged,0,0,0
49217,1000109,4,570,488,82,0.85614,0.14386,3.405368,77,5,571,489,82,0.856392,0.143608,3.406317,77,5,1, merged,0,0,0
49217,1000199,3,474,399,75,0.841772,0.158228,2.549227,68,7,475,400,75,0.842105,0.157895,2.549924,68,7,1, merged,0,0,0
49219,1000132,2,611,528,83,0.864157,0.135843,1.718275,66,17,612,529,83,0.864379,0.135621,1.718839,66,17,1, merged,0,0,0
49231,1000003,1,1303,1083,220,0.831159,0.168841,0.831159,193,27,1305,1085,220,0.831418,0.168582,0.831418,193,27,-1, merged,0,0,0
49231,1000109,3,571,489,82,0.856392,0.143608,2.458152,77,5,572,490,82,0.856643,0.143357,2.457462,77,5,1, merged,0,0,0
49237,1000004,2,3751,3322,429,0.88563,0.11437,1.687661,340,89,3752,3323,429,0.885661,0.114339,1.687309,340,89,1, merged,0,0,0
49237,1000007,1,1576,1264,312,0.80203,0.19797,0.80203,281,31,1578,1265,313,0.801648,0.198352,0.801648,281,32,-1, merged,1,1,0
49239,1000199,2,475,400,75,0.842105,0.157895,1.611507,68,7,477,402,75,0.842767,0.157233,1.610979,68,7,-1, merged,0,0,0
49242,1000108,2,264,223,41,0.844697,0.155303,1.611415,37,4,268,227,41,0.847015,0.152985,1.614096,37,4,-1, merged,0,0,0
49242,1000110,3,429,383,46,0.892774,0.107226,2.504189,43,3,430,384,46,0.893023,0.106977,2.507119,43,3,-1, merged,0,0,0
49242,1000121,7,2307,1902,405,0.824447,0.175553,5.072713,379,26,2309,1904,405,0.824599,0.175401,4.574643,379,26,-1, merged,0,0,0
49242,1002169,1,643,493,150,0.766719,0.233281,0.766719,121,29,644,494,150,0.767081,0.232919,0.767081,121,29,-1, merged,0,0,0
49243,1000105,3,657,514,143,0.782344,0.217656,2.501524,126,17,658,515,143,0.782675,0.217325,2.500079,126,17,1, merged,0,0,0
49243,1000132,2,612,529,83,0.864379,0.135621,1.71918,66,17,613,530,83,0.8646,0.1354,1.717404,66,17,-1, merged,0,0,0
49251,1000009,1,1443,1194,249,0.827443,0.172557,0.827443,224,25,1445,1195,250,0.82699,0.17301,0.82699,225,25,1, merged,1,1,0
49256,1000110,2,431,385,46,0.893271,0.106729,1.71406,43,3,432,386,46,0.893519,0.106481,1.711376,43,3,1, merged,0,0,0
49256,1000140,1,279,229,50,0.820789,0.179211,0.820789,44,6,280,229,51,0.817857,0.182143,0.817857,45,6,1, merged,1,1,0
49261,1000120,2,1813,1578,235,0.870381,0.129619,1.585124,207,28,1814,1579,235,0.870452,0.129548,1.587013,207,28,1, merged,0,0,0
49262,1000132,2,614,531,83,0.864821,0.135179,1.717625,66,17,615,532,83,0.865041,0.134959,1.718188,66,17,1, merged,0,0,0
49263,1000121,2,2309,1904,405,0.824599,0.175401,1.677746,379,26,2310,1905,405,0.824675,0.175325,1.678164,379,26,1, merged,0,0,0
49265,1000108,1,268,227,41,0.847015,0.152985,0.847015,37,4,272,231,41,0.849265,0.150735,0.849265,37,4,-1, merged,0,0,0
49265,1000110,2,432,386,46,0.893519,0.106481,1.740533,43,3,433,387,46,0.893764,0.106236,1.743029,43,3,1, merged,0,0,0
49287,1000004,1,3752,3323,429,0.885661,0.114339,0.885661,340,89,3753,3324,429,0.885691,0.114309,0.885691,340,89,-1, abandoned,0,0,0
49293,1000007,1,1578,1265,313,0.801648,0.198352,0.801648,281,32,1579,1266,313,0.801773,0.198227,0.801773,281,32,1, merged,0,0,0
49293,1000153,2,1021,927,94,0.907933,0.092067,1.709581,71,23,1022,928,94,0.908023,0.091977,1.709797,71,23,1, merged,0,0,0
49305,1000009,2,1448,1198,250,0.827348,0.172652,1.415583,225,25,1449,1199,250,0.827467,0.172533,1.427467,225,25,1, merged,0,0,0
49311,1000105,1,659,516,143,0.783005,0.216995,0.783005,126,17,660,517,143,0.783333,0.216667,0.783333,126,17,-1, abandoned,0,0,0
49311,1000130,2,505,418,87,0.827723,0.172277,1.610727,67,20,506,419,87,0.828063,0.171937,1.611397,67,20,-1, abandoned,0,0,0
49321,1000004,2,3753,3324,429,0.885691,0.114309,1.722901,340,89,3754,3325,429,0.885722,0.114278,1.723201,340,89,1, merged,0,0,0
49321,1000043,1,602,504,98,0.837209,0.162791,0.837209,84,14,603,505,98,0.837479,0.162521,0.837479,84,14,1, merged,0,0,0
49326,1000003,3,1307,1087,220,0.831676,0.168324,2.563954,193,27,1308,1088,220,0.831804,0.168196,2.564477,193,27,1, merged,0,0,0
49326,1000120,1,1814,1579,235,0.870452,0.129548,0.870452,207,28,1815,1580,235,0.870523,0.129477,0.870523,207,28,1, merged,0,0,0
49332,1000009,1,1458,1208,250,0.828532,0.171468,0.828532,225,25,1459,1209,250,0.82865,0.17135,0.82865,225,25,1, merged,0,0,0
49333,1000009,1,1459,1209,250,0.82865,0.17135,0.82865,225,25,1460,1210,250,0.828767,0.171233,0.828767,225,25,1, merged,0,0,0
49334,1000108,1,272,231,41,0.849265,0.150735,0.849265,37,4,274,231,43,0.843066,0.156934,0.843066,39,4,1, abandoned,1,1,0
49334,1000130,3,506,419,87,0.828063,0.171937,2.369636,67,20,507,420,87,0.828402,0.171598,2.371468,67,20,-1, abandoned,0,0,0
49339,1000005,4,670,562,108,0.838806,0.161194,3.367686,100,8,671,563,108,0.839046,0.160954,3.372548,100,8,1, merged,0,0,0
49339,1000120,3,1815,1580,235,0.870523,0.129477,2.52888,207,28,1816,1581,235,0.870595,0.129405,2.533502,207,28,1, merged,0,0,0
49340,1000007,2,1579,1266,313,0.801773,0.198227,1.666071,281,32,1580,1267,313,0.801899,0.198101,1.663412,281,32,-1, abandoned,0,0,0
49340,1000132,1,619,535,84,0.864297,0.135703,0.864297,67,17,621,535,86,0.861514,0.138486,0.861514,69,17,1, abandoned,1,1,0
49345,1000014,2,2606,2157,449,0.827705,0.172295,1.620809,417,32,2607,2158,449,0.827771,0.172229,1.627771,417,32,1, merged,0,0,0
49345,1000120,3,1816,1581,235,0.870595,0.129405,2.491403,207,28,1817,1582,235,0.870666,0.129334,2.498437,207,28,1, merged,0,0,0
49348,1000014,1,2607,2158,449,0.827771,0.172229,0.827771,417,32,2608,2159,449,0.827837,0.172163,0.827837,417,32,1, merged,0,0,0
49348,1000120,2,1817,1582,235,0.870666,0.129334,1.698437,207,28,1818,1583,235,0.870737,0.129263,1.698574,207,28,1, merged,0,0,0
49349,1000014,1,2608,2159,449,0.827837,0.172163,0.827837,417,32,2609,2160,449,0.827903,0.172097,0.827903,417,32,1, merged,0,0,0
49349,1000120,2,1818,1583,235,0.870737,0.129263,1.698574,207,28,1819,1584,235,0.870808,0.129192,1.698712,207,28,1, merged,0,0,0
49350,1000014,1,2609,2160,449,0.827903,0.172097,0.827903,417,32,2610,2161,449,0.827969,0.172031,0.827969,417,32,1, merged,0,0,0
49350,1000120,2,1819,1584,235,0.870808,0.129192,1.698712,207,28,1820,1585,235,0.870879,0.129121,1.698848,207,28,1, merged,0,0,0
49353,1000329,2,3273,2550,723,0.779102,0.220898,1.546182,625,98,3274,2551,723,0.779169,0.220831,1.546611,625,98,-1, abandoned,0,0,0
49353,1002169,1,644,494,150,0.767081,0.232919,0.767081,121,29,645,495,150,0.767442,0.232558,0.767442,121,29,-1, abandoned,0,0,0
49354,1000014,2,2610,2161,449,0.827969,0.172031,1.689483,417,32,2611,2162,449,0.828035,0.171965,1.688388,417,32,-1, merged,0,0,0
49354,1000070,5,1341,1144,197,0.853095,0.146905,4.179727,171,26,1342,1145,197,0.853204,0.146796,4.179735,171,26,1, merged,0,0,0
49354,1000105,4,661,518,143,0.783661,0.216339,3.326633,126,17,663,520,143,0.784314,0.215686,3.32653,126,17,-1, merged,0,0,0
49354,1000132,1,621,535,86,0.861514,0.138486,0.861514,69,17,623,536,87,0.860353,0.139647,0.860353,70,17,-1, merged,1,0,0
49357,1000004,3,3756,3326,430,0.885517,0.114483,2.523837,341,89,3757,3327,430,0.885547,0.114453,2.524299,341,89,-1, abandoned,0,0,0
49357,1000120,2,1820,1585,235,0.870879,0.129121,1.638321,207,28,1821,1586,235,0.87095,0.12905,1.638752,207,28,-1, abandoned,0,0,0
49357,1002169,1,645,495,150,0.767442,0.232558,0.767442,121,29,646,496,150,0.767802,0.232198,0.767802,121,29,-1, abandoned,0,0,0
49360,1000012,1,631,547,84,0.866878,0.133122,0.866878,81,3,632,547,85,0.865506,0.134494,0.865506,82,3,1, merged,1,1,0
49360,1000109,2,573,491,82,0.856894,0.143106,1.723772,77,5,574,491,83,0.855401,0.144599,1.720907,78,5,1, merged,1,1,0
49365,1000015,2,2185,1954,231,0.894279,0.105721,1.754632,211,20,2186,1955,231,0.894328,0.105672,1.754904,211,20,1, merged,0,0,0
49365,1000132,1,623,536,87,0.860353,0.139647,0.860353,70,17,624,537,87,0.860577,0.139423,0.860577,70,17,1, merged,0,0,0
49374,1000007,1,1587,1272,315,0.801512,0.198488,0.801512,283,32,1589,1273,316,0.801133,0.198867,0.801133,283,33,-1, merged,1,0,0
49374,1000009,2,1461,1211,250,0.828884,0.171116,1.630397,225,25,1462,1212,250,0.829001,0.170999,1.630134,225,25,1, merged,0,0,0
49377,1000007,1,1591,1275,316,0.801383,0.198617,0.801383,283,33,1592,1276,316,0.801508,0.198492,0.801508,283,33,1, merged,0,0,0
49377,1000009,2,1462,1212,250,0.829001,0.170999,1.630384,225,25,1463,1213,250,0.829118,0.170882,1.630626,225,25,1, merged,0,0,0
49384,1000329,1,3274,2551,723,0.779169,0.220831,0.779169,625,98,3275,2552,723,0.779237,0.220763,0.779237,625,98,1, merged,0,0,0
49385,1000070,1,1342,1145,197,0.853204,0.146796,0.853204,171,26,1343,1145,198,0.852569,0.147431,0.852569,172,26,1, abandoned,1,1,0
49385,1000105,3,663,520,143,0.784314,0.215686,2.531527,126,17,664,521,143,0.784639,0.215361,2.529161,126,17,-1, abandoned,0,0,0
49385,1000110,2,434,388,46,0.894009,0.105991,1.747213,43,3,435,388,47,0.891954,0.108046,1.744523,44,3,1, abandoned,1,1,0
49387,1000110,2,436,389,47,0.892202,0.107798,0.892202,44,3,437,390,47,0.892449,0.107551,1.892449,44,3,1, merged,0,0,0
49388,1000003,2,1308,1088,220,0.831804,0.168196,1.600016,193,27,1309,1088,221,0.831169,0.168831,1.597689,194,27,1, merged,1,1,0
49388,1000109,3,574,491,83,0.855401,0.144599,2.455417,78,5,578,494,84,0.854671,0.145329,2.45236,79,5,1, merged,1,1,0
49389,1000003,2,1309,1088,221,0.831169,0.168831,1.597689,194,27,1310,1089,221,0.831298,0.168702,1.598842,194,27,1, merged,0,0,0
49399,1000110,2,437,390,47,0.892449,0.107551,1.710954,44,3,438,391,47,0.892694,0.107306,1.711843,44,3,1, merged,0,0,0
49399,1000140,1,281,230,51,0.818505,0.181495,0.818505,45,6,282,231,51,0.819149,0.180851,0.819149,45,6,-1, merged,0,0,0
49415,1000004,1,3758,3328,430,0.885577,0.114423,0.885577,341,89,3759,3329,430,0.885608,0.114392,0.885608,341,89,-1, merged,0,0,0
49415,1000043,3,603,505,98,0.837479,0.162521,2.547808,84,14,605,507,98,0.838017,0.161983,2.548527,84,14,1, merged,0,0,0
49415,1000121,2,2311,1906,405,0.824751,0.175249,1.710329,379,26,2313,1908,405,0.824903,0.175097,1.710511,379,26,-1, merged,0,0,0
49435,1000105,3,664,521,143,0.784639,0.215361,2.501055,126,17,665,522,143,0.784962,0.215038,2.502263,126,17,1, merged,0,0,0
49435,1000132,1,627,540,87,0.861244,0.138756,0.861244,70,17,628,541,87,0.861465,0.138535,0.861465,70,17,-1, merged,0,0,0
49437,1000004,2,3761,3331,430,0.885669,0.114331,1.723169,341,89,3762,3332,430,0.885699,0.114301,1.723873,341,89,1, merged,0,0,0
49445,1000054,2,881,755,126,0.856981,0.143019,1.720717,110,16,882,756,126,0.857143,0.142857,1.721178,110,16,1, merged,0,0,0
49448,1000004,1,3764,3333,431,0.885494,0.114506,0.885494,342,89,3765,3334,431,0.885525,0.114475,0.885525,342,89,1, merged,0,0,0
49448,1000329,2,3278,2553,725,0.778829,0.221171,1.664323,627,98,3279,2554,725,0.778896,0.221104,1.664421,627,98,1, merged,0,0,0
49451,1000043,1,605,507,98,0.838017,0.161983,0.838017,84,14,607,509,98,0.83855,0.16145,0.83855,84,14,-1, merged,0,0,0
49451,1000108,2,276,233,43,0.844203,0.155797,1.682219,39,4,278,234,44,0.841727,0.158273,1.680277,40,4,1, merged,1,1,0
49452,1000043,1,607,509,98,0.83855,0.16145,0.83855,84,14,609,511,98,0.83908,0.16092,0.83908,84,14,-1, abandoned,0,0,0
49452,1000108,3,278,234,44,0.841727,0.158273,2.448438,40,4,280,234,46,0.835714,0.164286,2.444026,42,4,1, abandoned,1,1,0
49452,1002169,2,647,497,150,0.768161,0.231839,1.606711,121,29,650,500,150,0.769231,0.230769,1.608311,121,29,-1, abandoned,0,0,0
49462,1000120,3,1825,1590,235,0.871233,0.128767,2.374407,207,28,1826,1591,235,0.871303,0.128697,2.376543,207,28,1, merged,0,0,0
49463,1000070,2,1343,1145,198,0.852569,0.147431,1.785902,172,26,1345,1145,200,0.851301,0.148699,1.788801,174,26,1, abandoned,1,1,0
49467,1000004,1,3765,3334,431,0.885525,0.114475,0.885525,342,89,3766,3335,431,0.885555,0.114445,0.885555,342,89,1, merged,0,0,0
49467,1000329,2,3279,2554,725,0.778896,0.221104,1.664421,627,98,3280,2555,725,0.778963,0.221037,1.664518,627,98,1, merged,0,0,0
49483,1002169,1,650,500,150,0.769231,0.230769,0.769231,121,29,651,501,150,0.769585,0.230415,0.769585,121,29,-1, merged,0,0,0
49494,1000130,2,507,420,87,0.828402,0.171598,1.518879,67,20,508,421,87,0.82874,0.17126,1.526415,67,20,1, merged,0,0,0
49496,1000108,2,280,234,46,0.835714,0.164286,1.642732,42,4,281,234,47,0.83274,0.16726,1.62935,43,4,1, merged,1,1,0
49496,1000130,3,508,421,87,0.82874,0.17126,2.471472,67,20,511,424,87,0.829746,0.170254,2.459096,67,20,-1, merged,0,0,0
49501,1000005,2,674,565,109,0.838279,0.161721,1.504946,101,8,675,566,109,0.838519,0.161481,1.588519,101,8,1, merged,0,0,0
49505,1000004,2,3766,3335,431,0.885555,0.114445,1.618888,342,89,3770,3338,432,0.885411,0.114589,1.608237,343,89,-1, merged,1,0,0
49505,1000014,3,2613,2164,449,0.828167,0.171833,2.447055,417,32,2614,2164,450,0.82785,0.17215,2.436087,418,32,1, merged,1,1,0
49512,1000004,3,3770,3338,432,0.885411,0.114589,2.584565,343,89,3771,3339,432,0.885442,0.114558,2.583467,343,89,1, merged,0,0,0
49512,1000014,1,2614,2164,450,0.82785,0.17215,0.82785,418,32,2619,2165,454,0.826651,0.173349,0.826651,422,32,1, merged,1,1,0
49512,1000120,2,1826,1591,235,0.871303,0.128697,1.699153,207,28,1827,1592,235,0.871374,0.128626,1.698025,207,28,-1, merged,0,0,0
49512,1000329,4,3280,2555,725,0.778963,0.221037,3.363528,627,98,3281,2556,725,0.779031,0.220969,3.362498,627,98,1, merged,0,0,0
49519,1000014,2,2619,2165,454,0.826651,0.173349,1.613537,422,32,2620,2166,454,0.826718,0.173282,1.610501,422,32,-1, merged,0,0,0
49519,1000120,3,1827,1592,235,0.871374,0.128626,2.48491,207,28,1829,1594,235,0.871514,0.128486,2.482016,207,28,-1, merged,0,0,0
49520,1000120,1,1829,1594,235,0.871514,0.128486,0.871514,207,28,1831,1595,236,0.871109,0.128891,0.871109,208,28,1, merged,1,1,0
49522,1000004,1,3772,3340,432,0.885472,0.114528,0.885472,343,89,3773,3341,432,0.885502,0.114498,0.885502,343,89,-1, merged,0,0,0
49522,1000108,3,282,235,47,0.833333,0.166667,2.515415,43,4,283,236,47,0.833922,0.166078,2.519425,43,4,1, merged,0,0,0
49538,1000120,2,1832,1596,236,0.871179,0.128821,1.719455,208,28,1833,1597,236,0.871249,0.128751,1.720564,208,28,1, merged,0,0,0
49539,1000070,1,1347,1147,200,0.851522,0.148478,0.851522,174,26,1348,1148,200,0.851632,0.148368,0.851632,174,26,1, merged,0,0,0
49541,1000105,3,666,523,143,0.785285,0.214715,2.455031,126,17,667,523,144,0.784108,0.215892,2.448954,127,17,1, abandoned,1,1,0
49541,1000130,2,511,424,87,0.829746,0.170254,1.669746,67,20,513,426,87,0.830409,0.169591,1.664846,67,20,-1, abandoned,0,0,0
49546,1000014,1,2620,2166,454,0.826718,0.173282,0.826718,422,32,2622,2168,454,0.82685,0.17315,0.82685,422,32,-1, merged,0,0,0
49549,1000003,1,1310,1089,221,0.831298,0.168702,0.831298,194,27,1311,1090,221,0.831426,0.168574,0.831426,194,27,1, merged,0,0,0
49549,1000014,3,2622,2168,454,0.82685,0.17315,2.483201,422,32,2623,2169,454,0.826916,0.173084,2.483472,422,32,1, merged,0,0,0
49549,1000043,4,617,519,98,0.841167,0.158833,3.324368,84,14,618,520,98,0.841424,0.158576,3.324896,84,14,1, merged,0,0,0
49549,1000121,2,2315,1910,405,0.825054,0.174946,1.656352,379,26,2316,1911,405,0.82513,0.17487,1.656556,379,26,1, merged,0,0,0
49553,1000091,1,597,466,131,0.78057,0.21943,0.78057,111,20,598,467,131,0.780936,0.219064,0.780936,111,20,1, merged,0,0,0
49553,1000329,2,3282,2557,725,0.779098,0.220902,1.559668,627,98,3283,2557,726,0.778861,0.221139,1.559797,627,99,-1, merged,1,1,0
49560,1000329,2,3283,2557,726,0.778861,0.221139,1.61003,627,99,3284,2557,727,0.778624,0.221376,1.60621,627,100,-1, merged,1,1,0
49567,1000004,2,3777,3343,434,0.885094,0.114906,1.716673,344,90,3779,3345,434,0.885155,0.114845,1.708989,344,90,-1, merged,0,0,0
49568,1000004,1,3779,3345,434,0.885155,0.114845,0.885155,344,90,3781,3346,435,0.884951,0.115049,0.884951,345,90,1, merged,1,1,0
49569,1000004,1,3781,3346,435,0.884951,0.115049,0.884951,345,90,3782,3347,435,0.884981,0.115019,0.884981,345,90,1, merged,0,0,0
49570,1000004,1,3782,3347,435,0.884981,0.115019,0.884981,345,90,3784,3348,436,0.884778,0.115222,0.884778,346,90,1, merged,1,1,0
49571,1000004,1,3784,3348,436,0.884778,0.115222,0.884778,346,90,3786,3350,436,0.884839,0.115161,0.884839,346,90,-1, merged,0,0,0
49583,1000014,3,2623,2169,454,0.826916,0.173084,2.470018,422,32,2624,2170,454,0.826982,0.173018,2.471569,422,32,1, merged,0,0,0
49588,1000014,2,2624,2170,454,0.826982,0.173018,1.605199,422,32,2625,2171,454,0.827048,0.172952,1.605332,422,32,-1, abandoned,0,0,0
49588,1000329,1,3287,2558,729,0.778217,0.221783,0.778217,629,100,3288,2559,729,0.778285,0.221715,0.778285,629,100,-1, abandoned,0,0,0
49589,1000329,1,3288,2559,729,0.778285,0.221715,0.778285,629,100,3290,2561,729,0.778419,0.221581,0.778419,629,100,-1, merged,0,0,0
49592,1000327,1,704,554,150,0.786932,0.213068,0.786932,116,34,705,555,150,0.787234,0.212766,0.787234,116,34,-1, merged,0,0,0
49592,1000329,2,3290,2561,729,0.778419,0.221581,1.565351,629,100,3292,2563,729,0.778554,0.221446,1.565788,629,100,-1, merged,0,0,0
49596,1000007,1,1602,1286,316,0.802747,0.197253,0.802747,283,33,1604,1288,316,0.802993,0.197007,0.802993,283,33,-1, merged,0,0,0
49599,1000004,1,3786,3350,436,0.884839,0.115161,0.884839,346,90,3787,3351,436,0.884869,0.115131,0.884869,346,90,-1, abandoned,0,0,0
49599,1000132,2,632,545,87,0.862342,0.137658,1.747181,70,17,635,546,89,0.859843,0.140157,1.744712,72,17,1, abandoned,1,1,0
49602,1000007,3,1604,1288,316,0.802993,0.197007,2.532909,283,33,1605,1289,316,0.803115,0.196885,2.534037,283,33,1, merged,0,0,0
49602,1000009,2,1467,1217,250,0.829584,0.170416,1.729916,225,25,1470,1220,250,0.829932,0.170068,1.730922,225,25,-1, merged,0,0,0
49629,1000120,2,1834,1598,236,0.87132,0.12868,1.658554,208,28,1835,1599,236,0.87139,0.12861,1.659749,208,28,1, merged,0,0,0
49630,1000003,3,1311,1090,221,0.831426,0.168574,2.550413,194,27,1313,1092,221,0.831683,0.168317,2.55123,194,27,1, merged,0,0,0
49630,1000026,1,529,463,66,0.875236,0.124764,0.875236,63,3,530,464,66,0.875472,0.124528,0.875472,63,3,1, merged,0,0,0
49630,1000199,2,480,405,75,0.84375,0.15625,1.718986,68,7,481,406,75,0.844075,0.155925,1.719547,68,7,1, merged,0,0,0
49643,1000007,3,1605,1289,316,0.803115,0.196885,2.538429,283,33,1606,1290,316,0.803238,0.196762,2.537581,283,33,1, merged,0,0,0
49643,1000026,1,530,464,66,0.875472,0.124528,0.875472,63,3,532,465,67,0.87406,0.12594,0.87406,64,3,1, merged,1,1,0
49643,1000132,2,635,546,89,0.859843,0.140157,1.735314,72,17,637,548,89,0.860283,0.139717,1.734343,72,17,-1, merged,0,0,0
49652,1000054,2,883,757,126,0.857305,0.142695,1.532305,110,16,884,758,126,0.857466,0.142534,1.536478,110,16,1, merged,0,0,0
49654,1000003,4,1313,1092,221,0.831683,0.168317,3.298482,194,27,1315,1094,221,0.831939,0.168061,3.296905,194,27,-1, merged,0,0,0
49654,1000109,2,578,494,84,0.854671,0.145329,1.622724,79,5,580,495,85,0.853448,0.146552,1.621344,80,5,1, merged,1,1,0
49654,1000199,3,481,406,75,0.844075,0.155925,2.466799,68,7,486,410,76,0.843621,0.156379,2.464966,69,7,-1, merged,1,0,0
49655,1000014,1,2625,2171,454,0.827048,0.172952,0.827048,422,32,2626,2172,454,0.827113,0.172887,0.827113,422,32,1, merged,0,0,0
49668,1000007,2,1606,1290,316,0.803238,0.196762,1.550073,283,33,1607,1291,316,0.80336,0.19664,1.551788,283,33,1, merged,0,0,0
49672,1000329,2,3296,2567,729,0.778823,0.221177,1.584705,629,100,3297,2568,729,0.77889,0.22111,1.585342,629,100,1, merged,0,0,0
49673,1000004,1,3787,3351,436,0.884869,0.115131,0.884869,346,90,3790,3354,436,0.88496,0.11504,0.88496,346,90,-1, merged,0,0,0
49673,1000329,2,3297,2568,729,0.77889,0.22111,1.663759,629,100,3298,2568,730,0.778654,0.221346,1.663614,630,100,1, merged,1,1,0
49675,1000004,1,3790,3354,436,0.88496,0.11504,0.88496,346,90,3792,3355,437,0.884757,0.115243,0.884757,347,90,1, merged,1,1,0
49675,1000329,2,3299,2569,730,0.778721,0.221279,1.663681,630,100,3300,2570,730,0.778788,0.221212,1.663545,630,100,1, merged,0,0,0
49679,1000140,1,299,248,51,0.829431,0.170569,0.829431,45,6,300,249,51,0.83,0.17,0.83,45,6,1, merged,0,0,0
49682,1000329,2,3300,2570,730,0.778788,0.221212,1.494066,630,100,3302,2572,730,0.778922,0.221078,1.4981,630,100,-1, merged,0,0,0
49696,1000004,2,3793,3356,437,0.884788,0.115212,1.711901,347,90,3794,3357,437,0.884818,0.115182,1.711683,347,90,1, merged,0,0,0
49696,1000014,1,2626,2172,454,0.827113,0.172887,0.827113,422,32,2628,2173,455,0.826865,0.173135,0.826865,423,32,1, merged,1,1,0
49698,1000004,3,3794,3357,437,0.884818,0.115182,2.591293,347,90,3795,3358,437,0.884848,0.115152,2.589115,347,90,-1, merged,0,0,0
49698,1000023,2,1259,1105,154,0.877681,0.122319,1.706474,138,16,1261,1106,155,0.877082,0.122918,1.704266,139,16,1, merged,1,1,0
49698,1000130,1,514,426,88,0.828794,0.171206,0.828794,68,20,515,426,89,0.827184,0.172816,0.827184,69,20,1, merged,1,1,0
49708,1000004,3,3795,3358,437,0.884848,0.115152,2.634887,347,90,3799,3362,437,0.88497,0.11503,2.634645,347,90,-1, merged,0,0,0
49708,1000009,2,1472,1221,251,0.829484,0.170516,1.750039,226,25,1473,1221,252,0.828921,0.171079,1.749675,227,25,1, merged,1,1,0
49708,1000011,1,793,730,63,0.920555,0.079445,0.920555,58,5,795,732,63,0.920755,0.079245,0.920755,58,5,-1, merged,0,0,0
49712,1000004,1,3799,3362,437,0.88497,0.11503,0.88497,347,90,3800,3363,437,0.885,0.115,0.885,347,90,1, merged,0,0,0
49712,1000132,2,638,548,90,0.858934,0.141066,1.743904,73,17,639,549,90,0.859155,0.140845,1.744155,73,17,1, merged,0,0,0
49728,1000329,1,3304,2574,730,0.779056,0.220944,0.779056,630,100,3305,2575,730,0.779123,0.220877,0.779123,630,100,-1, abandoned,0,0,0
49730,1000026,1,533,466,67,0.874296,0.125704,0.874296,64,3,534,466,68,0.872659,0.127341,0.872659,65,3,1, merged,1,1,0
49735,1000110,2,464,416,48,0.896552,0.103448,1.723736,45,3,465,417,48,0.896774,0.103226,1.724294,45,3,1, merged,0,0,0
49735,1000130,1,515,426,89,0.827184,0.172816,0.827184,69,20,516,427,89,0.827519,0.172481,0.827519,69,20,-1, merged,0,0,0
49739,1000026,2,534,466,68,0.872659,0.127341,1.780157,65,3,536,468,68,0.873134,0.126866,1.77984,65,3,-1, merged,0,0,0
49739,1000153,1,1027,932,95,0.907498,0.092502,0.907498,72,23,1029,933,96,0.906706,0.093294,0.906706,73,23,1, merged,1,1,0
49744,1000070,2,1349,1149,200,0.851742,0.148258,1.663217,174,26,1350,1150,200,0.851852,0.148148,1.66486,174,26,1, merged,0,0,0
49750,1000004,2,3800,3363,437,0.885,0.115,1.64126,347,90,3801,3364,437,0.88503,0.11497,1.641697,347,90,1, merged,0,0,0
49752,1000054,1,884,758,126,0.857466,0.142534,0.857466,110,16,885,759,126,0.857627,0.142373,0.857627,110,16,1, merged,0,0,0
49755,1002169,1,651,501,150,0.769585,0.230415,0.769585,121,29,653,503,150,0.770291,0.229709,0.770291,121,29,-1, merged,0,0,0
49756,1000329,1,3305,2575,730,0.779123,0.220877,0.779123,630,100,3307,2577,730,0.779256,0.220744,0.779256,630,100,-1, merged,0,0,0
49758,1000121,2,2324,1918,406,0.825301,0.174699,1.595592,379,27,2325,1919,406,0.825376,0.174624,1.596019,379,27,1, merged,0,0,0
49758,1002169,1,653,503,150,0.770291,0.229709,0.770291,121,29,654,504,150,0.770642,0.229358,0.770642,121,29,-1, merged,0,0,0
49760,1000014,3,2629,2174,455,0.82693,0.17307,2.34704,423,32,2631,2176,455,0.827062,0.172938,2.346711,423,32,-1, merged,0,0,0
49760,1000328,2,984,729,255,0.740854,0.259146,1.52011,230,25,987,731,256,0.740628,0.259372,1.519649,231,25,-1, merged,1,0,0
49760,1000329,1,3307,2577,730,0.779256,0.220744,0.779256,630,100,3308,2577,731,0.779021,0.220979,0.779021,631,100,1, merged,1,1,0
49761,1000130,2,516,427,89,0.827519,0.172481,1.628905,69,20,517,428,89,0.827853,0.172147,1.627392,69,20,-1, abandoned,0,0,0
49766,1000004,2,3801,3364,437,0.88503,0.11497,1.743065,347,90,3802,3365,437,0.88506,0.11494,1.743316,347,90,1, merged,0,0,0
49766,1000132,1,641,550,91,0.858034,0.141966,0.858034,74,17,642,551,91,0.858255,0.141745,0.858255,74,17,1, merged,0,0,0
49769,1000014,1,2631,2176,455,0.827062,0.172938,0.827062,423,32,2633,2178,455,0.827193,0.172807,0.827193,423,32,-1, merged,0,0,0
49769,1000015,2,2187,1956,231,0.894376,0.105624,1.721438,211,20,2188,1957,231,0.894424,0.105576,1.721617,211,20,1, merged,0,0,0
49770,1000105,1,670,526,144,0.785075,0.214925,0.785075,127,17,671,526,145,0.783905,0.216095,0.783905,128,17,1, merged,1,1,0
49770,1000140,2,301,250,51,0.830565,0.169435,1.615639,45,6,302,251,51,0.831126,0.168874,1.61503,45,6,1, merged,0,0,0
49772,1000015,2,2188,1957,231,0.894424,0.105576,1.800341,211,20,2189,1958,231,0.894472,0.105528,1.79882,211,20,1, merged,0,0,0
49772,1000153,1,1031,934,97,0.905917,0.094083,0.905917,73,24,1035,936,99,0.904348,0.095652,0.904348,73,26,1, merged,1,0,0
49774,1000153,2,1036,937,99,0.90444,0.09556,1.672838,73,26,1037,938,99,0.904532,0.095468,1.673431,73,26,1, merged,0,0,0
49777,1002169,1,654,504,150,0.770642,0.229358,0.770642,121,29,656,505,151,0.769817,0.230183,0.769817,121,30,-1, merged,1,0,0
49782,1000003,1,1315,1094,221,0.831939,0.168061,0.831939,194,27,1318,1095,223,0.830804,0.169196,0.830804,196,27,1, merged,1,1,0
49788,1000014,1,2634,2179,455,0.827259,0.172741,0.827259,423,32,2636,2181,455,0.82739,0.17261,0.82739,423,32,-1, merged,0,0,0
49790,1000009,2,1474,1222,252,0.829037,0.170963,1.749791,227,25,1475,1223,252,0.829153,0.170847,1.750007,227,25,1, merged,0,0,0
49790,1000011,1,795,732,63,0.920755,0.079245,0.920755,58,5,796,733,63,0.920854,0.079146,0.920854,58,5,1, merged,0,0,0
49794,1000003,3,1319,1096,223,0.830933,0.169067,2.444412,196,27,1320,1097,223,0.831061,0.168939,2.445851,196,27,1, merged,0,0,0
49794,1000199,2,489,413,76,0.844581,0.155419,1.613479,69,7,490,414,76,0.844898,0.155102,1.61479,69,7,1, merged,0,0,0
49797,1000004,2,3802,3365,437,0.88506,0.11494,1.743316,347,90,3803,3366,437,0.885091,0.114909,1.743567,347,90,1, merged,0,0,0
49797,1000132,1,642,551,91,0.858255,0.141745,0.858255,74,17,643,552,91,0.858476,0.141524,0.858476,74,17,1, merged,0,0,0
49799,1000199,1,490,414,76,0.844898,0.155102,0.844898,69,7,491,415,76,0.845214,0.154786,0.845214,69,7,1, merged,0,0,0
49803,1000004,3,3803,3366,437,0.885091,0.114909,2.476148,347,90,3805,3368,437,0.885151,0.114849,2.463742,347,90,-1, merged,0,0,0
49803,1000009,1,1475,1223,252,0.829153,0.170847,0.829153,227,25,1476,1223,253,0.828591,0.171409,0.828591,228,25,1, merged,1,1,0
49808,1000004,2,3805,3368,437,0.885151,0.114849,1.785151,347,90,3806,3369,437,0.885181,0.114819,1.801848,347,90,1, merged,0,0,0
49809,1000011,2,796,733,63,0.920854,0.079146,1.815327,58,5,797,734,63,0.920954,0.079046,1.815474,58,5,1, merged,0,0,0
49809,1000015,1,2189,1958,231,0.894472,0.105528,0.894472,211,20,2190,1959,231,0.894521,0.105479,0.894521,211,20,1, merged,0,0,0
49809,1000153,3,1037,938,99,0.904532,0.095468,2.719859,73,26,1038,939,99,0.904624,0.095376,2.720098,73,26,1, merged,0,0,0
49811,1000054,2,885,759,126,0.857627,0.142373,1.68931,110,16,886,760,126,0.857788,0.142212,1.690025,110,16,1, merged,0,0,0
49811,1000140,1,303,252,51,0.831683,0.168317,0.831683,45,6,304,253,51,0.832237,0.167763,0.832237,45,6,1, merged,0,0,0
49816,1000026,2,538,470,68,0.873606,0.126394,1.548606,65,3,539,471,68,0.87384,0.12616,1.556767,65,3,1, merged,0,0,0
49825,1000004,1,3806,3369,437,0.885181,0.114819,0.885181,347,90,3809,3371,438,0.885009,0.114991,0.885009,347,91,-1, merged,1,0,0
49827,1000004,2,3809,3371,438,0.885009,0.114991,1.712465,347,91,3810,3372,438,0.885039,0.114961,1.712626,347,91,1, merged,0,0,0
49827,1000014,1,2637,2182,455,0.827455,0.172545,0.827455,423,32,2639,2184,455,0.827586,0.172414,0.827586,423,32,1, merged,0,0,0
49831,1000004,2,3810,3372,438,0.885039,0.114961,1.756639,347,91,3811,3373,438,0.88507,0.11493,1.756739,347,91,1, merged,0,0,0
49831,1000120,1,1838,1602,236,0.8716,0.1284,0.8716,208,28,1839,1603,236,0.871669,0.128331,0.871669,208,28,1, merged,0,0,0
49832,1000004,2,3811,3373,438,0.88507,0.11493,1.756739,347,91,3812,3374,438,0.8851,0.1149,1.756839,347,91,1, merged,0,0,0
49832,1000120,1,1839,1603,236,0.871669,0.128331,0.871669,208,28,1840,1604,236,0.871739,0.128261,0.871739,208,28,1, merged,0,0,0
49833,1000120,1,1840,1604,236,0.871739,0.128261,0.871739,208,28,1841,1604,237,0.871266,0.128734,0.871266,209,28,1, abandoned,1,1,0
49833,1000121,3,2327,1921,406,0.825526,0.174474,2.476353,379,27,2328,1922,406,0.825601,0.174399,2.476021,379,27,-1, abandoned,0,0,0
49833,1000329,2,3309,2578,731,0.779087,0.220913,1.650826,631,100,3310,2579,731,0.779154,0.220846,1.65042,631,100,-1, abandoned,0,0,0
49835,1000105,2,672,527,145,0.784226,0.215774,1.609828,128,17,673,528,145,0.784547,0.215453,1.610223,128,17,1, merged,0,0,0
49835,1000121,1,2328,1922,406,0.825601,0.174399,0.825601,379,27,2329,1923,406,0.825676,0.174324,0.825676,379,27,1, merged,0,0,0
49840,1000003,2,1320,1097,223,0.831061,0.168939,1.600878,196,27,1322,1098,224,0.83056,0.16944,1.601425,196,28,-1, merged,1,0,0
49840,1000329,3,3310,2579,731,0.779154,0.220846,2.380032,631,100,3311,2579,732,0.778919,0.221081,2.380343,631,101,-1, merged,1,1,0
49840,1002169,1,656,505,151,0.769817,0.230183,0.769817,121,30,659,508,151,0.770865,0.229135,0.770865,121,30,-1, merged,0,0,0
49841,1000004,2,3812,3374,438,0.8851,0.1149,1.743576,347,91,3813,3375,438,0.88513,0.11487,1.743825,347,91,1, merged,0,0,0
49841,1000132,1,643,552,91,0.858476,0.141524,0.858476,74,17,644,553,91,0.858696,0.141304,0.858696,74,17,1, merged,0,0,0
49842,1000026,2,539,471,68,0.87384,0.12616,1.778465,65,3,540,472,68,0.874074,0.125926,1.77879,65,3,-1, merged,0,0,0
49842,1000153,1,1038,939,99,0.904624,0.095376,0.904624,73,26,1039,940,99,0.904716,0.095284,0.904716,73,26,-1, merged,0,0,0
49850,1000004,2,3814,3376,438,0.88516,0.11484,1.712746,347,91,3815,3377,438,0.88519,0.11481,1.712842,347,91,1, merged,0,0,0
49850,1000014,1,2639,2184,455,0.827586,0.172414,0.827586,423,32,2640,2185,455,0.827652,0.172348,0.827652,423,32,1, merged,0,0,0
49850,1000043,3,618,520,98,0.841424,0.158576,2.55417,84,14,619,521,98,0.84168,0.15832,2.554522,84,14,1, merged,0,0,0
49854,1000014,2,2640,2185,455,0.827652,0.172348,1.679613,423,32,2641,2186,455,0.827717,0.172283,1.679788,423,32,1, merged,0,0,0
49854,1000070,1,1351,1151,200,0.851962,0.148038,0.851962,174,26,1352,1152,200,0.852071,0.147929,0.852071,174,26,1, merged,0,0,0
49856,1000009,2,1478,1225,253,0.828823,0.171177,1.450444,228,25,1479,1226,253,0.828938,0.171062,1.460517,228,25,1, merged,0,0,0
49859,1000004,1,3816,3378,438,0.88522,0.11478,0.88522,347,91,3817,3379,438,0.88525,0.11475,0.88525,347,91,-1, merged,0,0,0
49859,1000121,4,2330,1924,406,0.825751,0.174249,3.303449,379,27,2331,1925,406,0.825826,0.174174,3.305321,379,27,1, merged,0,0,0
49859,1000329,3,3311,2579,732,0.778919,0.221081,2.477698,631,101,3314,2582,732,0.779119,0.220881,2.479495,631,101,-1, merged,0,0,0
49861,1000121,2,2331,1925,406,0.825826,0.174174,1.604945,379,27,2332,1926,406,0.825901,0.174099,1.605086,379,27,1, merged,0,0,0
49861,1000329,1,3314,2582,732,0.779119,0.220881,0.779119,631,101,3315,2583,732,0.779186,0.220814,0.779186,631,101,1, merged,0,0,0
49864,1000328,1,988,732,256,0.740891,0.259109,0.740891,231,25,990,732,258,0.739394,0.260606,0.739394,233,25,1, merged,1,1,0
49864,1000329,2,3317,2585,732,0.779319,0.220681,1.520209,631,101,3319,2586,733,0.77915,0.22085,1.518544,631,102,-1, merged,1,0,0
49872,1000005,2,678,569,109,0.839233,0.160767,1.665134,101,8,679,570,109,0.83947,0.16053,1.665445,101,8,1, merged,0,0,0
49872,1000121,1,2332,1926,406,0.825901,0.174099,0.825901,379,27,2333,1927,406,0.825975,0.174025,0.825975,379,27,1, merged,0,0,0
49880,1000014,3,2641,2186,455,0.827717,0.172283,2.613127,423,32,2642,2187,455,0.827782,0.172218,2.616166,423,32,1, merged,0,0,0
49883,1000105,1,676,531,145,0.785503,0.214497,0.785503,128,17,677,531,146,0.784343,0.215657,0.784343,129,17,1, abandoned,1,1,0
49884,1000108,2,294,244,50,0.829932,0.170068,1.637932,46,4,296,245,51,0.827703,0.172297,1.637227,47,4,1, abandoned,1,1,0
49888,1000120,3,1841,1604,237,0.871266,0.128734,2.613132,209,28,1842,1605,237,0.871336,0.128664,2.614925,209,28,1, merged,0,0,0
49889,1000328,1,990,732,258,0.739394,0.260606,0.739394,233,25,991,732,259,0.738648,0.261352,0.738648,233,26,-1, merged,1,1,0
49889,1000329,2,3320,2587,733,0.779217,0.220783,1.518611,631,102,3321,2587,734,0.778982,0.221018,1.51763,631,103,-1, merged,1,1,0
49891,1000014,2,2642,2187,455,0.827782,0.172218,1.687595,423,32,2643,2188,455,0.827847,0.172153,1.687987,423,32,1, merged,0,0,0
49892,1000015,2,2190,1959,231,0.894521,0.105479,1.748367,211,20,2191,1960,231,0.894569,0.105431,1.749531,211,20,1, merged,0,0,0
49897,1000009,2,1479,1226,253,0.828938,0.171062,1.577366,228,25,1481,1228,253,0.829169,0.170831,1.546037,228,25,-1, merged,0,0,0
49899,1000003,1,1323,1099,224,0.830688,0.169312,0.830688,196,28,1324,1099,225,0.83006,0.16994,0.83006,197,28,1, merged,1,1,0
49899,1000153,2,1041,942,99,0.904899,0.095101,1.735587,73,26,1042,943,99,0.90499,0.09501,1.735051,73,26,1, merged,0,0,0
49900,1000070,1,1352,1152,200,0.852071,0.147929,0.852071,174,26,1353,1153,200,0.85218,0.14782,0.85218,174,26,1, merged,0,0,0
49900,1000121,2,2333,1927,406,0.825975,0.174025,1.678046,379,27,2334,1928,406,0.82605,0.17395,1.67823,379,27,1, merged,0,0,0
49905,1000026,1,540,472,68,0.874074,0.125926,0.874074,65,3,541,473,68,0.874307,0.125693,0.874307,65,3,1, merged,0,0,0
49908,1000014,1,2643,2188,455,0.827847,0.172153,0.827847,423,32,2644,2189,455,0.827912,0.172088,0.827912,423,32,1, merged,0,0,0
49908,1000132,2,647,556,91,0.859351,0.140649,1.687198,74,17,648,557,91,0.859568,0.140432,1.68748,74,17,1, merged,0,0,0
49913,1000120,2,1842,1605,237,0.871336,0.128664,1.666207,209,28,1843,1606,237,0.871405,0.128595,1.667324,209,28,1, merged,0,0,0
49918,1000070,2,1353,1153,200,0.85218,0.14782,1.711748,174,26,1354,1154,200,0.85229,0.14771,1.709213,174,26,1, merged,0,0,0
49918,1000132,1,648,557,91,0.859568,0.140432,0.859568,74,17,650,557,93,0.856923,0.143077,0.856923,74,19,-1, merged,1,1,0
49919,1000007,4,1611,1295,316,0.803849,0.196151,3.422905,283,33,1612,1296,316,0.80397,0.19603,3.419125,283,33,1, merged,0,0,0
49919,1000015,6,2192,1961,231,0.894617,0.105383,5.119502,211,20,2193,1962,231,0.894665,0.105335,5.117711,211,20,1, merged,0,0,0
49919,1000132,3,650,557,93,0.856923,0.143077,2.619056,74,19,652,558,94,0.855828,0.144172,2.615155,75,19,1, merged,1,1,0
49919,1000153,1,1042,943,99,0.90499,0.09501,0.90499,73,26,1043,943,100,0.904123,0.095877,0.904123,74,26,1, merged,1,1,0
49921,1000015,2,2193,1962,231,0.894665,0.105335,1.763415,211,20,2194,1963,231,0.894713,0.105287,1.764278,211,20,1, merged,0,0,0
49923,1000110,2,470,422,48,0.897872,0.102128,1.730659,45,3,471,423,48,0.898089,0.101911,1.731423,45,3,1, merged,0,0,0
49923,1000140,1,305,254,51,0.832787,0.167213,0.832787,45,6,306,255,51,0.833333,0.166667,0.833333,45,6,1, merged,0,0,0
49933,1000004,1,3817,3379,438,0.88525,0.11475,0.88525,347,91,3818,3380,438,0.88528,0.11472,0.88528,347,91,1, merged,0,0,0
49933,1000043,2,619,521,98,0.84168,0.15832,1.72693,84,14,620,522,98,0.841935,0.158065,1.727216,84,14,1, merged,0,0,0
49955,1000007,1,1612,1296,316,0.80397,0.19603,0.80397,283,33,1613,1297,316,0.804092,0.195908,0.804092,283,33,1, merged,0,0,0
49955,1000153,2,1044,944,100,0.904215,0.095785,1.708185,74,26,1045,945,100,0.904306,0.095694,1.708398,74,26,1, merged,0,0,0
49956,1000015,2,2194,1963,231,0.894713,0.105287,1.799019,211,20,2195,1964,231,0.894761,0.105239,1.799159,211,20,1, merged,0,0,0
49956,1000153,1,1045,945,100,0.904306,0.095694,0.904306,74,26,1046,946,100,0.904398,0.095602,0.904398,74,26,1, merged,0,0,0
49958,1000014,2,2658,2196,462,0.826185,0.173815,1.654468,430,32,2659,2197,462,0.82625,0.17375,1.652337,430,32,-1, merged,0,0,0
49958,1000108,1,297,246,51,0.828283,0.171717,0.828283,47,4,299,247,52,0.826087,0.173913,0.826087,48,4,1, merged,1,1,0
49959,1000110,2,472,424,48,0.898305,0.101695,1.802703,45,3,473,425,48,0.89852,0.10148,1.803009,45,3,1, merged,0,0,0
49959,1000153,1,1046,946,100,0.904398,0.095602,0.904398,74,26,1047,947,100,0.904489,0.095511,0.904489,74,26,1, merged,0,0,0
49960,1000026,2,541,473,68,0.874307,0.125693,1.737321,65,3,542,474,68,0.874539,0.125461,1.73802,65,3,1, merged,0,0,0
49961,1000003,2,1326,1101,225,0.830317,0.169683,1.675845,197,28,1327,1102,225,0.830445,0.169555,1.672869,197,28,-1, merged,0,0,0
49961,1000199,1,492,416,76,0.845528,0.154472,0.845528,69,7,495,417,78,0.842424,0.157576,0.842424,71,7,1, merged,1,1,0
49964,1000003,2,1327,1102,225,0.830445,0.169555,1.609259,197,28,1328,1103,225,0.830572,0.169428,1.609453,197,28,1, merged,0,0,0
49964,1000329,1,3323,2588,735,0.778814,0.221186,0.778814,631,104,3324,2589,735,0.778881,0.221119,0.778881,631,104,1, merged,0,0,0
49965,1000121,2,2335,1929,406,0.826124,0.173876,1.605005,379,27,2336,1930,406,0.826199,0.173801,1.605146,379,27,1, merged,0,0,0
49965,1000329,1,3324,2589,735,0.778881,0.221119,0.778881,631,104,3325,2590,735,0.778947,0.221053,0.778947,631,104,1, merged,0,0,0
49966,1000003,2,1328,1103,225,0.830572,0.169428,1.60952,197,28,1329,1104,225,0.8307,0.1693,1.609714,197,28,1, merged,0,0,0
49966,1000329,1,3325,2590,735,0.778947,0.221053,0.778947,631,104,3326,2591,735,0.779014,0.220986,0.779014,631,104,1, merged,0,0,0
49967,1000003,3,1329,1104,225,0.8307,0.1693,2.435912,197,28,1330,1105,225,0.830827,0.169173,2.43618,197,28,1, merged,0,0,0
49967,1000121,2,2336,1930,406,0.826199,0.173801,1.605212,379,27,2337,1931,406,0.826273,0.173727,1.605353,379,27,1, merged,0,0,0
49967,1000329,1,3326,2591,735,0.779014,0.220986,0.779014,631,104,3327,2592,735,0.77908,0.22092,0.77908,631,104,1, merged,0,0,0
49971,1000153,1,1047,947,100,0.904489,0.095511,0.904489,74,26,1051,951,100,0.904853,0.095147,0.904853,74,26,-1, merged,0,0,0
49971,1000199,2,495,417,78,0.842424,0.157576,1.746913,71,7,498,419,79,0.841365,0.158635,1.746218,72,7,-1, merged,1,0,0
49972,1000003,2,1330,1105,225,0.830827,0.169173,1.73568,197,28,1332,1107,225,0.831081,0.168919,1.736114,197,28,-1, merged,0,0,0
49972,1000109,3,584,498,86,0.85274,0.14726,2.588419,81,5,585,498,87,0.851282,0.148718,2.587396,82,5,1, merged,1,1,0
49972,1000153,1,1051,951,100,0.904853,0.095147,0.904853,74,26,1053,953,100,0.905033,0.094967,0.905033,74,26,-1, merged,0,0,0
49973,1000004,1,3818,3380,438,0.88528,0.11472,0.88528,347,91,3819,3381,438,0.88531,0.11469,0.88531,347,91,1, merged,0,0,0
49979,1000329,2,3328,2593,735,0.779147,0.220853,1.487884,631,104,3329,2594,735,0.779213,0.220787,1.490751,631,104,1, merged,0,0,0
49981,1000091,2,598,467,131,0.780936,0.219064,1.495222,111,20,599,468,131,0.781302,0.218698,1.491583,111,20,1, merged,0,0,0
49987,1000014,2,2659,2197,462,0.82625,0.17375,1.564898,430,32,2660,2198,462,0.826316,0.173684,1.565227,430,32,1, merged,0,0,0
49987,1000328,1,991,732,259,0.738648,0.261352,0.738648,233,26,992,733,259,0.738911,0.261089,0.738911,233,26,1, merged,0,0,0
49990,1000110,2,473,425,48,0.89852,0.10148,1.733472,45,3,474,426,48,0.898734,0.101266,1.734218,45,3,1, merged,0,0,0
49990,1000140,1,309,258,51,0.834951,0.165049,0.834951,45,6,310,259,51,0.835484,0.164516,0.835484,45,6,1, merged,0,0,0
49992,1000026,2,542,474,68,0.874539,0.125461,1.541205,65,3,543,475,68,0.87477,0.12523,1.549188,65,3,1, merged,0,0,0
49997,1000329,4,3329,2594,735,0.779213,0.220787,2.764728,631,104,3330,2595,735,0.779279,0.220721,2.804977,631,104,1, merged,0,0,0
49998,1000007,1,1613,1297,316,0.804092,0.195908,0.804092,283,33,1614,1297,317,0.803594,0.196406,0.803594,284,33,1, merged,1,1,0
49998,1000009,2,1481,1228,253,0.829169,0.170831,1.633261,228,25,1482,1229,253,0.829285,0.170715,1.632878,228,25,1, merged,0,0,0
49999,1000014,2,2660,2198,462,0.826316,0.173684,1.565227,430,32,2661,2199,462,0.826381,0.173619,1.564812,430,32,1, merged,0,0,0
49999,1000328,1,992,733,259,0.738911,0.261089,0.738911,233,26,994,734,260,0.738431,0.261569,0.738431,234,26,1, merged,1,1,0
50001,1000004,3,3819,3381,438,0.88531,0.11469,2.531569,347,91,3821,3382,439,0.885109,0.114891,2.446019,348,91,1, merged,1,1,0
50006,1000132,2,652,558,94,0.855828,0.144172,1.661653,75,19,653,559,94,0.856049,0.143951,1.663741,75,19,1, merged,0,0,0
50008,1000199,1,498,419,79,0.841365,0.158635,0.841365,72,7,499,420,79,0.841683,0.158317,0.841683,72,7,1, merged,0,0,0
50010,1000091,2,599,468,131,0.781302,0.218698,1.642091,111,20,600,469,131,0.781667,0.218333,1.642778,111,20,1, merged,0,0,0
50012,1000004,1,3821,3382,439,0.885109,0.114891,0.885109,348,91,3822,3382,440,0.884877,0.115123,0.884877,349,91,1, abandoned,1,1,0
50015,1000026,2,543,475,68,0.87477,0.12523,1.735881,65,3,544,476,68,0.875,0.125,1.736751,65,3,1, merged,0,0,0
50021,1000011,2,797,734,63,0.920954,0.079046,1.782705,58,5,798,735,63,0.921053,0.078947,1.783122,58,5,1, merged,0,0,0
50023,1000026,3,544,476,68,0.875,0.125,2.527719,65,3,545,477,68,0.875229,0.124771,2.528823,65,3,1, merged,0,0,0
50023,1000153,2,1054,954,100,0.905123,0.094877,1.652719,74,26,1057,957,100,0.905393,0.094607,1.653594,74,26,-1, merged,0,0,0
50023,1000534,1,416,311,105,0.747596,0.252404,0.747596,95,10,417,312,105,0.748201,0.251799,0.748201,95,10,-1, merged,0,0,0
50028,1000005,2,682,573,109,0.840176,0.159824,1.668459,101,8,683,574,109,0.84041,0.15959,1.669556,101,8,1, merged,0,0,0
50028,1000043,3,620,522,98,0.841935,0.158065,2.510394,84,14,621,523,98,0.84219,0.15781,2.511746,84,14,1, merged,0,0,0
50029,1000004,2,3824,3384,440,0.884937,0.115063,1.662715,349,91,3825,3385,440,0.884967,0.115033,1.674441,349,91,1, merged,0,0,0
50035,1000007,2,1614,1297,317,0.803594,0.196406,1.520461,284,33,1615,1298,317,0.803715,0.196285,1.522278,284,33,1, merged,0,0,0
50037,1000153,2,1057,957,100,0.905393,0.094607,1.619678,74,26,1058,958,100,0.905482,0.094518,1.611364,74,26,-1, abandoned,0,0,0
50044,1000132,2,653,559,94,0.856049,0.143951,1.665573,75,19,654,560,94,0.856269,0.143731,1.667293,75,19,1, merged,0,0,0
50046,1000105,1,678,532,146,0.784661,0.215339,0.784661,129,17,679,533,146,0.784978,0.215022,0.784978,129,17,1, merged,0,0,0
50046,1000121,2,2343,1936,407,0.826291,0.173709,1.610952,379,28,2344,1937,407,0.826365,0.173635,1.611343,379,28,1, merged,0,0,0
50053,1000070,1,1355,1155,200,0.852399,0.147601,0.852399,174,26,1357,1155,202,0.851142,0.148858,0.851142,176,26,1, abandoned,1,1,0
50053,1000105,2,680,533,147,0.783824,0.216176,1.636222,130,17,681,534,147,0.784141,0.215859,1.635283,130,17,-1, abandoned,0,0,0
50064,1000329,1,3330,2595,735,0.779279,0.220721,0.779279,631,104,3331,2595,736,0.779045,0.220955,0.779045,632,104,1, abandoned,1,1,0
50065,1000329,2,3331,2595,736,0.779045,0.220955,1.548742,632,104,3332,2596,736,0.779112,0.220888,1.549157,632,104,-1, abandoned,0,0,0
50065,1002169,1,660,508,152,0.769697,0.230303,0.769697,121,31,661,509,152,0.770045,0.229955,0.770045,121,31,-1, abandoned,0,0,0
50066,1000329,2,3332,2596,736,0.779112,0.220888,1.549157,632,104,3333,2596,737,0.778878,0.221122,1.549617,633,104,1, abandoned,1,1,0
50066,1002169,1,661,509,152,0.770045,0.229955,0.770045,121,31,663,511,152,0.770739,0.229261,0.770739,121,31,-1, abandoned,0,0,0
50067,1000121,3,2344,1937,407,0.826365,0.173635,2.375982,379,28,2347,1939,408,0.826161,0.173839,2.3779,380,28,-1, abandoned,1,0,0
50067,1000329,2,3333,2596,737,0.778878,0.221122,1.549617,633,104,3334,2597,737,0.778944,0.221056,1.551739,633,104,-1, abandoned,0,0,0
50067,1002169,1,663,511,152,0.770739,0.229261,0.770739,121,31,669,517,152,0.772795,0.227205,0.772795,121,31,-1, abandoned,0,0,0
50069,1000329,2,3335,2598,737,0.77901,0.22099,1.551806,633,104,3336,2599,737,0.779077,0.220923,1.552211,633,104,-1, abandoned,0,0,0
50069,1002169,1,669,517,152,0.772795,0.227205,0.772795,121,31,670,518,152,0.773134,0.226866,0.773134,121,31,-1, abandoned,0,0,0
50070,1000043,1,622,524,98,0.842444,0.157556,0.842444,84,14,623,524,99,0.841091,0.158909,0.841091,85,14,1, abandoned,1,1,0
50070,1000329,2,3336,2599,737,0.779077,0.220923,1.62152,633,104,3337,2599,738,0.778843,0.221157,1.619935,634,104,1, abandoned,1,1,0
50071,1000014,2,2663,2201,462,0.826511,0.173489,1.599646,430,32,2670,2205,465,0.825843,0.174157,1.599315,433,32,-1, abandoned,1,0,0
50071,1000329,3,3337,2599,738,0.778843,0.221157,2.378489,634,104,3338,2600,738,0.77891,0.22109,2.378225,634,104,-1, abandoned,0,0,0
50071,1002169,1,670,518,152,0.773134,0.226866,0.773134,121,31,671,519,152,0.773472,0.226528,0.773472,121,31,-1, abandoned,0,0,0
50072,1000329,1,3338,2600,738,0.77891,0.22109,0.77891,634,104,3339,2601,738,0.778976,0.221024,0.778976,634,104,-1, abandoned,0,0,0
50072,1002169,2,671,519,152,0.773472,0.226528,1.552382,121,31,672,520,152,0.77381,0.22619,1.552785,121,31,-1, abandoned,0,0,0
50074,1000003,2,1332,1107,225,0.831081,0.168919,1.569775,197,28,1333,1108,225,0.831208,0.168792,1.570164,197,28,1, merged,0,0,0
50074,1000328,1,995,735,260,0.738693,0.261307,0.738693,234,26,996,736,260,0.738956,0.261044,0.738956,234,26,1, merged,0,0,0
50077,1000091,1,600,469,131,0.781667,0.218333,0.781667,111,20,601,470,131,0.78203,0.21797,0.78203,111,20,1, merged,0,0,0
50079,1000153,2,1058,958,100,0.905482,0.094518,1.766969,74,26,1059,959,100,0.905571,0.094429,1.764157,74,26,1, merged,0,0,0
50080,1000012,2,638,551,87,0.863636,0.136364,1.722222,84,3,639,552,87,0.86385,0.13615,1.719554,84,3,1, merged,0,0,0
50084,1000091,2,602,471,131,0.782392,0.217608,1.559789,111,20,603,472,131,0.782753,0.217247,1.56091,111,20,1, merged,0,0,0
50104,1000043,1,623,524,99,0.841091,0.158909,0.841091,85,14,625,526,99,0.8416,0.1584,0.8416,85,14,-1, abandoned,0,0,0
50104,1000108,2,300,247,53,0.823333,0.176667,1.664425,49,4,301,247,54,0.820598,0.179402,1.662198,50,4,1, abandoned,1,1,0
50105,1000329,2,3339,2601,738,0.778976,0.221024,1.677002,634,104,3340,2602,738,0.779042,0.220958,1.674124,634,104,-1, abandoned,0,0,0
50107,1000007,3,1615,1298,317,0.803715,0.196285,2.515407,284,33,1617,1300,317,0.803958,0.196042,2.513938,284,33,-1, merged,0,0,0
50107,1000132,1,655,561,94,0.856489,0.143511,0.856489,75,19,656,562,94,0.856707,0.143293,0.856707,75,19,-1, merged,0,0,0
50108,1000132,1,656,562,94,0.856707,0.143293,0.856707,75,19,658,564,94,0.857143,0.142857,0.857143,75,19,-1, abandoned,0,0,0
50114,1000108,1,301,247,54,0.820598,0.179402,0.820598,50,4,302,248,54,0.821192,0.178808,0.821192,50,4,1, merged,0,0,0
50114,1000140,2,314,263,51,0.83758,0.16242,1.658178,45,6,315,264,51,0.838095,0.161905,1.659287,45,6,1, merged,0,0,0
50127,1000091,1,606,475,131,0.783828,0.216172,0.783828,111,20,607,475,132,0.782537,0.217463,0.782537,112,20,1, merged,1,1,0
50127,1000130,2,525,435,90,0.828571,0.171429,1.6124,70,20,526,436,90,0.828897,0.171103,1.611434,70,20,1, merged,0,0,0
50130,1000054,2,891,765,126,0.858586,0.141414,1.625106,110,16,892,766,126,0.858744,0.141256,1.62358,110,16,-1, abandoned,0,0,0
50130,1000166,1,454,348,106,0.76652,0.23348,0.76652,101,5,455,348,107,0.764835,0.235165,0.764835,102,5,1, abandoned,1,1,0
50132,1000014,1,2674,2208,466,0.825729,0.174271,0.825729,433,33,2676,2210,466,0.825859,0.174141,0.825859,433,33,-1, merged,0,0,0
50132,1000120,2,1844,1607,237,0.871475,0.128525,1.697204,209,28,1845,1608,237,0.871545,0.128455,1.697404,209,28,1, merged,0,0,0
50163,1000120,2,1852,1614,238,0.87149,0.12851,1.650532,210,28,1853,1615,238,0.87156,0.12844,1.650368,210,28,1, merged,0,0,0
50163,1000329,1,3340,2602,738,0.779042,0.220958,0.779042,634,104,3341,2602,739,0.778809,0.221191,0.778809,635,104,1, merged,1,1,0
50164,1000004,2,3826,3386,440,0.884997,0.115003,1.756557,349,91,3827,3387,440,0.885027,0.114973,1.756656,349,91,1, merged,0,0,0
50164,1000120,1,1853,1615,238,0.87156,0.12844,0.87156,210,28,1854,1616,238,0.871629,0.128371,0.871629,210,28,1, merged,0,0,0
50170,1000120,3,1855,1617,238,0.871698,0.128302,2.355052,210,28,1856,1618,238,0.871767,0.128233,2.339531,210,28,1, merged,0,0,0
50170,1000329,2,3341,2602,739,0.778809,0.221191,1.483354,635,104,3342,2603,739,0.778875,0.221125,1.467764,635,104,-1, merged,0,0,0
50172,1000004,2,3827,3387,440,0.885027,0.114973,1.779932,349,91,3828,3388,440,0.885057,0.114943,1.78001,349,91,1, merged,0,0,0
50172,1000015,1,2198,1967,231,0.894904,0.105096,0.894904,211,20,2199,1968,231,0.894952,0.105048,0.894952,211,20,1, merged,0,0,0
50175,1000004,2,3828,3388,440,0.885057,0.114943,1.780057,349,91,3829,3389,440,0.885087,0.114913,1.780135,349,91,1, merged,0,0,0
50175,1000015,1,2200,1969,231,0.895,0.105,0.895,211,20,2201,1970,231,0.895048,0.104952,0.895048,211,20,1, merged,0,0,0
50176,1000004,2,3829,3389,440,0.885087,0.114913,1.780135,349,91,3830,3390,440,0.885117,0.114883,1.780213,349,91,1, merged,0,0,0
50176,1000015,1,2201,1970,231,0.895048,0.104952,0.895048,211,20,2202,1971,231,0.895095,0.104905,0.895095,211,20,1, merged,0,0,0
50188,1000004,2,3830,3390,440,0.885117,0.114883,1.663992,349,91,3832,3392,440,0.885177,0.114823,1.663653,349,91,-1, abandoned,0,0,0
50188,1000054,4,892,766,126,0.858744,0.141256,3.394504,110,16,893,766,127,0.857783,0.142217,3.392733,111,16,1, abandoned,1,1,0
50188,1000120,3,1856,1618,238,0.871767,0.128233,2.53576,210,28,1857,1618,239,0.871298,0.128702,2.534951,211,28,1, abandoned,1,1,0
50188,1000329,1,3342,2603,739,0.778875,0.221125,0.778875,635,104,3345,2604,741,0.778475,0.221525,0.778475,637,104,-1, abandoned,1,0,0
50189,1000004,2,3832,3392,440,0.885177,0.114823,1.650013,349,91,3833,3393,440,0.885207,0.114793,1.650558,349,91,1, merged,0,0,0
50189,1000166,1,455,348,107,0.764835,0.235165,0.764835,102,5,456,349,107,0.765351,0.234649,0.765351,102,5,1, merged,0,0,0
50190,1000054,2,893,766,127,0.857783,0.142217,1.684166,111,16,894,767,127,0.857942,0.142058,1.683973,111,16,1, merged,0,0,0
50190,1000091,3,608,476,132,0.782895,0.217105,2.46706,112,20,609,476,133,0.781609,0.218391,2.465583,112,21,-1, merged,1,1,0
50190,1000121,1,2350,1942,408,0.826383,0.173617,0.826383,380,28,2351,1942,409,0.826031,0.173969,0.826031,380,29,-1, merged,1,1,0
50190,1000166,4,456,349,107,0.765351,0.234649,3.232411,102,5,457,350,107,0.765864,0.234136,3.231447,102,5,1, merged,0,0,0
50195,1000004,3,3834,3394,440,0.885237,0.114763,2.530681,349,91,3835,3395,440,0.885267,0.114733,2.529631,349,91,1, merged,0,0,0
50195,1000120,2,1857,1618,239,0.871298,0.128702,1.645443,211,28,1858,1619,239,0.871367,0.128633,1.644364,211,28,1, merged,0,0,0
50195,1002169,1,673,521,152,0.774146,0.225854,0.774146,121,31,674,521,153,0.772997,0.227003,0.772997,121,32,-1, merged,1,1,0
50196,1000121,2,2351,1942,409,0.826031,0.173969,1.599029,380,29,2353,1943,410,0.825754,0.174246,1.599088,381,29,1, merged,1,1,0
50196,1000329,3,3345,2604,741,0.778475,0.221525,2.377504,637,104,3347,2606,741,0.778608,0.221392,2.377695,637,104,-1, merged,0,0,0
50196,1002169,1,674,521,153,0.772997,0.227003,0.772997,121,32,675,522,153,0.773333,0.226667,0.773333,121,32,-1, merged,0,0,0
50197,1000120,3,1858,1619,239,0.871367,0.128633,2.470455,211,28,1859,1619,240,0.870898,0.129102,2.470045,212,28,1, merged,1,1,0
50197,1000121,2,2353,1943,410,0.825754,0.174246,1.599088,381,29,2355,1944,411,0.825478,0.174522,1.599146,382,29,1, merged,1,1,0
50197,1000329,4,3347,2606,741,0.778608,0.221392,3.249062,637,104,3349,2607,742,0.778441,0.221559,3.248486,638,104,1, merged,1,1,0
50197,1002169,1,675,522,153,0.773333,0.226667,0.773333,121,32,676,523,153,0.773669,0.226331,0.773669,121,32,-1, merged,0,0,0
50198,1000011,2,806,743,63,0.921836,0.078164,1.797294,58,5,807,744,63,0.921933,0.078067,1.796021,58,5,1, merged,0,0,0
50198,1000026,1,546,478,68,0.875458,0.124542,0.875458,65,3,548,479,69,0.874088,0.125912,0.874088,66,3,-1, merged,1,0,0
50201,1000153,1,1060,960,100,0.90566,0.09434,0.90566,74,26,1061,960,101,0.904807,0.095193,0.904807,75,26,1, merged,1,1,0
50202,1000592,2,731,619,112,0.846785,0.153215,1.559748,69,43,733,620,113,0.845839,0.154161,1.561435,69,44,-1, merged,1,1,0
50231,1000004,3,3837,3397,440,0.885327,0.114673,2.58228,349,91,3839,3399,440,0.885387,0.114613,2.581767,349,91,-1, merged,0,0,0
50231,1000014,1,2679,2213,466,0.826054,0.173946,0.826054,433,33,2681,2214,467,0.825811,0.174189,0.825811,434,33,1, merged,1,1,0
50231,1000120,2,1859,1619,240,0.870898,0.129102,1.696953,212,28,1862,1621,241,0.870569,0.129431,1.696381,213,28,1, merged,1,1,0
50235,1000011,2,810,747,63,0.922222,0.077778,1.743651,58,5,811,748,63,0.922318,0.077682,1.749904,58,5,1, merged,0,0,0
50239,1000054,1,895,767,128,0.856983,0.143017,0.856983,112,16,896,768,128,0.857143,0.142857,0.857143,112,16,1, merged,0,0,0
50239,1000110,2,478,430,48,0.899582,0.100418,1.756565,45,3,479,431,48,0.899791,0.100209,1.756934,45,3,1, merged,0,0,0
50240,1000054,1,896,768,128,0.857143,0.142857,0.857143,112,16,898,769,129,0.856347,0.143653,0.856347,113,16,1, merged,1,1,0
50240,1000110,2,479,431,48,0.899791,0.100209,1.756934,45,3,480,432,48,0.9,0.1,1.756347,45,3,1, merged,0,0,0
50253,1000011,2,811,748,63,0.922318,0.077682,1.793096,58,5,813,749,64,0.921279,0.078721,1.791729,59,5,1, merged,1,1,0
50253,1000120,1,1865,1624,241,0.870777,0.129223,0.870777,213,28,1868,1626,242,0.87045,0.12955,0.87045,213,29,-1, merged,1,0,0
50257,1000026,1,548,479,69,0.874088,0.125912,0.874088,66,3,549,479,70,0.872495,0.127505,0.872495,67,3,1, abandoned,1,1,0
50257,1000153,2,1061,960,101,0.904807,0.095193,1.778894,75,26,1062,961,101,0.904896,0.095104,1.777392,75,26,-1, abandoned,0,0,0
50259,1000070,1,1362,1159,203,0.850954,0.149046,0.850954,177,26,1363,1159,204,0.85033,0.14967,0.85033,177,27,-1, merged,1,1,0
50263,1000026,1,549,479,70,0.872495,0.127505,0.872495,67,3,550,480,70,0.872727,0.127273,0.872727,67,3,1, merged,0,0,0
50263,1000054,2,899,770,129,0.856507,0.143493,1.729003,113,16,900,771,129,0.856667,0.143333,1.729394,113,16,1, merged,0,0,0
50264,1000070,3,1363,1159,204,0.85033,0.14967,2.448333,177,27,1364,1160,204,0.85044,0.14956,2.445069,177,27,1, merged,0,0,0
50264,1000140,2,319,268,51,0.840125,0.159875,1.598003,45,6,321,269,52,0.838006,0.161994,1.594629,46,6,1, merged,1,1,0
50276,1000003,1,1333,1108,225,0.831208,0.168792,0.831208,197,28,1334,1109,225,0.831334,0.168666,0.831334,197,28,1, merged,0,0,0
50278,1000054,1,901,772,129,0.856826,0.143174,0.856826,113,16,904,773,131,0.855088,0.144912,0.855088,115,16,1, merged,1,1,0
50284,1000130,2,528,438,90,0.829545,0.170455,1.634233,70,20,530,438,92,0.826415,0.173585,1.632617,70,22,-1, merged,1,1,0
50287,1000014,2,2681,2214,467,0.825811,0.174189,1.666115,434,33,2683,2215,468,0.825568,0.174432,1.667674,435,33,1, merged,1,1,0
50290,1000132,2,662,567,95,0.856495,0.143505,1.705934,76,19,663,567,96,0.855204,0.144796,1.702737,77,19,1, abandoned,1,1,0
50295,1000004,2,3839,3399,440,0.885387,0.114613,1.758345,349,91,3840,3400,440,0.885417,0.114583,1.757026,349,91,-1, abandoned,0,0,0
50295,1000026,1,551,481,70,0.872958,0.127042,0.872958,67,3,553,482,71,0.871609,0.128391,0.871609,68,3,-1, abandoned,1,0,0
50311,1000328,2,996,736,260,0.738956,0.261044,1.602282,234,26,997,737,260,0.739218,0.260782,1.600896,234,26,-1, abandoned,0,0,0
50313,1000120,4,1871,1629,242,0.870657,0.129343,3.248467,213,29,1872,1630,242,0.870726,0.129274,3.247533,213,29,1, merged,0,0,0
50313,1000121,3,2358,1947,411,0.8257,0.1743,2.37781,382,29,2359,1948,411,0.825774,0.174226,2.376807,382,29,1, merged,0,0,0
50313,1000329,2,3349,2607,742,0.778441,0.221559,1.55211,638,104,3350,2608,742,0.778507,0.221493,1.551033,638,104,1, merged,0,0,0
50313,1002169,1,676,523,153,0.773669,0.226331,0.773669,121,32,677,523,154,0.772526,0.227474,0.772526,121,33,-1, merged,1,1,0
50314,1000120,3,1872,1630,242,0.870726,0.129274,2.42176,213,29,1877,1631,246,0.86894,0.13106,2.420411,217,29,1, merged,1,1,0
50314,1000329,2,3350,2608,742,0.778507,0.221493,1.551033,638,104,3351,2608,743,0.778275,0.221725,1.551471,639,104,1, merged,1,1,0
50314,1002169,1,677,523,154,0.772526,0.227474,0.772526,121,33,679,525,154,0.773196,0.226804,0.773196,121,33,-1, merged,0,0,0
50315,1000120,3,1877,1631,246,0.86894,0.13106,2.420411,217,29,1879,1632,247,0.868547,0.131453,2.42075,218,29,1, merged,1,1,0
50315,1000329,2,3351,2608,743,0.778275,0.221725,1.551471,639,104,3352,2609,743,0.778341,0.221659,1.552203,639,104,-1, merged,0,0,0
50315,1002169,1,679,525,154,0.773196,0.226804,0.773196,121,33,681,527,154,0.773862,0.226138,0.773862,121,33,-1, merged,0,0,0
50317,1000009,2,1491,1237,254,0.829645,0.170355,1.578448,228,26,1492,1238,254,0.829759,0.170241,1.579162,228,26,1, merged,0,0,0
50317,1000534,1,418,313,105,0.748804,0.251196,0.748804,95,10,419,314,105,0.749403,0.250597,0.749403,95,10,1, merged,0,0,0
50318,1000009,3,1492,1238,254,0.829759,0.170241,2.290741,228,26,1493,1239,254,0.829873,0.170127,2.298005,228,26,1, merged,0,0,0
50318,1000153,5,1063,962,101,0.904986,0.095014,3.897855,75,26,1064,963,101,0.905075,0.094925,3.911413,75,26,1, merged,0,0,0
50319,1000009,5,1493,1239,254,0.829873,0.170127,3.911413,228,26,1494,1240,254,0.829987,0.170013,3.922921,228,26,1, merged,0,0,0
50319,1000153,4,1064,963,101,0.905075,0.094925,3.08154,75,26,1065,964,101,0.905164,0.094836,3.092935,75,26,1, merged,0,0,0
50321,1000329,2,3352,2609,743,0.778341,0.221659,1.552203,639,104,3354,2610,744,0.778175,0.221825,1.552369,640,104,1, merged,1,1,0
50321,1002169,1,681,527,154,0.773862,0.226138,0.773862,121,33,682,528,154,0.774194,0.225806,0.774194,121,33,-1, merged,0,0,0
50325,1000105,2,683,536,147,0.784773,0.215227,1.541396,130,17,684,537,147,0.785088,0.214912,1.542113,130,17,1, merged,0,0,0
50326,1000004,1,3841,3401,440,0.885446,0.114554,0.885446,349,91,3842,3401,441,0.885216,0.114784,0.885216,350,91,1, abandoned,1,1,0
50327,1000091,3,609,476,133,0.781609,0.218391,2.29502,112,21,611,477,134,0.780687,0.219313,2.296003,113,21,1, merged,1,1,0
50327,1000328,2,997,737,260,0.739218,0.260782,1.513411,234,26,998,738,260,0.739479,0.260521,1.515316,234,26,-1, merged,0,0,0
50327,1002169,1,682,528,154,0.774194,0.225806,0.774194,121,33,687,533,154,0.775837,0.224163,0.775837,121,33,-1, merged,0,0,0
50330,1000121,2,2359,1948,411,0.825774,0.174226,0.825774,382,29,2360,1949,411,0.825847,0.174153,1.325847,382,29,1, merged,0,0,0
50332,1000009,1,1494,1240,254,0.829987,0.170013,0.829987,228,26,1498,1243,255,0.829773,0.170227,0.829773,229,26,-1, merged,1,0,0
50332,1000534,2,419,314,105,0.749403,0.250597,1.57939,95,10,420,315,105,0.75,0.25,1.579773,95,10,1, merged,0,0,0
50333,1000009,2,1498,1243,255,0.829773,0.170227,1.579773,229,26,1501,1245,256,0.829447,0.170553,1.58122,230,26,-1, merged,1,0,0
50333,1000534,1,420,315,105,0.75,0.25,0.75,95,10,423,318,105,0.751773,0.248227,0.751773,95,10,-1, merged,0,0,0
50334,1000121,1,2360,1949,411,0.825847,0.174153,0.825847,382,29,2362,1951,411,0.825995,0.174005,0.825995,382,29,-1, merged,0,0,0
50335,1000121,2,2362,1951,411,0.825995,0.174005,1.604236,382,29,2363,1952,411,0.826069,0.173931,1.604376,382,29,1, merged,0,0,0
50335,1000329,1,3355,2611,744,0.778241,0.221759,0.778241,640,104,3356,2612,744,0.778308,0.221692,0.778308,640,104,1, merged,0,0,0
50342,1000014,2,2686,2217,469,0.825391,0.174609,1.582967,436,33,2687,2218,469,0.825456,0.174544,1.571725,436,33,-1, abandoned,0,0,0
50342,1000153,3,1065,964,101,0.905164,0.094836,2.488131,75,26,1066,965,101,0.905253,0.094747,2.476978,75,26,-1, abandoned,0,0,0
50343,1000004,3,3842,3401,441,0.885216,0.114784,2.496372,350,91,3843,3402,441,0.885246,0.114754,2.496789,350,91,1, merged,0,0,0
50343,1000105,1,684,537,147,0.785088,0.214912,0.785088,130,17,685,538,147,0.785401,0.214599,0.785401,130,17,1, merged,0,0,0
50343,1000121,2,2363,1952,411,0.826069,0.173931,1.611156,382,29,2364,1953,411,0.826142,0.173858,1.611544,382,29,1, merged,0,0,0
50344,1000004,2,3843,3402,441,0.885246,0.114754,1.790499,350,91,3844,3403,441,0.885276,0.114724,1.790706,350,91,1, merged,0,0,0
50344,1000153,1,1066,965,101,0.905253,0.094747,0.905253,75,26,1068,967,101,0.905431,0.094569,0.905431,75,26,-1, merged,0,0,0
50350,1000110,2,482,434,48,0.900415,0.099585,1.701769,45,3,483,435,48,0.900621,0.099379,1.701516,45,3,1, merged,0,0,0
50360,1000109,1,586,499,87,0.851536,0.148464,0.851536,82,5,587,500,87,0.851789,0.148211,0.851789,82,5,1, merged,0,0,0
50362,1000329,1,3358,2613,745,0.778142,0.221858,0.778142,641,104,3361,2616,745,0.77834,0.22166,0.77834,641,104,-1, merged,0,0,0
50364,1000004,1,3847,3405,442,0.885105,0.114895,0.885105,351,91,3853,3411,442,0.885284,0.114716,0.885284,351,91,-1, merged,0,0,0
50373,1000328,1,998,738,260,0.739479,0.260521,0.739479,234,26,999,739,260,0.73974,0.26026,0.73974,234,26,1, merged,0,0,0
50373,1000592,2,733,620,113,0.845839,0.154161,1.585318,69,44,734,621,113,0.846049,0.153951,1.585789,69,44,1, merged,0,0,0
50380,1000009,2,1503,1247,256,0.829674,0.170326,1.54396,230,26,1504,1248,256,0.829787,0.170213,1.53567,230,26,-1, merged,0,0,0
50383,1000004,1,3853,3411,442,0.885284,0.114716,0.885284,351,91,3854,3411,443,0.885054,0.114946,0.885054,352,91,1, merged,1,1,0
50383,1000132,2,663,567,96,0.855204,0.144796,1.740488,77,19,665,569,96,0.855639,0.144361,1.740694,77,19,-1, merged,0,0,0
50390,1000003,1,1336,1110,226,0.830838,0.169162,0.830838,198,28,1337,1111,226,0.830965,0.169035,0.830965,198,28,1, merged,0,0,0
50390,1000199,2,501,422,79,0.842315,0.157685,1.673154,72,7,502,423,79,0.842629,0.157371,1.673594,72,7,1, merged,0,0,0
50557,1000007,2,1625,1308,317,0.804923,0.195077,1.665217,284,33,1626,1309,317,0.805043,0.194957,1.667362,284,33,1, merged,0,0,0
50558,1000004,2,3854,3411,443,0.885054,0.114946,1.71051,352,91,3855,3412,443,0.885084,0.114916,1.71067,352,91,1, merged,0,0,0
50558,1000014,1,2687,2218,469,0.825456,0.174544,0.825456,436,33,2689,2220,469,0.825586,0.174414,0.825586,436,33,-1, merged,0,0,0
50559,1000004,1,3855,3412,443,0.885084,0.114916,0.885084,352,91,3857,3414,443,0.885144,0.114856,0.885144,352,91,-1, abandoned,0,0,0
50559,1000007,6,1626,1309,317,0.805043,0.194957,4.998997,284,33,1629,1312,317,0.805402,0.194598,4.945354,284,33,-1, abandoned,0,0,0
50559,1000015,5,2205,1974,231,0.895238,0.104762,4.193954,211,20,2206,1974,232,0.894832,0.105168,4.139952,212,20,1, abandoned,1,1,0
50559,1000026,7,553,482,71,0.871609,0.128391,5.870606,68,3,554,483,71,0.871841,0.128159,5.817195,68,3,-1, abandoned,0,0,0
50560,1000004,2,3857,3414,443,0.885144,0.114856,1.746576,352,91,3858,3415,443,0.885174,0.114826,1.744944,352,91,1, merged,0,0,0
50561,1000014,1,2689,2220,469,0.825586,0.174414,0.825586,436,33,2690,2221,469,0.825651,0.174349,0.825651,436,33,1, merged,0,0,0
50561,1000091,2,611,477,134,0.780687,0.219313,1.606273,113,21,612,478,134,0.781046,0.218954,1.606696,113,21,1, merged,0,0,0
50562,1000091,2,612,478,134,0.781046,0.218954,1.588063,113,21,613,479,134,0.781403,0.218597,1.586068,113,21,1, merged,0,0,0
50567,1000009,3,1506,1249,257,0.829349,0.170651,2.247789,230,27,1508,1250,258,0.828912,0.171088,2.288997,231,27,1, merged,1,1,0
50567,1000153,4,1068,967,101,0.905431,0.094569,3.15322,75,26,1069,967,102,0.904584,0.095416,3.19358,76,26,1, merged,1,1,0
50567,1000534,1,423,318,105,0.751773,0.248227,0.751773,95,10,431,326,105,0.756381,0.243619,0.756381,95,10,-1, merged,0,0,0
50570,1000015,1,2206,1974,232,0.894832,0.105168,0.894832,212,20,2207,1975,232,0.89488,0.10512,0.89488,212,20,1, merged,0,0,0
50580,1000014,1,2690,2221,469,0.825651,0.174349,0.825651,436,33,2693,2223,470,0.825473,0.174527,0.825473,437,33,-1, abandoned,1,0,0
50580,1000070,4,1366,1162,204,0.850659,0.149341,3.249101,177,27,1367,1162,205,0.850037,0.149963,3.244602,178,27,1, abandoned,1,1,0
50580,1002169,2,687,533,154,0.775837,0.224163,1.601488,121,33,688,534,154,0.776163,0.223837,1.601636,121,33,-1, abandoned,0,0,0
50581,1000054,1,904,773,131,0.855088,0.144912,0.855088,115,16,906,775,131,0.855408,0.144592,0.855408,115,16,1, merged,0,0,0
50581,1000140,2,322,270,52,0.838509,0.161491,1.693598,46,6,323,271,52,0.839009,0.160991,1.694418,46,6,1, merged,0,0,0
50583,1000015,2,2207,1975,232,0.89488,0.10512,1.791082,212,20,2208,1976,232,0.894928,0.105072,1.791392,212,20,1, merged,0,0,0
50589,1000108,4,306,252,54,0.823529,0.176471,3.38631,50,4,307,253,54,0.824104,0.175896,3.388198,50,4,1, merged,0,0,0
50589,1000110,2,486,438,48,0.901235,0.098765,1.769852,45,3,487,439,48,0.901437,0.098563,1.770124,45,3,1, merged,0,0,0
50589,1000120,1,1880,1633,247,0.868617,0.131383,0.868617,218,29,1881,1634,247,0.868687,0.131313,0.868687,218,29,1, merged,0,0,0
50590,1000108,3,307,253,54,0.824104,0.175896,2.486761,50,4,308,254,54,0.824675,0.175325,2.488432,50,4,1, merged,0,0,0
50590,1000120,1,1881,1634,247,0.868687,0.131313,0.868687,218,29,1882,1635,247,0.868757,0.131243,0.868757,218,29,1, merged,0,0,0
50593,1000153,1,1069,967,102,0.904584,0.095416,0.904584,76,26,1070,968,102,0.904673,0.095327,0.904673,76,26,1, merged,0,0,0
50597,1000592,2,734,621,113,0.846049,0.153951,1.604273,69,44,735,622,113,0.846259,0.153741,1.604879,69,44,1, merged,0,0,0
50603,1000014,1,2693,2223,470,0.825473,0.174527,0.825473,437,33,2694,2224,470,0.825538,0.174462,0.825538,437,33,1, merged,0,0,0
50603,1000534,2,431,326,105,0.756381,0.243619,1.581854,95,10,432,327,105,0.756944,0.243056,1.582483,95,10,1, merged,0,0,0
50610,1000003,2,1337,1111,226,0.830965,0.169035,1.683006,198,28,1338,1111,227,0.830344,0.169656,1.682636,198,29,-1, merged,1,1,0
50610,1000109,1,588,501,87,0.852041,0.147959,0.852041,82,5,589,502,87,0.852292,0.147708,0.852292,82,5,1, merged,0,0,0
50613,1000109,1,589,502,87,0.852292,0.147708,0.852292,82,5,590,503,87,0.852542,0.147458,0.852542,82,5,1, merged,0,0,0
50613,1000120,2,1883,1636,247,0.868826,0.131174,1.721118,218,29,1884,1637,247,0.868896,0.131104,1.721438,218,29,1, merged,0,0,0
50620,1000004,1,3859,3416,443,0.885203,0.114797,0.885203,352,91,3862,3419,443,0.885293,0.114707,0.885293,352,91,-1, merged,0,0,0
50620,1000120,2,1884,1637,247,0.868896,0.131104,1.754099,218,29,1885,1638,247,0.868966,0.131034,1.754258,218,29,1, merged,0,0,0
50621,1000004,2,3862,3419,443,0.885293,0.114707,1.790054,352,91,3863,3420,443,0.885322,0.114678,1.790173,352,91,1, merged,0,0,0
50621,1000011,3,818,754,64,0.92176,0.07824,2.711815,59,5,819,755,64,0.921856,0.078144,2.712029,59,5,1, merged,0,0,0
50621,1000153,1,1071,969,102,0.904762,0.095238,0.904762,76,26,1072,970,102,0.904851,0.095149,0.904851,76,26,-1, merged,0,0,0
50622,1000108,1,308,254,54,0.824675,0.175325,0.824675,50,4,311,257,54,0.826367,0.173633,0.826367,50,4,-1, merged,0,0,0
50622,1000130,2,535,443,92,0.828037,0.171963,1.652713,70,22,536,444,92,0.828358,0.171642,1.654725,70,22,1, merged,0,0,0
50631,1000003,2,1338,1111,227,0.830344,0.169656,1.689567,198,29,1339,1112,227,0.830471,0.169529,1.690374,198,29,1, merged,0,0,0
50635,1000014,1,2694,2224,470,0.825538,0.174462,0.825538,437,33,2695,2225,470,0.825603,0.174397,0.825603,437,33,1, merged,0,0,0
50635,1000054,3,906,775,131,0.855408,0.144592,2.507313,115,16,907,776,131,0.855568,0.144432,2.508094,115,16,1, merged,0,0,0
50635,1000108,2,311,257,54,0.826367,0.173633,1.651905,50,4,312,258,54,0.826923,0.173077,1.652526,50,4,1, merged,0,0,0
50635,1000110,5,490,442,48,0.902041,0.097959,4.235863,45,3,492,444,48,0.902439,0.097561,4.237115,45,3,1, merged,0,0,0
50635,1000121,4,2369,1958,411,0.826509,0.173491,3.333822,382,29,2370,1959,411,0.826582,0.173418,3.334676,382,29,1, merged,0,0,0
50639,1000110,2,492,444,48,0.902439,0.097561,1.739362,45,3,493,445,48,0.902637,0.097363,1.734441,45,3,1, merged,0,0,0
50639,1000140,1,325,272,53,0.836923,0.163077,0.836923,47,6,327,272,55,0.831804,0.168196,0.831804,47,8,-1, merged,1,1,0
50643,1000009,2,1511,1252,259,0.82859,0.17141,1.460169,232,27,1512,1253,259,0.828704,0.171296,1.444088,232,27,1, merged,0,0,0
50658,1000026,1,554,483,71,0.871841,0.128159,0.871841,68,3,555,484,71,0.872072,0.127928,0.872072,68,3,1, merged,0,0,0
50658,1000054,2,907,776,131,0.855568,0.144432,1.727409,115,16,908,777,131,0.855727,0.144273,1.727799,115,16,1, merged,0,0,0
50666,1000070,1,1369,1164,205,0.850256,0.149744,0.850256,178,27,1370,1165,205,0.850365,0.149635,0.850365,178,27,1, merged,0,0,0
50669,1000015,2,2211,1979,232,0.89507,0.10493,1.69507,212,20,2212,1980,232,0.895118,0.104882,1.707618,212,20,1, merged,0,0,0
50672,1000592,2,736,623,113,0.846467,0.153533,1.628077,69,44,737,624,113,0.846676,0.153324,1.630767,69,44,1, merged,0,0,0
50673,1000592,2,737,624,113,0.846676,0.153324,1.630767,69,44,738,625,113,0.846883,0.153117,1.6334,69,44,1, merged,0,0,0
50674,1000592,2,738,625,113,0.846883,0.153117,1.6334,69,44,739,626,113,0.847091,0.152909,1.63598,69,44,1, merged,0,0,0
50675,1000015,1,2212,1980,232,0.895118,0.104882,0.895118,212,20,2213,1981,232,0.895165,0.104835,0.895165,212,20,-1, abandoned,0,0,0
50677,1000004,1,3864,3421,443,0.885352,0.114648,0.885352,352,91,3866,3421,445,0.884894,0.115106,0.884894,352,93,-1, merged,1,1,0
50677,1000592,3,739,626,113,0.847091,0.152909,2.521332,69,44,740,627,113,0.847297,0.152703,2.5234,69,44,1, merged,0,0,0
50678,1000166,2,457,350,107,0.765864,0.234136,1.542027,102,5,460,351,109,0.763043,0.236957,1.539855,104,5,1, merged,1,1,0
50678,1002169,1,688,534,154,0.776163,0.223837,0.776163,121,33,690,536,154,0.776812,0.223188,0.776812,121,33,-1, merged,0,0,0
50681,1000014,1,2695,2225,470,0.825603,0.174397,0.825603,437,33,2696,2225,471,0.825297,0.174703,0.825297,438,33,1, abandoned,1,1,0
50681,1000070,2,1371,1166,205,0.850474,0.149526,1.676077,178,27,1372,1166,206,0.849854,0.150146,1.675151,179,27,1, abandoned,1,1,0
50682,1000043,1,626,527,99,0.841853,0.158147,0.841853,85,14,627,527,100,0.84051,0.15949,0.84051,86,14,1, merged,1,1,0
50682,1000592,2,740,627,113,0.847297,0.152703,1.68915,69,44,743,629,114,0.846568,0.153432,1.687078,69,45,1, merged,1,0,0
50683,1000043,1,627,527,100,0.84051,0.15949,0.84051,86,14,628,527,101,0.839172,0.160828,0.839172,87,14,1, merged,1,1,0
50683,1000592,2,743,629,114,0.846568,0.153432,1.687078,69,45,744,630,114,0.846774,0.153226,1.685946,69,45,1, merged,0,0,0
50684,1000043,1,628,527,101,0.839172,0.160828,0.839172,87,14,629,527,102,0.837838,0.162162,0.837838,88,14,1, merged,1,1,0
50684,1000592,2,744,630,114,0.846774,0.153226,1.685946,69,45,745,631,114,0.84698,0.15302,1.684818,69,45,1, merged,0,0,0
50685,1000043,1,629,527,102,0.837838,0.162162,0.837838,88,14,630,527,103,0.836508,0.163492,0.836508,89,14,1, merged,1,1,0
50685,1000592,2,745,631,114,0.84698,0.15302,1.684818,69,45,746,632,114,0.847185,0.152815,1.683693,69,45,1, merged,0,0,0
50687,1000043,1,630,527,103,0.836508,0.163492,0.836508,89,14,631,527,104,0.835182,0.164818,0.835182,90,14,1, merged,1,1,0
50687,1000592,2,746,632,114,0.847185,0.152815,1.683693,69,45,747,633,114,0.84739,0.15261,1.682572,69,45,1, merged,0,0,0
50688,1000043,1,631,527,104,0.835182,0.164818,0.835182,90,14,632,527,105,0.833861,0.166139,0.833861,91,14,1, merged,1,1,0
50688,1000592,2,747,633,114,0.84739,0.15261,1.682572,69,45,748,634,114,0.847594,0.152406,1.681454,69,45,1, merged,0,0,0
50689,1000043,1,632,527,105,0.833861,0.166139,0.833861,91,14,633,527,106,0.832543,0.167457,0.832543,92,14,1, merged,1,1,0
50689,1000592,2,748,634,114,0.847594,0.152406,1.681454,69,45,749,635,114,0.847797,0.152203,1.680341,69,45,1, merged,0,0,0
50690,1000043,1,633,527,106,0.832543,0.167457,0.832543,92,14,634,527,107,0.83123,0.16877,0.83123,93,14,1, merged,1,1,0
50690,1000592,2,749,635,114,0.847797,0.152203,1.680341,69,45,750,636,114,0.848,0.152,1.67923,69,45,1, merged,0,0,0
50691,1000109,2,591,504,87,0.852792,0.147208,1.623005,82,5,592,505,87,0.853041,0.146959,1.623741,82,5,1, merged,0,0,0
50692,1000043,1,634,527,107,0.83123,0.16877,0.83123,93,14,635,527,108,0.829921,0.170079,0.829921,94,14,1, merged,1,1,0
50692,1000592,2,750,636,114,0.848,0.152,1.67923,69,45,751,637,114,0.848202,0.151798,1.678124,69,45,1, merged,0,0,0
50701,1000043,2,635,527,108,0.829921,0.170079,1.829921,94,14,637,527,110,0.827316,0.172684,1.327316,96,14,1, abandoned,1,1,0
50715,1000003,2,1340,1113,227,0.830597,0.169403,1.610258,198,29,1341,1114,227,0.830723,0.169277,1.612603,198,29,1, merged,0,0,0
50716,1000015,1,2215,1983,232,0.89526,0.10474,0.89526,212,20,2216,1983,233,0.894856,0.105144,0.894856,213,20,1, merged,1,1,0
50720,1000003,1,1341,1114,227,0.830723,0.169277,0.830723,198,29,1342,1115,227,0.830849,0.169151,0.830849,198,29,1, merged,0,0,0
50720,1000011,2,822,758,64,0.922141,0.077859,1.752864,59,5,823,759,64,0.922236,0.077764,1.753085,59,5,1, merged,0,0,0
50727,1000054,2,910,778,132,0.854945,0.145055,1.525677,116,16,911,779,132,0.855104,0.144896,1.529803,116,16,1, merged,0,0,0
50734,1000130,1,537,445,92,0.828678,0.171322,0.828678,70,22,540,448,92,0.82963,0.17037,0.82963,70,22,-1, abandoned,0,0,0
50737,1000109,2,592,505,87,0.853041,0.146959,1.698744,82,5,593,506,87,0.853288,0.146712,1.699292,82,5,1, merged,0,0,0
50737,1000199,1,512,433,79,0.845703,0.154297,0.845703,72,7,513,434,79,0.846004,0.153996,0.846004,72,7,1, merged,0,0,0
50742,1000004,1,3866,3421,445,0.884894,0.115106,0.884894,352,93,3867,3422,445,0.884924,0.115076,0.884924,352,93,1, merged,0,0,0
50745,1000004,2,3867,3422,445,0.884924,0.115076,1.611918,352,93,3871,3425,446,0.884784,0.115216,1.609555,353,93,-1, abandoned,1,0,0
50750,1000109,3,593,506,87,0.853288,0.146712,2.469334,82,5,594,507,87,0.853535,0.146465,2.470847,82,5,1, merged,0,0,0
50750,1000199,2,513,434,79,0.846004,0.153996,1.616046,72,7,514,435,79,0.846304,0.153696,1.617312,72,7,1, merged,0,0,0
50755,1000009,1,1518,1259,259,0.829381,0.170619,0.829381,232,27,1519,1260,259,0.829493,0.170507,0.829493,232,27,1, merged,0,0,0
50755,1000153,2,1073,971,102,0.904939,0.095061,1.73432,76,26,1074,972,102,0.905028,0.094972,1.734521,76,26,1, merged,0,0,0
50757,1000004,1,3871,3425,446,0.884784,0.115216,0.884784,353,93,3872,3426,446,0.884814,0.115186,0.884814,353,93,1, merged,0,0,0
50762,1000003,3,1342,1115,227,0.830849,0.169151,2.455885,198,29,1344,1116,228,0.830357,0.169643,2.45195,198,30,-1, merged,1,0,0
50762,1000109,2,596,509,87,0.854027,0.145973,1.625035,82,5,598,510,88,0.852843,0.147157,1.621593,83,5,1, merged,1,1,0
50764,1000015,1,2217,1984,233,0.894903,0.105097,0.894903,213,20,2218,1985,233,0.89495,0.10505,0.89495,213,20,1, merged,0,0,0
50764,1000153,2,1074,972,102,0.905028,0.094972,1.799931,76,26,1075,973,102,0.905116,0.094884,1.800067,76,26,1, merged,0,0,0
50766,1000592,2,751,637,114,0.848202,0.151798,1.639411,69,45,752,638,114,0.848404,0.151596,1.641883,69,45,1, merged,0,0,0
50767,1000004,1,3872,3426,446,0.884814,0.115186,0.884814,353,93,3873,3427,446,0.884844,0.115156,0.884844,353,93,1, merged,0,0,0
50767,1000120,2,1886,1639,247,0.869035,0.130965,1.753849,218,29,1887,1640,247,0.869104,0.130896,1.753948,218,29,1, merged,0,0,0
50772,1000121,2,2373,1962,411,0.826802,0.173198,1.682657,382,29,2374,1963,411,0.826874,0.173126,1.681665,382,29,1, merged,0,0,0
50772,1000132,1,666,570,96,0.855856,0.144144,0.855856,77,19,668,571,97,0.85479,0.14521,0.85479,78,19,1, merged,1,1,0
50773,1000007,3,1636,1319,317,0.806235,0.193765,2.606301,284,33,1638,1320,318,0.805861,0.194139,2.604949,284,34,-1, merged,1,0,0
50773,1000015,1,2218,1985,233,0.89495,0.10505,0.89495,213,20,2219,1985,234,0.894547,0.105453,0.894547,214,20,1, merged,1,1,0
50773,1000153,2,1075,973,102,0.905116,0.094884,1.800067,76,26,1079,976,103,0.904541,0.095459,1.799088,77,26,1, merged,1,1,0
50778,1000007,2,1639,1321,318,0.805979,0.194021,1.453038,284,34,1640,1322,318,0.806098,0.193902,1.458271,284,34,1, merged,0,0,0
50783,1000004,1,3873,3427,446,0.884844,0.115156,0.884844,353,93,3874,3428,446,0.884874,0.115126,0.884874,353,93,1, merged,0,0,0
50783,1000007,2,1640,1322,318,0.806098,0.193902,1.690941,284,34,1641,1323,318,0.806216,0.193784,1.691089,284,34,1, merged,0,0,0
50784,1000003,1,1345,1117,228,0.830483,0.169517,0.830483,198,30,1346,1117,229,0.829866,0.170134,0.829866,199,30,1, merged,1,1,0
50784,1000007,2,1641,1323,318,0.806216,0.193784,1.636699,284,34,1643,1324,319,0.805843,0.194157,1.635709,284,35,-1, merged,1,0,0
50784,1000153,3,1080,977,103,0.90463,0.09537,2.541329,77,26,1081,978,103,0.904718,0.095282,2.540427,77,26,1, merged,0,0,0
50785,1000004,2,3874,3428,446,0.884874,0.115126,1.690716,353,93,3875,3429,446,0.884903,0.115097,1.690493,353,93,1, merged,0,0,0
50785,1000007,1,1643,1324,319,0.805843,0.194157,0.805843,284,35,1646,1326,320,0.805589,0.194411,0.805589,284,36,-1, merged,1,0,0
50786,1000007,1,1646,1326,320,0.805589,0.194411,0.805589,284,36,1648,1327,321,0.805218,0.194782,0.805218,284,37,-1, merged,1,0,0
50786,1000153,2,1081,978,103,0.904718,0.095282,1.710307,77,26,1083,980,103,0.904894,0.095106,1.710112,77,26,1, merged,0,0,0
50793,1000329,1,3363,2618,745,0.778472,0.221528,0.778472,641,104,3364,2619,745,0.778537,0.221463,0.778537,641,104,1, merged,0,0,0
50795,1000004,2,3875,3429,446,0.884903,0.115097,1.721638,353,93,3877,3431,446,0.884963,0.115037,1.722361,353,93,-1, abandoned,0,0,0
50797,1000004,2,3877,3431,446,0.884963,0.115037,1.754275,353,93,3878,3432,446,0.884992,0.115008,1.754374,353,93,1, merged,0,0,0
50797,1000120,1,1890,1643,247,0.869312,0.130688,0.869312,218,29,1891,1644,247,0.869381,0.130619,0.869381,218,29,1, merged,0,0,0
50798,1000121,2,2374,1963,411,0.826874,0.173126,1.681665,382,29,2375,1964,411,0.826947,0.173053,1.682171,382,29,1, merged,0,0,0
50798,1000132,1,668,571,97,0.85479,0.14521,0.85479,78,19,670,573,97,0.855224,0.144776,0.855224,78,19,-1, merged,0,0,0
50802,1000004,1,3879,3433,446,0.885022,0.114978,0.885022,353,93,3881,3434,447,0.884823,0.115177,0.884823,354,93,1, merged,1,1,0
50802,1000023,2,1261,1106,155,0.877082,0.122918,1.762104,139,16,1262,1107,155,0.877179,0.122821,1.762003,139,16,-1, merged,0,0,0
50806,1000121,2,2376,1965,411,0.82702,0.17298,1.510437,382,29,2378,1966,412,0.826745,0.173255,1.511745,383,29,1, merged,1,1,0
50806,1000329,3,3364,2619,745,0.778537,0.221463,2.288975,641,104,3366,2621,745,0.778669,0.221331,2.290414,641,104,-1, merged,0,0,0
50811,1000004,2,3882,3435,447,0.884853,0.115147,1.607679,354,93,3883,3436,447,0.884883,0.115117,1.609207,354,93,1, merged,0,0,0
50811,1000120,3,1891,1644,247,0.869381,0.130619,2.477061,218,29,1892,1645,247,0.86945,0.13055,2.478657,218,29,1, merged,0,0,0
50817,1000108,2,321,267,54,0.831776,0.168224,1.664602,50,4,322,268,54,0.832298,0.167702,1.666135,50,4,1, merged,0,0,0
50817,1000140,1,329,274,55,0.832827,0.167173,0.832827,47,8,331,276,55,0.833837,0.166163,0.833837,47,8,-1, merged,0,0,0
50818,1000026,1,555,484,71,0.872072,0.127928,0.872072,68,3,557,486,71,0.872531,0.127469,0.872531,68,3,-1, merged,0,0,0
50826,1000012,2,643,555,88,0.863142,0.136858,1.718246,85,3,644,556,88,0.863354,0.136646,1.718617,85,3,1, merged,0,0,0
50826,1000054,1,911,779,132,0.855104,0.144896,0.855104,116,16,912,780,132,0.855263,0.144737,0.855263,116,16,1, merged,0,0,0
50827,1000014,1,2699,2228,471,0.825491,0.174509,0.825491,438,33,2702,2230,472,0.825315,0.174685,0.825315,439,33,1, merged,1,1,0
50827,1000120,2,1893,1646,247,0.869519,0.130481,1.69501,218,29,1894,1647,247,0.869588,0.130412,1.694903,218,29,1, merged,0,0,0
50829,1000105,2,689,542,147,0.786647,0.213353,1.786647,130,17,690,543,147,0.786957,0.213043,1.786957,130,17,1, merged,0,0,0
50832,1000091,1,614,480,134,0.781759,0.218241,0.781759,113,21,615,481,134,0.782114,0.217886,0.782114,113,21,1, merged,0,0,0
50832,1000328,2,999,739,260,0.73974,0.26026,1.521499,234,26,1000,740,260,0.74,0.26,1.522114,234,26,1, merged,0,0,0
50832,1000329,3,3366,2621,745,0.778669,0.221331,2.300168,641,104,3367,2622,745,0.778735,0.221265,2.300849,641,104,1, merged,0,0,0
50833,1000329,2,3367,2622,745,0.778735,0.221265,1.627541,641,104,3368,2622,746,0.778504,0.221496,1.625469,642,104,1, abandoned,1,1,0
50833,1000592,1,754,640,114,0.848806,0.151194,0.848806,69,45,758,642,116,0.846966,0.153034,0.846966,71,45,-1, abandoned,1,0,0
50836,1000054,2,912,780,132,0.855263,0.144737,1.529962,116,16,913,781,132,0.855422,0.144578,1.522088,116,16,1, merged,0,0,0
50836,1000140,3,331,276,55,0.833837,0.166163,2.363799,47,8,332,277,55,0.834337,0.165663,2.356426,47,8,1, merged,0,0,0
50839,1000014,2,2702,2230,472,0.825315,0.174685,1.607428,439,33,2703,2231,472,0.825379,0.174621,1.607847,439,33,1, merged,0,0,0
50839,1000070,3,1375,1169,206,0.850182,0.149818,2.45761,179,27,1376,1170,206,0.850291,0.149709,2.458137,179,27,1, merged,0,0,0
50839,1000091,1,615,481,134,0.782114,0.217886,0.782114,113,21,616,482,134,0.782468,0.217532,0.782468,113,21,1, merged,0,0,0
50843,1000120,1,1895,1648,247,0.869657,0.130343,0.869657,218,29,1896,1649,247,0.869726,0.130274,0.869726,218,29,-1, abandoned,0,0,0
50844,1000153,1,1083,980,103,0.904894,0.095106,0.904894,77,26,1084,981,103,0.904982,0.095018,0.904982,77,26,1, merged,0,0,0
50852,1000014,1,2703,2231,472,0.825379,0.174621,0.825379,439,33,2704,2231,473,0.825074,0.174926,0.825074,440,33,1, merged,1,1,0
50854,1000003,1,1346,1117,229,0.829866,0.170134,0.829866,199,30,1347,1118,229,0.829993,0.170007,0.829993,199,30,1, merged,0,0,0
50854,1000153,2,1084,981,103,0.904982,0.095018,1.734848,77,26,1085,982,103,0.905069,0.094931,1.735062,77,26,1, merged,0,0,0
50858,1000009,1,1522,1263,259,0.829829,0.170171,0.829829,232,27,1523,1264,259,0.829941,0.170059,0.829941,232,27,1, merged,0,0,0
50858,1000011,2,823,759,64,0.922236,0.077764,1.752065,59,5,824,760,64,0.92233,0.07767,1.752271,59,5,1, merged,0,0,0
50861,1000153,2,1085,982,103,0.905069,0.094931,1.772202,77,26,1087,982,105,0.903404,0.096596,1.771459,77,28,-1, merged,1,1,0
50866,1000110,1,497,448,49,0.901408,0.098592,0.901408,46,3,498,449,49,0.901606,0.098394,0.901606,46,3,-1, abandoned,0,0,0
50868,1000199,1,515,436,79,0.846602,0.153398,0.846602,72,7,517,438,79,0.847195,0.152805,0.847195,72,7,-1, merged,0,0,0
50870,1000109,1,599,511,88,0.853088,0.146912,0.853088,83,5,601,512,89,0.851913,0.148087,0.851913,84,5,1, merged,1,1,0
50870,1000199,2,517,438,79,0.847195,0.152805,1.700284,72,7,519,440,79,0.847784,0.152216,1.699698,72,7,-1, merged,0,0,0
50874,1000120,2,1897,1650,247,0.869794,0.130206,1.773198,218,29,1898,1651,247,0.869863,0.130137,1.773444,218,29,1, merged,0,0,0
50874,1000153,1,1087,982,105,0.903404,0.096596,0.903404,77,28,1089,984,105,0.903581,0.096419,0.903581,77,28,-1, merged,0,0,0
50876,1000011,4,824,760,64,0.92233,0.07767,2.991487,59,5,825,761,64,0.922424,0.077576,2.961255,59,5,1, merged,0,0,0
50877,1000014,1,2704,2231,473,0.825074,0.174926,0.825074,440,33,2705,2232,473,0.825139,0.174861,0.825139,440,33,1, merged,0,0,0
50886,1000130,1,547,455,92,0.83181,0.16819,0.83181,70,22,548,456,92,0.832117,0.167883,0.832117,70,22,-1, abandoned,0,0,0
50886,1000140,2,332,277,55,0.834337,0.165663,1.666147,47,8,333,278,55,0.834835,0.165165,1.666952,47,8,-1, abandoned,0,0,0
50887,1000109,2,601,512,89,0.851913,0.148087,1.621144,84,5,602,513,89,0.852159,0.147841,1.621869,84,5,1, merged,0,0,0
50888,1000153,1,1089,984,105,0.903581,0.096419,0.903581,77,28,1094,989,105,0.904022,0.095978,0.904022,77,28,-1, merged,0,0,0
50889,1000009,1,1523,1264,259,0.829941,0.170059,0.829941,232,27,1524,1265,259,0.830052,0.169948,0.830052,232,27,1, merged,0,0,0
50889,1000011,2,825,761,64,0.922424,0.077576,1.752365,59,5,826,762,64,0.922518,0.077482,1.752571,59,5,1, merged,0,0,0
50895,1000109,1,602,513,89,0.852159,0.147841,0.852159,84,5,603,514,89,0.852405,0.147595,0.852405,84,5,1, merged,0,0,0
50898,1000012,2,644,556,88,0.863354,0.136646,1.72097,85,3,645,557,88,0.863566,0.136434,1.718351,85,3,1, merged,0,0,0
50900,1000004,1,3891,3442,449,0.884605,0.115395,0.884605,356,93,3892,3443,449,0.884635,0.115365,0.884635,356,93,1, merged,0,0,0
50911,1000004,2,3892,3443,449,0.884635,0.115365,1.73312,356,93,3893,3444,449,0.884665,0.115335,1.737606,356,93,-1, merged,0,0,0
50911,1000120,3,1899,1652,247,0.869932,0.130068,2.603052,218,29,1900,1653,247,0.87,0.13,2.607606,218,29,1, merged,0,0,0
50915,1000130,1,548,456,92,0.832117,0.167883,0.832117,70,22,549,457,92,0.832423,0.167577,0.832423,70,22,-1, merged,0,0,0
50921,1000329,1,3369,2623,746,0.778569,0.221431,0.778569,642,104,3370,2624,746,0.778635,0.221365,0.778635,642,104,-1, abandoned,0,0,0
50922,1000004,1,3893,3444,449,0.884665,0.115335,0.884665,356,93,3895,3445,450,0.884467,0.115533,0.884467,357,93,1, abandoned,1,1,0
50922,1000023,2,1267,1112,155,0.877664,0.122336,1.762329,139,16,1270,1114,156,0.877165,0.122835,1.761633,140,16,-1, abandoned,1,0,0
50923,1000004,1,3895,3445,450,0.884467,0.115533,0.884467,357,93,3896,3445,451,0.88424,0.11576,0.88424,358,93,1, abandoned,1,1,0
50923,1000023,3,1270,1114,156,0.877165,0.122835,2.593459,140,16,1273,1116,157,0.876669,0.123331,2.591234,141,16,-1, abandoned,1,0,0
50923,1000130,2,553,460,93,0.831826,0.168174,1.716294,71,22,554,460,94,0.830325,0.169675,1.714565,72,22,1, abandoned,1,1,0
50946,1000004,4,3896,3445,451,0.88424,0.11576,3.338342,358,93,3897,3446,451,0.88427,0.11573,3.338488,358,93,-1, abandoned,0,0,0
50946,1000130,1,554,460,94,0.830325,0.169675,0.830325,72,22,560,466,94,0.832143,0.167857,0.832143,72,22,-1, abandoned,0,0,0
50946,1000592,3,758,642,116,0.846966,0.153034,2.454102,71,45,761,643,118,0.844941,0.155059,2.454218,73,45,1, abandoned,1,1,0
50946,1002169,2,690,536,154,0.776812,0.223188,1.607137,121,33,691,537,154,0.777135,0.222865,1.609277,121,33,-1, abandoned,0,0,0
50955,1000011,2,826,762,64,0.922518,0.077482,1.795732,59,5,827,763,64,0.922612,0.077388,1.79427,59,5,1, merged,0,0,0
50955,1000026,1,560,489,71,0.873214,0.126786,0.873214,68,3,561,489,72,0.871658,0.128342,0.871658,69,3,1, merged,1,1,0
50956,1000121,3,2379,1967,412,0.826818,0.173182,2.368609,383,29,2380,1967,413,0.826471,0.173529,2.363588,383,30,-1, merged,1,1,0
50956,1000132,1,670,573,97,0.855224,0.144776,0.855224,78,19,671,573,98,0.853949,0.146051,0.853949,78,20,-1, merged,1,1,0
50967,1000108,3,328,274,54,0.835366,0.164634,2.532372,50,4,329,275,54,0.835866,0.164134,2.534048,50,4,1, merged,0,0,0
50967,1000140,2,336,281,55,0.83631,0.16369,1.697006,47,8,337,282,55,0.836795,0.163205,1.698181,47,8,1, merged,0,0,0
50975,1000054,1,913,781,132,0.855422,0.144578,0.855422,116,16,914,782,132,0.85558,0.14442,0.85558,116,16,1, merged,0,0,0
50975,1000166,2,460,351,109,0.763043,0.236957,1.618465,104,5,461,352,109,0.763557,0.236443,1.619137,104,5,1, merged,0,0,0
50979,1000043,4,637,527,110,0.827316,0.172684,3.043993,96,14,638,528,110,0.827586,0.172414,2.95412,96,14,1, merged,0,0,0
50980,1000054,1,914,782,132,0.85558,0.14442,0.85558,116,16,915,783,132,0.855738,0.144262,0.855738,116,16,1, merged,0,0,0
50980,1000166,2,461,352,109,0.763557,0.236443,1.619137,104,5,462,353,109,0.764069,0.235931,1.619807,104,5,1, merged,0,0,0
50985,1000003,4,1347,1118,229,0.829993,0.170007,3.374506,199,30,1348,1119,229,0.830119,0.169881,3.375778,199,30,1, merged,0,0,0
50985,1000012,2,645,557,88,0.863566,0.136434,1.75835,85,3,646,558,88,0.863777,0.136223,1.758159,85,3,1, merged,0,0,0
50985,1000015,1,2224,1990,234,0.894784,0.105216,0.894784,214,20,2225,1990,235,0.894382,0.105618,0.894382,214,21,-1, merged,1,1,0
50986,1000003,2,1348,1119,229,0.830119,0.169881,1.724501,199,30,1349,1119,230,0.829503,0.170497,1.723933,200,30,1, abandoned,1,1,0
50986,1000015,1,2225,1990,235,0.894382,0.105618,0.894382,214,21,2226,1991,235,0.894429,0.105571,0.894429,214,21,-1, abandoned,0,0,0
50987,1000003,1,1349,1119,230,0.829503,0.170497,0.829503,200,30,1350,1120,230,0.82963,0.17037,0.82963,200,30,1, merged,0,0,0
50987,1000004,2,3897,3446,451,0.88427,0.11573,1.713773,358,93,3898,3447,451,0.8843,0.1157,1.713929,358,93,1, merged,0,0,0
51006,1000592,2,761,643,118,0.844941,0.155059,1.638419,73,45,762,644,118,0.845144,0.154856,1.640843,73,45,1, merged,0,0,0
51008,1000592,2,763,645,118,0.845347,0.154653,1.641046,73,45,764,646,118,0.84555,0.15445,1.643422,73,45,1, merged,0,0,0
51009,1000592,2,764,646,118,0.84555,0.15445,1.643422,73,45,765,647,118,0.845752,0.154248,1.645752,73,45,1, merged,0,0,0
51013,1000592,2,765,647,118,0.845752,0.154248,1.645752,73,45,766,648,118,0.845953,0.154047,1.648036,73,45,1, merged,0,0,0
51014,1000592,2,766,648,118,0.845953,0.154047,1.648036,73,45,767,649,118,0.846154,0.153846,1.650278,73,45,1, merged,0,0,0
51016,1000009,1,1525,1266,259,0.830164,0.169836,0.830164,232,27,1526,1267,259,0.830275,0.169725,0.830275,232,27,1, merged,0,0,0
51016,1000014,3,2713,2239,474,0.825286,0.174714,2.607257,440,34,2714,2240,474,0.82535,0.17465,2.608566,440,34,1, merged,0,0,0
51020,1000592,2,767,649,118,0.846154,0.153846,1.650278,73,45,768,650,118,0.846354,0.153646,1.652477,73,45,1, merged,0,0,0
51022,1000328,2,1000,740,260,0.74,0.26,1.517135,234,26,1002,741,261,0.739521,0.260479,1.516978,235,26,-1, abandoned,1,0,0
51022,1002169,1,691,537,154,0.777135,0.222865,0.777135,121,33,692,538,154,0.777457,0.222543,0.777457,121,33,-1, abandoned,0,0,0
51026,1000014,1,2714,2240,474,0.82535,0.17465,0.82535,440,34,2715,2240,475,0.825046,0.174954,0.825046,441,34,1, merged,1,1,0
51029,1000026,2,562,490,72,0.871886,0.128114,1.768612,69,3,563,491,72,0.872114,0.127886,1.769357,69,3,1, merged,0,0,0
51031,1000130,3,561,467,94,0.832442,0.167558,2.411369,72,22,562,468,94,0.83274,0.16726,2.406138,72,22,-1, merged,0,0,0
51031,1000328,6,1002,741,261,0.739521,0.260479,4.675446,235,26,1003,742,261,0.739781,0.260219,4.670056,235,26,1, merged,0,0,0
51031,1000329,5,3370,2624,746,0.778635,0.221365,3.935925,642,104,3372,2626,746,0.778766,0.221234,3.930275,642,104,-1, merged,0,0,0
51031,1002169,1,692,538,154,0.777457,0.222543,0.777457,121,33,693,539,154,0.777778,0.222222,0.777778,121,33,-1, merged,0,0,0
51037,1000014,1,2715,2240,475,0.825046,0.174954,0.825046,441,34,2716,2241,475,0.82511,0.17489,0.82511,441,34,-1, abandoned,0,0,0
51037,1000120,2,1905,1656,249,0.869291,0.130709,1.694337,220,29,1906,1657,249,0.86936,0.13064,1.69447,220,29,-1, abandoned,0,0,0
51046,1000199,1,520,441,79,0.848077,0.151923,0.848077,72,7,522,443,79,0.848659,0.151341,0.848659,72,7,-1, merged,0,0,0
51051,1000004,1,3901,3449,452,0.884132,0.115868,0.884132,359,93,3903,3451,452,0.884192,0.115808,0.884192,359,93,-1, merged,0,0,0
51051,1000070,2,1380,1174,206,0.850725,0.149275,1.734857,179,27,1381,1175,206,0.850833,0.149167,1.735024,179,27,1, merged,0,0,0
51057,1000132,1,674,575,99,0.853116,0.146884,0.853116,79,20,675,576,99,0.853333,0.146667,0.853333,79,20,-1, abandoned,0,0,0
51061,1000014,2,2716,2241,475,0.82511,0.17489,1.630908,441,34,2717,2242,475,0.825175,0.174825,1.631533,441,34,1, merged,0,0,0
51078,1000004,2,3905,3452,453,0.883995,0.116005,1.661773,360,93,3908,3455,453,0.884084,0.115916,1.662182,360,93,-1, abandoned,0,0,0
51078,1002169,1,693,539,154,0.777778,0.222222,0.777778,121,33,694,540,154,0.778098,0.221902,0.778098,121,33,-1, abandoned,0,0,0
51081,1000070,2,1381,1175,206,0.850833,0.149167,1.610637,179,27,1382,1176,206,0.850941,0.149059,1.611136,179,27,1, merged,0,0,0
51084,1000070,2,1382,1176,206,0.850941,0.149059,1.657299,179,27,1383,1177,206,0.851048,0.148952,1.657965,179,27,1, merged,0,0,0
51086,1000014,2,2717,2242,475,0.825175,0.174825,1.671928,441,34,2718,2243,475,0.825239,0.174761,1.672191,441,34,1, merged,0,0,0
51086,1000592,1,770,652,118,0.846753,0.153247,0.846753,73,45,771,653,118,0.846952,0.153048,0.846952,73,45,1, merged,0,0,0
51088,1000130,4,564,470,94,0.833333,0.166667,3.266033,72,22,565,471,94,0.833628,0.166372,3.267343,72,22,-1, merged,0,0,0
51088,1000329,1,3379,2631,748,0.778633,0.221367,0.778633,644,104,3383,2635,748,0.778894,0.221106,0.778894,644,104,-1, merged,0,0,0
51088,1000592,2,772,654,118,0.84715,0.15285,1.625783,73,45,775,655,120,0.845161,0.154839,1.624056,75,45,-1, merged,1,0,0
51095,1000014,1,2718,2243,475,0.825239,0.174761,0.825239,441,34,2720,2244,476,0.825,0.175,0.825,442,34,1, merged,1,1,0
51095,1000110,2,501,452,49,0.902196,0.097804,1.727435,46,3,502,453,49,0.90239,0.09761,1.72739,46,3,1, merged,0,0,0
51097,1000070,2,1384,1178,206,0.851156,0.148844,1.611352,179,27,1385,1179,206,0.851264,0.148736,1.61185,179,27,1, merged,0,0,0
51109,1000153,1,1101,996,105,0.904632,0.095368,0.904632,77,28,1102,997,105,0.904719,0.095281,0.904719,77,28,1, merged,0,0,0
51119,1000009,4,1528,1269,259,0.830497,0.169503,2.995603,232,27,1529,1270,259,0.830608,0.169392,2.996927,232,27,1, merged,0,0,0
51119,1000153,5,1102,997,105,0.904719,0.095281,3.900322,77,28,1103,998,105,0.904805,0.095195,3.901732,77,28,1, merged,0,0,0
51121,1000004,1,3909,3455,454,0.883858,0.116142,0.883858,361,93,3911,3457,454,0.883917,0.116083,0.883917,361,93,-1, merged,0,0,0
51128,1000011,2,835,771,64,0.923353,0.076647,1.792987,59,5,836,772,64,0.923445,0.076555,1.793147,59,5,1, merged,0,0,0
51128,1000120,1,1910,1661,249,0.869634,0.130366,0.869634,220,29,1911,1662,249,0.869702,0.130298,0.869702,220,29,-1, merged,0,0,0
51136,1000009,1,1530,1271,259,0.830719,0.169281,0.830719,232,27,1531,1272,259,0.83083,0.16917,0.83083,232,27,1, merged,0,0,0
51136,1000109,2,607,518,89,0.853377,0.146623,1.684096,84,5,608,519,89,0.853618,0.146382,1.684448,84,5,1, merged,0,0,0
51138,1000015,1,2228,1993,235,0.894524,0.105476,0.894524,214,21,2229,1993,236,0.894123,0.105877,0.894123,215,21,1, merged,1,1,0
51139,1000054,3,916,784,132,0.855895,0.144105,2.490176,116,16,917,784,133,0.854962,0.145038,2.48714,117,16,1, abandoned,1,1,0
51139,1000120,1,1911,1662,249,0.869702,0.130298,0.869702,220,29,1912,1662,250,0.869247,0.130753,0.869247,221,29,1, abandoned,1,1,0
51139,1000166,2,463,354,109,0.764579,0.235421,1.634281,104,5,464,354,110,0.762931,0.237069,1.632178,105,5,1, abandoned,1,1,0
51140,1000054,2,917,784,133,0.854962,0.145038,1.617893,117,16,918,784,134,0.854031,0.145969,1.615321,118,16,1, abandoned,1,1,0
51140,1000166,1,464,354,110,0.762931,0.237069,0.762931,105,5,465,354,111,0.76129,0.23871,0.76129,106,5,1, abandoned,1,1,0
51144,1000004,1,3913,3458,455,0.883721,0.116279,0.883721,362,93,3914,3459,455,0.883751,0.116249,0.883751,362,93,1, merged,0,0,0
51148,1000004,2,3914,3459,455,0.883751,0.116249,1.708943,362,93,3915,3460,455,0.88378,0.11622,1.708734,362,93,1, merged,0,0,0
51148,1000014,1,2723,2247,476,0.825193,0.174807,0.825193,442,34,2725,2248,477,0.824954,0.175046,0.824954,443,34,1, merged,1,1,0
51151,1000121,1,2380,1967,413,0.826471,0.173529,0.826471,383,30,2381,1967,414,0.826123,0.173877,0.826123,384,30,1, abandoned,1,1,0
51157,1000121,1,2381,1967,414,0.826123,0.173877,0.826123,384,30,2382,1968,414,0.826196,0.173804,0.826196,384,30,1, merged,0,0,0
51158,1000121,1,2382,1968,414,0.826196,0.173804,0.826196,384,30,2383,1968,415,0.82585,0.17415,0.82585,385,30,1, abandoned,1,1,0
51159,1000121,1,2383,1968,415,0.82585,0.17415,0.82585,385,30,2385,1968,417,0.825157,0.174843,0.825157,387,30,1, abandoned,1,1,0
51161,1000009,1,1531,1272,259,0.83083,0.16917,0.83083,232,27,1535,1275,260,0.830619,0.169381,0.830619,233,27,-1, merged,1,0,0
51161,1000534,2,432,327,105,0.756944,0.243056,1.587774,95,10,436,331,105,0.759174,0.240826,1.589793,95,10,-1, merged,0,0,0
51162,1000009,1,1535,1275,260,0.830619,0.169381,0.830619,233,27,1536,1276,260,0.830729,0.169271,0.830729,233,27,-1, abandoned,0,0,0
51162,1000534,2,436,331,105,0.759174,0.240826,1.589793,95,10,438,332,106,0.757991,0.242009,1.58872,96,10,1, abandoned,1,1,0
51163,1000014,3,2727,2250,477,0.825083,0.174917,2.349139,443,34,2728,2251,477,0.825147,0.174853,2.35069,443,34,1, merged,0,0,0
51163,1000328,5,1003,742,261,0.739781,0.260219,3.767491,235,26,1004,743,261,0.74004,0.25996,3.780385,235,26,1, merged,0,0,0
51163,1002169,1,694,540,154,0.778098,0.221902,0.778098,121,33,695,541,154,0.778417,0.221583,0.778417,121,33,-1, merged,0,0,0
51164,1000004,3,3918,3463,455,0.883869,0.116131,2.495193,362,93,3919,3464,455,0.883899,0.116101,2.495165,362,93,1, merged,0,0,0
51165,1000592,2,775,655,120,0.845161,0.154839,1.645161,75,45,776,656,120,0.845361,0.154639,1.654885,75,45,1, merged,0,0,0
51166,1000130,4,565,471,94,0.833628,0.166372,3.078355,72,22,567,472,95,0.832451,0.167549,3.024743,73,22,-1, merged,1,0,0
51166,1000328,6,1004,743,261,0.74004,0.25996,4.684249,235,26,1006,743,263,0.738569,0.261431,4.620455,237,26,1, merged,1,1,0
51169,1000004,1,3919,3464,455,0.883899,0.116101,0.883899,362,93,3920,3465,455,0.883929,0.116071,0.883929,362,93,-1, abandoned,0,0,0
51172,1000328,1,1006,743,263,0.738569,0.261431,0.738569,237,26,1008,745,263,0.739087,0.260913,0.739087,237,26,-1, merged,0,0,0
51172,1000329,2,3389,2640,749,0.778991,0.221009,1.517559,645,104,3390,2641,749,0.779056,0.220944,1.518143,645,104,-1, merged,0,0,0
51174,1000153,2,1103,998,105,0.904805,0.095195,1.654805,77,28,1104,999,105,0.904891,0.095109,1.658316,77,28,1, merged,0,0,0
51176,1000007,4,1655,1333,322,0.805438,0.194562,3.150901,284,38,1658,1336,322,0.80579,0.19421,3.16096,284,38,-1, merged,0,0,0
51176,1000009,3,1536,1276,260,0.830729,0.169271,2.345463,233,27,1539,1279,260,0.831059,0.168941,2.35517,233,27,-1, merged,0,0,0
51176,1000153,1,1105,1000,105,0.904977,0.095023,0.904977,77,28,1106,1001,105,0.905063,0.094937,0.905063,77,28,-1, merged,0,0,0
51184,1000015,2,2229,1993,236,0.894123,0.105877,1.706623,215,21,2230,1994,236,0.89417,0.10583,1.7177,215,21,1, merged,0,0,0
51187,1000120,3,1918,1667,251,0.869135,0.130865,2.477654,222,29,1920,1668,252,0.86875,0.13125,2.424718,223,29,1, merged,1,1,0
51191,1000009,2,1539,1279,260,0.831059,0.168941,1.736122,233,27,1541,1280,261,0.830629,0.169371,1.735779,233,28,-1, merged,1,1,0
51191,1000153,1,1106,1001,105,0.905063,0.094937,0.905063,77,28,1107,1002,105,0.905149,0.094851,0.905149,77,28,1, merged,0,0,0
51192,1000140,2,341,286,55,0.83871,0.16129,1.700779,47,8,342,287,55,0.839181,0.160819,1.697024,47,8,1, merged,0,0,0
51193,1000105,2,693,546,147,0.787879,0.212121,1.787879,130,17,694,547,147,0.788184,0.211816,1.788184,130,17,1, merged,0,0,0
51194,1000153,3,1107,1002,105,0.905149,0.094851,2.360328,77,28,1108,1003,105,0.905235,0.094765,2.368888,77,28,1, merged,0,0,0
51211,1000054,2,918,784,134,0.854031,0.145969,1.711874,118,16,919,785,134,0.854189,0.145811,1.707848,118,16,1, merged,0,0,0
51211,1000130,3,568,473,95,0.832746,0.167254,2.54462,73,22,569,474,95,0.83304,0.16696,2.540888,73,22,1, merged,0,0,0
51213,1000120,2,1921,1669,252,0.868818,0.131182,1.740911,223,29,1922,1670,252,0.868887,0.131113,1.734787,223,29,-1, merged,0,0,0
51214,1000120,2,1922,1670,252,0.868887,0.131113,1.734787,223,29,1923,1671,252,0.868955,0.131045,1.728803,223,29,-1, merged,0,0,0
51217,1000011,1,838,774,64,0.923628,0.076372,0.923628,59,5,839,774,65,0.922527,0.077473,0.922527,60,5,1, merged,1,1,0
51217,1000120,2,1923,1671,252,0.868955,0.131045,1.792582,223,29,1924,1672,252,0.869023,0.130977,1.79155,223,29,1, merged,0,0,0
51223,1000199,2,523,444,79,0.848948,0.151052,1.619135,72,7,524,445,79,0.849237,0.150763,1.618784,72,7,1, merged,0,0,0
51232,1000004,1,3923,3468,455,0.884017,0.115983,0.884017,362,93,3924,3469,455,0.884047,0.115953,0.884047,362,93,-1, abandoned,0,0,0
51232,1000023,2,1273,1116,157,0.876669,0.123331,1.760687,141,16,1274,1117,157,0.876766,0.123234,1.760813,141,16,-1, abandoned,0,0,0
51236,1000004,3,3926,3471,455,0.884106,0.115894,2.594205,362,93,3928,3472,456,0.88391,0.11609,2.59196,362,94,-1, merged,1,0,0
51236,1000023,1,1274,1117,157,0.876766,0.123234,0.876766,141,16,1276,1118,158,0.876176,0.123824,0.876176,142,16,1, merged,1,1,0
51236,1000130,2,570,475,95,0.833333,0.166667,1.710099,73,22,571,475,96,0.831874,0.168126,1.708049,74,22,1, merged,1,1,0
51252,1000109,1,608,519,89,0.853618,0.146382,0.853618,84,5,610,520,90,0.852459,0.147541,0.852459,85,5,1, merged,1,1,0
51252,1000199,2,524,445,79,0.849237,0.150763,1.702855,72,7,525,446,79,0.849524,0.150476,1.701983,72,7,-1, merged,0,0,0
51266,1000011,2,839,774,65,0.922527,0.077473,1.782904,60,5,840,775,65,0.922619,0.077381,1.783521,60,5,1, merged,0,0,0
51267,1000054,1,919,785,134,0.854189,0.145811,0.854189,118,16,920,786,134,0.854348,0.145652,0.854348,118,16,1, merged,0,0,0
51267,1000140,2,342,287,55,0.839181,0.160819,1.693371,47,8,343,288,55,0.83965,0.16035,1.693998,47,8,1, merged,0,0,0
51267,1000166,3,465,354,111,0.76129,0.23871,2.454661,106,5,466,355,111,0.761803,0.238197,2.455801,106,5,1, merged,0,0,0
51283,1000108,2,332,278,54,0.837349,0.162651,1.669223,50,4,333,279,54,0.837838,0.162162,1.668257,50,4,-1, merged,0,0,0
51283,1000130,1,571,475,96,0.831874,0.168126,0.831874,74,22,572,475,97,0.83042,0.16958,0.83042,75,22,1, merged,1,1,0
51283,1000140,3,343,288,55,0.83965,0.16035,2.508873,47,8,344,289,55,0.840116,0.159884,2.508374,47,8,1, merged,0,0,0
51285,1000328,2,1008,745,263,0.739087,0.260913,1.518274,237,26,1009,746,263,0.739346,0.260654,1.518597,237,26,1, merged,0,0,0
51285,1000329,1,3392,2643,749,0.779186,0.220814,0.779186,645,104,3393,2644,749,0.779251,0.220749,0.779251,645,104,1, merged,0,0,0
51290,1000110,2,503,454,49,0.902584,0.097416,1.746334,46,3,504,455,49,0.902778,0.097222,1.747498,46,3,1, merged,0,0,0
51302,1000004,4,3928,3472,456,0.88391,0.11609,3.269033,362,94,3929,3473,456,0.88394,0.11606,3.267977,362,94,-1, merged,0,0,0
51302,1000328,3,1009,746,263,0.739346,0.260654,2.385123,237,26,1012,747,265,0.738142,0.261858,2.384037,239,26,1, merged,1,1,0
51302,1000329,2,3393,2644,749,0.779251,0.220749,1.645777,645,104,3395,2645,750,0.779087,0.220913,1.645895,646,104,-1, merged,1,0,0
51309,1000199,1,525,446,79,0.849524,0.150476,0.849524,72,7,527,447,80,0.848197,0.151803,0.848197,73,7,1, merged,1,1,0
51310,1000004,2,3930,3474,456,0.883969,0.116031,1.81818,362,94,3931,3475,456,0.883999,0.116001,1.819064,362,94,1, merged,0,0,0
51316,1000007,2,1659,1337,322,0.805907,0.194093,1.636537,284,38,1661,1339,322,0.806141,0.193859,1.63699,284,38,1, merged,0,0,0
51316,1000009,1,1541,1280,261,0.830629,0.169371,0.830629,233,28,1543,1282,261,0.830849,0.169151,0.830849,233,28,-1, merged,0,0,0
51317,1000009,2,1543,1282,261,0.830849,0.169151,1.58884,233,28,1544,1283,261,0.830959,0.169041,1.589501,233,28,1, merged,0,0,0
51317,1000534,1,438,332,106,0.757991,0.242009,0.757991,96,10,439,333,106,0.758542,0.241458,0.758542,96,10,1, merged,0,0,0
51318,1000009,1,1544,1283,261,0.830959,0.169041,0.830959,233,28,1547,1285,262,0.83064,0.16936,0.83064,234,28,-1, merged,1,0,0
51318,1000015,2,2234,1998,236,0.89436,0.10564,1.725318,215,21,2235,1999,236,0.894407,0.105593,1.725047,215,21,1, merged,0,0,0
51324,1000009,2,1547,1285,262,0.83064,0.16936,1.449688,234,28,1550,1286,264,0.829677,0.170323,1.434329,236,28,1, merged,1,1,0
51324,1000153,3,1108,1003,105,0.905235,0.094765,2.354922,77,28,1109,1004,105,0.90532,0.09468,2.339649,77,28,1, merged,0,0,0
51329,1000043,1,640,529,111,0.826562,0.173437,0.826562,97,14,641,529,112,0.825273,0.174727,0.825273,98,14,1, abandoned,1,1,0
51335,1000004,2,3932,3475,457,0.883774,0.116226,1.760625,363,94,3933,3476,457,0.883804,0.116196,1.760751,363,94,1, merged,0,0,0
51335,1000023,1,1283,1125,158,0.876851,0.123149,0.876851,142,16,1284,1126,158,0.876947,0.123053,0.876947,142,16,-1, merged,0,0,0
51343,1000109,1,610,520,90,0.852459,0.147541,0.852459,85,5,611,520,91,0.851064,0.148936,0.851064,86,5,1, merged,1,1,0
51343,1000199,2,527,447,80,0.848197,0.151803,1.700656,73,7,528,448,80,0.848485,0.151515,1.699549,73,7,1, merged,0,0,0
51351,1000011,1,840,775,65,0.922619,0.077381,0.922619,60,5,841,776,65,0.922711,0.077289,0.922711,60,5,-1, merged,0,0,0
51351,1000120,2,1926,1673,253,0.86864,0.13136,1.791259,224,29,1927,1674,253,0.868708,0.131292,1.791419,224,29,1, merged,0,0,0
51352,1000004,1,3939,3482,457,0.883981,0.116019,0.883981,363,94,3941,3483,458,0.883786,0.116214,0.883786,364,94,1, merged,1,1,0
51355,1000003,1,1358,1127,231,0.829897,0.170103,0.829897,200,31,1359,1127,232,0.829286,0.170714,0.829286,201,31,1, merged,1,1,0
51357,1000166,2,466,355,111,0.761803,0.238197,1.618945,106,5,467,356,111,0.762313,0.237687,1.624382,106,5,1, merged,0,0,0
51362,1000070,1,1388,1181,207,0.850865,0.149135,0.850865,180,27,1389,1182,207,0.850972,0.149028,0.850972,180,27,1, merged,0,0,0
51365,1000004,2,3944,3486,458,0.883874,0.116126,1.721712,364,94,3945,3486,459,0.88365,0.11635,1.721974,364,95,-1, merged,1,1,0
51365,1000108,1,333,279,54,0.837838,0.162162,0.837838,50,4,334,280,54,0.838323,0.161677,0.838323,50,4,1, merged,0,0,0
51368,1000009,1,1550,1286,264,0.829677,0.170323,0.829677,236,28,1553,1288,265,0.829363,0.170637,0.829363,237,28,-1, merged,1,0,0
51368,1000534,2,439,333,106,0.758542,0.241458,1.58822,96,10,440,334,106,0.759091,0.240909,1.588453,96,10,1, merged,0,0,0
51373,1000014,1,2734,2257,477,0.82553,0.17447,0.82553,443,34,2736,2258,478,0.825292,0.174708,0.825292,444,34,1, merged,1,1,0
51373,1000120,3,1928,1675,253,0.868776,0.131224,2.694306,224,29,1929,1676,253,0.868844,0.131156,2.360803,224,29,1, merged,0,0,0
51376,1000110,2,506,457,49,0.903162,0.096838,1.743278,46,3,507,458,49,0.903353,0.096647,1.741034,46,3,1, merged,0,0,0
51376,1000140,1,344,289,55,0.840116,0.159884,0.840116,47,8,345,289,56,0.837681,0.162319,0.837681,48,8,1, merged,1,1,0
51377,1000004,1,3945,3486,459,0.88365,0.11635,0.88365,364,95,3946,3487,459,0.88368,0.11632,0.88368,364,95,1, merged,0,0,0
51377,1000199,2,528,448,80,0.848485,0.151515,1.732135,73,7,529,449,80,0.848771,0.151229,1.732451,73,7,1, merged,0,0,0
51381,1000007,1,1662,1340,322,0.806258,0.193742,0.806258,284,38,1663,1340,323,0.805773,0.194227,0.805773,285,38,1, merged,1,1,0
51381,1000153,2,1111,1006,105,0.905491,0.094509,1.711748,77,28,1112,1007,105,0.905576,0.094424,1.711348,77,28,1, merged,0,0,0
51382,1000009,1,1554,1289,265,0.829472,0.170528,0.829472,237,28,1557,1291,266,0.829159,0.170841,0.829159,238,28,1, merged,1,1,0
51382,1000015,3,2236,2000,236,0.894454,0.105546,2.629502,215,21,2237,2001,236,0.894502,0.105498,2.628422,215,21,1, merged,0,0,0
51382,1000153,2,1112,1007,105,0.905576,0.094424,1.735048,77,28,1113,1007,106,0.904762,0.095238,1.733921,78,28,1, merged,1,1,0
51383,1000011,1,842,777,65,0.922803,0.077197,0.922803,60,5,843,777,66,0.921708,0.078292,0.921708,61,5,1, merged,1,1,0
51383,1000015,2,2237,2001,236,0.894502,0.105498,1.817304,215,21,2238,2002,236,0.894549,0.105451,1.816257,215,21,1, merged,0,0,0
51387,1000015,2,2239,2003,236,0.894596,0.105404,1.799443,215,21,2240,2004,236,0.894643,0.105357,1.799576,215,21,1, merged,0,0,0
51387,1000153,1,1114,1008,106,0.904847,0.095153,0.904847,78,28,1115,1009,106,0.904933,0.095067,0.904933,78,28,1, merged,0,0,0
51393,1000005,1,699,589,110,0.842632,0.157368,0.842632,102,8,700,590,110,0.842857,0.157143,0.842857,102,8,1, merged,0,0,0
51393,1000121,2,2388,1971,417,0.825377,0.174623,1.668009,387,30,2389,1972,417,0.82545,0.17455,1.668307,387,30,1, merged,0,0,0
51396,1000014,2,2737,2259,478,0.825356,0.174644,1.614452,444,34,2738,2260,478,0.82542,0.17458,1.613386,444,34,1, merged,0,0,0
51396,1000105,1,697,550,147,0.789096,0.210904,0.789096,130,17,698,550,148,0.787966,0.212034,0.787966,131,17,1, merged,1,1,0
51406,1000140,2,345,289,56,0.837681,0.162319,1.69345,48,8,346,290,56,0.83815,0.16185,1.69461,48,8,1, merged,0,0,0
51410,1000004,3,3946,3487,459,0.88368,0.11632,2.482221,364,95,3947,3488,459,0.883709,0.116291,2.463438,364,95,-1, merged,0,0,0
51411,1000014,3,2738,2260,478,0.82542,0.17458,2.624185,444,34,2740,2261,479,0.825182,0.174818,2.622739,445,34,1, merged,1,1,0
51411,1000015,1,2240,2004,236,0.894643,0.105357,0.894643,215,21,2241,2004,237,0.894244,0.105756,0.894244,216,21,1, merged,1,1,0
51411,1000153,2,1116,1009,107,0.904122,0.095878,1.798765,79,28,1117,1009,108,0.903312,0.096688,1.797556,80,28,1, merged,1,1,0
51423,1000009,2,1558,1292,266,0.829268,0.170732,1.654451,238,28,1559,1293,266,0.829378,0.170622,1.654624,238,28,1, merged,0,0,0
51423,1000014,1,2740,2261,479,0.825182,0.174818,0.825182,445,34,2741,2262,479,0.825246,0.174754,0.825246,445,34,1, merged,0,0,0
51423,1000015,3,2241,2004,237,0.894244,0.105756,2.548694,216,21,2242,2005,237,0.894291,0.105709,2.548915,216,21,1, merged,0,0,0
51437,1000054,2,922,788,134,0.854664,0.145336,1.653225,118,16,923,789,134,0.854821,0.145179,1.654821,118,16,1, merged,0,0,0
51440,1000011,2,843,777,66,0.921708,0.078292,1.759546,61,5,844,778,66,0.921801,0.078199,1.767955,61,5,1, merged,0,0,0
51443,1000003,2,1366,1133,233,0.829429,0.170571,1.61338,202,31,1367,1134,233,0.829554,0.170446,1.608695,202,31,-1, abandoned,0,0,0
51444,1000004,1,3949,3490,459,0.883768,0.116232,0.883768,364,95,3950,3490,460,0.883544,0.116456,0.883544,365,95,1, merged,1,1,0
51444,1000014,2,2741,2262,479,0.825246,0.174754,1.709014,445,34,2743,2263,480,0.825009,0.174991,1.708553,446,34,1, merged,1,1,0
51451,1000120,2,1932,1679,253,0.869048,0.130952,1.592452,224,29,1933,1680,253,0.869115,0.130885,1.593358,224,29,1, merged,0,0,0
51470,1000132,2,680,579,101,0.851471,0.148529,1.700695,81,20,681,580,101,0.851689,0.148311,1.699371,81,20,-1, abandoned,0,0,0
51472,1000054,2,923,789,134,0.854821,0.145179,1.71738,118,16,924,790,134,0.854978,0.145022,1.718186,118,16,1, merged,0,0,0
51476,1000004,2,3951,3491,460,0.883574,0.116426,1.74806,365,95,3952,3492,460,0.883603,0.116397,1.74872,365,95,1, merged,0,0,0
51478,1000023,2,1284,1126,158,0.876947,0.123053,1.718007,142,16,1285,1127,158,0.877043,0.122957,1.718627,142,16,1, merged,0,0,0
51480,1000004,2,3952,3492,460,0.883603,0.116397,1.749344,365,95,3953,3493,460,0.883633,0.116367,1.749992,365,95,1, merged,0,0,0
51482,1000004,2,3953,3493,460,0.883633,0.116367,1.750605,365,95,3954,3494,460,0.883662,0.116338,1.751242,365,95,1, merged,0,0,0
51484,1000011,2,844,778,66,0.921801,0.078199,1.767955,61,5,845,779,66,0.921893,0.078107,1.771893,61,5,1, merged,0,0,0
51486,1000120,2,1933,1680,253,0.869115,0.130885,1.738681,224,29,1934,1681,253,0.869183,0.130817,1.760092,224,29,1, merged,0,0,0
51498,1000120,2,1934,1681,253,0.869183,0.130817,1.593425,224,29,1936,1683,253,0.869318,0.130682,1.594394,224,29,-1, merged,0,0,0
51499,1000004,1,3956,3495,461,0.883468,0.116532,0.883468,366,95,3957,3496,461,0.883498,0.116502,0.883498,366,95,1, merged,0,0,0
51499,1000130,2,573,476,97,0.830716,0.169284,1.714184,75,22,574,476,98,0.829268,0.170732,1.712766,75,23,-1, merged,1,1,0
51500,1000004,3,3957,3496,461,0.883498,0.116502,2.46755,366,95,3962,3501,461,0.883645,0.116355,2.458604,366,95,-1, merged,0,0,0
51503,1000003,2,1367,1134,233,0.829554,0.170446,1.603944,202,31,1368,1135,233,0.829678,0.170322,1.600763,202,31,-1, abandoned,0,0,0
51507,1000014,1,2743,2263,480,0.825009,0.174991,0.825009,446,34,2744,2264,480,0.825073,0.174927,0.825073,446,34,-1, abandoned,0,0,0
51507,1000329,2,3396,2645,751,0.778857,0.221143,1.603867,647,104,3397,2646,751,0.778923,0.221077,1.603995,647,104,-1, abandoned,0,0,0
51510,1000014,1,2744,2264,480,0.825073,0.174927,0.825073,446,34,2746,2265,481,0.824836,0.175164,0.824836,447,34,1, merged,1,1,0
51511,1000009,3,1563,1296,267,0.829175,0.170825,2.255648,239,28,1564,1297,267,0.829284,0.170716,2.262201,239,28,1, merged,0,0,0
51511,1000153,4,1119,1011,108,0.903485,0.096515,3.159133,80,28,1120,1012,108,0.903571,0.096429,3.165772,80,28,1, merged,0,0,0
51520,1000012,2,675,578,97,0.856296,0.143704,1.681132,94,3,676,579,97,0.856509,0.143491,1.681409,94,3,1, merged,0,0,0
51520,1000014,1,2746,2265,481,0.824836,0.175164,0.824836,447,34,2747,2266,481,0.8249,0.1751,0.8249,447,34,1, merged,0,0,0
51525,1000023,3,1286,1128,158,0.877138,0.122862,2.484824,142,16,1287,1129,158,0.877234,0.122766,2.485852,142,16,1, merged,0,0,0
51525,1000130,2,574,476,98,0.829268,0.170732,1.607686,75,23,575,477,98,0.829565,0.170435,1.608618,75,23,1, merged,0,0,0
51525,1002169,1,695,541,154,0.778417,0.221583,0.778417,121,33,697,543,154,0.779053,0.220947,0.779053,121,33,-1, merged,0,0,0
51526,1000011,2,845,779,66,0.921893,0.078107,1.782796,61,5,846,780,66,0.921986,0.078014,1.783409,61,5,1, merged,0,0,0
51529,1000004,2,3963,3502,461,0.883674,0.116326,1.694995,366,95,3964,3503,461,0.883703,0.116297,1.698518,366,95,1, merged,0,0,0
51530,1000023,4,1287,1129,158,0.877234,0.122766,2.677302,142,16,1288,1130,158,0.877329,0.122671,3.679492,142,16,1, merged,0,0,0
51534,1000009,2,1564,1297,267,0.829284,0.170716,1.75127,239,28,1565,1298,267,0.829393,0.170607,1.751563,239,28,-1, merged,0,0,0
51534,1000011,1,846,780,66,0.921986,0.078014,0.921986,61,5,848,782,66,0.92217,0.07783,0.92217,61,5,-1, merged,0,0,0
51545,1000004,1,3968,3505,463,0.883317,0.116683,0.883317,368,95,3969,3506,463,0.883346,0.116654,0.883346,368,95,1, merged,0,0,0
51545,1000592,2,776,656,120,0.845361,0.154639,1.728677,75,45,777,657,120,0.84556,0.15444,1.728906,75,45,1, merged,0,0,0
51546,1000004,1,3969,3506,463,0.883346,0.116654,0.883346,368,95,3970,3507,463,0.883375,0.116625,0.883375,368,95,1, merged,0,0,0
51546,1000592,2,777,657,120,0.84556,0.15444,1.728906,75,45,778,658,120,0.845758,0.154242,1.729134,75,45,1, merged,0,0,0
51547,1000110,2,507,458,49,0.903353,0.096647,1.737476,46,3,508,459,49,0.903543,0.096457,1.738449,46,3,1, merged,0,0,0
51551,1000004,1,3970,3507,463,0.883375,0.116625,0.883375,368,95,3971,3508,463,0.883405,0.116595,0.883405,368,95,1, merged,0,0,0
51551,1000592,3,778,658,120,0.845758,0.154242,2.535256,75,45,779,659,120,0.845956,0.154044,2.537442,75,45,1, merged,0,0,0
51556,1000014,2,2747,2266,481,0.8249,0.1751,1.603953,447,34,2748,2267,481,0.824964,0.175036,1.604649,447,34,1, merged,0,0,0
51556,1000329,3,3398,2646,752,0.778693,0.221307,2.382646,647,105,3399,2647,752,0.778758,0.221242,2.383407,647,105,1, merged,0,0,0
51556,1002169,1,697,543,154,0.779053,0.220947,0.779053,121,33,699,545,154,0.779685,0.220315,0.779685,121,33,-1, merged,0,0,0
51558,1000070,1,1397,1188,209,0.850394,0.149606,0.850394,182,27,1398,1188,210,0.849785,0.150215,0.849785,182,28,-1, merged,1,1,0
51558,1000329,2,3399,2647,752,0.778758,0.221242,1.629152,647,105,3400,2647,753,0.778529,0.221471,1.628315,647,106,-1, merged,1,1,0
51560,1000110,2,509,460,49,0.903733,0.096267,1.628808,46,3,510,461,49,0.903922,0.096078,1.629825,46,3,1, merged,0,0,0
51564,1000110,2,510,461,49,0.903922,0.096078,1.629825,46,3,511,462,49,0.90411,0.09589,1.630836,46,3,1, merged,0,0,0
51572,1000004,2,3973,3510,463,0.883463,0.116537,1.75367,368,95,3975,3512,463,0.883522,0.116478,1.751169,368,95,-1, merged,0,0,0
51573,1000043,1,642,530,112,0.825545,0.174455,0.825545,98,14,643,531,112,0.825816,0.174184,0.825816,98,14,1, merged,0,0,0
51575,1000014,2,2749,2268,481,0.825027,0.174973,1.491694,447,34,2750,2269,481,0.825091,0.174909,1.575091,447,34,1, merged,0,0,0
51577,1000011,1,848,782,66,0.92217,0.07783,0.92217,61,5,849,782,67,0.921084,0.078916,0.921084,62,5,1, merged,1,1,0
51577,1000120,2,1936,1683,253,0.869318,0.130682,1.791488,224,29,1937,1684,253,0.869386,0.130614,1.790469,224,29,-1, merged,0,0,0
51578,1000014,1,2750,2269,481,0.825091,0.174909,0.825091,447,34,2752,2270,482,0.824855,0.175145,0.824855,448,34,1, merged,1,1,0
51584,1000009,1,1567,1300,267,0.829611,0.170389,0.829611,239,28,1572,1301,271,0.827608,0.172392,0.827608,243,28,1, merged,1,1,0
51584,1000011,2,850,783,67,0.921176,0.078824,1.750787,62,5,851,784,67,0.921269,0.078731,1.748877,62,5,1, merged,0,0,0
51590,1000592,2,779,659,120,0.845956,0.154044,1.625642,75,45,780,660,120,0.846154,0.153846,1.627093,75,45,1, merged,0,0,0
51590,1002169,1,699,545,154,0.779685,0.220315,0.779685,121,33,703,549,154,0.780939,0.219061,0.780939,121,33,-1, merged,0,0,0
51591,1000120,3,1937,1684,253,0.869386,0.130614,2.558027,224,29,1938,1685,253,0.869453,0.130547,2.559159,224,29,1, merged,0,0,0
51591,1000329,1,3400,2647,753,0.778529,0.221471,0.778529,647,106,3401,2648,753,0.778595,0.221405,0.778595,647,106,1, merged,0,0,0
51594,1000043,3,644,532,112,0.826087,0.173913,2.069288,98,14,645,533,112,0.826357,0.173643,2.139277,98,14,1, merged,0,0,0
51608,1000014,1,2752,2270,482,0.824855,0.175145,0.824855,448,34,2753,2271,482,0.824918,0.175082,0.824918,448,34,1, merged,0,0,0
51619,1000004,2,3981,3517,464,0.883446,0.116554,1.752899,369,95,3983,3519,464,0.883505,0.116495,1.75251,369,95,-1, merged,0,0,0
51619,1000120,1,1938,1685,253,0.869453,0.130547,0.869453,224,29,1939,1685,254,0.869005,0.130995,0.869005,225,29,1, merged,1,1,0
51620,1000009,1,1572,1301,271,0.827608,0.172392,0.827608,243,28,1576,1303,273,0.826777,0.173223,0.826777,245,28,-1, merged,1,0,0
51620,1000534,3,443,337,106,0.760722,0.239278,2.192982,96,10,444,338,106,0.761261,0.238739,2.188038,96,10,1, merged,0,0,0
51621,1000328,1,1013,748,265,0.738401,0.261599,0.738401,239,26,1014,749,265,0.738659,0.261341,0.738659,239,26,1, merged,0,0,0
51621,1000329,2,3401,2648,753,0.778595,0.221405,1.516995,647,106,3402,2649,753,0.77866,0.22134,1.517318,647,106,1, merged,0,0,0
51622,1000004,2,3983,3519,464,0.883505,0.116495,1.664444,369,95,3984,3520,464,0.883534,0.116466,1.664784,369,95,1, merged,0,0,0
51622,1002169,1,703,549,154,0.780939,0.219061,0.780939,121,33,704,550,154,0.78125,0.21875,0.78125,121,33,-1, merged,0,0,0
51623,1000105,2,699,551,148,0.788269,0.211731,1.528675,131,17,700,552,148,0.788571,0.211429,1.529562,131,17,1, merged,0,0,0
51626,1000007,1,1671,1348,323,0.806703,0.193297,0.806703,285,38,1672,1348,324,0.80622,0.19378,0.80622,286,38,1, merged,1,1,0
51626,1000009,2,1576,1303,273,0.826777,0.173223,1.633479,245,28,1578,1305,273,0.826996,0.173004,1.633216,245,28,-1, merged,0,0,0
51627,1000007,1,1672,1348,324,0.80622,0.19378,0.80622,286,38,1673,1349,324,0.806336,0.193664,0.806336,286,38,1, merged,0,0,0
51627,1000153,2,1124,1015,109,0.903025,0.096975,1.709245,80,29,1125,1016,109,0.903111,0.096889,1.709447,80,29,1, merged,0,0,0
51630,1000121,3,2396,1979,417,0.82596,0.17404,2.434481,387,30,2397,1980,417,0.826033,0.173967,2.434978,387,30,1, merged,0,0,0
51630,1000329,1,3402,2649,753,0.77866,0.22134,0.77866,647,106,3404,2650,754,0.778496,0.221504,0.778496,648,106,1, merged,1,1,0
51632,1000015,3,2243,2006,237,0.894338,0.105662,2.55871,216,21,2244,2007,237,0.894385,0.105615,2.557691,216,21,1, merged,0,0,0
51632,1000153,2,1125,1016,109,0.903111,0.096889,1.664372,80,29,1127,1016,111,0.901508,0.098492,1.663306,80,31,-1, merged,1,1,0
51632,1000534,1,444,338,106,0.761261,0.238739,0.761261,96,10,445,339,106,0.761798,0.238202,0.761798,96,10,-1, merged,0,0,0
51644,1000054,2,927,793,134,0.855448,0.144552,1.61776,118,16,928,794,134,0.855603,0.144397,1.618424,118,16,1, merged,0,0,0
51644,1000166,1,467,356,111,0.762313,0.237687,0.762313,106,5,468,357,111,0.762821,0.237179,0.762821,106,5,1, merged,0,0,0
51646,1000007,2,1673,1349,324,0.806336,0.193664,1.654018,286,38,1674,1350,324,0.806452,0.193548,1.654469,286,38,1, merged,0,0,0
51646,1000132,3,681,580,101,0.851689,0.148311,2.505707,81,20,682,581,101,0.851906,0.148094,2.506375,81,20,1, merged,0,0,0
51648,1000009,3,1578,1305,273,0.826996,0.173004,2.259913,245,28,1579,1306,273,0.827106,0.172894,2.254537,245,28,1, merged,0,0,0
51652,1000009,2,1579,1306,273,0.827106,0.172894,1.728614,245,28,1580,1307,273,0.827215,0.172785,1.728811,245,28,1, merged,0,0,0
51652,1000153,1,1127,1016,111,0.901508,0.098492,0.901508,80,31,1128,1017,111,0.901596,0.098404,0.901596,80,31,1, merged,0,0,0
51684,1000004,1,3987,3523,464,0.883622,0.116378,0.883622,369,95,3989,3525,464,0.88368,0.11632,0.88368,369,95,-1, merged,0,0,0
51684,1000007,2,1674,1350,324,0.806452,0.193548,1.690073,286,38,1675,1351,324,0.806567,0.193433,1.690247,286,38,1, merged,0,0,0
51687,1000004,1,3989,3525,464,0.88368,0.11632,0.88368,369,95,3990,3525,465,0.883459,0.116541,0.883459,370,95,1, abandoned,1,1,0
51687,1000070,5,1399,1189,210,0.849893,0.150107,4.170694,182,28,1400,1190,210,0.85,0.15,4.169932,182,28,-1, abandoned,0,0,0
51687,1000130,2,575,477,98,0.829565,0.170435,1.713245,75,23,576,477,99,0.828125,0.171875,1.711584,76,23,1, abandoned,1,1,0
51687,1000329,3,3404,2650,754,0.778496,0.221504,2.491741,648,106,3405,2651,754,0.778561,0.221439,2.490145,648,106,-1, abandoned,0,0,0
51690,1000003,2,1371,1138,233,0.830051,0.169949,1.724436,202,31,1372,1139,233,0.830175,0.169825,1.724162,202,31,-1, abandoned,0,0,0
51690,1000015,1,2244,2007,237,0.894385,0.105615,0.894385,216,21,2245,2007,238,0.893987,0.106013,0.893987,217,21,1, abandoned,1,1,0
51707,1000014,2,2753,2271,482,0.824918,0.175082,1.614392,448,34,2754,2272,482,0.824982,0.175018,1.611712,448,34,1, merged,0,0,0
51708,1000009,1,1582,1309,273,0.827434,0.172566,0.827434,245,28,1583,1310,273,0.827543,0.172457,0.827543,245,28,1, merged,0,0,0
51708,1000153,2,1128,1017,111,0.901596,0.098404,1.729029,80,31,1129,1018,111,0.901683,0.098317,1.729226,80,31,1, merged,0,0,0
51714,1000003,1,1372,1139,233,0.830175,0.169825,0.830175,202,31,1373,1139,234,0.82957,0.17043,0.82957,203,31,1, merged,1,1,0
51715,1000014,2,2754,2272,482,0.824982,0.175018,1.539268,448,34,2755,2273,482,0.825045,0.174955,1.575045,448,34,1, merged,0,0,0
51716,1000329,3,3405,2651,754,0.778561,0.221439,1.492847,648,106,3406,2652,754,0.778626,0.221374,1.994415,648,106,1, merged,0,0,0
51719,1000004,3,3991,3526,465,0.883488,0.116512,2.099277,370,95,3993,3528,465,0.883546,0.116454,2.26749,370,95,1, merged,0,0,0
51726,1000108,1,343,286,57,0.833819,0.166181,0.833819,53,4,344,287,57,0.834302,0.165698,0.834302,53,4,-1, merged,0,0,0
51726,1000140,2,356,300,56,0.842697,0.157303,1.676516,48,8,357,301,56,0.843137,0.156863,1.67744,48,8,1, merged,0,0,0
51735,1000121,2,2397,1980,417,0.826033,0.173967,1.513533,387,30,2398,1981,417,0.826105,0.173895,1.5151,387,30,1, merged,0,0,0
51741,1000003,2,1373,1139,234,0.82957,0.17043,1.599267,203,31,1374,1140,234,0.829694,0.170306,1.599856,203,31,1, merged,0,0,0
51743,1000015,2,2247,2009,238,0.894081,0.105919,1.394081,217,21,2248,2010,238,0.894128,0.105872,1.494128,217,21,1, merged,0,0,0
51748,1000199,2,537,457,80,0.851024,0.148976,1.621185,73,7,538,458,80,0.851301,0.148699,1.619913,73,7,-1, abandoned,0,0,0
51749,1000199,2,538,458,80,0.851301,0.148699,1.619913,73,7,540,460,80,0.851852,0.148148,1.620928,73,7,-1, merged,0,0,0
51750,1000199,2,540,460,80,0.851852,0.148148,1.620928,73,7,541,461,80,0.852126,0.147874,1.621665,73,7,1, merged,0,0,0
51751,1000199,2,541,461,80,0.852126,0.147874,1.621665,73,7,542,462,80,0.852399,0.147601,1.622399,73,7,1, merged,0,0,0
51784,1000153,2,1133,1021,112,0.901147,0.098853,1.670531,81,31,1134,1022,112,0.901235,0.098765,1.671076,81,31,1, merged,0,0,0
51785,1000043,1,647,535,112,0.826893,0.173107,0.826893,98,14,648,536,112,0.82716,0.17284,0.82716,98,14,1, merged,0,0,0
51785,1000105,2,703,555,148,0.789474,0.210526,1.616367,131,17,704,556,148,0.789773,0.210227,1.616933,131,17,1, merged,0,0,0
51803,1000011,2,855,788,67,0.921637,0.078363,1.815604,62,5,856,789,67,0.921729,0.078271,1.815346,62,5,1, merged,0,0,0
51803,1000015,1,2254,2015,239,0.893966,0.106034,0.893966,217,22,2256,2016,240,0.893617,0.106383,0.893617,218,22,1, merged,1,1,0
51809,1000014,1,2759,2276,483,0.824937,0.175063,0.824937,449,34,2760,2277,483,0.825,0.175,0.825,449,34,1, merged,0,0,0
51809,1000110,2,517,468,49,0.905222,0.094778,1.730159,46,3,518,469,49,0.905405,0.094595,1.730405,46,3,1, merged,0,0,0
51820,1000121,3,2398,1981,417,0.826105,0.173895,2.410365,387,30,2399,1982,417,0.826178,0.173822,2.40879,387,30,1, merged,0,0,0
51820,1000329,2,3406,2652,754,0.778626,0.221374,1.58426,648,106,3407,2653,754,0.778691,0.221309,1.582612,648,106,1, merged,0,0,0
51821,1000132,2,682,581,101,0.851906,0.148094,1.70059,81,20,685,583,102,0.851095,0.148905,1.697922,82,20,-1, merged,1,0,0
51824,1000121,2,2399,1982,417,0.826178,0.173822,1.604869,387,30,2400,1983,417,0.82625,0.17375,1.605006,387,30,1, merged,0,0,0
51824,1000329,1,3407,2653,754,0.778691,0.221309,0.778691,648,106,3408,2654,754,0.778756,0.221244,0.778756,648,106,1, merged,0,0,0
51825,1000109,1,617,526,91,0.852512,0.147488,0.852512,86,5,618,527,91,0.852751,0.147249,0.852751,86,5,1, merged,0,0,0
51827,1000043,2,648,536,112,0.82716,0.17284,1.65588,98,14,649,537,112,0.827427,0.172573,1.655013,98,14,1, merged,0,0,0
51827,1000130,1,578,479,99,0.82872,0.17128,0.82872,76,23,580,480,100,0.827586,0.172414,0.827586,76,24,-1, merged,1,0,0
51830,1000108,1,344,287,57,0.834302,0.165698,0.834302,53,4,350,291,59,0.831429,0.168571,0.831429,55,4,1, merged,1,1,0
51830,1000110,2,518,469,49,0.905405,0.094595,1.739708,46,3,519,470,49,0.905588,0.094412,1.737016,46,3,1, merged,0,0,0
51835,1000009,1,1587,1314,273,0.827977,0.172023,0.827977,245,28,1589,1315,274,0.827565,0.172435,0.827565,246,28,-1, merged,1,0,0
51839,1000003,1,1374,1140,234,0.829694,0.170306,0.829694,203,31,1377,1142,235,0.829339,0.170661,0.829339,204,31,-1, merged,1,0,0
51839,1000199,2,545,465,80,0.853211,0.146789,1.682905,73,7,548,467,81,0.85219,0.14781,1.681529,74,7,-1, merged,1,0,0
51843,1000004,3,3993,3528,465,0.883546,0.116454,2.616006,370,95,3994,3529,465,0.883575,0.116425,2.622678,370,95,1, merged,0,0,0
51843,1000070,1,1401,1191,210,0.850107,0.149893,0.850107,182,28,1402,1192,210,0.850214,0.149786,0.850214,182,28,1, merged,0,0,0
51844,1000004,1,3994,3529,465,0.883575,0.116425,0.883575,370,95,3995,3530,465,0.883605,0.116395,0.883605,370,95,1, merged,0,0,0
51846,1000121,2,2400,1983,417,0.82625,0.17375,1.516726,387,30,2401,1984,417,0.826322,0.173678,1.518265,387,30,1, merged,0,0,0
51847,1000070,3,1402,1192,210,0.850214,0.149786,2.320913,182,28,1403,1193,210,0.850321,0.149679,2.322538,182,28,1, merged,0,0,0
51847,1000105,4,704,556,148,0.789773,0.210227,3.110686,131,17,705,557,148,0.790071,0.209929,3.112609,131,17,1, merged,0,0,0
51847,1000329,1,3408,2654,754,0.778756,0.221244,0.778756,648,106,3409,2655,754,0.778821,0.221179,0.778821,648,106,-1, merged,0,0,0
51848,1000328,2,1014,749,265,0.738659,0.261341,1.509743,239,26,1015,750,265,0.738916,0.261084,1.511371,239,26,1, merged,0,0,0
51848,1000329,3,3409,2655,754,0.778821,0.221179,2.288564,648,106,3410,2656,754,0.778886,0.221114,2.290257,648,106,1, merged,0,0,0
51856,1000004,2,3996,3531,465,0.883634,0.116366,1.670363,370,95,3997,3532,465,0.883663,0.116337,1.6677,370,95,-1, abandoned,0,0,0
51856,1000105,3,705,557,148,0.790071,0.209929,2.460434,131,17,706,558,148,0.790368,0.209632,2.458069,131,17,-1, abandoned,0,0,0
51857,1000014,3,2761,2278,483,0.825063,0.174937,2.359101,449,34,2766,2281,485,0.824657,0.175343,2.382808,451,34,1, merged,1,1,0
51858,1000014,1,2766,2281,485,0.824657,0.175343,0.824657,451,34,2773,2282,491,0.822935,0.177065,0.822935,457,34,1, merged,1,1,0
51862,1000329,3,3410,2656,754,0.778886,0.221114,2.569141,648,106,3411,2656,755,0.778657,0.221343,2.564525,649,106,1, merged,1,1,0
51863,1000009,4,1589,1315,274,0.827565,0.172435,3.012298,246,28,1590,1316,274,0.827673,0.172327,2.996841,246,28,1, merged,0,0,0
51863,1000014,1,2773,2282,491,0.822935,0.177065,0.822935,457,34,2781,2289,492,0.823085,0.176915,0.823085,458,34,-1, merged,1,0,0
51863,1000534,2,445,339,106,0.761798,0.238202,1.584733,96,10,451,344,107,0.762749,0.237251,1.585835,97,10,-1, merged,1,0,0
51865,1000130,1,580,480,100,0.827586,0.172414,0.827586,76,24,581,480,101,0.826162,0.173838,0.826162,77,24,1, merged,1,1,0
51865,1000328,3,1015,750,265,0.738916,0.261084,2.259899,239,26,1017,752,265,0.73943,0.26057,2.255732,239,26,1, merged,0,0,0
51875,1000109,2,618,527,91,0.852751,0.147249,1.623788,86,5,619,528,91,0.852989,0.147011,1.622969,86,5,1, merged,0,0,0
51876,1000109,2,619,528,91,0.852989,0.147011,1.622969,86,5,620,529,91,0.853226,0.146774,1.622158,86,5,1, merged,0,0,0
51880,1000011,2,857,790,67,0.92182,0.07818,1.792845,62,5,859,791,68,0.920838,0.079162,1.792317,63,5,1, merged,1,1,0
51880,1000026,1,566,493,73,0.871025,0.128975,0.871025,70,3,568,495,73,0.871479,0.128521,0.871479,70,3,-1, merged,0,0,0
51882,1000011,2,860,792,68,0.92093,0.07907,1.787597,63,5,861,793,68,0.921022,0.078978,1.775861,63,5,1, merged,0,0,0
51883,1000004,1,4001,3535,466,0.883529,0.116471,0.883529,371,95,4002,3536,466,0.883558,0.116442,0.883558,371,95,1, merged,0,0,0
51883,1000026,2,568,495,73,0.871479,0.128521,1.755008,70,3,569,496,73,0.871705,0.128295,1.755263,70,3,1, merged,0,0,0
51888,1000120,4,1940,1686,254,0.869072,0.130928,2.80474,225,29,1941,1687,254,0.86914,0.13086,2.904556,225,29,1, merged,0,0,0
51890,1000014,2,2781,2289,492,0.823085,0.176915,1.623085,458,34,2782,2289,493,0.822789,0.177211,1.640971,459,34,1, abandoned,1,1,0
51896,1000014,1,2782,2289,493,0.822789,0.177211,0.822789,459,34,2783,2290,493,0.822853,0.177147,0.822853,459,34,-1, merged,0,0,0
51896,1000120,2,1942,1688,254,0.869207,0.130793,1.691996,225,29,1943,1689,254,0.869274,0.130726,1.692127,225,29,1, merged,0,0,0
51899,1000140,3,359,303,56,0.844011,0.155989,2.361145,48,8,360,304,56,0.844444,0.155556,2.344038,48,8,1, merged,0,0,0
51900,1000009,1,1592,1318,274,0.827889,0.172111,0.827889,246,28,1593,1318,275,0.82737,0.17263,0.82737,247,28,1, abandoned,1,1,0
51901,1000108,2,356,297,59,0.83427,0.16573,1.63427,55,4,357,297,60,0.831933,0.168067,1.626259,56,4,1, abandoned,1,1,0
51904,1000014,3,2783,2290,493,0.822853,0.177147,2.455631,459,34,2784,2291,493,0.822917,0.177083,2.456221,459,34,1, merged,0,0,0
51904,1000070,4,1403,1193,210,0.850321,0.149679,3.305952,182,28,1404,1194,210,0.850427,0.149573,3.306648,182,28,1, merged,0,0,0
51904,1000132,2,687,585,102,0.851528,0.148472,1.632778,82,20,688,586,102,0.851744,0.148256,1.633304,82,20,1, merged,0,0,0
51904,1002169,1,704,550,154,0.78125,0.21875,0.78125,121,33,705,551,154,0.78156,0.21844,0.78156,121,33,-1, merged,0,0,0
51905,1000004,1,4002,3536,466,0.883558,0.116442,0.883558,371,95,4004,3538,466,0.883616,0.116384,0.883616,371,95,-1, merged,0,0,0
51912,1000004,1,4004,3538,466,0.883616,0.116384,0.883616,371,95,4005,3538,467,0.883396,0.116604,0.883396,372,95,1, abandoned,1,1,0
51917,1000014,3,2784,2291,493,0.822917,0.177083,2.386671,459,34,2785,2291,494,0.822621,0.177379,2.388395,459,35,-1, merged,1,1,0
51920,1000043,2,649,537,112,0.827427,0.172573,1.556593,98,14,650,538,112,0.827692,0.172308,1.557663,98,14,1, merged,0,0,0
51928,1000014,1,2786,2292,494,0.822685,0.177315,0.822685,459,35,2787,2293,494,0.822748,0.177252,0.822748,459,35,1, merged,0,0,0
51931,1000328,2,1017,752,265,0.73943,0.26057,1.4694,239,26,1018,753,265,0.739686,0.260314,1.470455,239,26,1, merged,0,0,0
51931,1000329,3,3411,2656,755,0.778657,0.221343,2.248057,649,106,3412,2657,755,0.778722,0.221278,2.249177,649,106,1, merged,0,0,0
51933,1000023,1,1294,1135,159,0.877125,0.122875,0.877125,143,16,1295,1136,159,0.87722,0.12278,0.87722,143,16,1, merged,0,0,0
51934,1000130,1,583,482,101,0.826758,0.173242,0.826758,77,24,584,483,101,0.827055,0.172945,0.827055,77,24,1, merged,0,0,0
51934,1000329,3,3412,2657,755,0.778722,0.221278,2.377935,649,106,3413,2658,755,0.778787,0.221213,2.379651,649,106,1, merged,0,0,0
51936,1000007,2,1678,1354,324,0.806913,0.193087,1.700624,286,38,1679,1355,324,0.807028,0.192972,1.700786,286,38,1, merged,0,0,0
51936,1000015,1,2258,2018,240,0.893711,0.106289,0.893711,218,22,2259,2019,240,0.893758,0.106242,0.893758,218,22,-1, merged,0,0,0
51940,1000007,1,1679,1355,324,0.807028,0.192972,0.807028,286,38,1680,1356,324,0.807143,0.192857,0.807143,286,38,1, merged,0,0,0
51940,1000110,2,520,470,50,0.903846,0.096154,1.710874,47,3,521,471,50,0.904031,0.095969,1.711174,47,3,1, merged,0,0,0
51945,1000130,1,584,483,101,0.827055,0.172945,0.827055,77,24,585,484,101,0.82735,0.17265,0.82735,77,24,1, merged,0,0,0
51945,1000329,2,3413,2658,755,0.778787,0.221213,1.605842,649,106,3414,2659,755,0.778852,0.221148,1.606202,649,106,1, merged,0,0,0
51951,1000004,2,4006,3539,467,0.883425,0.116575,1.730252,372,95,4007,3540,467,0.883454,0.116546,1.730616,372,95,1, merged,0,0,0
51953,1000110,2,521,471,50,0.904031,0.095969,1.698357,47,3,523,473,50,0.904398,0.095602,1.69313,47,3,-1, merged,0,0,0
51997,1000132,1,689,587,102,0.851959,0.148041,0.851959,82,20,690,588,102,0.852174,0.147826,0.852174,82,20,1, merged,0,0,0
51997,1000153,2,1134,1022,112,0.901235,0.098765,1.753194,81,31,1135,1023,112,0.901322,0.098678,1.753495,81,31,1, merged,0,0,0
52002,1000004,2,4008,3541,467,0.883483,0.116517,1.760798,372,95,4009,3542,467,0.883512,0.116488,1.760922,372,95,1, merged,0,0,0
52002,1000023,1,1296,1137,159,0.877315,0.122685,0.877315,143,16,1297,1138,159,0.877409,0.122591,0.877409,143,16,1, merged,0,0,0
52004,1000026,1,569,496,73,0.871705,0.128295,0.871705,70,3,571,498,73,0.872154,0.127846,0.872154,70,3,-1, merged,0,0,0
52004,1000109,3,623,532,91,0.853933,0.146067,2.495908,86,5,624,533,91,0.854167,0.145833,2.497034,86,5,1, merged,0,0,0
52006,1000023,3,1297,1138,159,0.877409,0.122591,2.553787,143,16,1298,1138,160,0.876733,0.123267,2.554011,143,17,-1, merged,1,1,0
52006,1000108,1,357,297,60,0.831933,0.168067,0.831933,56,4,358,298,60,0.832402,0.167598,0.832402,56,4,1, merged,0,0,0
52006,1000140,2,360,304,56,0.844444,0.155556,1.676377,48,8,361,305,56,0.844875,0.155125,1.677278,48,8,1, merged,0,0,0
52009,1000329,2,3414,2659,755,0.778852,0.221148,1.467163,649,106,3416,2661,755,0.778981,0.221019,1.466481,649,106,-1, merged,0,0,0
52011,1000108,2,358,298,60,0.832402,0.167598,1.736982,56,4,359,298,61,0.830084,0.169916,1.732941,57,4,1, merged,1,1,0
52011,1000110,1,524,474,50,0.90458,0.09542,0.90458,47,3,525,474,51,0.902857,0.097143,0.902857,48,3,1, merged,1,1,0
52011,1000166,4,468,357,111,0.762821,0.237179,3.273612,106,5,469,358,111,0.763326,0.236674,3.272738,106,5,1, merged,0,0,0
52019,1000328,4,1018,753,265,0.739686,0.260314,3.104149,239,26,1019,754,265,0.739941,0.260059,3.105391,239,26,-1, merged,0,0,0
52019,1000329,1,3416,2661,755,0.778981,0.221019,0.778981,649,106,3418,2663,755,0.779111,0.220889,0.779111,649,106,-1, merged,0,0,0
52019,1002169,3,705,551,154,0.78156,0.21844,2.364463,121,33,706,552,154,0.78187,0.21813,2.36545,121,33,-1, merged,0,0,0
52024,1000012,2,678,581,97,0.856932,0.143068,1.579445,94,3,679,582,97,0.857143,0.142857,1.581101,94,3,1, merged,0,0,0
52026,1000012,2,679,582,97,0.857143,0.142857,1.581101,94,3,680,583,97,0.857353,0.142647,1.582742,94,3,1, merged,0,0,0
52027,1000007,2,1681,1357,324,0.807258,0.192742,1.532646,286,38,1682,1357,325,0.806778,0.193222,1.528427,287,38,1, abandoned,1,1,0
52044,1000130,1,590,488,102,0.827119,0.172881,0.827119,78,24,592,489,103,0.826014,0.173986,0.826014,79,24,-1, abandoned,1,0,0
52044,1000592,2,780,660,120,0.846154,0.153846,1.673272,75,45,781,660,121,0.84507,0.15493,1.671084,76,45,1, abandoned,1,1,0
52046,1000328,2,1019,754,265,0.739941,0.260059,1.655482,239,26,1020,755,265,0.740196,0.259804,1.656021,239,26,1, merged,0,0,0
52052,1000054,1,929,795,134,0.855759,0.144241,0.855759,118,16,930,795,135,0.854839,0.145161,0.854839,119,16,1, merged,1,1,0
52052,1000592,2,781,660,121,0.84507,0.15493,1.700829,76,45,782,661,121,0.845269,0.154731,1.700107,76,45,1, merged,0,0,0
52053,1000007,1,1682,1357,325,0.806778,0.193222,0.806778,287,38,1683,1358,325,0.806892,0.193108,0.806892,287,38,1, merged,0,0,0
52053,1000009,2,1597,1322,275,0.827802,0.172198,1.63458,247,28,1598,1323,275,0.82791,0.17209,1.634802,247,28,1, merged,0,0,0
52059,1000004,2,4012,3545,467,0.883599,0.116401,1.66271,372,95,4014,3546,468,0.883408,0.116592,1.66242,373,95,-1, merged,1,0,0
52059,1000329,1,3418,2663,755,0.779111,0.220889,0.779111,649,106,3421,2665,756,0.779012,0.220988,0.779012,650,106,-1, merged,1,0,0
52059,1002169,3,706,552,154,0.78187,0.21813,2.444579,121,33,707,553,154,0.782178,0.217822,2.444598,121,33,-1, merged,0,0,0
52068,1000110,2,528,477,51,0.903409,0.096591,1.75729,48,3,529,478,51,0.903592,0.096408,1.753592,48,3,1, merged,0,0,0
52078,1000014,1,2790,2296,494,0.822939,0.177061,0.822939,459,35,2792,2298,494,0.823066,0.176934,0.823066,459,35,-1, merged,0,0,0
52082,1000004,1,4014,3546,468,0.883408,0.116592,0.883408,373,95,4015,3547,468,0.883437,0.116563,0.883437,373,95,1, merged,0,0,0
52086,1000004,2,4015,3547,468,0.883437,0.116563,1.550104,373,95,4016,3548,468,0.883466,0.116534,1.597752,373,95,1, merged,0,0,0
52086,1000023,3,1303,1143,160,0.877206,0.122794,2.42731,143,17,1304,1144,160,0.877301,0.122699,2.475052,143,17,1, merged,0,0,0
52104,1000109,3,624,533,91,0.854167,0.145833,2.434844,86,5,625,534,91,0.8544,0.1456,2.436804,86,5,1, merged,0,0,0
52115,1000014,1,2798,2303,495,0.823088,0.176912,0.823088,460,35,2799,2303,496,0.822794,0.177206,0.822794,461,35,1, merged,1,1,0
52115,1000592,2,782,661,121,0.845269,0.154731,1.668356,76,45,783,662,121,0.845466,0.154534,1.66826,76,45,1, merged,0,0,0
52119,1000014,1,2805,2306,499,0.822103,0.177897,0.822103,464,35,2808,2308,500,0.821937,0.178063,0.821937,464,36,-1, merged,1,0,0
52126,1000110,2,529,478,51,0.903592,0.096408,1.729899,48,3,530,479,51,0.903774,0.096226,1.730373,48,3,1, merged,0,0,0
52126,1000130,1,593,490,103,0.826307,0.173693,0.826307,79,24,594,491,103,0.826599,0.173401,0.826599,79,24,1, merged,0,0,0
52129,1000054,1,930,795,135,0.854839,0.145161,0.854839,119,16,931,795,136,0.853921,0.146079,0.853921,120,16,1, merged,1,1,0
52129,1000328,5,1020,755,265,0.740196,0.259804,3.833309,239,26,1023,758,265,0.740958,0.259042,3.810631,239,26,-1, merged,0,0,0
52130,1000110,3,530,479,51,0.903774,0.096226,2.525923,48,3,531,479,52,0.902072,0.097928,2.521562,49,3,1, merged,1,1,0
52132,1000109,1,625,534,91,0.8544,0.1456,0.8544,86,5,626,535,91,0.854633,0.145367,0.854633,86,5,1, merged,0,0,0
52139,1000012,2,682,584,98,0.856305,0.143695,1.577954,95,3,684,586,98,0.856725,0.143275,1.579802,95,3,1, merged,0,0,0
52140,1000328,2,1023,758,265,0.740958,0.259042,1.556084,239,26,1024,759,265,0.741211,0.258789,1.557878,239,26,1, merged,0,0,0
52142,1000007,1,1683,1358,325,0.806892,0.193108,0.806892,287,38,1684,1359,325,0.807007,0.192993,0.807007,287,38,1, merged,0,0,0
52142,1000153,2,1139,1027,112,0.901668,0.098332,1.708561,81,31,1140,1028,112,0.901754,0.098246,1.708762,81,31,1, merged,0,0,0
52150,1000109,2,626,535,91,0.854633,0.145367,1.627966,86,5,627,536,91,0.854864,0.145136,1.629058,86,5,1, merged,0,0,0
52151,1000004,2,4037,3568,469,0.883825,0.116175,1.705889,374,95,4039,3570,469,0.883882,0.116118,1.705425,374,95,-1, merged,0,0,0
52151,1000014,1,2810,2310,500,0.822064,0.177936,0.822064,464,36,2813,2311,502,0.821543,0.178457,0.821543,466,36,1, merged,1,1,0
52159,1000014,1,2813,2311,502,0.821543,0.178457,0.821543,466,36,2814,2312,502,0.821606,0.178394,0.821606,466,36,1, merged,0,0,0
52160,1000014,1,2814,2312,502,0.821606,0.178394,0.821606,466,36,2815,2313,502,0.82167,0.17833,0.82167,466,36,1, merged,0,0,0
52162,1000109,2,627,536,91,0.854864,0.145136,1.707054,86,5,630,539,91,0.855556,0.144444,1.706735,86,5,-1, merged,0,0,0
52162,1000199,1,548,467,81,0.85219,0.14781,0.85219,74,7,551,469,82,0.85118,0.14882,0.85118,75,7,1, merged,1,1,0
52165,1000108,1,362,301,61,0.831492,0.168508,0.831492,57,4,364,302,62,0.82967,0.17033,0.82967,58,4,-1, merged,1,0,0
52165,1000110,3,531,479,52,0.902072,0.097928,2.584242,49,3,532,480,52,0.902256,0.097744,2.578773,49,3,1, merged,0,0,0
52166,1000014,2,2816,2314,502,0.821733,0.178267,1.565037,466,36,2817,2315,502,0.821796,0.178204,1.565672,466,36,1, merged,0,0,0
52170,1000004,4,4039,3570,469,0.883882,0.116118,3.258906,374,95,4040,3571,469,0.883911,0.116089,3.266106,374,95,1, merged,0,0,0
52170,1000120,2,1944,1690,254,0.869342,0.130658,1.687523,225,29,1945,1691,254,0.869409,0.130591,1.690837,225,29,1, merged,0,0,0
52171,1000109,2,630,539,91,0.855556,0.144444,1.629749,86,5,631,540,91,0.855784,0.144216,1.630406,86,5,1, merged,0,0,0
52174,1000120,2,1945,1691,254,0.869409,0.130591,1.648679,225,29,1946,1692,254,0.869476,0.130524,1.648518,225,29,1, merged,0,0,0
52174,1000329,1,3425,2669,756,0.77927,0.22073,0.77927,650,106,3426,2669,757,0.779043,0.220957,0.779043,650,107,-1, merged,1,1,0
52175,1000121,2,2405,1988,417,0.826611,0.173389,1.340897,387,30,2408,1990,418,0.826412,0.173588,1.313591,388,30,-1, merged,1,0,0
52176,1000014,1,2817,2315,502,0.821796,0.178204,0.821796,466,36,2822,2317,505,0.821049,0.178951,0.821049,469,36,-1, merged,1,0,0
52176,1000070,2,1404,1194,210,0.850427,0.149573,1.672224,182,28,1406,1195,211,0.849929,0.150071,1.670978,183,28,1, merged,1,1,0
52177,1000130,1,594,491,103,0.826599,0.173401,0.826599,79,24,595,492,103,0.826891,0.173109,0.826891,79,24,-1, merged,0,0,0
52179,1000110,3,532,480,52,0.902256,0.097744,2.600614,49,3,533,481,52,0.902439,0.097561,2.600249,49,3,1, merged,0,0,0
52179,1000132,1,694,590,104,0.850144,0.149856,0.850144,84,20,695,590,105,0.848921,0.151079,0.848921,85,20,1, merged,1,1,0
52182,1000014,1,2822,2317,505,0.821049,0.178951,0.821049,469,36,2824,2319,505,0.821176,0.178824,0.821176,469,36,-1, merged,0,0,0
52182,1000105,5,707,559,148,0.790665,0.209335,4.083287,131,17,709,561,148,0.791255,0.208745,4.071732,131,17,-1, merged,0,0,0
52182,1000132,2,695,590,105,0.848921,0.151079,1.66997,85,20,697,591,106,0.84792,0.15208,1.669095,86,20,-1, merged,1,0,0
52183,1000007,2,1687,1362,325,0.80735,0.19265,1.635173,287,38,1688,1363,325,0.807464,0.192536,1.635395,287,38,1, merged,0,0,0
52183,1000009,1,1603,1327,276,0.827823,0.172177,0.827823,248,28,1604,1328,276,0.82793,0.17207,0.82793,248,28,1, merged,0,0,0
52186,1000004,2,4040,3571,469,0.883911,0.116089,1.728269,374,95,4042,3573,469,0.883968,0.116032,1.72893,374,95,-1, merged,0,0,0
52186,1000329,3,3426,2669,757,0.779043,0.220957,2.507311,650,107,3427,2669,758,0.778815,0.221185,2.507745,650,108,-1, merged,1,1,0
52188,1000004,1,4042,3573,469,0.883968,0.116032,0.883968,374,95,4044,3575,469,0.884026,0.115974,0.884026,374,95,-1, merged,0,0,0
52188,1000329,2,3428,2670,758,0.77888,0.22112,1.662848,650,108,3429,2671,758,0.778944,0.221056,1.66297,650,108,1, merged,0,0,0
52190,1000004,1,4047,3577,470,0.883865,0.116135,0.883865,375,95,4048,3578,470,0.883893,0.116107,0.883893,375,95,1, merged,0,0,0
52190,1000329,2,3429,2671,758,0.778944,0.221056,1.662809,650,108,3430,2672,758,0.779009,0.220991,1.662902,650,108,1, merged,0,0,0
52191,1000004,1,4048,3578,470,0.883893,0.116107,0.883893,375,95,4050,3580,470,0.883951,0.116049,0.883951,375,95,-1, merged,0,0,0
52191,1000329,2,3430,2672,758,0.779009,0.220991,1.662902,650,108,3431,2673,758,0.779073,0.220927,1.663024,650,108,1, merged,0,0,0
52193,1000023,1,1307,1145,162,0.876052,0.123948,0.876052,143,19,1308,1146,162,0.876147,0.123853,0.876147,143,19,1, merged,0,0,0
52193,1000026,2,571,498,73,0.872154,0.127846,1.748206,70,3,572,499,73,0.872378,0.127622,1.748524,70,3,1, merged,0,0,0
52201,1000004,1,4050,3580,470,0.883951,0.116049,0.883951,375,95,4051,3581,470,0.883979,0.116021,0.883979,375,95,-1, merged,0,0,0
52209,1000121,2,2408,1990,418,0.826412,0.173588,1.673773,388,30,2409,1990,419,0.826069,0.173931,1.674296,389,30,1, merged,1,1,0
52209,1000132,1,701,594,107,0.847361,0.152639,0.847361,86,21,705,598,107,0.848227,0.151773,0.848227,86,21,-1, merged,0,0,0
52210,1000121,2,2409,1990,419,0.826069,0.173931,1.674296,389,30,2410,1991,419,0.826141,0.173859,1.674583,389,30,-1, abandoned,0,0,0
52210,1000132,1,705,598,107,0.848227,0.151773,0.848227,86,21,706,599,107,0.848442,0.151558,0.848442,86,21,-1, abandoned,0,0,0
52217,1000009,2,1604,1328,276,0.82793,0.17207,1.729771,248,28,1605,1329,276,0.828037,0.171963,1.729964,248,28,1, merged,0,0,0
52217,1000153,1,1141,1029,112,0.90184,0.09816,0.90184,81,31,1142,1030,112,0.901926,0.098074,0.901926,81,31,1, merged,0,0,0
52218,1000009,2,1605,1329,276,0.828037,0.171963,1.729964,248,28,1606,1330,276,0.828144,0.171856,1.730157,248,28,1, merged,0,0,0
52218,1000153,1,1142,1030,112,0.901926,0.098074,0.901926,81,31,1143,1031,112,0.902012,0.097988,0.902012,81,31,1, merged,0,0,0
52219,1000009,2,1606,1330,276,0.828144,0.171856,1.730157,248,28,1607,1331,276,0.828251,0.171749,1.730349,248,28,1, merged,0,0,0
52219,1000153,1,1143,1031,112,0.902012,0.097988,0.902012,81,31,1144,1032,112,0.902098,0.097902,0.902098,81,31,1, merged,0,0,0
52220,1000009,2,1607,1331,276,0.828251,0.171749,1.730349,248,28,1609,1332,277,0.827843,0.172157,1.728367,249,28,1, merged,1,1,0
52220,1000153,1,1144,1032,112,0.902098,0.097902,0.902098,81,31,1146,1032,114,0.900524,0.099476,0.900524,82,32,1, merged,1,1,0
52221,1000009,1,1609,1332,277,0.827843,0.172157,0.827843,249,28,1610,1333,277,0.82795,0.17205,0.82795,249,28,1, merged,0,0,0
52221,1000153,2,1146,1032,114,0.900524,0.099476,1.728367,82,32,1147,1033,114,0.90061,0.09939,1.728561,82,32,1, merged,0,0,0
52222,1000009,2,1610,1333,277,0.82795,0.17205,1.728561,249,28,1611,1334,277,0.828057,0.171943,1.728754,249,28,1, merged,0,0,0
52222,1000153,1,1147,1033,114,0.90061,0.09939,0.90061,82,32,1148,1034,114,0.900697,0.099303,0.900697,82,32,1, merged,0,0,0
52223,1000009,2,1611,1334,277,0.828057,0.171943,1.728754,249,28,1613,1335,278,0.82765,0.17235,1.72765,250,28,1, merged,1,1,0
52223,1000153,1,1148,1034,114,0.900697,0.099303,0.900697,82,32,1150,1035,115,0.9,0.1,0.9,83,32,1, merged,1,1,0
52224,1000004,3,4053,3583,470,0.884037,0.115963,2.611687,375,95,4055,3584,471,0.883847,0.116153,2.609731,375,96,-1, merged,1,0,0
52224,1000009,2,1613,1335,278,0.82765,0.17235,1.72765,250,28,1618,1336,282,0.825711,0.174289,1.725884,253,29,1, merged,1,1,0
52224,1000153,1,1150,1035,115,0.9,0.1,0.9,83,32,1152,1037,115,0.900174,0.099826,0.900174,83,32,-1, merged,0,0,0
52225,1000004,1,4055,3584,471,0.883847,0.116153,0.883847,375,96,4057,3585,472,0.883658,0.116342,0.883658,376,96,1, merged,1,1,0
52225,1000592,2,785,663,122,0.844586,0.155414,1.728433,76,46,786,664,122,0.844784,0.155216,1.728442,76,46,1, merged,0,0,0
52230,1000153,1,1152,1037,115,0.900174,0.099826,0.900174,83,32,1153,1037,116,0.899393,0.100607,0.899393,84,32,1, abandoned,1,1,0
52236,1000132,2,707,600,107,0.848656,0.151344,1.697545,86,21,708,601,107,0.84887,0.15113,1.694685,86,21,1, merged,0,0,0
52239,1000004,3,4058,3586,472,0.883687,0.116313,2.558698,376,96,4059,3586,473,0.883469,0.116531,2.557012,376,97,-1, merged,1,1,0
52239,1000121,1,2410,1991,419,0.826141,0.173859,0.826141,389,30,2412,1992,420,0.825871,0.174129,0.825871,390,30,1, merged,1,1,0
52239,1000132,2,708,601,107,0.84887,0.15113,1.675011,86,21,709,601,108,0.847673,0.152327,1.673543,87,21,1, merged,1,1,0
52240,1000121,3,2412,1992,420,0.825871,0.174129,2.296336,390,30,2413,1993,420,0.825943,0.174057,2.297907,390,30,1, merged,0,0,0
52240,1000329,2,3437,2677,760,0.778877,0.221123,1.470466,651,109,3438,2678,760,0.778941,0.221059,1.471965,651,109,1, merged,0,0,0
52241,1000121,2,2413,1993,420,0.825943,0.174057,1.697943,390,30,2414,1993,421,0.825601,0.174399,1.697856,391,30,1, merged,1,1,0
52241,1000132,3,709,601,108,0.847673,0.152327,2.545616,87,21,710,602,108,0.847887,0.152113,2.545743,87,21,1, merged,0,0,0
52251,1000014,1,2824,2319,505,0.821176,0.178824,0.821176,469,36,2825,2320,505,0.821239,0.178761,0.821239,469,36,1, merged,0,0,0
52252,1000109,2,633,542,91,0.85624,0.14376,1.722907,86,5,634,543,91,0.856467,0.143533,1.723724,86,5,1, merged,0,0,0
52255,1000014,2,2825,2320,505,0.821239,0.178761,1.675159,469,36,2826,2321,505,0.821302,0.178698,1.675379,469,36,1, merged,0,0,0
52255,1000054,1,931,795,136,0.853921,0.146079,0.853921,120,16,932,796,136,0.854077,0.145923,0.854077,120,16,1, merged,0,0,0
52268,1000054,2,932,796,136,0.854077,0.145923,1.658547,120,16,933,797,136,0.854234,0.145766,1.659248,120,16,1, merged,0,0,0
52268,1000166,3,469,358,111,0.763326,0.236674,2.421873,106,5,470,359,111,0.76383,0.23617,2.423077,106,5,1, merged,0,0,0
52270,1000014,1,2826,2321,505,0.821302,0.178698,0.821302,469,36,2830,2325,505,0.821555,0.178445,0.821555,469,36,-1, merged,0,0,0
52270,1000120,2,1949,1695,254,0.869677,0.130323,1.690979,225,29,1950,1696,254,0.869744,0.130256,1.691298,225,29,1, merged,0,0,0
52281,1000004,1,4060,3587,473,0.883498,0.116502,0.883498,376,97,4063,3589,474,0.883337,0.116663,0.883337,377,97,-1, merged,1,0,0
52284,1000054,1,935,798,137,0.853476,0.146524,0.853476,121,16,936,798,138,0.852564,0.147436,0.852564,122,16,1, merged,1,1,0
52284,1000166,3,470,359,111,0.76383,0.23617,2.489561,106,5,475,361,114,0.76,0.24,2.483596,109,5,1, merged,1,1,0
52290,1000004,1,4064,3590,474,0.883366,0.116634,0.883366,377,97,4066,3592,474,0.883424,0.116576,0.883424,377,97,-1, merged,0,0,0
52290,1000153,2,1153,1037,116,0.899393,0.100607,1.782759,84,32,1154,1038,116,0.89948,0.10052,1.782904,84,32,-1, merged,0,0,0
52294,1000110,3,538,484,54,0.899628,0.100372,2.441424,51,3,539,485,54,0.899814,0.100186,2.349814,51,3,1, merged,0,0,0
52297,1000023,2,1313,1149,164,0.875095,0.124905,1.707653,145,19,1314,1150,164,0.87519,0.12481,1.708524,145,19,1, merged,0,0,0
52315,1000023,1,1314,1150,164,0.87519,0.12481,0.87519,145,19,1315,1151,164,0.875285,0.124715,0.875285,145,19,1, merged,0,0,0
52323,1000070,1,1406,1195,211,0.849929,0.150071,0.849929,183,28,1407,1196,211,0.850036,0.149964,0.850036,183,28,1, merged,0,0,0
52323,1000105,2,709,561,148,0.791255,0.208745,1.641184,131,17,710,562,148,0.791549,0.208451,1.641585,131,17,1, merged,0,0,0
52324,1000014,2,2830,2325,505,0.821555,0.178445,1.56713,469,36,2831,2326,505,0.821618,0.178382,1.567755,469,36,1, merged,0,0,0
52327,1000014,2,2831,2326,505,0.821618,0.178382,1.609289,469,36,2832,2327,505,0.821681,0.178319,1.610796,469,36,1, merged,0,0,0
52327,1000108,3,375,313,62,0.834667,0.165333,2.443956,58,4,376,314,62,0.835106,0.164894,2.445903,58,4,1, merged,0,0,0
52328,1000004,2,4068,3594,474,0.883481,0.116519,1.643545,377,97,4069,3595,474,0.883509,0.116491,1.64396,377,97,1, merged,0,0,0
52333,1000009,2,1618,1336,282,0.825711,0.174289,1.694792,253,29,1620,1337,283,0.825309,0.174691,1.691975,254,29,1, merged,1,1,0
52338,1000004,1,4069,3595,474,0.883509,0.116491,0.883509,377,97,4070,3595,475,0.883292,0.116708,0.883292,378,97,1, abandoned,1,1,0
52338,1000329,2,3438,2678,760,0.778941,0.221059,1.662451,651,109,3439,2679,760,0.779006,0.220994,1.662298,651,109,-1, abandoned,0,0,0
52339,1000329,2,3439,2679,760,0.779006,0.220994,1.624565,651,109,3440,2680,760,0.77907,0.22093,1.625224,651,109,-1, abandoned,0,0,0
52341,1000004,3,4070,3595,475,0.883292,0.116708,2.580158,378,97,4071,3596,475,0.883321,0.116679,2.579327,378,97,-1, abandoned,0,0,0
52341,1000014,1,2833,2327,506,0.821391,0.178609,0.821391,470,36,2834,2327,507,0.821101,0.178899,0.821101,471,36,1, abandoned,1,1,0
52341,1000023,2,1317,1153,164,0.875475,0.124525,1.696865,145,19,1319,1154,165,0.874905,0.125095,1.696006,146,19,-1, abandoned,1,0,0
52344,1000004,1,4071,3596,475,0.883321,0.116679,0.883321,378,97,4073,3597,476,0.883133,0.116867,0.883133,379,97,-1, abandoned,1,0,0
52344,1000130,2,595,492,103,0.826891,0.173109,1.710212,79,24,597,494,103,0.827471,0.172529,1.710604,79,24,-1, abandoned,0,0,0
52358,1000009,1,1620,1337,283,0.825309,0.174691,0.825309,254,29,1622,1339,283,0.825524,0.174476,0.825524,254,29,-1, merged,0,0,0
52358,1000011,3,867,799,68,0.921569,0.078431,2.616621,63,5,868,800,68,0.921659,0.078341,2.61706,63,5,1, merged,0,0,0
52358,1000120,2,1950,1696,254,0.869744,0.130256,1.695052,225,29,1952,1698,254,0.869877,0.130123,1.695401,225,29,-1, merged,0,0,0
52359,1000009,1,1622,1339,283,0.825524,0.174476,0.825524,254,29,1627,1342,285,0.824831,0.175169,0.824831,256,29,-1, merged,1,0,0
52359,1000153,2,1157,1041,116,0.899741,0.100259,1.725265,84,32,1159,1043,116,0.899914,0.100086,1.724745,84,32,1, merged,0,0,0
52363,1000004,1,4073,3597,476,0.883133,0.116867,0.883133,379,97,4074,3598,476,0.883162,0.116838,0.883162,379,97,-1, abandoned,0,0,0
52363,1000091,4,629,495,134,0.786963,0.213037,2.449166,113,21,630,496,134,0.787302,0.212698,3.449597,113,21,-1, abandoned,0,0,0
52363,1000328,5,1025,760,265,0.741463,0.258537,3.190629,239,26,1026,761,265,0.741715,0.258285,4.191312,239,26,-1, abandoned,0,0,0
52363,1000329,3,3440,2680,760,0.77907,0.22093,1.662203,651,109,3441,2681,760,0.779134,0.220866,2.662295,651,109,-1, abandoned,0,0,0
52368,1000004,6,4074,3598,476,0.883162,0.116838,4.677722,379,97,4075,3599,476,0.88319,0.11681,4.669331,379,97,1, merged,0,0,0
52368,1000329,2,3441,2681,760,0.779134,0.220866,1.484052,651,109,3442,2682,760,0.779198,0.220802,1.488876,651,109,-1, merged,0,0,0
52370,1000009,1,1627,1342,285,0.824831,0.175169,0.824831,256,29,1628,1343,285,0.824939,0.175061,0.824939,256,29,1, merged,0,0,0
52370,1000534,2,456,348,108,0.763158,0.236842,1.587989,98,10,458,349,109,0.762009,0.237991,1.586947,98,11,-1, merged,1,1,0
52379,1000004,1,4075,3599,476,0.88319,0.11681,0.88319,379,97,4077,3601,476,0.883247,0.116753,0.883247,379,97,-1, merged,0,0,0
52379,1000592,2,787,665,122,0.844981,0.155019,1.728171,76,46,788,666,122,0.845178,0.154822,1.728425,76,46,1, merged,0,0,0
52380,1000004,1,4077,3601,476,0.883247,0.116753,0.883247,379,97,4078,3602,476,0.883276,0.116724,0.883276,379,97,1, merged,0,0,0
52380,1000054,2,938,799,139,0.851812,0.148188,1.73506,123,16,939,800,139,0.85197,0.14803,1.735246,123,16,1, merged,0,0,0
52381,1000004,2,4078,3602,476,0.883276,0.116724,1.731377,379,97,4081,3605,476,0.883362,0.116638,1.730487,379,97,-1, merged,0,0,0
52381,1000121,3,2414,1993,421,0.825601,0.174399,2.556978,391,30,2415,1994,421,0.825673,0.174327,2.55616,391,30,1, merged,0,0,0
52381,1000132,1,711,603,108,0.848101,0.151899,0.848101,87,21,713,604,109,0.847125,0.152875,0.847125,88,21,1, merged,1,1,0
52384,1000004,2,4081,3605,476,0.883362,0.116638,1.730487,379,97,4083,3607,476,0.883419,0.116581,1.729573,379,97,-1, merged,0,0,0
52384,1000132,1,713,604,109,0.847125,0.152875,0.847125,88,21,715,605,110,0.846154,0.153846,0.846154,89,21,1, merged,1,1,0
52385,1000105,2,712,564,148,0.792135,0.207865,1.66033,131,17,713,565,148,0.792426,0.207574,1.660998,131,17,1, merged,0,0,0
52389,1000003,2,1378,1143,235,0.829463,0.170537,1.704558,204,31,1379,1144,235,0.829587,0.170413,1.704776,204,31,1, merged,0,0,0
52389,1000023,1,1321,1156,165,0.875095,0.124905,0.875095,146,19,1322,1157,165,0.875189,0.124811,0.875189,146,19,1, merged,0,0,0
52393,1000007,2,1689,1364,325,0.807578,0.192422,1.626208,287,38,1691,1366,325,0.807806,0.192194,1.626499,287,38,-1, merged,0,0,0
52393,1000014,1,2845,2329,516,0.818629,0.181371,0.818629,480,36,2846,2330,516,0.818693,0.181307,0.818693,480,36,-1, merged,0,0,0
52394,1000007,1,1691,1366,325,0.807806,0.192194,0.807806,287,38,1692,1367,325,0.80792,0.19208,0.80792,287,38,1, merged,0,0,0
52394,1000012,2,684,586,98,0.856725,0.143275,1.664531,95,3,685,587,98,0.856934,0.143066,1.664854,95,3,1, merged,0,0,0
52404,1000009,4,1629,1344,285,0.825046,0.174954,2.997584,256,29,1630,1345,285,0.825153,0.174847,3.005074,256,29,1, merged,0,0,0
52404,1000014,1,2846,2330,516,0.818693,0.181307,0.818693,480,36,2849,2332,517,0.818533,0.181467,0.818533,481,36,-1, merged,1,0,0
52404,1000534,2,458,349,109,0.762009,0.237991,1.580702,98,11,461,351,110,0.761388,0.238612,1.579921,99,11,1, merged,1,1,0
52415,1000014,2,2850,2333,517,0.818596,0.181404,1.718596,481,36,2851,2334,517,0.81866,0.18134,1.718746,481,36,1, merged,0,0,0
52415,1000153,1,1160,1044,116,0.9,0.1,0.9,84,32,1161,1045,116,0.900086,0.099914,0.900086,84,32,1, merged,0,0,0
52430,1000132,2,715,605,110,0.846154,0.153846,1.74624,89,21,717,606,111,0.845188,0.154812,1.744586,90,21,1, merged,1,1,0
52430,1000153,1,1161,1045,116,0.900086,0.099914,0.900086,84,32,1163,1046,117,0.899398,0.100602,0.899398,85,32,1, merged,1,1,0
52434,1000153,2,1163,1046,117,0.899398,0.100602,1.708922,85,32,1164,1047,117,0.899485,0.100515,1.710805,85,32,1, merged,0,0,0
52467,1000023,1,1347,1182,165,0.877506,0.122494,0.877506,146,19,1350,1183,167,0.876296,0.123704,0.876296,148,19,1, merged,1,1,0
52468,1000004,1,4083,3607,476,0.883419,0.116581,0.883419,379,97,4084,3608,476,0.883448,0.116552,0.883448,379,97,1, merged,0,0,0
52468,1000153,2,1164,1047,117,0.899485,0.100515,1.782904,85,32,1165,1048,117,0.899571,0.100429,1.783018,85,32,1, merged,0,0,0
52469,1000004,1,4084,3608,476,0.883448,0.116552,0.883448,379,97,4085,3609,476,0.883476,0.116524,0.883476,379,97,1, merged,0,0,0
52469,1000014,2,2851,2334,517,0.81866,0.18134,1.702108,481,36,2852,2335,517,0.818724,0.181276,1.7022,481,36,1, merged,0,0,0
52471,1000004,1,4085,3609,476,0.883476,0.116524,0.883476,379,97,4086,3609,477,0.88326,0.11674,0.88326,380,97,1, merged,1,1,0
52471,1000014,2,2852,2335,517,0.818724,0.181276,1.7022,481,36,2854,2335,519,0.81815,0.18185,1.70141,483,36,1, merged,1,1,0
52471,1000015,4,2262,2022,240,0.893899,0.106101,3.419628,218,22,2263,2023,240,0.893946,0.106054,3.395356,218,22,1, merged,0,0,0
52473,1000327,3,707,557,150,0.787836,0.212164,2.224426,116,34,708,558,150,0.788136,0.211864,2.227679,116,34,1, merged,0,0,0
52474,1000004,1,4086,3609,477,0.88326,0.11674,0.88326,380,97,4087,3610,477,0.883288,0.116712,0.883288,380,97,1, merged,0,0,0
52474,1000014,2,2854,2335,519,0.81815,0.18185,1.70141,483,36,2855,2336,519,0.818214,0.181786,1.701502,483,36,1, merged,0,0,0
52487,1000012,2,688,590,98,0.857558,0.142442,1.720946,95,3,689,591,98,0.857765,0.142235,1.716461,95,3,1, merged,0,0,0
52488,1000012,2,689,591,98,0.857765,0.142235,1.716461,95,3,690,592,98,0.857971,0.142029,1.712025,95,3,1, merged,0,0,0
52489,1000012,3,690,592,98,0.857971,0.142029,2.342046,95,3,691,593,98,0.858177,0.141823,2.346305,95,3,1, merged,0,0,0
52489,1000105,2,714,566,148,0.792717,0.207283,1.484075,131,17,715,567,148,0.793007,0.206993,1.488129,131,17,1, merged,0,0,0
52500,1000007,1,1702,1375,327,0.807873,0.192127,0.807873,289,38,1705,1375,330,0.806452,0.193548,0.806452,292,38,1, merged,1,1,0
52500,1000009,3,1631,1346,285,0.825261,0.174739,2.52708,256,29,1632,1347,285,0.825368,0.174632,2.52537,256,29,1, merged,0,0,0
52500,1000015,2,2263,2023,240,0.893946,0.106054,1.701819,218,22,2264,2023,241,0.893551,0.106449,1.700003,219,22,1, merged,1,1,0
52501,1000007,1,1705,1375,330,0.806452,0.193548,0.806452,292,38,1709,1376,333,0.805149,0.194851,0.805149,295,38,-1, merged,1,0,0
52501,1000009,3,1632,1347,285,0.825368,0.174632,2.52537,256,29,1633,1348,285,0.825475,0.174525,2.523781,256,29,1, merged,0,0,0
52501,1000015,2,2264,2023,241,0.893551,0.106449,1.700003,219,22,2265,2023,242,0.893157,0.106843,1.698306,220,22,1, merged,1,1,0
52502,1000007,1,1709,1376,333,0.805149,0.194851,0.805149,295,38,1712,1376,336,0.803738,0.196262,0.803738,298,38,1, merged,1,1,0
52502,1000009,3,1633,1348,285,0.825475,0.174525,2.523781,256,29,1634,1349,285,0.825581,0.174419,2.522082,256,29,1, merged,0,0,0
52502,1000015,2,2265,2023,242,0.893157,0.106843,1.698306,220,22,2266,2023,243,0.892763,0.107237,1.696501,221,22,1, merged,1,1,0
52504,1000004,1,4088,3611,477,0.883317,0.116683,0.883317,380,97,4090,3612,478,0.88313,0.11687,0.88313,381,97,1, merged,1,1,0
52504,1000592,3,788,666,122,0.845178,0.154822,2.538018,76,46,789,667,122,0.845374,0.154626,2.546685,76,46,1, merged,0,0,0
52509,1000026,3,572,499,73,0.872378,0.127622,2.772121,70,3,573,500,73,0.8726,0.1274,2.772429,70,3,-1, abandoned,0,0,0
52509,1000153,2,1167,1050,117,0.899743,0.100257,1.899743,85,32,1168,1051,117,0.899829,0.100171,1.899829,85,32,-1, abandoned,0,0,0
52524,1000121,2,2416,1995,421,0.825745,0.174255,1.545745,391,30,2417,1996,421,0.825817,0.174183,1.551307,391,30,-1, abandoned,0,0,0
52527,1000003,2,1382,1147,235,0.829957,0.170043,1.648298,204,31,1383,1148,235,0.83008,0.16992,1.648261,204,31,1, merged,0,0,0
52527,1000014,1,2857,2338,519,0.818341,0.181659,0.818341,483,36,2860,2340,520,0.818182,0.181818,0.818182,483,37,-1, merged,1,0,0
52530,1000009,1,1634,1349,285,0.825581,0.174419,0.825581,256,29,1635,1350,285,0.825688,0.174312,0.825688,256,29,1, merged,0,0,0
52530,1000153,2,1170,1053,117,0.9,0.1,1.725581,85,32,1171,1054,117,0.900085,0.099915,1.725773,85,32,1, merged,0,0,0
52531,1000009,1,1635,1350,285,0.825688,0.174312,0.825688,256,29,1636,1351,285,0.825795,0.174205,0.825795,256,29,1, merged,0,0,0
52531,1000153,2,1171,1054,117,0.900085,0.099915,1.725773,85,32,1172,1055,117,0.900171,0.099829,1.725965,85,32,1, merged,0,0,0
52532,1000009,1,1636,1351,285,0.825795,0.174205,0.825795,256,29,1637,1352,285,0.825901,0.174099,0.825901,256,29,1, merged,0,0,0
52532,1000153,2,1172,1055,117,0.900171,0.099829,1.725965,85,32,1173,1056,117,0.900256,0.099744,1.726157,85,32,1, merged,0,0,0
52533,1000009,1,1637,1352,285,0.825901,0.174099,0.825901,256,29,1638,1352,286,0.825397,0.174603,0.825397,256,30,-1, merged,1,1,0
52533,1000011,2,868,800,68,0.921659,0.078341,1.74756,63,5,869,801,68,0.921749,0.078251,1.747146,63,5,1, merged,0,0,0
52533,1000120,3,1954,1700,254,0.87001,0.12999,2.61757,225,29,1955,1701,254,0.870077,0.129923,2.617223,225,29,1, merged,0,0,0
52534,1000009,1,1638,1352,286,0.825397,0.174603,0.825397,256,30,1639,1353,286,0.825503,0.174497,0.825503,256,30,1, merged,0,0,0
52534,1000153,2,1173,1056,117,0.900256,0.099744,1.725653,85,32,1174,1057,117,0.900341,0.099659,1.725844,85,32,1, merged,0,0,0
52535,1000009,1,1639,1353,286,0.825503,0.174497,0.825503,256,30,1640,1354,286,0.82561,0.17439,0.82561,256,30,1, merged,0,0,0
52535,1000153,2,1174,1057,117,0.900341,0.099659,1.725844,85,32,1175,1058,117,0.900426,0.099574,1.726035,85,32,1, merged,0,0,0
52536,1000009,1,1640,1354,286,0.82561,0.17439,0.82561,256,30,1643,1356,287,0.82532,0.17468,0.82532,257,30,-1, merged,1,0,0
52536,1000153,2,1175,1058,117,0.900426,0.099574,1.726035,85,32,1176,1059,117,0.90051,0.09949,1.72583,85,32,1, merged,0,0,0
52537,1000009,1,1643,1356,287,0.82532,0.17468,0.82532,257,30,1644,1357,287,0.825426,0.174574,0.825426,257,30,1, merged,0,0,0
52537,1000153,2,1176,1059,117,0.90051,0.09949,1.72583,85,32,1177,1060,117,0.900595,0.099405,1.726021,85,32,1, merged,0,0,0
52538,1000009,1,1644,1357,287,0.825426,0.174574,0.825426,257,30,1645,1358,287,0.825532,0.174468,0.825532,257,30,1, merged,0,0,0
52538,1000153,2,1177,1060,117,0.900595,0.099405,1.726021,85,32,1178,1061,117,0.900679,0.099321,1.726211,85,32,1, merged,0,0,0
52544,1000009,1,1650,1363,287,0.826061,0.173939,0.826061,257,30,1652,1364,288,0.825666,0.174334,0.825666,258,30,1, merged,1,1,0
52544,1000153,2,1178,1061,117,0.900679,0.099321,1.72674,85,32,1179,1062,117,0.900763,0.099237,1.726429,85,32,1, merged,0,0,0
52545,1000004,2,4096,3617,479,0.883057,0.116943,1.708723,382,97,4097,3618,479,0.883085,0.116915,1.708857,382,97,1, merged,0,0,0
52545,1000009,1,1652,1364,288,0.825666,0.174334,0.825666,258,30,1653,1365,288,0.825771,0.174229,0.825771,258,30,1, merged,0,0,0
52547,1000004,3,4097,3618,479,0.883085,0.116915,2.462655,382,97,4098,3619,479,0.883114,0.116886,2.461396,382,97,1, merged,0,0,0
52547,1000014,1,2860,2340,520,0.818182,0.181818,0.818182,483,37,2863,2342,521,0.818023,0.181977,0.818023,484,37,-1, merged,1,0,0
52547,1000534,2,461,351,110,0.761388,0.238612,1.57957,99,11,463,352,111,0.760259,0.239741,1.578282,100,11,1, merged,1,1,0
52548,1000004,2,4098,3619,479,0.883114,0.116886,1.711397,382,97,4099,3620,479,0.883142,0.116858,1.712001,382,97,-1, abandoned,0,0,0
52551,1000007,2,1712,1376,336,0.803738,0.196262,1.62951,298,38,1713,1377,336,0.803853,0.196147,1.62973,298,38,1, merged,0,0,0
52551,1000009,1,1653,1365,288,0.825771,0.174229,0.825771,258,30,1654,1366,288,0.825877,0.174123,0.825877,258,30,1, merged,0,0,0
52554,1000009,1,1655,1367,288,0.825982,0.174018,0.825982,258,30,1657,1368,289,0.825588,0.174412,0.825588,259,30,1, merged,1,1,0
52554,1000153,2,1179,1062,117,0.900763,0.099237,1.726745,85,32,1180,1063,117,0.900847,0.099153,1.726436,85,32,1, merged,0,0,0
52556,1000009,1,1658,1369,289,0.825694,0.174306,0.825694,259,30,1660,1370,290,0.825301,0.174699,0.825301,260,30,1, merged,1,1,0
52556,1000153,2,1180,1063,117,0.900847,0.099153,1.726541,85,32,1182,1065,117,0.901015,0.098985,1.726316,85,32,1, merged,0,0,0
52560,1000026,1,573,500,73,0.8726,0.1274,0.8726,70,3,576,502,74,0.871528,0.128472,0.871528,71,3,-1, merged,1,0,0
52560,1000153,2,1183,1066,117,0.901099,0.098901,1.773699,85,32,1185,1067,118,0.900422,0.099578,1.77195,86,32,1, merged,1,1,0
52567,1000003,1,1383,1148,235,0.83008,0.16992,0.83008,204,31,1384,1148,236,0.82948,0.17052,0.82948,205,31,1, merged,1,1,0
52574,1000328,2,1026,761,265,0.741715,0.258285,1.521042,239,26,1030,763,267,0.740777,0.259223,1.520133,241,26,-1, merged,1,0,0
52574,1000329,1,3444,2684,760,0.779326,0.220674,0.779326,651,109,3449,2688,761,0.779356,0.220644,0.779356,651,110,-1, merged,1,0,0
52577,1000329,1,3449,2688,761,0.779356,0.220644,0.779356,651,110,3452,2690,762,0.779258,0.220742,0.779258,652,110,-1, merged,1,0,0
52578,1000329,2,3452,2690,762,0.779258,0.220742,1.561744,652,110,3453,2691,762,0.779322,0.220678,1.562115,652,110,1, merged,0,0,0
52578,1002169,1,708,554,154,0.782486,0.217514,0.782486,121,33,709,555,154,0.782793,0.217207,0.782793,121,33,-1, merged,0,0,0
52579,1000328,1,1030,763,267,0.740777,0.259223,0.740777,241,26,1031,764,267,0.741028,0.258972,0.741028,241,26,-1, merged,0,0,0
52579,1000329,3,3453,2691,762,0.779322,0.220678,2.265713,652,110,3454,2692,762,0.779386,0.220614,2.264956,652,110,-1, merged,0,0,0
52579,1000592,4,790,668,122,0.84557,0.15443,3.111283,76,46,791,669,122,0.845765,0.154235,3.110721,76,46,1, merged,0,0,0
52580,1000329,2,3454,2692,762,0.779386,0.220614,1.523928,652,110,3455,2692,763,0.779161,0.220839,1.52208,653,110,1, merged,1,1,0
52580,1000592,3,791,669,122,0.845765,0.154235,2.369693,76,46,792,670,122,0.84596,0.15404,2.36804,76,46,1, merged,0,0,0
52581,1000328,1,1031,764,267,0.741028,0.258972,0.741028,241,26,1032,765,267,0.741279,0.258721,0.741279,241,26,1, merged,0,0,0
52581,1000592,2,792,670,122,0.84596,0.15404,1.586988,76,46,793,671,122,0.846154,0.153846,1.587433,76,46,1, merged,0,0,0
52590,1000015,1,2266,2023,243,0.892763,0.107237,0.892763,221,22,2267,2024,243,0.89281,0.10719,0.89281,221,22,1, merged,0,0,0
52590,1000153,2,1185,1067,118,0.900422,0.099578,1.793185,86,32,1186,1068,118,0.900506,0.099494,1.793316,86,32,1, merged,0,0,0
52592,1000328,1,1032,765,267,0.741279,0.258721,0.741279,241,26,1035,768,267,0.742029,0.257971,0.742029,241,26,-1, merged,0,0,0
52592,1000329,2,3455,2692,763,0.779161,0.220839,1.52044,653,110,3456,2693,763,0.779225,0.220775,1.521254,653,110,-1, merged,0,0,0
52592,1000592,3,793,671,122,0.846154,0.153846,2.366594,76,46,794,672,122,0.846348,0.153652,2.367601,76,46,1, merged,0,0,0
52598,1000014,1,2864,2343,521,0.818087,0.181913,0.818087,484,37,2866,2344,522,0.817865,0.182135,0.817865,485,37,1, merged,1,1,0
52598,1000329,2,3456,2693,763,0.779225,0.220775,1.597311,653,110,3457,2694,763,0.779288,0.220712,1.597153,653,110,-1, merged,0,0,0
52599,1000329,2,3457,2694,763,0.779288,0.220712,1.64725,653,110,3458,2695,763,0.779352,0.220648,1.645631,653,110,1, merged,0,0,0
52603,1000014,2,2866,2344,522,0.817865,0.182135,1.600087,485,37,2869,2345,524,0.817358,0.182642,1.597094,487,37,1, merged,1,1,0
52605,1000004,2,4103,3624,479,0.883256,0.116744,1.666049,382,97,4106,3627,479,0.883341,0.116659,1.66644,382,97,-1, abandoned,0,0,0
52605,1002169,1,709,555,154,0.782793,0.217207,0.782793,121,33,710,556,154,0.783099,0.216901,0.783099,121,33,-1, abandoned,0,0,0
52609,1000054,3,940,801,139,0.852128,0.147872,2.476993,123,16,941,802,139,0.852285,0.147715,2.477914,123,16,1, merged,0,0,0
52609,1000166,2,475,361,114,0.76,0.24,1.624865,109,5,476,362,114,0.760504,0.239496,1.625629,109,5,1, merged,0,0,0
52610,1000054,2,941,802,139,0.852285,0.147715,1.71741,123,16,942,803,139,0.852442,0.147558,1.715903,123,16,1, merged,0,0,0
52611,1000054,2,942,803,139,0.852442,0.147558,1.715903,123,16,943,803,140,0.851538,0.148462,1.715261,124,16,1, abandoned,1,1,0
52611,1000121,3,2418,1997,421,0.825889,0.174111,2.541792,391,30,2419,1998,421,0.825961,0.174039,2.541222,391,30,-1, abandoned,0,0,0
52614,1000004,1,4107,3628,479,0.88337,0.11663,0.88337,382,97,4108,3629,479,0.883398,0.116602,0.883398,382,97,-1, abandoned,0,0,0
52614,1000153,2,1186,1068,118,0.900506,0.099494,1.783876,86,32,1187,1069,118,0.90059,0.09941,1.783988,86,32,-1, abandoned,0,0,0
52623,1000004,1,4108,3629,479,0.883398,0.116602,0.883398,382,97,4109,3630,479,0.883427,0.116573,0.883427,382,97,1, merged,0,0,0
52623,1000132,2,719,608,111,0.845619,0.154381,1.729017,90,21,720,609,111,0.845833,0.154167,1.72926,90,21,1, merged,0,0,0
52624,1000004,2,4109,3630,479,0.883427,0.116573,1.76578,382,97,4110,3631,479,0.883455,0.116545,1.766572,382,97,1, merged,0,0,0
52624,1000132,3,720,609,111,0.845833,0.154167,2.611613,90,21,721,610,111,0.846047,0.153953,2.612619,90,21,1, merged,0,0,0
52638,1000070,1,1407,1196,211,0.850036,0.149964,0.850036,183,28,1408,1197,211,0.850142,0.149858,0.850142,183,28,1, merged,0,0,0
52641,1000132,1,723,612,111,0.846473,0.153527,0.846473,90,21,724,613,111,0.846685,0.153315,0.846685,90,21,1, merged,0,0,0
52641,1000329,2,3459,2696,763,0.779416,0.220584,1.625889,653,110,3460,2697,763,0.77948,0.22052,1.626165,653,110,1, merged,0,0,0
52659,1000110,1,566,512,54,0.904594,0.095406,0.904594,51,3,567,513,54,0.904762,0.095238,0.904762,51,3,-1, abandoned,0,0,0
52659,1000130,2,598,495,103,0.827759,0.172241,1.732353,79,24,599,495,104,0.826377,0.173623,1.731139,80,24,1, abandoned,1,1,0
52660,1000014,2,2869,2345,524,0.817358,0.182642,1.51321,487,37,2870,2346,524,0.817422,0.182578,1.511486,487,37,-1, abandoned,0,0,0
52665,1000130,2,599,495,104,0.826377,0.173623,1.605789,80,24,600,496,104,0.826667,0.173333,1.609275,80,24,1, merged,0,0,0
52668,1000014,2,2870,2346,524,0.817422,0.182578,1.511486,487,37,2875,2351,524,0.817739,0.182261,1.514572,487,37,-1, merged,0,0,0
52673,1000023,3,1354,1187,167,0.876662,0.123338,2.601818,148,19,1355,1188,167,0.876753,0.123247,2.605023,148,19,1, merged,0,0,0
52673,1000132,1,726,615,111,0.847107,0.152893,0.847107,90,21,727,616,111,0.847318,0.152682,0.847318,90,21,1, merged,0,0,0
52676,1000004,2,4121,3639,482,0.883038,0.116962,1.76399,385,97,4123,3641,482,0.883095,0.116905,1.746731,385,97,-1, merged,0,0,0
52682,1000004,2,4125,3643,482,0.883152,0.116848,1.676448,385,97,4126,3644,482,0.88318,0.11682,1.676764,385,97,-1, merged,0,0,0
52682,1000105,1,716,568,148,0.793296,0.206704,0.793296,131,17,717,569,148,0.793584,0.206416,0.793584,131,17,-1, merged,0,0,0
52683,1000004,2,4126,3644,482,0.88318,0.11682,1.676764,385,97,4127,3645,482,0.883208,0.116792,1.67708,385,97,-1, abandoned,0,0,0
52683,1000105,1,717,569,148,0.793584,0.206416,0.793584,131,17,718,570,148,0.793872,0.206128,0.793872,131,17,-1, abandoned,0,0,0
52684,1000004,2,4127,3645,482,0.883208,0.116792,1.753351,385,97,4129,3646,483,0.883023,0.116977,1.753232,386,97,1, merged,1,1,0
52684,1000011,3,869,801,68,0.921749,0.078251,2.6751,63,5,870,802,68,0.921839,0.078161,2.675071,63,5,1, merged,0,0,0
52684,1000120,1,1956,1702,254,0.870143,0.129857,0.870143,225,29,1957,1703,254,0.87021,0.12979,0.87021,225,29,-1, merged,0,0,0
52692,1000054,1,947,807,140,0.852165,0.147835,0.852165,124,16,948,807,141,0.851266,0.148734,0.851266,125,16,1, merged,1,1,0
52692,1000592,2,795,673,122,0.846541,0.153459,1.698706,76,46,797,675,122,0.846926,0.153074,1.698192,76,46,-1, merged,0,0,0
52696,1000110,2,568,514,54,0.90493,0.09507,1.50493,51,3,569,515,54,0.905097,0.094903,1.476525,51,3,1, merged,0,0,0
52701,1000014,1,2876,2352,524,0.817803,0.182197,0.817803,487,37,2882,2352,530,0.8161,0.1839,0.8161,493,37,1, abandoned,1,1,0
52710,1000014,2,2883,2353,530,0.816164,0.183836,1.716921,493,37,2884,2354,530,0.816227,0.183773,1.717068,493,37,1, merged,0,0,0
52710,1000153,1,1189,1071,118,0.900757,0.099243,0.900757,86,32,1190,1072,118,0.90084,0.09916,0.90084,86,32,1, merged,0,0,0
52715,1000070,1,1408,1197,211,0.850142,0.149858,0.850142,183,28,1409,1198,211,0.850248,0.149752,0.850248,183,28,1, merged,0,0,0
52715,1000105,2,719,571,148,0.794159,0.205841,1.644301,131,17,720,572,148,0.794444,0.205556,1.644693,131,17,1, merged,0,0,0
52719,1000166,2,478,364,114,0.761506,0.238494,1.461506,109,5,479,365,114,0.762004,0.237996,1.489277,109,5,1, merged,0,0,0
52726,1000130,2,601,497,104,0.826955,0.173045,1.571041,80,24,602,497,105,0.825581,0.174419,1.568071,81,24,1, merged,1,1,0
52726,1000592,4,797,675,122,0.846926,0.153074,3.282471,76,46,798,676,122,0.847118,0.152882,3.27995,76,46,1, merged,0,0,0
52731,1000007,1,1718,1382,336,0.804424,0.195576,0.804424,298,38,1719,1383,336,0.804538,0.195462,0.804538,298,38,-1, merged,0,0,0
52731,1000009,2,1662,1372,290,0.825511,0.174489,1.629935,260,30,1663,1373,290,0.825616,0.174384,1.630154,260,30,1, merged,0,0,0
52732,1000007,2,1719,1383,336,0.804538,0.195462,1.726377,298,38,1720,1384,336,0.804651,0.195349,1.725523,298,38,1, merged,0,0,0
52732,1000011,1,870,802,68,0.921839,0.078161,0.921839,63,5,872,803,69,0.920872,0.079128,0.920872,64,5,1, merged,1,1,0
52732,1000014,3,2884,2354,530,0.816227,0.183773,2.542604,493,37,2885,2355,530,0.816291,0.183709,2.541814,493,37,1, merged,0,0,0
52736,1000014,2,2885,2355,530,0.816291,0.183709,1.559332,493,37,2886,2356,530,0.816355,0.183645,1.559945,493,37,1, merged,0,0,0
52746,1000014,1,2886,2356,530,0.816355,0.183645,0.816355,493,37,2888,2358,530,0.816482,0.183518,0.816482,493,37,-1, merged,0,0,0
52752,1000130,2,602,497,105,0.825581,0.174419,1.606227,81,24,603,498,105,0.825871,0.174129,1.60931,81,24,1, merged,0,0,0
52754,1000009,1,1663,1373,290,0.825616,0.174384,0.825616,260,30,1665,1375,290,0.825826,0.174174,0.825826,260,30,-1, abandoned,0,0,0
52754,1000011,2,873,804,69,0.920962,0.079038,1.746579,64,5,874,804,70,0.919908,0.080092,1.745734,65,5,1, abandoned,1,1,0
52756,1000328,3,1035,768,267,0.742029,0.257971,2.361594,241,26,1037,770,267,0.742527,0.257473,2.204229,241,26,-1, merged,0,0,0
52766,1000023,4,1359,1192,167,0.877116,0.122884,3.182203,148,19,1360,1193,167,0.877206,0.122794,3.182033,148,19,-1, abandoned,0,0,0
52766,1000328,3,1037,770,267,0.742527,0.257473,2.305087,241,26,1039,771,268,0.74206,0.25794,2.304827,242,26,1, abandoned,1,1,0
52766,1000329,2,3464,2699,765,0.779157,0.220843,1.562561,655,110,3467,2701,766,0.77906,0.22094,1.562768,656,110,1, abandoned,1,1,0
52766,1002169,1,711,557,154,0.783404,0.216596,0.783404,121,33,712,558,154,0.783708,0.216292,0.783708,121,33,-1, abandoned,0,0,0
52767,1000014,1,2889,2359,530,0.816546,0.183454,0.816546,493,37,2890,2360,530,0.816609,0.183391,0.816609,493,37,1, merged,0,0,0
52767,1000043,2,654,542,112,0.828746,0.171254,1.645292,98,14,655,543,112,0.829008,0.170992,1.645617,98,14,1, merged,0,0,0
52770,1000015,2,2270,2027,243,0.892952,0.107048,1.653211,221,22,2271,2028,243,0.892999,0.107001,1.653775,221,22,1, merged,0,0,0
52770,1000534,1,463,352,111,0.760259,0.239741,0.760259,100,11,464,353,111,0.760776,0.239224,0.760776,100,11,1, merged,0,0,0
52779,1000534,1,471,358,113,0.760085,0.239915,0.760085,102,11,473,360,113,0.761099,0.238901,0.761099,102,11,-1, merged,0,0,0
52781,1000004,1,4129,3646,483,0.883023,0.116977,0.883023,386,97,4130,3647,483,0.883051,0.116949,0.883051,386,97,1, merged,0,0,0
52781,1000153,2,1193,1075,118,0.90109,0.09891,1.784112,86,32,1194,1076,118,0.901173,0.098827,1.784223,86,32,1, merged,0,0,0
52784,1000014,1,2891,2361,530,0.816672,0.183328,0.816672,493,37,2892,2362,530,0.816736,0.183264,0.816736,493,37,1, merged,0,0,0
52785,1000132,2,728,617,111,0.847527,0.152473,1.658848,90,21,729,618,111,0.847737,0.152263,1.660821,90,21,1, merged,0,0,0
52789,1000004,1,4130,3647,483,0.883051,0.116949,0.883051,386,97,4131,3648,483,0.883079,0.116921,0.883079,386,97,1, merged,0,0,0
52792,1000004,1,4131,3648,483,0.883079,0.116921,0.883079,386,97,4132,3648,484,0.882865,0.117135,0.882865,387,97,1, merged,1,1,0
52792,1000043,2,656,544,112,0.829268,0.170732,1.712347,98,14,658,545,113,0.828267,0.171733,1.711133,99,14,1, merged,1,1,0
52793,1000004,2,4132,3648,484,0.882865,0.117135,1.733114,387,97,4134,3650,484,0.882922,0.117078,1.732674,387,97,-1, merged,0,0,0
52793,1000070,1,1409,1198,211,0.850248,0.149752,0.850248,183,28,1411,1199,212,0.849752,0.150248,0.849752,184,28,1, merged,1,1,0
52793,1000121,3,2422,2001,421,0.826177,0.173823,2.559291,391,30,2423,2002,421,0.826248,0.173752,2.558923,391,30,1, merged,0,0,0
52794,1000043,2,658,545,113,0.828267,0.171733,1.693939,99,14,659,546,113,0.828528,0.171472,1.696175,99,14,1, merged,0,0,0
52795,1000026,3,577,503,74,0.87175,0.12825,2.67934,71,3,579,505,74,0.872193,0.127807,2.63343,71,3,-1, merged,0,0,0
52795,1000109,2,639,548,91,0.85759,0.14241,1.80759,86,5,641,549,92,0.856474,0.143526,1.761236,87,5,1, merged,1,1,0
52795,1000199,4,551,469,82,0.85118,0.14882,3.53052,75,7,552,470,82,0.851449,0.148551,3.484879,75,7,1, merged,0,0,0
52796,1000023,2,1361,1194,167,0.877296,0.122704,1.720063,148,19,1362,1195,167,0.877386,0.122614,1.721136,148,19,-1, merged,0,0,0
52801,1000011,1,875,805,70,0.92,0.08,0.92,65,5,877,806,71,0.919042,0.080958,0.919042,66,5,1, merged,1,1,0
52801,1000153,2,1194,1076,118,0.901173,0.098827,1.821173,86,32,1196,1078,118,0.901338,0.098662,1.82038,86,32,-1, merged,0,0,0
52802,1000043,2,659,546,113,0.828528,0.171472,1.302212,99,14,660,547,113,0.828788,0.171212,1.311546,99,14,1, merged,0,0,0
52806,1000011,3,879,808,71,0.919226,0.080774,2.657348,66,5,880,809,71,0.919318,0.080682,2.658471,66,5,1, merged,0,0,0
52806,1000120,2,1961,1707,254,0.870474,0.129526,1.738121,225,29,1963,1707,256,0.869587,0.130413,1.739153,225,31,-1, merged,1,1,0
52808,1000166,2,479,365,114,0.762004,0.237996,1.440576,109,5,480,366,114,0.7625,0.2375,1.434914,109,5,1, merged,0,0,0
52810,1000004,1,4134,3650,484,0.882922,0.117078,0.882922,387,97,4138,3653,485,0.882794,0.117206,0.882794,388,97,-1, merged,1,0,0
52810,1000014,3,2892,2362,530,0.816736,0.183264,2.494102,493,37,2896,2365,531,0.816644,0.183356,2.494167,493,38,1, merged,1,0,0
52810,1000105,2,720,572,148,0.794444,0.205556,1.677367,131,17,721,573,148,0.79473,0.20527,1.677523,131,17,1, merged,0,0,0
52811,1000004,3,4138,3653,485,0.882794,0.117206,2.494167,388,97,4140,3655,485,0.88285,0.11715,2.490962,388,97,-1, merged,0,0,0
52811,1000014,1,2896,2365,531,0.816644,0.183356,0.816644,493,38,2901,2366,535,0.815581,0.184419,0.815581,497,38,1, merged,1,1,0
52811,1000105,2,721,573,148,0.79473,0.20527,1.611373,131,17,723,573,150,0.792531,0.207469,1.608112,133,17,1, merged,1,1,0
52812,1000054,6,948,807,141,0.851266,0.148734,4.869655,125,16,949,808,141,0.851423,0.148577,4.742368,125,16,1, merged,0,0,0
52812,1000110,3,572,518,54,0.905594,0.094406,2.602086,51,3,573,518,55,0.904014,0.095986,2.523903,52,3,1, merged,1,1,0
52812,1000140,5,361,305,56,0.844875,0.155125,4.01839,48,8,362,306,56,0.845304,0.154696,3.890946,48,8,1, merged,0,0,0
52814,1000014,3,2901,2366,535,0.815581,0.184419,2.422153,497,38,2902,2367,535,0.815644,0.184356,2.418409,497,38,-1, merged,0,0,0
52814,1000130,2,603,498,105,0.825871,0.174129,1.606572,81,24,604,498,106,0.824503,0.175497,1.602764,82,24,1, merged,1,1,0
52828,1000023,2,1364,1197,167,0.877566,0.122434,1.667205,148,19,1365,1198,167,0.877656,0.122344,1.667624,148,19,1, merged,0,0,0
52828,1000091,1,637,503,134,0.789639,0.210361,0.789639,113,21,638,504,134,0.789969,0.210031,0.789969,113,21,1, merged,0,0,0
52828,1000592,3,799,677,122,0.847309,0.152691,2.514514,76,46,801,678,123,0.846442,0.153558,2.514066,76,47,-1, merged,1,1,0
52831,1000153,1,1196,1078,118,0.901338,0.098662,0.901338,86,32,1197,1079,118,0.90142,0.09858,0.90142,86,32,1, merged,0,0,0
52832,1000153,1,1197,1079,118,0.90142,0.09858,0.90142,86,32,1198,1080,118,0.901503,0.098497,0.901503,86,32,1, merged,0,0,0
52835,1000023,1,1367,1200,167,0.877835,0.122165,0.877835,148,19,1368,1201,167,0.877924,0.122076,0.877924,148,19,1, merged,0,0,0
52839,1000004,1,4141,3656,485,0.882879,0.117121,0.882879,388,97,4144,3658,486,0.882722,0.117278,0.882722,389,97,-1, merged,1,0,0
52839,1000043,3,660,547,113,0.828788,0.171212,2.490726,99,14,662,549,113,0.829305,0.170695,2.49099,99,14,1, merged,0,0,0
52839,1000121,4,2423,2002,421,0.826248,0.173752,3.316975,391,30,2424,2003,421,0.82632,0.17368,3.31731,391,30,1, merged,0,0,0
52839,1000329,2,3467,2701,766,0.77906,0.22094,1.661938,656,110,3470,2703,767,0.778963,0.221037,1.661685,656,111,1, merged,1,0,0
52840,1000014,2,2902,2367,535,0.815644,0.184356,1.542917,497,38,2903,2368,535,0.815708,0.184292,1.554838,497,38,1, merged,0,0,0
52856,1000023,2,1368,1201,167,0.877924,0.122076,1.669912,148,19,1369,1202,167,0.878013,0.121987,1.670321,148,19,1, merged,0,0,0
52856,1000091,1,649,514,135,0.791988,0.208012,0.791988,114,21,650,515,135,0.792308,0.207692,0.792308,114,21,1, merged,0,0,0
52859,1000091,1,650,515,135,0.792308,0.207692,0.792308,114,21,651,516,135,0.792627,0.207373,0.792627,114,21,1, merged,0,0,0
52859,1000130,2,604,498,106,0.824503,0.175497,1.616811,82,24,606,498,108,0.821782,0.178218,1.614409,82,26,-1, merged,1,1,0
52863,1000199,2,552,470,82,0.851449,0.148551,1.627344,75,7,553,471,82,0.851718,0.148282,1.626999,75,7,1, merged,0,0,0
52867,1000130,1,607,499,108,0.822076,0.177924,0.822076,82,26,608,500,108,0.822368,0.177632,0.822368,82,26,1, merged,0,0,0
52867,1000329,2,3470,2703,767,0.778963,0.221037,1.601038,656,111,3471,2704,767,0.779026,0.220974,1.601395,656,111,1, merged,0,0,0
52869,1000043,1,662,549,113,0.829305,0.170695,0.829305,99,14,663,550,113,0.829563,0.170437,0.829563,99,14,1, merged,0,0,0
52872,1000014,3,2903,2368,535,0.815708,0.184292,2.018486,497,38,2904,2369,535,0.815771,0.184229,2.119639,497,38,1, merged,0,0,0
52876,1000004,4,4146,3660,486,0.882779,0.117221,3.158523,389,97,4147,3661,486,0.882807,0.117193,3.118242,389,97,1, merged,0,0,0
52880,1000007,4,1721,1385,336,0.804765,0.195235,3.21699,298,38,1722,1386,336,0.804878,0.195122,3.173922,298,38,-1, merged,0,0,0
52880,1000015,3,2272,2029,243,0.893046,0.106954,2.412225,221,22,2273,2029,244,0.892653,0.107347,2.369044,222,22,1, merged,1,1,0
52880,1000534,1,474,361,113,0.761603,0.238397,0.761603,102,11,475,362,113,0.762105,0.237895,0.762105,102,11,-1, merged,0,0,0
52882,1000534,1,475,362,113,0.762105,0.237895,0.762105,102,11,476,363,113,0.762605,0.237395,0.762605,102,11,-1, merged,0,0,0
52884,1000043,1,664,551,113,0.829819,0.170181,0.829819,99,14,666,553,113,0.83033,0.16967,0.83033,99,14,-1, merged,0,0,0
52884,1000108,2,380,317,63,0.834211,0.165789,1.66403,59,4,381,318,63,0.834646,0.165354,1.664976,59,4,1, merged,0,0,0
52885,1000130,1,608,500,108,0.822368,0.177632,0.822368,82,26,610,502,108,0.822951,0.177049,0.822951,82,26,-1, merged,0,0,0
52885,1002169,2,712,558,154,0.783708,0.216292,1.606076,121,33,714,560,154,0.784314,0.215686,1.607265,121,33,-1, merged,0,0,0
52886,1000130,1,610,502,108,0.822951,0.177049,0.822951,82,26,612,504,108,0.823529,0.176471,0.823529,82,26,-1, merged,0,0,0
52892,1000329,2,3471,2704,767,0.779026,0.220974,1.511379,656,111,3472,2705,767,0.77909,0.22091,1.512228,656,111,1, merged,0,0,0
52893,1000004,4,4147,3661,486,0.882807,0.117193,3.336542,389,97,4149,3663,486,0.882863,0.117137,3.331007,389,97,-1, merged,0,0,0
52902,1000014,1,2904,2369,535,0.815771,0.184229,0.815771,497,38,2905,2370,535,0.815835,0.184165,0.815835,497,38,1, merged,0,0,0
52902,1000070,2,1414,1202,212,0.850071,0.149929,1.665842,184,28,1415,1203,212,0.850177,0.149823,1.666011,184,28,1, merged,0,0,0
52903,1000014,1,2905,2370,535,0.815835,0.184165,0.815835,497,38,2906,2371,535,0.815898,0.184102,0.815898,497,38,1, merged,0,0,0
52903,1000070,2,1415,1203,212,0.850177,0.149823,1.666011,184,28,1416,1204,212,0.850282,0.149718,1.666181,184,28,1, merged,0,0,0
52905,1000007,1,1722,1386,336,0.804878,0.195122,0.804878,298,38,1727,1390,337,0.804864,0.195136,0.804864,299,38,-1, merged,1,0,0
52907,1000023,1,1369,1202,167,0.878013,0.121987,0.878013,148,19,1370,1203,167,0.878102,0.121898,0.878102,148,19,1, merged,0,0,0
52907,1000132,2,731,619,112,0.846785,0.153215,1.724798,91,21,732,620,112,0.846995,0.153005,1.725097,91,21,1, merged,0,0,0
52911,1000015,1,2273,2029,244,0.892653,0.107347,0.892653,222,22,2274,2029,245,0.89226,0.10774,0.89226,223,22,1, merged,1,1,0
52911,1000026,2,579,505,74,0.872193,0.127807,1.764846,71,3,580,506,74,0.872414,0.127586,1.764674,71,3,1, merged,0,0,0
52912,1000070,2,1416,1204,212,0.850282,0.149718,1.333041,184,28,1417,1205,212,0.850388,0.149612,1.341914,184,28,1, merged,0,0,0
52913,1000070,2,1417,1205,212,0.850388,0.149612,1.341914,184,28,1418,1206,212,0.850494,0.149506,1.350494,184,28,1, merged,0,0,0
52914,1000070,3,1418,1206,212,0.850494,0.149506,2.134807,184,28,1419,1207,212,0.850599,0.149401,2.142013,184,28,1, merged,0,0,0
52914,1002169,1,714,560,154,0.784314,0.215686,0.784314,121,33,715,560,155,0.783217,0.216783,0.783217,121,34,-1, merged,1,1,0
52920,1000534,1,476,363,113,0.762605,0.237395,0.762605,102,11,478,365,113,0.763598,0.236402,0.763598,102,11,-1, merged,0,0,0
52928,1000054,3,949,808,141,0.851423,0.148577,2.387214,125,16,950,809,141,0.851579,0.148421,2.393181,125,16,1, merged,0,0,0
52930,1000009,3,1667,1377,290,0.826035,0.173965,2.189633,260,30,1668,1378,290,0.826139,0.173861,2.178466,260,30,1, merged,0,0,0
52930,1000534,2,478,365,113,0.763598,0.236402,1.363598,102,11,479,366,113,0.764092,0.235908,1.352327,102,11,1, merged,0,0,0
52945,1000130,2,612,504,108,0.823529,0.176471,1.669394,82,26,613,505,108,0.823817,0.176183,1.670259,82,26,1, merged,0,0,0
52960,1000007,1,1728,1391,337,0.804977,0.195023,0.804977,299,38,1729,1392,337,0.80509,0.19491,0.80509,299,38,1, merged,0,0,0
52960,1000009,2,1669,1379,290,0.826243,0.173757,1.63122,260,30,1670,1380,290,0.826347,0.173653,1.631437,260,30,1, merged,0,0,0
52961,1000007,1,1729,1392,337,0.80509,0.19491,0.80509,299,38,1730,1392,338,0.804624,0.195376,0.804624,300,38,1, merged,1,1,0
52961,1000009,2,1670,1380,290,0.826347,0.173653,1.631437,260,30,1671,1381,290,0.826451,0.173549,1.631076,260,30,1, merged,0,0,0
52976,1000130,3,614,505,109,0.822476,0.177524,2.466031,82,27,615,506,109,0.822764,0.177236,2.46806,82,27,1, merged,0,0,0
52977,1000004,3,4150,3664,486,0.882892,0.117108,2.528187,389,97,4151,3665,486,0.88292,0.11708,2.529935,389,97,1, merged,0,0,0
52982,1000534,1,479,366,113,0.764092,0.235908,0.764092,102,11,480,367,113,0.764583,0.235417,0.764583,102,11,1, merged,0,0,0
52987,1000026,2,580,506,74,0.872414,0.127586,1.796521,71,3,581,506,75,0.870912,0.129088,1.796676,72,3,1, merged,1,1,0
52999,1000070,1,1419,1207,212,0.850599,0.149401,0.850599,184,28,1420,1208,212,0.850704,0.149296,0.850704,184,28,1, merged,0,0,0
52999,1000132,2,734,622,112,0.847411,0.152589,1.69801,91,21,735,623,112,0.847619,0.152381,1.698323,91,21,1, merged,0,0,0
53001,1000120,1,1964,1708,256,0.869654,0.130346,0.869654,225,31,1965,1709,256,0.86972,0.13028,0.86972,225,31,1, merged,0,0,0
53006,1000004,1,4151,3665,486,0.88292,0.11708,0.88292,389,97,4152,3666,486,0.882948,0.117052,0.882948,389,97,1, merged,0,0,0
53006,1000110,2,581,526,55,0.905336,0.094664,1.788255,52,3,582,527,55,0.905498,0.094502,1.788446,52,3,1, merged,0,0,0
53008,1000329,2,3474,2707,767,0.779217,0.220783,1.488212,656,111,3475,2708,767,0.779281,0.220719,1.489807,656,111,1, merged,0,0,0
53009,1000328,1,1040,772,268,0.742308,0.257692,0.742308,242,26,1041,772,269,0.741595,0.258405,0.741595,243,26,1, abandoned,1,1,0
53009,1000329,2,3475,2708,767,0.779281,0.220719,1.521588,656,111,3476,2709,767,0.779344,0.220656,1.520939,656,111,-1, abandoned,0,0,0
53016,1000110,2,582,527,55,0.905498,0.094502,1.75266,52,3,584,528,56,0.90411,0.09589,1.752594,53,3,1, merged,1,1,0
53018,1000007,2,1737,1397,340,0.80426,0.19574,1.620411,301,39,1738,1397,341,0.803797,0.196203,1.619451,302,39,1, merged,1,1,0
53018,1000009,5,1674,1384,290,0.826762,0.173238,3.884124,260,30,1676,1386,290,0.826969,0.173031,3.868451,260,30,-1, merged,0,0,0
53018,1000014,1,2910,2375,535,0.816151,0.183849,0.816151,497,38,2913,2376,537,0.815654,0.184346,0.815654,499,38,-1, merged,1,0,0
53018,1000153,6,1198,1080,118,0.901503,0.098497,4.785626,86,32,1201,1083,118,0.901749,0.098251,4.7702,86,32,-1, merged,0,0,0
53019,1000004,1,4152,3666,486,0.882948,0.117052,0.882948,389,97,4153,3667,486,0.882976,0.117024,0.882976,389,97,-1, abandoned,0,0,0
53019,1000329,2,3476,2709,767,0.779344,0.220656,1.662292,656,111,3477,2710,767,0.779408,0.220592,1.662384,656,111,-1, abandoned,0,0,0
53020,1000009,2,1676,1386,290,0.826969,0.173031,1.591552,260,30,1677,1387,290,0.827072,0.172928,1.592632,260,30,1, merged,0,0,0
53020,1000534,1,480,367,113,0.764583,0.235417,0.764583,102,11,482,369,113,0.76556,0.23444,0.76556,102,11,-1, merged,0,0,0
53031,1000091,2,652,517,135,0.792945,0.207055,1.576162,114,21,653,518,135,0.793262,0.206738,1.576781,114,21,1, merged,0,0,0
53031,1002169,1,715,560,155,0.783217,0.216783,0.783217,121,34,716,561,155,0.78352,0.21648,0.78352,121,34,-1, merged,0,0,0
53032,1000091,2,653,518,135,0.793262,0.206738,1.576781,114,21,654,518,136,0.792049,0.207951,1.577367,115,21,1, merged,1,1,0
53032,1000592,3,803,680,123,0.846824,0.153176,2.423606,76,47,804,681,123,0.847015,0.152985,2.424382,76,47,1, merged,0,0,0
53032,1002169,1,716,561,155,0.78352,0.21648,0.78352,121,34,722,567,155,0.785319,0.214681,0.785319,121,34,-1, merged,0,0,0
53033,1000592,3,804,681,123,0.847015,0.152985,2.199901,76,47,805,682,123,0.847205,0.152795,2.214483,76,47,1, merged,0,0,0
53033,1002169,1,722,567,155,0.785319,0.214681,0.785319,121,34,737,581,156,0.788331,0.211669,0.788331,121,35,-1, merged,1,0,0
53040,1000070,2,1420,1208,212,0.850704,0.149296,1.639035,184,28,1421,1209,212,0.850809,0.149191,1.639713,184,28,1, merged,0,0,0
53040,1000105,3,723,573,150,0.792531,0.207469,2.431566,133,17,724,574,150,0.792818,0.207182,2.432531,133,17,1, merged,0,0,0
53040,1002169,1,737,581,156,0.788331,0.211669,0.788331,121,35,739,583,156,0.788904,0.211096,0.788904,121,35,-1, merged,0,0,0
53049,1000130,2,615,506,109,0.822764,0.177236,1.585264,82,27,616,507,109,0.823052,0.176948,1.586046,82,27,1, merged,0,0,0
53049,1000166,1,480,366,114,0.7625,0.2375,0.7625,109,5,481,367,114,0.762994,0.237006,0.762994,109,5,1, merged,0,0,0
53050,1000130,2,616,507,109,0.823052,0.176948,1.586046,82,27,617,508,109,0.823339,0.176661,1.586824,82,27,1, merged,0,0,0
53050,1000166,1,481,367,114,0.762994,0.237006,0.762994,109,5,482,368,114,0.763485,0.236515,0.763485,109,5,1, merged,0,0,0
53061,1000070,1,1423,1211,212,0.851019,0.148981,0.851019,184,28,1424,1212,212,0.851124,0.148876,0.851124,184,28,1, merged,0,0,0
53062,1000004,1,4155,3669,486,0.883032,0.116968,0.883032,389,97,4156,3669,487,0.88282,0.11718,0.88282,390,97,1, merged,1,1,0
53073,1002169,1,739,583,156,0.788904,0.211096,0.788904,121,35,740,584,156,0.789189,0.210811,0.789189,121,35,-1, abandoned,0,0,0
53081,1000054,2,950,809,141,0.851579,0.148421,1.71513,125,16,951,810,141,0.851735,0.148265,1.713932,125,16,1, merged,0,0,0
53083,1000054,2,951,810,141,0.851735,0.148265,1.713932,125,16,952,811,141,0.851891,0.148109,1.714344,125,16,1, merged,0,0,0
53087,1000054,3,952,811,141,0.851891,0.148109,2.629909,125,16,953,812,141,0.852046,0.147954,2.623903,125,16,1, merged,0,0,0
53091,1000005,2,717,605,112,0.843794,0.156206,1.670328,103,9,718,606,112,0.844011,0.155989,1.670617,103,9,1, merged,0,0,0
53091,1000121,1,2427,2006,421,0.826535,0.173465,0.826535,391,30,2428,2007,421,0.826606,0.173394,0.826606,391,30,-1, merged,0,0,0
53096,1000004,2,4166,3678,488,0.882861,0.117139,1.752581,391,97,4168,3680,488,0.882917,0.117083,1.752704,391,97,-1, abandoned,0,0,0
53096,1000120,1,1965,1709,256,0.86972,0.13028,0.86972,225,31,1966,1710,256,0.869786,0.130214,0.869786,225,31,-1, abandoned,0,0,0
53098,1000015,1,2285,2040,245,0.892779,0.107221,0.892779,223,22,2286,2040,246,0.892388,0.107612,0.892388,224,22,1, merged,1,1,0
53098,1000534,2,483,370,113,0.766046,0.233954,1.658825,102,11,485,371,114,0.764948,0.235052,1.657337,103,11,1, merged,1,1,0
53116,1000534,1,485,371,114,0.764948,0.235052,0.764948,103,11,487,372,115,0.76386,0.23614,0.76386,104,11,1, merged,1,1,0
53117,1000007,4,1739,1398,341,0.80391,0.19609,2.838925,302,39,1740,1399,341,0.804023,0.195977,2.833112,302,39,-1, abandoned,0,0,0
53117,1000026,5,581,506,75,0.870912,0.129088,3.709837,72,3,582,507,75,0.871134,0.128866,3.704246,72,3,-1, abandoned,0,0,0
53117,1000534,1,487,372,115,0.76386,0.23614,0.76386,104,11,488,373,115,0.764344,0.235656,0.764344,104,11,-1, abandoned,0,0,0
53125,1000153,1,1202,1084,118,0.90183,0.09817,0.90183,86,32,1204,1085,119,0.901163,0.098837,0.901163,87,32,-1, merged,1,0,0
53126,1000014,2,2917,2380,537,0.815907,0.184093,1.815907,499,38,2918,2381,537,0.81597,0.18403,1.81597,499,38,1, merged,0,0,0
53126,1000132,3,736,624,112,0.847826,0.152174,2.663733,91,21,737,625,112,0.848033,0.151967,2.664002,91,21,1, merged,0,0,0
53127,1000014,1,2918,2381,537,0.81597,0.18403,0.81597,499,38,2921,2383,538,0.815817,0.184183,0.815817,499,39,-1, merged,1,1,0
53127,1000132,3,737,625,112,0.848033,0.151967,2.664002,91,21,738,626,112,0.848238,0.151762,2.664055,91,21,1, merged,0,0,0
53133,1000534,2,488,373,115,0.764344,0.235656,1.447271,104,11,489,374,115,0.764826,0.235174,1.455302,104,11,1, merged,0,0,0
53135,1000004,1,4178,3690,488,0.883198,0.116802,0.883198,391,97,4181,3692,489,0.883042,0.116958,0.883042,392,97,-1, merged,1,0,0
53137,1000005,2,718,606,112,0.844011,0.155989,1.670617,103,9,719,607,112,0.844228,0.155772,1.670906,103,9,1, merged,0,0,0
53137,1000121,1,2428,2007,421,0.826606,0.173394,0.826606,391,30,2429,2008,421,0.826678,0.173322,0.826678,391,30,1, merged,0,0,0
53145,1000091,2,656,519,137,0.791159,0.208841,1.533001,115,22,657,520,137,0.791476,0.208524,1.533567,115,22,-1, abandoned,0,0,0
53145,1000328,1,1042,773,269,0.741843,0.258157,0.741843,243,26,1043,774,269,0.74209,0.25791,0.74209,243,26,-1, abandoned,0,0,0
53146,1000105,2,724,574,150,0.792818,0.207182,1.672583,133,17,725,575,150,0.793103,0.206897,1.67322,133,17,1, merged,0,0,0
53155,1000130,4,617,508,109,0.823339,0.176661,2.97907,82,27,618,508,110,0.822006,0.177994,2.924537,83,27,1, merged,1,1,0
53165,1000015,2,2289,2043,246,0.892529,0.107471,1.793774,224,22,2290,2044,246,0.892576,0.107424,1.793903,224,22,1, merged,0,0,0
53165,1000153,1,1205,1086,119,0.901245,0.098755,0.901245,87,32,1206,1087,119,0.901327,0.098673,0.901327,87,32,1, merged,0,0,0
53166,1000009,2,1679,1389,290,0.827278,0.172722,1.592104,260,30,1680,1390,290,0.827381,0.172619,1.591128,260,30,1, merged,0,0,0
53166,1000534,1,489,374,115,0.764826,0.235174,0.764826,104,11,491,375,116,0.763747,0.236253,0.763747,105,11,1, merged,1,1,0
53167,1000120,2,1967,1711,256,0.869853,0.130147,1.744853,225,31,1969,1713,256,0.869985,0.130015,1.748363,225,31,-1, merged,0,0,0
53170,1000004,2,4181,3692,489,0.883042,0.116958,1.784369,392,97,4182,3693,489,0.88307,0.11693,1.784479,392,97,1, merged,0,0,0
53170,1000153,1,1206,1087,119,0.901327,0.098673,0.901327,87,32,1207,1088,119,0.901408,0.098592,0.901408,87,32,1, merged,0,0,0
53177,1000005,1,719,607,112,0.844228,0.155772,0.844228,103,9,720,608,112,0.844444,0.155556,0.844444,103,9,1, merged,0,0,0
53186,1000054,2,953,812,141,0.852046,0.147954,1.710228,125,16,954,813,141,0.852201,0.147799,1.708826,125,16,1, merged,0,0,0
53187,1000007,1,1740,1399,341,0.804023,0.195977,0.804023,302,39,1741,1400,341,0.804136,0.195864,0.804136,302,39,1, merged,0,0,0
53192,1000014,2,2921,2383,538,0.815817,0.184183,1.554947,499,39,2922,2383,539,0.815537,0.184463,1.523871,500,39,1, abandoned,1,1,0
53192,1000023,4,1378,1211,167,0.87881,0.12119,3.222946,148,19,1379,1212,167,0.878898,0.121102,3.192242,148,19,-1, abandoned,0,0,0
53192,1002169,3,740,584,156,0.789189,0.210811,2.344136,121,35,741,585,156,0.789474,0.210526,2.313344,121,35,-1, abandoned,0,0,0
53195,1002169,1,741,585,156,0.789474,0.210526,0.789474,121,35,743,587,156,0.79004,0.20996,0.79004,121,35,-1, merged,0,0,0
53198,1000015,1,2290,2044,246,0.892576,0.107424,0.892576,224,22,2291,2045,246,0.892623,0.107377,0.892623,224,22,1, merged,0,0,0
53199,1000054,2,954,813,141,0.852201,0.147799,1.596436,125,16,955,814,141,0.852356,0.147644,1.597126,125,16,1, merged,0,0,0
53203,1000199,2,554,472,82,0.851986,0.148014,1.62666,75,7,556,474,82,0.852518,0.147482,1.626592,75,7,-1, merged,0,0,0
53205,1000054,1,955,814,141,0.852356,0.147644,0.852356,125,16,956,815,141,0.85251,0.14749,0.85251,125,16,1, merged,0,0,0
53205,1000130,2,618,508,110,0.822006,0.177994,1.674362,83,27,619,509,110,0.822294,0.177706,1.674804,83,27,1, merged,0,0,0
53207,1000007,3,1741,1400,341,0.804136,0.195864,2.524243,302,39,1742,1401,341,0.804248,0.195752,2.524115,302,39,1, merged,0,0,0
53207,1000009,2,1681,1391,290,0.827484,0.172516,1.720107,260,30,1682,1392,290,0.827586,0.172414,1.719867,260,30,-1, merged,0,0,0
53207,1000015,1,2291,2045,246,0.892623,0.107377,0.892623,224,22,2293,2046,247,0.892281,0.107719,0.892281,225,22,-1, merged,1,0,0
53212,1000108,1,384,321,63,0.835938,0.164062,0.835938,59,4,385,321,64,0.833766,0.166234,0.833766,60,4,1, merged,1,1,0
53212,1000110,2,584,528,56,0.90411,0.09589,1.740047,53,3,585,529,56,0.904274,0.095726,1.73804,53,3,1, merged,0,0,0
53221,1000012,2,695,597,98,0.858993,0.141007,1.674782,95,3,696,598,98,0.859195,0.140805,1.675048,95,3,1, merged,0,0,0
53221,1000014,1,2926,2387,539,0.815789,0.184211,0.815789,500,39,2927,2388,539,0.815852,0.184148,0.815852,500,39,1, merged,0,0,0
53227,1000014,1,2927,2388,539,0.815852,0.184148,0.815852,500,39,2929,2390,539,0.815978,0.184022,0.815978,500,39,-1, merged,0,0,0
53227,1000026,2,582,507,75,0.871134,0.128866,1.686986,72,3,583,508,75,0.871355,0.128645,1.687333,72,3,1, merged,0,0,0
53232,1000329,2,3480,2713,767,0.779598,0.220402,1.648019,656,111,3481,2714,767,0.779661,0.220339,1.651456,656,111,1, merged,0,0,0
53235,1000121,1,2429,2008,421,0.826678,0.173322,0.826678,391,30,2432,2010,422,0.82648,0.17352,0.82648,392,30,-1, merged,1,0,0
53239,1000014,1,2929,2390,539,0.815978,0.184022,0.815978,500,39,2932,2393,539,0.816166,0.183834,0.816166,500,39,-1, merged,0,0,0
53239,1000121,3,2432,2010,422,0.82648,0.17352,2.198014,392,30,2433,2011,422,0.826552,0.173448,2.210286,392,30,1, merged,0,0,0
53242,1000014,1,2932,2393,539,0.816166,0.183834,0.816166,500,39,2937,2397,540,0.816139,0.183861,0.816139,501,39,-1, merged,1,0,0
53242,1000121,3,2433,2011,422,0.826552,0.173448,2.210286,392,30,2434,2012,422,0.826623,0.173377,2.221709,392,30,1, merged,0,0,0
53243,1000023,1,1384,1217,167,0.879335,0.120665,0.879335,148,19,1385,1217,168,0.8787,0.1213,0.8787,148,20,-1, merged,1,1,0
53246,1000023,2,1385,1217,168,0.8787,0.1213,0.8787,148,20,1386,1218,168,0.878788,0.121212,0.878788,148,20,1, merged,0,0,0
53246,1000132,3,738,626,112,0.848238,0.151762,1.726939,91,21,739,627,112,0.848444,0.151556,1.727232,91,21,1, merged,0,0,0
53248,1000043,1,669,556,113,0.831091,0.168909,0.831091,99,14,670,557,113,0.831343,0.168657,0.831343,99,14,1, merged,0,0,0
53250,1000109,2,642,550,92,0.856698,0.143302,1.630772,87,5,643,551,92,0.856921,0.143079,1.631412,87,5,1, merged,0,0,0
53254,1000015,1,2294,2047,247,0.892328,0.107672,0.892328,225,22,2295,2048,247,0.892375,0.107625,0.892375,225,22,1, merged,0,0,0
53254,1000153,3,1207,1088,119,0.901408,0.098592,2.571514,87,32,1208,1089,119,0.90149,0.09851,2.574687,87,32,1, merged,0,0,0
53255,1000592,2,806,683,123,0.847395,0.152605,1.664061,76,47,807,684,123,0.847584,0.152416,1.665765,76,47,1, merged,0,0,0
53256,1000054,2,956,815,141,0.85251,0.14749,1.530477,125,16,957,816,141,0.852665,0.147335,1.535998,125,16,1, merged,0,0,0
53257,1000015,2,2295,2048,247,0.892375,0.107625,1.760638,225,22,2296,2049,247,0.892422,0.107578,1.761469,225,22,1, merged,0,0,0
53259,1000015,2,2296,2049,247,0.892422,0.107578,1.788489,225,22,2297,2050,247,0.892468,0.107532,1.788827,225,22,1, merged,0,0,0
53278,1000012,1,696,598,98,0.859195,0.140805,0.859195,95,3,697,598,99,0.857963,0.142037,0.857963,96,3,1, abandoned,1,1,0
53278,1000132,2,739,627,112,0.848444,0.151556,1.707639,91,21,740,627,113,0.847297,0.152703,1.70526,92,21,1, abandoned,1,1,0
53279,1000014,2,2937,2397,540,0.816139,0.183861,1.705028,501,39,2938,2398,540,0.816201,0.183799,1.710938,501,39,1, merged,0,0,0
53284,1000003,2,1388,1152,236,0.829971,0.170029,1.713026,205,31,1389,1153,236,0.830094,0.169906,1.713204,205,31,1, merged,0,0,0
53284,1000004,1,4190,3700,490,0.883055,0.116945,0.883055,393,97,4192,3702,490,0.883111,0.116889,0.883111,393,97,-1, merged,0,0,0
53287,1000054,2,957,816,141,0.852665,0.147335,1.757101,125,16,958,817,141,0.852818,0.147182,1.757418,125,16,1, merged,0,0,0
53287,1000110,1,586,530,56,0.904437,0.095563,0.904437,53,3,587,531,56,0.9046,0.0954,0.9046,53,3,1, merged,0,0,0
53293,1000007,1,1744,1403,341,0.804472,0.195528,0.804472,302,39,1745,1404,341,0.804585,0.195415,0.804585,302,39,1, merged,0,0,0
53293,1000009,2,1682,1392,290,0.827586,0.172414,1.632059,260,30,1683,1393,290,0.827689,0.172311,1.632273,260,30,1, merged,0,0,0
53294,1000007,1,1745,1404,341,0.804585,0.195415,0.804585,302,39,1746,1405,341,0.804696,0.195304,0.804696,302,39,1, merged,0,0,0
53294,1000009,2,1683,1393,290,0.827689,0.172311,1.632273,260,30,1684,1394,290,0.827791,0.172209,1.632487,260,30,1, merged,0,0,0
53296,1000153,2,1208,1089,119,0.90149,0.09851,1.798138,87,32,1209,1090,119,0.901572,0.098428,1.798507,87,32,1, merged,0,0,0
53299,1000120,2,1973,1717,256,0.870248,0.129752,1.649469,225,31,1974,1718,256,0.870314,0.129686,1.650486,225,31,1, merged,0,0,0
53301,1000004,1,4192,3702,490,0.883111,0.116889,0.883111,393,97,4194,3703,491,0.882928,0.117072,0.882928,393,98,-1, merged,1,0,0
53301,1000120,2,1974,1718,256,0.870314,0.129686,1.753425,225,31,1976,1720,256,0.870445,0.129555,1.753373,225,31,-1, merged,0,0,0
53302,1000004,2,4194,3703,491,0.882928,0.117072,1.753373,393,98,4196,3703,493,0.882507,0.117493,1.753083,393,100,-1, merged,1,1,0
53302,1000120,1,1976,1720,256,0.870445,0.129555,0.870445,225,31,1978,1722,256,0.870576,0.129424,0.870576,225,31,-1, merged,0,0,0
53305,1000004,1,4196,3703,493,0.882507,0.117493,0.882507,393,100,4197,3703,494,0.882297,0.117703,0.882297,394,100,1, merged,1,1,0
53305,1000011,4,885,814,71,0.919774,0.080226,3.539865,66,5,886,815,71,0.919865,0.080135,3.524943,66,5,1, merged,0,0,0
53307,1000005,2,722,610,112,0.844875,0.155125,1.469875,103,9,723,611,112,0.84509,0.15491,1.511757,103,9,1, merged,0,0,0
53308,1000130,1,619,509,110,0.822294,0.177706,0.822294,83,27,620,510,110,0.822581,0.177419,0.822581,83,27,1, merged,0,0,0
53308,1000592,2,807,684,123,0.847584,0.152416,1.669878,76,47,808,685,123,0.847772,0.152228,1.670353,76,47,1, merged,0,0,0
53311,1000009,3,1684,1394,290,0.827791,0.172209,2.173357,260,30,1685,1395,290,0.827893,0.172107,2.179374,260,30,1, merged,0,0,0
53311,1000534,2,491,375,116,0.763747,0.236253,1.345566,105,11,492,375,117,0.762195,0.237805,1.351481,105,12,-1, merged,1,1,0
53313,1000009,2,1685,1395,290,0.827893,0.172107,1.590571,260,30,1686,1396,290,0.827995,0.172005,1.591153,260,30,1, merged,0,0,0
53313,1000534,1,493,376,117,0.762677,0.237323,0.762677,105,12,494,377,117,0.763158,0.236842,0.763158,105,12,1, merged,0,0,0
53315,1000004,2,4197,3703,494,0.882297,0.117703,1.672337,394,100,4198,3704,494,0.882325,0.117675,1.672647,394,100,1, merged,0,0,0
53315,1002169,1,743,587,156,0.79004,0.20996,0.79004,121,35,744,588,156,0.790323,0.209677,0.790323,121,35,-1, merged,0,0,0
53331,1000004,1,4198,3704,494,0.882325,0.117675,0.882325,394,100,4199,3705,494,0.882353,0.117647,0.882353,394,100,-1, merged,0,0,0
53331,1000014,3,2941,2400,541,0.816049,0.183951,2.590842,502,39,2942,2401,541,0.816111,0.183889,2.59098,502,39,1, merged,0,0,0
53331,1000015,2,2297,2050,247,0.892468,0.107532,1.774793,225,22,2298,2051,247,0.892515,0.107485,1.774868,225,22,1, merged,0,0,0
53332,1000003,1,1389,1153,236,0.830094,0.169906,0.830094,205,31,1391,1154,237,0.829619,0.170381,0.829619,206,31,1, merged,1,1,0
53335,1000108,2,387,323,64,0.834625,0.165375,1.695385,60,4,388,324,64,0.835052,0.164948,1.697552,60,4,1, merged,0,0,0
53336,1000108,2,388,324,64,0.835052,0.164948,1.697552,60,4,389,325,64,0.835476,0.164524,1.699673,60,4,1, merged,0,0,0
53337,1000108,2,389,325,64,0.835476,0.164524,1.699673,60,4,390,325,65,0.833333,0.166667,1.688755,60,5,-1, merged,1,1,0
53338,1000108,2,390,325,65,0.833333,0.166667,1.688755,60,5,391,326,65,0.83376,0.16624,1.690902,60,5,1, merged,0,0,0
53339,1000108,2,391,326,65,0.83376,0.16624,1.690902,60,5,392,327,65,0.834184,0.165816,1.693007,60,5,1, merged,0,0,0
53340,1000043,2,672,559,113,0.831845,0.168155,1.690669,99,14,673,560,113,0.832095,0.167905,1.680932,99,14,1, merged,0,0,0
53341,1000108,2,392,327,65,0.834184,0.165816,1.683021,60,5,393,328,65,0.834606,0.165394,1.68518,60,5,1, merged,0,0,0
53342,1000108,2,393,328,65,0.834606,0.165394,1.68518,60,5,394,329,65,0.835025,0.164975,1.677722,60,5,1, merged,0,0,0
53343,1000108,2,394,329,65,0.835025,0.164975,1.677722,60,5,395,330,65,0.835443,0.164557,1.679887,60,5,1, merged,0,0,0
53344,1000108,2,395,330,65,0.835443,0.164557,1.679887,60,5,396,331,65,0.835859,0.164141,1.682012,60,5,1, merged,0,0,0
53346,1000004,2,4199,3705,494,0.882353,0.117647,1.73246,394,100,4201,3707,494,0.882409,0.117591,1.7307,394,100,-1, merged,0,0,0
53351,1000023,1,1395,1224,171,0.877419,0.122581,0.877419,151,20,1396,1225,171,0.877507,0.122493,0.877507,151,20,1, merged,0,0,0
53352,1000007,2,1746,1405,341,0.804696,0.195304,1.62087,302,39,1747,1406,341,0.804808,0.195192,1.621045,302,39,1, merged,0,0,0
53352,1000014,1,2943,2402,541,0.816174,0.183826,0.816174,502,39,2944,2403,541,0.816236,0.183764,0.816236,502,39,1, merged,0,0,0
53355,1000003,1,1392,1155,237,0.829741,0.170259,0.829741,206,31,1393,1156,237,0.829864,0.170136,0.829864,206,31,1, merged,0,0,0
53362,1000105,4,726,576,150,0.793388,0.206612,2.908726,133,17,727,576,151,0.792297,0.207703,2.999748,134,17,1, merged,1,1,0
53362,1000166,2,482,368,114,0.763485,0.236515,1.615337,109,5,485,369,116,0.760825,0.239175,1.607451,111,5,1, merged,1,1,0
53364,1000007,2,1747,1406,341,0.804808,0.195192,1.633211,302,39,1748,1406,342,0.804348,0.195652,1.632362,303,39,1, merged,1,1,0
53364,1000009,1,1690,1400,290,0.828402,0.171598,0.828402,260,30,1692,1401,291,0.828014,0.171986,0.828014,261,30,1, merged,1,1,0
53366,1000014,1,2944,2403,541,0.816236,0.183764,0.816236,502,39,2945,2404,541,0.816299,0.183701,0.816299,502,39,1, merged,0,0,0
53366,1000130,2,620,510,110,0.822581,0.177419,1.638817,83,27,621,511,110,0.822866,0.177134,1.639165,83,27,1, merged,0,0,0
53368,1000592,4,808,685,123,0.847772,0.152228,2.926061,76,47,809,686,123,0.84796,0.15204,2.954703,76,47,1, merged,0,0,0
53370,1000012,2,697,598,99,0.857963,0.142037,1.714078,96,3,698,599,99,0.858166,0.141834,1.711213,96,3,1, merged,0,0,0
53374,1000004,1,4202,3708,494,0.882437,0.117563,0.882437,394,100,4203,3709,494,0.882465,0.117535,0.882465,394,100,1, merged,0,0,0
53374,1000592,2,809,686,123,0.84796,0.15204,1.730397,76,47,810,687,123,0.848148,0.151852,1.730613,76,47,1, merged,0,0,0
53375,1000105,1,728,577,151,0.792582,0.207418,0.792582,134,17,731,579,152,0.792066,0.207934,0.792066,135,17,1, merged,1,1,0
53375,1002169,2,746,590,156,0.790885,0.209115,1.583467,121,35,747,591,156,0.791165,0.208835,1.58323,121,35,-1, merged,0,0,0
53386,1000140,2,363,307,56,0.84573,0.15427,1.694868,48,8,364,308,56,0.846154,0.153846,1.695939,48,8,-1, abandoned,0,0,0
53390,1000004,1,4203,3709,494,0.882465,0.117535,0.882465,394,100,4204,3710,494,0.882493,0.117507,0.882493,394,100,-1, abandoned,0,0,0
53390,1000329,2,3481,2714,767,0.779661,0.220339,1.662126,656,111,3482,2715,767,0.779724,0.220276,1.662217,656,111,-1, abandoned,0,0,0
53391,1000004,3,4204,3710,494,0.882493,0.117507,2.599288,394,100,4205,3710,495,0.882283,0.117717,2.600816,395,100,1, merged,1,1,0
53391,1000011,4,887,816,71,0.919955,0.080045,3.519243,66,5,888,817,71,0.920045,0.079955,3.520861,66,5,-1, merged,0,0,0
53391,1000120,2,1979,1723,256,0.870642,0.129358,1.716796,225,31,1980,1724,256,0.870707,0.129293,1.718533,225,31,-1, merged,0,0,0
53394,1000003,1,1393,1156,237,0.829864,0.170136,0.829864,206,31,1394,1157,237,0.829986,0.170014,0.829986,206,31,1, merged,0,0,0
53394,1000592,2,810,687,123,0.848148,0.151852,1.678012,76,47,811,688,123,0.848335,0.151665,1.678321,76,47,1, merged,0,0,0
53410,1000004,2,4205,3710,495,0.882283,0.117717,1.745028,395,100,4206,3711,495,0.882311,0.117689,1.747696,395,100,1, merged,0,0,0
53410,1000592,3,811,688,123,0.848335,0.151665,2.593363,76,47,812,689,123,0.848522,0.151478,2.596218,76,47,1, merged,0,0,0
53411,1000014,1,2947,2406,541,0.816423,0.183577,0.816423,502,39,2948,2407,541,0.816486,0.183514,0.816486,502,39,1, merged,0,0,0
53413,1000592,2,812,689,123,0.848522,0.151478,1.639687,76,47,813,690,123,0.848708,0.151292,1.638815,76,47,1, merged,0,0,0
53413,1002169,1,747,591,156,0.791165,0.208835,0.791165,121,35,748,591,157,0.790107,0.209893,0.790107,121,36,-1, merged,1,1,0
53422,1000070,1,1428,1216,212,0.851541,0.148459,0.851541,184,28,1429,1217,212,0.851645,0.148355,0.851645,184,28,1, merged,0,0,0
53427,1000004,2,4208,3713,495,0.882367,0.117633,1.735185,395,100,4212,3716,496,0.882241,0.117759,1.733283,396,100,-1, merged,1,0,0
53427,1000026,3,584,509,75,0.871575,0.128425,2.606761,72,3,586,511,75,0.872014,0.127986,2.605297,72,3,-1, merged,0,0,0
53427,1000054,1,958,817,141,0.852818,0.147182,0.852818,125,16,960,817,143,0.851042,0.148958,0.851042,127,16,1, merged,1,1,0
53433,1000132,1,741,628,113,0.847503,0.152497,0.847503,92,21,743,630,113,0.847914,0.152086,0.847914,92,21,1, merged,0,0,0
53437,1000004,3,4212,3716,496,0.882241,0.117759,2.614352,396,100,4213,3717,496,0.882269,0.117731,2.606953,396,100,1, merged,0,0,0
53437,1000070,2,1429,1217,212,0.851645,0.148355,1.732111,184,28,1431,1219,212,0.851852,0.148148,1.724684,184,28,-1, merged,0,0,0
53441,1000004,4,4214,3718,496,0.882297,0.117703,3.015903,396,100,4217,3719,498,0.881907,0.118093,2.988366,398,100,1, merged,1,1,0
53441,1000026,5,586,511,75,0.872014,0.127986,3.887916,72,3,588,513,75,0.872449,0.127551,3.860815,72,3,-1, merged,0,0,0
53441,1000054,1,960,817,143,0.851042,0.148958,0.851042,127,16,962,818,144,0.850312,0.149688,0.850312,128,16,-1, merged,1,0,0
53441,1000166,3,485,369,116,0.760825,0.239175,2.133606,111,5,488,369,119,0.756148,0.243852,2.106459,114,5,1, merged,1,1,0
53442,1000054,2,962,818,144,0.850312,0.149688,1.698226,128,16,963,819,144,0.850467,0.149533,1.697447,128,16,1, merged,0,0,0
53442,1000132,1,743,630,113,0.847914,0.152086,0.847914,92,21,745,631,114,0.84698,0.15302,0.84698,93,21,-1, merged,1,0,0
53447,1000011,1,889,818,71,0.920135,0.079865,0.920135,66,5,890,819,71,0.920225,0.079775,0.920225,66,5,-1, abandoned,0,0,0
53447,1000120,2,1980,1724,256,0.870707,0.129293,1.790842,225,31,1981,1725,256,0.870772,0.129228,1.790997,225,31,-1, abandoned,0,0,0
53448,1000004,4,4217,3719,498,0.881907,0.118093,2.826579,398,100,4219,3721,498,0.881963,0.118037,2.78169,398,100,-1, merged,0,0,0
53448,1000166,3,488,369,119,0.756148,0.243852,1.944672,114,5,490,369,121,0.753061,0.246939,1.899728,116,5,1, merged,1,1,0
53449,1000592,3,813,690,123,0.848708,0.151292,2.474971,76,47,814,691,123,0.848894,0.151106,2.484981,76,47,1, merged,0,0,0
53450,1000014,1,2948,2407,541,0.816486,0.183514,0.816486,502,39,2949,2407,542,0.816209,0.183791,0.816209,503,39,1, merged,1,1,0
53453,1000592,3,814,691,123,0.848894,0.151106,2.484981,76,47,815,692,123,0.84908,0.15092,2.494294,76,47,1, merged,0,0,0
53464,1000091,2,658,521,137,0.791793,0.208207,1.615228,115,22,659,522,137,0.792109,0.207891,1.615827,115,22,1, merged,0,0,0
53464,1000130,1,623,513,110,0.823435,0.176565,0.823435,83,27,624,514,110,0.823718,0.176282,0.823718,83,27,1, merged,0,0,0
53466,1000054,2,963,819,144,0.850467,0.149533,1.517134,128,16,964,820,144,0.850622,0.149378,1.522497,128,16,1, merged,0,0,0
53470,1000534,1,494,377,117,0.763158,0.236842,0.763158,105,12,500,378,122,0.756,0.244,0.756,110,12,1, merged,1,1,0
53474,1000592,2,816,693,123,0.849265,0.150735,1.667447,76,47,817,694,123,0.849449,0.150551,1.669121,76,47,1, merged,0,0,0
53475,1000121,2,2434,2012,422,0.826623,0.173377,1.826623,392,30,2435,2013,422,0.826694,0.173306,1.626694,392,30,-1, abandoned,0,0,0
53476,1000329,1,3483,2716,767,0.779788,0.220212,0.779788,656,111,3484,2717,767,0.779851,0.220149,0.779851,656,111,-1, merged,0,0,0
53477,1000329,1,3484,2717,767,0.779851,0.220149,0.779851,656,111,3485,2718,767,0.779914,0.220086,0.779914,656,111,-1, abandoned,0,0,0
53479,1000070,2,1431,1219,212,0.851852,0.148148,1.725051,184,28,1433,1220,213,0.851361,0.148639,1.72205,185,28,1, merged,1,1,0
53482,1000108,2,400,333,67,0.8325,0.1675,1.681962,62,5,401,334,67,0.832918,0.167082,1.685549,62,5,1, merged,0,0,0
53483,1000108,2,401,334,67,0.832918,0.167082,1.685549,62,5,402,335,67,0.833333,0.166667,1.689003,62,5,1, merged,0,0,0
53487,1000132,1,746,631,115,0.845845,0.154155,0.845845,94,21,747,632,115,0.846051,0.153949,0.846051,94,21,1, merged,0,0,0
53488,1000109,1,644,552,92,0.857143,0.142857,0.857143,87,5,645,553,92,0.857364,0.142636,0.857364,87,5,1, merged,0,0,0
53488,1000199,2,557,475,82,0.852783,0.147217,1.709926,75,7,558,476,82,0.853047,0.146953,1.710411,75,7,1, merged,0,0,0
53489,1000199,3,558,476,82,0.853047,0.146953,2.496039,75,7,559,477,82,0.853309,0.146691,2.497276,75,7,1, merged,0,0,0
53496,1000004,2,4219,3721,498,0.881963,0.118037,1.67207,398,100,4222,3724,498,0.882046,0.117954,1.672713,398,100,-1, merged,0,0,0
53496,1000070,5,1433,1220,213,0.851361,0.148639,4.244861,185,28,1435,1221,214,0.850871,0.149129,4.250152,186,28,1, merged,1,1,0
53496,1000121,4,2435,2013,422,0.826694,0.173306,3.3935,392,30,2439,2016,423,0.826568,0.173432,3.399281,393,30,-1, merged,1,0,0
53496,1002169,1,748,591,157,0.790107,0.209893,0.790107,121,36,750,593,157,0.790667,0.209333,0.790667,121,36,-1, merged,0,0,0
53498,1000014,1,2949,2407,542,0.816209,0.183791,0.816209,503,39,2950,2408,542,0.816271,0.183729,0.816271,503,39,-1, merged,0,0,0
53500,1000592,2,818,695,123,0.849633,0.150367,1.682967,76,47,819,696,123,0.849817,0.150183,1.689817,76,47,1, merged,0,0,0
53502,1000105,2,736,583,153,0.79212,0.20788,1.63817,136,17,737,584,153,0.792402,0.207598,1.638658,136,17,1, merged,0,0,0
53502,1000132,1,747,632,115,0.846051,0.153949,0.846051,94,21,748,633,115,0.846257,0.153743,0.846257,94,21,1, merged,0,0,0
53504,1000011,3,890,819,71,0.920225,0.079775,2.646667,66,5,891,820,71,0.920314,0.079686,2.649738,66,5,1, merged,0,0,0
53504,1000120,1,1981,1725,256,0.870772,0.129228,0.870772,225,31,1982,1726,256,0.870838,0.129162,0.870838,225,31,-1, merged,0,0,0
53509,1000054,2,964,820,144,0.850622,0.149378,1.330622,128,16,965,821,144,0.850777,0.149223,1.350777,128,16,1, merged,0,0,0
53516,1000004,1,4222,3724,498,0.882046,0.117954,0.882046,398,100,4223,3725,498,0.882074,0.117926,0.882074,398,100,1, merged,0,0,0
53516,1000014,2,2950,2408,542,0.816271,0.183729,1.698318,503,39,2951,2409,542,0.816333,0.183667,1.698408,503,39,1, merged,0,0,0
53542,1000014,1,2952,2410,542,0.816396,0.183604,0.816396,503,39,2954,2410,544,0.815843,0.184157,0.815843,505,39,1, abandoned,1,1,0
53548,1000121,2,2439,2016,423,0.826568,0.173432,1.485659,393,30,2440,2017,423,0.826639,0.173361,1.489561,393,30,1, merged,0,0,0
53557,1000004,1,4225,3727,498,0.88213,0.11787,0.88213,398,100,4229,3730,499,0.882005,0.117995,0.882005,399,100,-1, merged,1,0,0
53557,1000014,2,2954,2410,544,0.815843,0.184157,1.697973,505,39,2955,2410,545,0.815567,0.184433,1.697572,506,39,1, merged,1,1,0
53564,1000003,2,1398,1159,239,0.829041,0.170959,1.549854,206,33,1399,1160,239,0.829164,0.170836,1.551386,206,33,1, merged,0,0,0
53565,1000091,2,659,522,137,0.792109,0.207891,1.472109,115,22,661,524,137,0.792738,0.207262,1.511488,115,22,-1, abandoned,0,0,0
53572,1000009,2,1695,1404,291,0.828319,0.171681,1.728319,261,30,1696,1405,291,0.82842,0.17158,1.733182,261,30,1, merged,0,0,0
53574,1000199,2,559,477,82,0.853309,0.146691,1.629045,75,7,561,479,82,0.853832,0.146168,1.628558,75,7,-1, merged,0,0,0
53594,1000328,1,1044,775,269,0.742337,0.257663,0.742337,243,26,1046,776,270,0.741874,0.258126,0.741874,244,26,1, merged,1,1,0
53594,1000329,2,3486,2719,767,0.779977,0.220023,1.522314,656,111,3487,2720,767,0.78004,0.21996,1.521914,656,111,-1, merged,0,0,0
53595,1000004,2,4229,3730,499,0.882005,0.117995,1.672672,399,100,4231,3732,499,0.882061,0.117939,1.673284,399,100,-1, merged,0,0,0
53595,1002169,1,750,593,157,0.790667,0.209333,0.790667,121,36,752,595,157,0.791223,0.208777,0.791223,121,36,-1, merged,0,0,0
53606,1000004,1,4231,3732,499,0.882061,0.117939,0.882061,399,100,4232,3733,499,0.882089,0.117911,0.882089,399,100,1, merged,0,0,0
53606,1000327,2,710,559,151,0.787324,0.212676,1.669385,117,34,711,560,151,0.787623,0.212377,1.669712,117,34,1, merged,0,0,0
53607,1000004,1,4232,3733,499,0.882089,0.117911,0.882089,399,100,4233,3734,499,0.882117,0.117883,0.882117,399,100,1, merged,0,0,0
53607,1000327,2,711,560,151,0.787623,0.212377,1.669712,117,34,712,561,151,0.787921,0.212079,1.670038,117,34,1, merged,0,0,0
53609,1000004,1,4233,3734,499,0.882117,0.117883,0.882117,399,100,4234,3734,500,0.881908,0.118092,0.881908,400,100,1, merged,1,1,0
53609,1000120,4,1982,1726,256,0.870838,0.129162,3.465633,225,31,1984,1728,256,0.870968,0.129032,3.468,225,31,1, merged,0,0,0
53612,1000121,2,2440,2017,423,0.826639,0.173361,1.626639,393,30,2441,2018,423,0.82671,0.17329,1.660044,393,30,1, merged,0,0,0
53613,1000121,2,2441,2018,423,0.82671,0.17329,1.660044,393,30,2442,2019,423,0.826781,0.173219,1.683924,393,30,1, merged,0,0,0
53616,1000004,3,4234,3734,500,0.881908,0.118092,2.456625,400,100,4235,3734,501,0.8817,0.1183,2.455607,400,101,-1, merged,1,1,0
53616,1000130,2,626,515,111,0.822684,0.177316,1.574716,84,27,627,515,112,0.821372,0.178628,1.573907,84,28,-1, merged,1,1,0
53616,1000166,1,492,370,122,0.752033,0.247967,0.752033,117,5,493,371,122,0.752535,0.247465,0.752535,117,5,1, merged,0,0,0
53618,1000534,2,500,378,122,0.756,0.244,1.459704,110,12,501,379,122,0.756487,0.243513,1.480625,110,12,1, merged,0,0,0
53620,1000329,2,3487,2720,767,0.78004,0.21996,1.628188,656,111,3488,2721,767,0.780103,0.219897,1.628812,656,111,1, merged,0,0,0
53621,1000054,2,967,823,144,0.851086,0.148914,1.603621,128,16,968,824,144,0.85124,0.14876,1.602755,128,16,1, merged,0,0,0
53621,1000166,1,493,371,122,0.752535,0.247465,0.752535,117,5,495,372,123,0.751515,0.248485,0.751515,118,5,1, merged,1,1,0
53625,1000329,1,3488,2721,767,0.780103,0.219897,0.780103,656,111,3489,2721,768,0.77988,0.22012,0.77988,656,112,-1, merged,1,1,0
53628,1000054,2,968,824,144,0.85124,0.14876,1.642056,128,16,970,826,144,0.851546,0.148454,1.638348,128,16,-1, merged,0,0,0
53630,1000026,2,589,514,75,0.872666,0.127334,1.724212,72,3,591,516,75,0.873096,0.126904,1.723766,72,3,-1, merged,0,0,0
53630,1000054,1,970,826,144,0.851546,0.148454,0.851546,128,16,971,826,145,0.850669,0.149331,0.850669,129,16,1, merged,1,1,0
53631,1000026,2,591,516,75,0.873096,0.126904,1.723766,72,3,592,517,75,0.873311,0.126689,1.723105,72,3,1, merged,0,0,0
53631,1000054,1,971,826,145,0.850669,0.149331,0.850669,129,16,972,826,146,0.849794,0.150206,0.849794,130,16,1, merged,1,1,0
53632,1000026,2,592,517,75,0.873311,0.126689,1.723105,72,3,593,518,75,0.873524,0.126476,1.722445,72,3,1, merged,0,0,0
53632,1000054,1,972,826,146,0.849794,0.150206,0.849794,130,16,973,826,147,0.848921,0.151079,0.848921,131,16,1, merged,1,1,0
53633,1000328,1,1046,776,270,0.741874,0.258126,0.741874,244,26,1047,777,270,0.74212,0.25788,0.74212,244,26,1, merged,0,0,0
53633,1000329,2,3489,2721,768,0.77988,0.22012,1.521753,656,112,3490,2722,768,0.779943,0.220057,1.522063,656,112,1, merged,0,0,0
53639,1000014,1,2959,2414,545,0.815816,0.184184,0.815816,506,39,2960,2414,546,0.815541,0.184459,0.815541,507,39,1, abandoned,1,1,0
53639,1000130,2,627,515,112,0.821372,0.178628,1.637188,84,28,628,516,112,0.821656,0.178344,1.637197,84,28,-1, abandoned,0,0,0
53649,1000004,1,4237,3736,501,0.881756,0.118244,0.881756,400,101,4238,3736,502,0.881548,0.118452,0.881548,401,101,1, merged,1,1,0
53649,1000043,3,674,561,113,0.832344,0.167656,2.356957,99,14,675,562,113,0.832593,0.167407,2.31414,99,14,1, merged,0,0,0
53651,1000004,1,4238,3736,502,0.881548,0.118452,0.881548,401,101,4241,3737,504,0.88116,0.11884,0.88116,403,101,-1, abandoned,1,0,0
53651,1000043,2,676,563,113,0.83284,0.16716,1.714388,99,14,678,563,115,0.830383,0.169617,1.711544,101,14,1, abandoned,1,1,0
53652,1000054,1,974,827,147,0.849076,0.150924,0.849076,131,16,975,828,147,0.849231,0.150769,0.849231,131,16,1, merged,0,0,0
53653,1000121,2,2442,2019,423,0.826781,0.173219,1.677146,393,30,2443,2020,423,0.826852,0.173148,1.677399,393,30,1, merged,0,0,0
53653,1000592,1,822,699,123,0.850365,0.149635,0.850365,76,47,823,700,123,0.850547,0.149453,0.850547,76,47,1, merged,0,0,0
53656,1000108,2,404,337,67,0.834158,0.165842,1.612602,62,5,405,338,67,0.834568,0.165432,1.61433,62,5,1, merged,0,0,0
53657,1000043,2,678,563,115,0.830383,0.169617,1.661495,101,14,679,564,115,0.830633,0.169367,1.662492,101,14,1, merged,0,0,0
53658,1000110,1,596,539,57,0.904362,0.095638,0.904362,54,3,598,539,59,0.901338,0.098662,0.901338,54,5,-1, merged,1,1,0
53659,1000004,2,4241,3737,504,0.88116,0.11884,1.70958,403,101,4243,3737,506,0.880745,0.119255,1.709266,403,103,-1, merged,1,1,0
53659,1000009,1,1696,1405,291,0.82842,0.17158,0.82842,261,30,1697,1406,291,0.828521,0.171479,0.828521,261,30,1, merged,0,0,0
53661,1000120,2,1987,1731,256,0.871163,0.128837,1.62765,225,31,1988,1732,256,0.871227,0.128773,1.628199,225,31,1, merged,0,0,0
53661,1000534,1,501,379,122,0.756487,0.243513,0.756487,110,12,502,380,122,0.756972,0.243028,0.756972,110,12,1, merged,0,0,0
53670,1000023,1,1400,1229,171,0.877857,0.122143,0.877857,151,20,1401,1230,171,0.877944,0.122056,0.877944,151,20,1, merged,0,0,0
53678,1000329,3,3491,2723,768,0.780006,0.219994,2.476434,656,112,3492,2724,768,0.780069,0.219931,2.409634,656,112,-1, merged,0,0,0
53683,1000023,1,1402,1230,172,0.877318,0.122682,0.877318,152,20,1403,1231,172,0.877406,0.122594,0.877406,152,20,1, merged,0,0,0
53686,1000054,2,975,828,147,0.849231,0.150769,1.762969,131,16,978,831,147,0.849693,0.150307,1.760521,131,16,-1, merged,0,0,0
53691,1000004,2,4243,3737,506,0.880745,0.119255,1.660813,403,103,4244,3738,506,0.880773,0.119227,1.660905,403,103,1, merged,0,0,0
53691,1000329,1,3492,2724,768,0.780069,0.219931,0.780069,656,112,3493,2725,768,0.780132,0.219868,0.780132,656,112,1, merged,0,0,0
53693,1000014,2,2961,2414,547,0.815265,0.184735,1.70772,508,39,2962,2415,547,0.815327,0.184673,1.707829,508,39,1, merged,0,0,0
53693,1000015,1,2306,2058,248,0.892454,0.107546,0.892454,226,22,2307,2059,248,0.892501,0.107499,0.892501,226,22,1, merged,0,0,0
53705,1000026,2,593,518,75,0.873524,0.126476,1.545399,72,3,594,519,75,0.873737,0.126263,1.535276,72,3,1, merged,0,0,0
53718,1000004,1,4246,3740,506,0.880829,0.119171,0.880829,403,103,4247,3741,506,0.880857,0.119143,0.880857,403,103,1, merged,0,0,0
53718,1000014,2,2962,2415,547,0.815327,0.184673,1.696156,508,39,2963,2416,547,0.81539,0.18461,1.696247,508,39,1, merged,0,0,0
53720,1000004,1,4247,3741,506,0.880857,0.119143,0.880857,403,103,4249,3743,506,0.880913,0.119087,0.880913,403,103,-1, merged,0,0,0
53720,1002169,2,752,595,157,0.791223,0.208777,1.67208,121,36,759,602,157,0.793149,0.206851,1.674062,121,36,-1, merged,0,0,0
53722,1000199,1,561,479,82,0.853832,0.146168,0.853832,75,7,564,482,82,0.85461,0.14539,0.85461,75,7,-1, merged,0,0,0
53723,1000121,1,2443,2020,423,0.826852,0.173148,0.826852,393,30,2444,2021,423,0.826923,0.173077,0.826923,393,30,-1, abandoned,0,0,0
53735,1000043,1,680,565,115,0.830882,0.169118,0.830882,101,14,681,566,115,0.831131,0.168869,0.831131,101,14,-1, merged,0,0,0
53739,1000004,2,4251,3744,507,0.880734,0.119266,1.673883,404,103,4253,3746,507,0.88079,0.11921,1.674211,404,103,-1, merged,0,0,0
53739,1002169,1,759,602,157,0.793149,0.206851,0.793149,121,36,760,603,157,0.793421,0.206579,0.793421,121,36,-1, merged,0,0,0
53741,1000121,2,2444,2021,423,0.826923,0.173077,1.607055,393,30,2445,2022,423,0.826994,0.173006,1.607188,393,30,1, merged,0,0,0
53741,1000329,1,3493,2725,768,0.780132,0.219868,0.780132,656,112,3494,2726,768,0.780195,0.219805,0.780195,656,112,1, merged,0,0,0
53743,1000004,1,4253,3746,507,0.88079,0.11921,0.88079,404,103,4255,3748,507,0.880846,0.119154,0.880846,404,103,-1, merged,0,0,0
53743,1000105,4,741,587,154,0.792173,0.207827,3.287825,137,17,742,588,154,0.792453,0.207547,3.287526,137,17,1, merged,0,0,0
53745,1000004,2,4255,3748,507,0.880846,0.119154,1.661104,404,103,4256,3749,507,0.880874,0.119126,1.661194,404,103,1, merged,0,0,0
53745,1000329,1,3495,2727,768,0.780258,0.219742,0.780258,656,112,3496,2728,768,0.78032,0.21968,0.78032,656,112,1, merged,0,0,0
53746,1000070,2,1435,1221,214,0.850871,0.149129,1.611254,186,28,1436,1222,214,0.850975,0.149025,1.61174,186,28,1, merged,0,0,0
53752,1000132,1,749,634,115,0.846462,0.153538,0.846462,94,21,750,634,116,0.845333,0.154667,0.845333,94,22,-1, merged,1,1,0
53783,1000153,1,1219,1098,121,0.900738,0.099262,0.900738,89,32,1220,1099,121,0.90082,0.09918,0.90082,89,32,1, merged,0,0,0
53783,1000328,2,1049,779,270,0.742612,0.257388,1.64335,244,26,1050,780,270,0.742857,0.257143,1.643677,244,26,1, merged,0,0,0
53787,1000327,1,712,561,151,0.787921,0.212079,0.787921,117,34,717,565,152,0.788006,0.211994,0.788006,118,34,-1, merged,1,0,0
53798,1000132,1,750,634,116,0.845333,0.154667,0.845333,94,22,751,635,116,0.845539,0.154461,0.845539,94,22,-1, merged,0,0,0
53804,1000009,1,1698,1407,291,0.828622,0.171378,0.828622,261,30,1699,1408,291,0.828723,0.171277,0.828723,261,30,1, merged,0,0,0
53804,1000153,2,1220,1099,121,0.90082,0.09918,1.729442,89,32,1221,1100,121,0.900901,0.099099,1.729624,89,32,1, merged,0,0,0
53817,1000014,2,2963,2416,547,0.81539,0.18461,1.542663,508,39,2964,2417,547,0.815452,0.184548,1.550746,508,39,1, merged,0,0,0
53819,1000004,2,4264,3755,509,0.880629,0.119371,1.660949,405,104,4267,3758,509,0.880712,0.119288,1.66081,405,104,-1, merged,0,0,0
53819,1000329,1,3496,2728,768,0.78032,0.21968,0.78032,656,112,3497,2728,769,0.780097,0.219903,0.780097,657,112,1, merged,1,1,0
53820,1000012,1,701,601,100,0.857347,0.142653,0.857347,97,3,702,602,100,0.85755,0.14245,0.85755,97,3,1, merged,0,0,0
53820,1000110,2,601,541,60,0.900166,0.099834,1.757513,55,5,602,542,60,0.900332,0.099668,1.757882,55,5,1, merged,0,0,0
53836,1000009,2,1702,1411,291,0.829025,0.170975,1.690411,261,30,1703,1412,291,0.829125,0.170875,1.69187,261,30,1, merged,0,0,0
53839,1000132,1,751,635,116,0.845539,0.154461,0.845539,94,22,752,636,116,0.845745,0.154255,0.845745,94,22,1, merged,0,0,0
53854,1000015,1,2308,2060,248,0.892548,0.107452,0.892548,226,22,2309,2061,248,0.892594,0.107406,0.892594,226,22,-1, merged,0,0,0
53855,1000004,1,4267,3758,509,0.880712,0.119288,0.880712,405,104,4268,3759,509,0.88074,0.11926,0.88074,405,104,1, merged,0,0,0
53855,1000592,2,825,702,123,0.850909,0.149091,1.731622,76,47,826,703,123,0.85109,0.14891,1.73183,76,47,1, merged,0,0,0
53856,1000592,3,826,703,123,0.85109,0.14891,2.162971,76,47,827,704,123,0.85127,0.14873,2.255191,76,47,1, merged,0,0,0
53857,1000592,4,827,704,123,0.85127,0.14873,3.015957,76,47,828,705,123,0.851449,0.148551,2.980141,76,47,1, merged,0,0,0
53858,1000004,2,4268,3759,509,0.88074,0.11926,1.452169,405,104,4269,3759,510,0.880534,0.119466,1.324979,406,104,1, merged,1,1,0
53864,1000009,5,1703,1412,291,0.829125,0.170875,3.876518,261,30,1706,1415,291,0.829426,0.170574,3.848293,261,30,-1, merged,0,0,0
53864,1000026,3,594,519,75,0.873737,0.126263,2.350423,72,3,595,520,75,0.87395,0.12605,2.3522,72,3,-1, merged,0,0,0
53865,1000014,1,2964,2417,547,0.815452,0.184548,0.815452,508,39,2968,2417,551,0.814353,0.185647,0.814353,512,39,1, abandoned,1,1,0
53865,1000105,2,744,590,154,0.793011,0.206989,1.608463,137,17,745,590,155,0.791946,0.208054,1.606299,138,17,1, abandoned,1,1,0
53876,1000011,2,900,826,74,0.917778,0.082222,1.817507,69,5,901,827,74,0.917869,0.082131,1.817869,69,5,1, merged,0,0,0
53880,1000070,2,1437,1223,214,0.851079,0.148921,1.781311,186,28,1438,1224,214,0.851182,0.148818,1.782217,186,28,1, merged,0,0,0
53881,1000004,1,4270,3760,510,0.880562,0.119438,0.880562,406,104,4271,3761,510,0.88059,0.11941,0.88059,406,104,1, merged,0,0,0
53881,1000153,2,1221,1100,121,0.900901,0.099099,1.781463,89,32,1222,1101,121,0.900982,0.099018,1.781572,89,32,1, merged,0,0,0
53892,1000003,2,1404,1165,239,0.829772,0.170228,1.688927,206,33,1405,1166,239,0.829893,0.170107,1.689246,206,33,1, merged,0,0,0
53892,1000012,1,710,610,100,0.859155,0.140845,0.859155,97,3,711,611,100,0.859353,0.140647,0.859353,97,3,1, merged,0,0,0
53893,1000023,1,1406,1233,173,0.876956,0.123044,0.876956,153,20,1408,1234,174,0.87642,0.12358,0.87642,154,20,1, merged,1,1,0
53893,1000043,2,682,567,115,0.831378,0.168622,1.708334,101,14,683,567,116,0.830161,0.169839,1.706582,102,14,1, merged,1,1,0
53894,1000023,1,1408,1234,174,0.87642,0.12358,0.87642,154,20,1409,1235,174,0.876508,0.123492,0.876508,154,20,1, merged,0,0,0
53894,1000043,3,683,567,116,0.830161,0.169839,2.569327,102,14,684,568,116,0.830409,0.169591,2.570995,102,14,1, merged,0,0,0
53896,1000014,2,2968,2417,551,0.814353,0.185647,1.536575,512,39,2969,2418,551,0.814416,0.185584,1.539416,512,39,1, merged,0,0,0
53898,1000023,1,1409,1235,174,0.876508,0.123492,0.876508,154,20,1410,1236,174,0.876596,0.123404,0.876596,154,20,-1, abandoned,0,0,0
53898,1000105,2,745,590,155,0.791946,0.208054,1.668454,138,17,746,591,155,0.792225,0.207775,1.668821,138,17,-1, abandoned,0,0,0
53900,1000007,1,1753,1411,342,0.804906,0.195094,0.804906,303,39,1754,1411,343,0.804447,0.195553,0.804447,304,39,1, merged,1,1,0
53900,1000009,2,1707,1416,291,0.829525,0.170475,1.634431,261,30,1709,1418,291,0.829725,0.170275,1.634172,261,30,1, merged,0,0,0
53906,1000014,1,2969,2418,551,0.814416,0.185584,0.814416,512,39,2971,2419,552,0.814204,0.185796,0.814204,513,39,1, merged,1,1,0
53906,1000110,2,602,542,60,0.900332,0.099668,1.714748,55,5,603,543,60,0.900498,0.099502,1.714701,55,5,1, merged,0,0,0
53917,1000105,2,747,592,155,0.792503,0.207497,1.55403,138,17,748,593,155,0.792781,0.207219,1.554686,138,17,1, merged,0,0,0
53920,1000166,2,495,372,123,0.751515,0.248485,1.544936,118,5,496,373,123,0.752016,0.247984,1.544395,118,5,1, merged,0,0,0
53920,1002169,1,760,603,157,0.793421,0.206579,0.793421,121,36,761,603,158,0.792378,0.207622,0.792378,121,37,-1, merged,1,1,0
53923,1000026,4,595,520,75,0.87395,0.12605,3.162568,72,3,596,520,76,0.872483,0.127517,3.103733,73,3,1, merged,1,1,0
53925,1000054,2,981,834,147,0.850153,0.149847,1.642934,131,16,983,836,147,0.850458,0.149542,1.642458,131,16,-1, merged,0,0,0
53925,1000105,1,748,593,155,0.792781,0.207219,0.792781,138,17,750,594,156,0.792,0.208,0.792,139,17,1, merged,1,1,0
53943,1000026,2,596,520,76,0.872483,0.127517,1.723245,73,3,599,522,77,0.871452,0.128548,1.721655,74,3,1, merged,1,1,0
53943,1000054,1,985,838,147,0.850761,0.149239,0.850761,131,16,988,840,148,0.850202,0.149798,0.850202,132,16,1, merged,1,1,0
53957,1000132,2,754,638,116,0.846154,0.153846,1.746643,94,22,755,639,116,0.846358,0.153642,1.746928,94,22,1, merged,0,0,0
53957,1000153,1,1226,1104,122,0.900489,0.099511,0.900489,90,32,1227,1105,122,0.90057,0.09943,0.90057,90,32,1, merged,0,0,0
53959,1000592,3,828,705,123,0.851449,0.148551,2.516955,76,47,830,706,124,0.850602,0.149398,2.497445,77,47,1, merged,1,1,0
53975,1000007,1,1755,1412,343,0.804558,0.195442,0.804558,304,39,1757,1413,344,0.804212,0.195788,0.804212,305,39,1, merged,1,1,0
53980,1000023,1,1416,1241,175,0.876412,0.123588,0.876412,155,20,1417,1242,175,0.8765,0.1235,0.8765,155,20,1, merged,0,0,0
53980,1000109,2,648,556,92,0.858025,0.141975,1.734437,87,5,649,557,92,0.858243,0.141757,1.734743,87,5,1, merged,0,0,0
53982,1000023,1,1418,1243,175,0.876587,0.123413,0.876587,155,20,1419,1244,175,0.876674,0.123326,0.876674,155,20,1, merged,0,0,0
53986,1000014,1,2973,2421,552,0.814329,0.185671,0.814329,513,39,2975,2423,552,0.814454,0.185546,0.814454,513,39,-1, merged,0,0,0
53986,1000070,2,1439,1225,214,0.851286,0.148714,1.665615,186,28,1440,1226,214,0.851389,0.148611,1.665843,186,28,1, merged,0,0,0
53987,1000023,1,1420,1245,175,0.876761,0.123239,0.876761,155,20,1421,1246,175,0.876847,0.123153,0.876847,155,20,1, merged,0,0,0
53993,1000054,2,988,840,148,0.850202,0.149798,1.600202,132,16,989,841,148,0.850354,0.149646,1.619585,132,16,1, merged,0,0,0
53994,1000110,1,603,543,60,0.900498,0.099502,0.900498,55,5,604,543,61,0.899007,0.100993,0.899007,56,5,1, merged,1,1,0
53994,1000140,2,377,319,58,0.846154,0.153846,1.746651,50,8,378,320,58,0.846561,0.153439,1.745567,50,8,1, merged,0,0,0
54001,1000014,2,2978,2425,553,0.814305,0.185695,1.539305,514,39,2979,2426,553,0.814367,0.185633,1.540735,514,39,1, merged,0,0,0
54002,1000014,2,2979,2426,553,0.814367,0.185633,1.540735,514,39,2980,2427,553,0.81443,0.18557,1.542152,514,39,1, merged,0,0,0
54014,1000120,2,1993,1737,256,0.87155,0.12845,1.600364,225,31,1994,1738,256,0.871615,0.128385,1.596615,225,31,1, merged,0,0,0
54019,1000070,1,1442,1227,215,0.850902,0.149098,0.850902,187,28,1443,1227,216,0.850312,0.149688,0.850312,188,28,1, merged,1,1,0
54019,1000105,4,752,596,156,0.792553,0.207447,3.389189,139,17,754,596,158,0.790451,0.209549,3.387234,139,19,-1, merged,1,1,0
54019,1000110,2,605,544,61,0.899174,0.100826,1.750075,56,5,607,546,61,0.899506,0.100494,1.749818,56,5,-1, merged,0,0,0
54019,1000140,3,378,320,58,0.846561,0.153439,2.596636,50,8,379,321,58,0.846966,0.153034,2.596783,50,8,1, merged,0,0,0
54020,1000007,2,1757,1413,344,0.804212,0.195788,1.682261,305,39,1758,1414,344,0.804323,0.195677,1.664788,305,39,1, merged,0,0,0
54025,1000070,2,1443,1227,216,0.850312,0.149688,1.677518,188,28,1444,1228,216,0.850416,0.149584,1.677692,188,28,1, merged,0,0,0
54025,1000121,1,2448,2025,423,0.827206,0.172794,0.827206,393,30,2449,2026,423,0.827276,0.172724,0.827276,393,30,1, merged,0,0,0
54027,1000009,2,1716,1424,292,0.829837,0.170163,1.599068,261,31,1717,1425,292,0.829936,0.170064,1.61565,261,31,1, merged,0,0,0
54028,1000007,1,1758,1414,344,0.804323,0.195677,0.804323,305,39,1759,1414,345,0.803866,0.196134,0.803866,306,39,1, merged,1,1,0
54028,1000009,2,1717,1425,292,0.829936,0.170064,1.634259,261,31,1718,1426,292,0.830035,0.169965,1.633901,261,31,1, merged,0,0,0
54029,1000534,1,502,380,122,0.756972,0.243028,0.756972,110,12,503,381,122,0.757455,0.242545,0.757455,110,12,1, merged,0,0,0
54030,1000120,2,1994,1738,256,0.871615,0.128385,1.648439,225,31,1995,1739,256,0.871679,0.128321,1.649457,225,31,1, merged,0,0,0
54038,1000014,3,2982,2428,554,0.814219,0.185781,2.122587,515,39,2983,2428,555,0.813946,0.186054,2.093357,516,39,1, abandoned,1,1,0
54045,1000004,1,4272,3762,510,0.880618,0.119382,0.880618,406,104,4273,3763,510,0.880646,0.119354,0.880646,406,104,1, merged,0,0,0
54045,1000011,2,903,829,74,0.918051,0.081949,1.798669,69,5,904,830,74,0.918142,0.081858,1.798788,69,5,1, merged,0,0,0
54046,1000014,1,2983,2428,555,0.813946,0.186054,0.813946,516,39,2984,2428,556,0.813673,0.186327,0.813673,517,39,1, merged,1,1,0
54046,1000110,2,607,546,61,0.899506,0.100494,1.713451,56,5,608,547,61,0.899671,0.100329,1.713344,56,5,1, merged,0,0,0
54049,1000014,2,2984,2428,556,0.813673,0.186327,1.372496,517,39,2985,2429,556,0.813735,0.186265,1.369291,517,39,1, merged,0,0,0
54050,1000009,1,1718,1426,292,0.830035,0.169965,0.830035,261,31,1719,1427,292,0.830134,0.169866,0.830134,261,31,1, merged,0,0,0
54050,1000011,3,904,830,74,0.918142,0.081858,2.648828,69,5,905,831,74,0.918232,0.081768,2.649098,69,5,1, merged,0,0,0
54050,1000153,2,1228,1106,122,0.900651,0.099349,1.730686,90,32,1229,1107,122,0.900732,0.099268,1.730866,90,32,1, merged,0,0,0
54061,1000592,2,833,709,124,0.85114,0.14886,1.647257,77,47,834,710,124,0.851319,0.148681,1.649396,77,47,1, merged,0,0,0
54062,1000592,2,834,710,124,0.851319,0.148681,1.691319,77,47,835,711,124,0.851497,0.148503,1.703349,77,47,1, merged,0,0,0
54063,1000014,2,2985,2429,556,0.813735,0.186265,1.683792,517,39,2988,2431,557,0.813588,0.186412,1.681193,518,39,-1, merged,1,0,0
54064,1000132,1,755,639,116,0.846358,0.153642,0.846358,94,22,756,640,116,0.846561,0.153439,0.846561,94,22,1, merged,0,0,0
54066,1000014,2,2988,2431,557,0.813588,0.186412,1.369143,518,39,2989,2432,557,0.81365,0.18635,1.381218,518,39,1, merged,0,0,0
54067,1000014,2,2989,2432,557,0.81365,0.18635,1.381218,518,39,2990,2433,557,0.813712,0.186288,1.39266,518,39,1, merged,0,0,0
54068,1000014,2,2990,2433,557,0.813712,0.186288,1.39266,518,39,2991,2434,557,0.813775,0.186225,1.403518,518,39,1, merged,0,0,0
54069,1000014,2,2991,2434,557,0.813775,0.186225,1.403518,518,39,2992,2435,557,0.813837,0.186163,1.413837,518,39,1, merged,0,0,0
54072,1000004,1,4273,3763,510,0.880646,0.119354,0.880646,406,104,4275,3765,510,0.880702,0.119298,0.880702,406,104,-1, merged,0,0,0
54090,1000043,1,691,573,118,0.829233,0.170767,0.829233,104,14,692,574,118,0.82948,0.17052,0.82948,104,14,1, merged,0,0,0
54090,1000108,2,424,357,67,0.841981,0.158019,1.671214,62,5,425,358,67,0.842353,0.157647,1.671833,62,5,1, merged,0,0,0
54092,1000011,1,905,831,74,0.918232,0.081768,0.918232,69,5,906,832,74,0.918322,0.081678,0.918322,69,5,1, merged,0,0,0
54101,1000026,1,601,524,77,0.87188,0.12812,0.87188,74,3,603,524,79,0.868988,0.131012,0.868988,76,3,1, merged,1,1,0
54117,1000015,3,2313,2065,248,0.89278,0.10722,2.381957,226,22,2314,2065,249,0.892394,0.107606,2.383646,227,22,1, abandoned,1,1,0
54120,1000043,1,692,574,118,0.82948,0.17052,0.82948,104,14,694,575,119,0.82853,0.17147,0.82853,104,15,-1, merged,1,0,0
54120,1000110,2,608,547,61,0.899671,0.100329,1.729151,56,5,609,548,61,0.899836,0.100164,1.728366,56,5,1, merged,0,0,0
54128,1000105,2,754,596,158,0.790451,0.209549,1.579396,139,19,756,598,158,0.791005,0.208995,1.576005,139,19,-1, merged,0,0,0
54132,1000003,3,1408,1168,240,0.829545,0.170455,2.552271,207,33,1410,1170,240,0.829787,0.170213,2.550875,207,33,-1, merged,0,0,0
54132,1000009,2,1721,1429,292,0.830331,0.169669,1.722725,261,31,1722,1429,293,0.829849,0.170151,1.721088,262,31,1, merged,1,1,0
54132,1000015,1,2314,2065,249,0.892394,0.107606,0.892394,227,22,2317,2065,252,0.891239,0.108761,0.891239,230,22,1, merged,1,1,0
54138,1000026,1,603,524,79,0.868988,0.131012,0.868988,76,3,604,525,79,0.869205,0.130795,0.869205,76,3,1, merged,0,0,0
54139,1000015,1,2317,2065,252,0.891239,0.108761,0.891239,230,22,2318,2066,252,0.891286,0.108714,0.891286,230,22,1, merged,0,0,0
54141,1000108,1,426,359,67,0.842723,0.157277,0.842723,62,5,427,360,67,0.843091,0.156909,0.843091,62,5,-1, merged,0,0,0
54141,1000153,2,1230,1107,123,0.9,0.1,1.742723,90,33,1232,1109,123,0.900162,0.099838,1.743254,90,33,-1, merged,0,0,0
54146,1000026,1,604,525,79,0.869205,0.130795,0.869205,76,3,605,526,79,0.869421,0.130579,0.869421,76,3,1, merged,0,0,0
54146,1000153,2,1232,1109,123,0.900162,0.099838,1.769368,90,33,1233,1110,123,0.900243,0.099757,1.769665,90,33,1, merged,0,0,0
54147,1000026,1,605,526,79,0.869421,0.130579,0.869421,76,3,607,527,80,0.868204,0.131796,0.868204,77,3,1, merged,1,1,0
54147,1000153,2,1233,1110,123,0.900243,0.099757,1.769665,90,33,1235,1112,123,0.900405,0.099595,1.768609,90,33,-1, merged,0,0,0
54148,1000026,1,607,527,80,0.868204,0.131796,0.868204,77,3,609,528,81,0.866995,0.133005,0.866995,78,3,1, merged,1,1,0
54148,1000153,2,1235,1112,123,0.900405,0.099595,1.768609,90,33,1236,1113,123,0.900485,0.099515,1.767481,90,33,1, merged,0,0,0
54149,1000012,2,712,612,100,0.859551,0.140449,1.726546,97,3,713,613,100,0.859748,0.140252,1.727178,97,3,1, merged,0,0,0
54149,1000026,1,609,528,81,0.866995,0.133005,0.866995,78,3,611,530,81,0.86743,0.13257,0.86743,78,3,-1, merged,0,0,0
54150,1000014,1,2992,2435,557,0.813837,0.186163,0.813837,518,39,2994,2437,557,0.813961,0.186039,0.813961,518,39,-1, merged,0,0,0
54155,1000014,1,2994,2437,557,0.813961,0.186039,0.813961,518,39,2996,2438,558,0.813752,0.186248,0.813752,519,39,1, merged,1,1,0
54155,1000026,2,611,530,81,0.86743,0.13257,1.681392,78,3,612,531,81,0.867647,0.132353,1.681399,78,3,1, merged,0,0,0
54158,1000011,1,907,833,74,0.918412,0.081588,0.918412,69,5,908,834,74,0.918502,0.081498,0.918502,69,5,1, merged,0,0,0
54158,1000026,2,612,531,81,0.867647,0.132353,1.786059,78,3,613,532,81,0.867863,0.132137,1.786365,78,3,1, merged,0,0,0
54160,1000023,1,1425,1250,175,0.877193,0.122807,0.877193,155,20,1426,1251,175,0.877279,0.122721,0.877279,155,20,1, merged,0,0,0
54164,1000026,3,613,532,81,0.867863,0.132137,2.502876,78,3,615,534,81,0.868293,0.131707,2.500798,78,3,-1, merged,0,0,0
54164,1000109,1,649,557,92,0.858243,0.141757,0.858243,87,5,651,558,93,0.857143,0.142857,0.857143,88,5,1, merged,1,1,0
54164,1000199,4,564,482,82,0.85461,0.14539,3.357486,75,7,565,483,82,0.854867,0.145133,3.355665,75,7,1, merged,0,0,0
54167,1000054,3,989,841,148,0.850354,0.149646,2.26221,132,16,990,842,148,0.850505,0.149495,2.264553,132,16,1, merged,0,0,0
54167,1000166,1,497,374,123,0.752515,0.247485,0.752515,118,5,498,374,124,0.751004,0.248996,0.751004,119,5,1, merged,1,1,0
54170,1000009,1,1723,1430,293,0.829948,0.170052,0.829948,262,31,1724,1431,293,0.830046,0.169954,0.830046,262,31,1, merged,0,0,0
54170,1000534,2,503,381,122,0.757455,0.242545,1.587403,110,12,504,382,122,0.757937,0.242063,1.587983,110,12,1, merged,0,0,0
54178,1000009,2,1724,1431,293,0.830046,0.169954,1.689794,262,31,1725,1432,293,0.830145,0.169855,1.688688,262,31,1, merged,0,0,0
54178,1000012,1,713,613,100,0.859748,0.140252,0.859748,97,3,714,613,101,0.858543,0.141457,0.858543,98,3,1, merged,1,1,0
54181,1000109,2,651,558,93,0.857143,0.142857,1.703906,88,5,652,559,93,0.857362,0.142638,1.704328,88,5,1, merged,0,0,0
54181,1000132,1,757,641,116,0.846764,0.153236,0.846764,94,22,758,642,116,0.846966,0.153034,0.846966,94,22,1, merged,0,0,0
54188,1000012,1,716,615,101,0.858939,0.141061,0.858939,98,3,719,617,102,0.858136,0.141864,0.858136,99,3,1, merged,1,1,0
54190,1000109,2,652,559,93,0.857362,0.142638,1.712229,88,5,655,561,94,0.856489,0.143511,1.710619,89,5,-1, merged,1,0,0
54190,1000199,1,565,483,82,0.854867,0.145133,0.854867,75,7,569,486,83,0.85413,0.14587,0.85413,76,7,-1, merged,1,0,0
54191,1000054,2,990,842,148,0.850505,0.149495,1.601509,132,16,991,842,149,0.849647,0.150353,1.599146,133,16,1, abandoned,1,1,0
54191,1000166,1,498,374,124,0.751004,0.248996,0.751004,119,5,499,374,125,0.749499,0.250501,0.749499,120,5,1, abandoned,1,1,0
54196,1000004,4,4279,3769,510,0.880813,0.119187,3.182869,406,104,4281,3771,510,0.880869,0.119131,3.163152,406,104,-1, merged,0,0,0
54196,1000014,1,2996,2438,558,0.813752,0.186248,0.813752,519,39,2999,2440,559,0.813605,0.186395,0.813605,520,39,-1, merged,1,0,0
54205,1000012,2,719,617,102,0.858136,0.141864,1.712816,99,3,720,618,102,0.858333,0.141667,1.71337,99,3,-1, abandoned,0,0,0
54209,1000132,1,758,642,116,0.846966,0.153034,0.846966,94,22,759,643,116,0.847167,0.152833,0.847167,94,22,1, merged,0,0,0
54209,1000153,2,1236,1113,123,0.900485,0.099515,1.747451,90,33,1237,1114,123,0.900566,0.099434,1.747733,90,33,1, merged,0,0,0
54214,1000121,3,2451,2028,423,0.827417,0.172583,2.423909,393,30,2452,2029,423,0.827488,0.172512,2.401178,393,30,1, merged,0,0,0
54214,1000329,6,3498,2729,769,0.78016,0.21984,4.486075,657,112,3499,2730,769,0.780223,0.219777,4.469984,657,112,1, merged,0,0,0
54219,1000153,2,1237,1114,123,0.900566,0.099434,1.658502,90,33,1239,1116,123,0.900726,0.099274,1.660095,90,33,-1, abandoned,0,0,0
54219,1000534,1,504,382,122,0.757937,0.242063,0.757937,110,12,507,385,122,0.759369,0.240631,0.759369,110,12,-1, abandoned,0,0,0
54222,1000054,2,993,844,149,0.84995,0.15005,1.697117,133,16,994,844,150,0.849095,0.150905,1.694239,134,16,1, abandoned,1,1,0
54222,1000132,1,759,643,116,0.847167,0.152833,0.847167,94,22,762,644,118,0.845144,0.154856,0.845144,96,22,-1, abandoned,1,0,0
54226,1000014,1,3001,2442,559,0.813729,0.186271,0.813729,520,39,3002,2442,560,0.813458,0.186542,0.813458,521,39,1, merged,1,1,0
54229,1000007,4,1759,1414,345,0.803866,0.196134,3.010634,306,39,1761,1415,346,0.803521,0.196479,3.001255,307,39,-1, merged,1,0,0
54229,1000153,5,1239,1116,123,0.900726,0.099274,3.911361,90,33,1241,1117,124,0.900081,0.099919,3.901336,91,33,1, merged,1,1,0
54230,1000009,1,1725,1432,293,0.830145,0.169855,0.830145,262,31,1726,1433,293,0.830243,0.169757,0.830243,262,31,-1, merged,0,0,0
54230,1000534,2,507,385,122,0.759369,0.240631,1.589514,110,12,509,387,122,0.760314,0.239686,1.590558,110,12,-1, merged,0,0,0
54231,1000009,1,1726,1433,293,0.830243,0.169757,0.830243,262,31,1727,1434,293,0.830342,0.169658,0.830342,262,31,-1, merged,0,0,0
54231,1000534,2,509,387,122,0.760314,0.239686,1.590558,110,12,510,388,122,0.760784,0.239216,1.591126,110,12,1, merged,0,0,0
54255,1000105,5,757,599,158,0.791281,0.208719,3.911757,139,19,759,601,158,0.791831,0.208169,3.908546,139,19,-1, merged,0,0,0
54255,1000121,4,2453,2030,423,0.827558,0.172442,3.120476,393,30,2454,2031,423,0.827628,0.172372,3.116714,393,30,-1, merged,0,0,0
54255,1002169,1,761,603,158,0.792378,0.207622,0.792378,121,37,762,604,158,0.792651,0.207349,0.792651,121,37,-1, merged,0,0,0
54258,1000132,1,762,644,118,0.845144,0.154856,0.845144,96,22,764,646,118,0.84555,0.15445,0.84555,96,22,-1, merged,0,0,0
54259,1000007,2,1761,1415,346,0.803521,0.196479,1.584586,307,39,1763,1417,346,0.803744,0.196256,1.581521,307,39,-1, merged,0,0,0
54259,1000153,3,1243,1119,124,0.900241,0.099759,2.484827,91,33,1244,1120,124,0.900322,0.099678,2.481843,91,33,1, merged,0,0,0
54260,1000009,1,1729,1436,293,0.830538,0.169462,0.830538,262,31,1731,1437,294,0.830156,0.169844,0.830156,263,31,1, merged,1,1,0
54262,1000012,1,721,619,102,0.85853,0.14147,0.85853,99,3,722,620,102,0.858726,0.141274,0.858726,99,3,1, merged,0,0,0
54264,1000054,2,996,846,150,0.849398,0.150602,1.598897,134,16,998,847,151,0.848697,0.151303,1.596697,135,16,1, abandoned,1,1,0
54264,1000166,1,499,374,125,0.749499,0.250501,0.749499,120,5,500,374,126,0.748,0.252,0.748,121,5,1, abandoned,1,1,0
54274,1000009,2,1733,1438,295,0.829775,0.170225,1.64193,264,31,1734,1439,295,0.829873,0.170127,1.642545,264,31,1, merged,0,0,0
54277,1000054,1,998,847,151,0.848697,0.151303,0.848697,135,16,1001,849,152,0.848152,0.151848,0.848152,136,16,1, merged,1,1,0
54280,1000110,3,611,550,61,0.900164,0.099836,2.530735,56,5,612,551,61,0.900327,0.099673,2.528392,56,5,1, merged,0,0,0
54285,1000007,1,1763,1417,346,0.803744,0.196256,0.803744,307,39,1764,1418,346,0.803855,0.196145,0.803855,307,39,-1, merged,0,0,0
54285,1000011,2,908,834,74,0.918502,0.081498,1.722246,69,5,909,835,74,0.918592,0.081408,1.722447,69,5,1, merged,0,0,0
54285,1000153,3,1244,1120,124,0.900322,0.099678,2.622567,91,33,1245,1121,124,0.900402,0.099598,2.622848,91,33,1, merged,0,0,0
54291,1000005,2,743,631,112,0.84926,0.15074,1.676888,103,9,744,632,112,0.849462,0.150538,1.677161,103,9,1, merged,0,0,0
54291,1000121,1,2454,2031,423,0.827628,0.172372,0.827628,393,30,2455,2032,423,0.827699,0.172301,0.827699,393,30,-1, merged,0,0,0
54293,1000014,1,3004,2443,561,0.813249,0.186751,0.813249,522,39,3007,2445,562,0.813103,0.186897,0.813103,523,39,1, merged,1,1,0
54293,1000153,2,1245,1121,124,0.900402,0.099598,1.713651,91,33,1247,1123,124,0.900561,0.099439,1.713664,91,33,-1, merged,0,0,0
54294,1000015,1,2318,2066,252,0.891286,0.108714,0.891286,230,22,2319,2066,253,0.890901,0.109099,0.890901,231,22,1, abandoned,1,1,0
54294,1000153,4,1247,1123,124,0.900561,0.099439,3.124462,91,33,1248,1124,124,0.900641,0.099359,3.093681,91,33,-1, abandoned,0,0,0
54298,1000328,2,1050,780,270,0.742857,0.257143,1.535508,244,26,1051,781,270,0.743102,0.256898,1.536296,244,26,-1, abandoned,0,0,0
54298,1000534,3,510,388,122,0.760784,0.239216,2.296292,110,12,511,389,122,0.761252,0.238748,2.297548,110,12,-1, abandoned,0,0,0
54298,1002169,1,762,604,158,0.792651,0.207349,0.792651,121,37,764,606,158,0.793194,0.206806,0.793194,121,37,-1, abandoned,0,0,0
54303,1000105,2,759,601,158,0.791831,0.208169,1.637381,139,19,760,602,158,0.792105,0.207895,1.63655,139,19,-1, abandoned,0,0,0
54303,1000132,1,764,646,118,0.84555,0.15445,0.84555,96,22,765,646,119,0.844444,0.155556,0.844444,97,22,1, abandoned,1,1,0
54304,1000054,2,1006,854,152,0.848907,0.151093,1.697391,136,16,1007,855,152,0.849057,0.150943,1.693368,136,16,-1, merged,0,0,0
54310,1000070,1,1446,1230,216,0.850622,0.149378,0.850622,188,28,1447,1230,217,0.850035,0.149965,0.850035,189,28,1, abandoned,1,1,0
54313,1000132,2,765,646,119,0.844444,0.155556,1.657117,97,22,766,647,119,0.844648,0.155352,1.657834,97,22,1, merged,0,0,0
54313,1000153,3,1250,1126,124,0.9008,0.0992,2.557917,91,33,1251,1127,124,0.900879,0.099121,2.558714,91,33,1, merged,0,0,0
54314,1000007,1,1765,1419,346,0.803966,0.196034,0.803966,307,39,1766,1419,347,0.803511,0.196489,0.803511,308,39,1, merged,1,1,0
54314,1000015,2,2320,2067,253,0.890948,0.109052,1.694914,231,22,2321,2068,253,0.890995,0.109005,1.694506,231,22,1, merged,0,0,0
54315,1000120,2,2001,1745,256,0.872064,0.127936,1.773921,225,31,2002,1746,256,0.872128,0.127872,1.771864,225,31,1, merged,0,0,0
54321,1000007,1,1766,1419,347,0.803511,0.196489,0.803511,308,39,1767,1420,347,0.803622,0.196378,0.803622,308,39,1, merged,0,0,0
54321,1000054,2,1007,855,152,0.849057,0.150943,1.652567,136,16,1008,856,152,0.849206,0.150794,1.652828,136,16,1, merged,0,0,0
54333,1000121,2,2455,2032,423,0.827699,0.172301,1.607984,393,30,2456,2032,424,0.827362,0.172638,1.607424,394,30,1, merged,1,1,0
54333,1000329,1,3500,2731,769,0.780286,0.219714,0.780286,657,112,3501,2731,770,0.780063,0.219937,0.780063,658,112,1, merged,1,1,0
54333,1000592,4,837,713,124,0.851852,0.148148,3.316979,77,47,838,714,124,0.852029,0.147971,3.323089,77,47,1, merged,0,0,0
54337,1000199,2,569,486,83,0.85413,0.14587,1.629492,76,7,571,488,83,0.854641,0.145359,1.63041,76,7,-1, merged,0,0,0
54338,1000199,1,571,488,83,0.854641,0.145359,0.854641,76,7,573,489,84,0.853403,0.146597,0.853403,77,7,1, abandoned,1,1,0
54349,1000004,1,4286,3775,511,0.880775,0.119225,0.880775,407,104,4289,3777,512,0.880625,0.119375,0.880625,408,104,-1, merged,1,0,0
54349,1000329,3,3505,2733,772,0.779743,0.220257,2.357488,660,112,3507,2735,772,0.779869,0.220131,2.357075,660,112,-1, merged,0,0,0
54357,1000023,1,1431,1255,176,0.877009,0.122991,0.877009,156,20,1432,1256,176,0.877095,0.122905,0.877095,156,20,1, merged,0,0,0
54357,1000327,2,717,565,152,0.788006,0.211994,1.665015,118,34,718,566,152,0.788301,0.211699,1.665396,118,34,1, merged,0,0,0
54358,1000070,3,1447,1230,217,0.850035,0.149965,2.64214,189,28,1449,1231,218,0.849551,0.150449,2.641163,190,28,1, merged,1,1,0
54358,1000105,2,760,602,158,0.792105,0.207895,1.792105,139,19,763,604,159,0.791612,0.208388,1.791612,140,19,-1, merged,1,0,0
54359,1000005,2,748,636,112,0.850267,0.149733,1.677769,103,9,749,637,112,0.850467,0.149533,1.678039,103,9,1, merged,0,0,0
54359,1000121,1,2458,2034,424,0.827502,0.172498,0.827502,394,30,2459,2035,424,0.827572,0.172428,0.827572,394,30,1, merged,0,0,0
54364,1000023,2,1432,1256,176,0.877095,0.122905,1.670289,156,20,1433,1257,176,0.877181,0.122819,1.671183,156,20,-1, abandoned,0,0,0
54364,1002169,1,764,606,158,0.793194,0.206806,0.793194,121,37,767,609,158,0.794003,0.205997,0.794003,121,37,-1, abandoned,0,0,0
54367,1000070,2,1449,1231,218,0.849551,0.150449,1.720784,190,28,1450,1232,218,0.849655,0.150345,1.72124,190,28,1, merged,0,0,0
54376,1000004,1,4289,3777,512,0.880625,0.119375,0.880625,408,104,4293,3780,513,0.880503,0.119497,0.880503,409,104,-1, abandoned,1,0,0
54376,1000328,2,1055,785,270,0.744076,0.255924,1.624701,244,26,1058,785,273,0.741966,0.258034,1.622469,247,26,1, abandoned,1,1,0
54378,1000121,2,2460,2036,424,0.827642,0.172358,1.627108,394,30,2461,2037,424,0.827712,0.172288,1.628244,394,30,-1, abandoned,0,0,0
54383,1000014,1,3012,2448,564,0.812749,0.187251,0.812749,525,39,3014,2448,566,0.81221,0.18779,0.81221,527,39,1, merged,1,1,0
54386,1000023,1,1435,1259,176,0.877352,0.122648,0.877352,156,20,1436,1260,176,0.877437,0.122563,0.877437,156,20,1, merged,0,0,0
54387,1000327,1,718,566,152,0.788301,0.211699,0.788301,118,34,719,567,152,0.788595,0.211405,0.788595,118,34,1, merged,0,0,0
54399,1000592,2,842,718,124,0.852732,0.147268,1.660732,77,47,844,720,124,0.853081,0.146919,1.662604,77,47,-1, merged,0,0,0
54400,1000054,2,1008,856,152,0.849206,0.150794,1.685941,136,16,1009,857,152,0.849356,0.150644,1.686754,136,16,1, merged,0,0,0
54400,1000110,3,614,553,61,0.900651,0.099349,2.586593,56,5,615,554,61,0.900813,0.099187,2.587567,56,5,1, merged,0,0,0
54403,1000009,2,1736,1441,295,0.830069,0.169931,1.602796,264,31,1737,1442,295,0.830167,0.169833,1.607945,264,31,1, merged,0,0,0
54404,1000004,1,4293,3780,513,0.880503,0.119497,0.880503,409,104,4294,3780,514,0.880298,0.119702,0.880298,409,105,-1, merged,1,1,0
54404,1000329,2,3507,2735,772,0.779869,0.220131,1.660372,660,112,3508,2736,772,0.779932,0.220068,1.66023,660,112,1, merged,0,0,0
54407,1000004,1,4294,3780,514,0.880298,0.119702,0.880298,409,105,4295,3781,514,0.880326,0.119674,0.880326,409,105,1, merged,0,0,0
54407,1000153,3,1253,1129,124,0.901038,0.098962,2.645413,91,33,1254,1130,124,0.901116,0.098884,2.646827,91,33,1, merged,0,0,0
54410,1000120,2,2002,1746,256,0.872128,0.127872,1.737512,225,31,2003,1747,256,0.872192,0.127808,1.729335,225,31,-1, merged,0,0,0
54410,1000153,3,1254,1130,124,0.901116,0.098884,2.638629,91,33,1255,1131,124,0.901195,0.098805,2.63053,91,33,1, merged,0,0,0
54411,1000014,2,3016,2450,566,0.812334,0.187666,1.547628,527,39,3017,2451,566,0.812396,0.187604,1.555254,527,39,1, merged,0,0,0
54412,1000004,1,4295,3781,514,0.880326,0.119674,0.880326,409,105,4297,3781,516,0.879916,0.120084,0.879916,411,105,1, abandoned,1,1,0
54413,1000110,1,615,554,61,0.900813,0.099187,0.900813,56,5,616,555,61,0.900974,0.099026,0.900974,56,5,1, merged,0,0,0
54418,1000007,1,1767,1420,347,0.803622,0.196378,0.803622,308,39,1769,1421,348,0.803279,0.196721,0.803279,309,39,1, merged,1,1,0
54418,1000120,2,2003,1747,256,0.872192,0.127808,1.675814,225,31,2005,1749,256,0.872319,0.127681,1.675598,225,31,-1, merged,0,0,0
54418,1000534,3,512,390,122,0.761719,0.238281,2.437532,110,12,513,391,122,0.762183,0.237817,2.437781,110,12,1, merged,0,0,0
54419,1000014,2,3017,2451,566,0.812396,0.187604,1.531498,527,39,3019,2452,567,0.812189,0.187811,1.526475,528,39,1, merged,1,1,0
54424,1000043,1,695,576,119,0.828777,0.171223,0.828777,104,15,696,577,119,0.829023,0.170977,0.829023,104,15,1, merged,0,0,0
54424,1000070,2,1450,1232,218,0.849655,0.150345,1.678432,190,28,1451,1233,218,0.849759,0.150241,1.678782,190,28,1, merged,0,0,0
54425,1000004,1,4297,3781,516,0.879916,0.120084,0.879916,411,105,4298,3782,516,0.879944,0.120056,0.879944,411,105,-1, merged,0,0,0
54425,1000153,3,1255,1131,124,0.901195,0.098805,2.638254,91,33,1256,1132,124,0.901274,0.098726,2.639709,91,33,1, merged,0,0,0
54426,1000014,1,3019,2452,567,0.812189,0.187811,0.812189,528,39,3021,2453,568,0.811983,0.188017,0.811983,529,39,1, merged,1,1,0
54426,1000043,2,696,577,119,0.829023,0.170977,1.641212,104,15,697,578,119,0.829268,0.170732,1.641251,104,15,1, merged,0,0,0
54433,1000329,1,3510,2738,772,0.780057,0.219943,0.780057,660,112,3512,2739,773,0.779897,0.220103,0.779897,661,112,1, merged,1,1,0
54434,1000108,1,433,365,68,0.842956,0.157044,0.842956,63,5,434,366,68,0.843318,0.156682,0.843318,63,5,1, merged,0,0,0
54434,1000110,2,617,556,61,0.901135,0.098865,1.744091,56,5,618,557,61,0.901294,0.098706,1.744612,56,5,1, merged,0,0,0
54438,1000004,3,4298,3782,516,0.879944,0.120056,2.434784,411,105,4299,3783,516,0.879972,0.120028,2.442017,411,105,1, merged,0,0,0
54438,1000014,2,3021,2453,568,0.811983,0.188017,1.55484,529,39,3022,2454,568,0.812045,0.187955,1.562045,529,39,1, merged,0,0,0
54440,1000014,2,3022,2454,568,0.812045,0.187955,1.635667,529,39,3023,2455,568,0.812107,0.187893,1.633143,529,39,1, merged,0,0,0
54440,1000130,1,635,523,112,0.823622,0.176378,0.823622,84,28,637,523,114,0.821036,0.178964,0.821036,84,30,-1, merged,1,1,0
54441,1000014,2,3023,2455,568,0.812107,0.187893,1.633143,529,39,3024,2456,568,0.812169,0.187831,1.630636,529,39,1, merged,0,0,0
54441,1000130,1,637,523,114,0.821036,0.178964,0.821036,84,30,639,523,116,0.818466,0.181534,0.818466,84,32,-1, merged,1,1,0
54443,1000043,1,697,578,119,0.829268,0.170732,0.829268,104,15,698,579,119,0.829513,0.170487,0.829513,104,15,1, merged,0,0,0
54443,1000108,2,434,366,68,0.843318,0.156682,1.672586,63,5,435,367,68,0.843678,0.156322,1.673191,63,5,1, merged,0,0,0
54446,1000014,1,3024,2456,568,0.812169,0.187831,0.812169,529,39,3025,2457,568,0.812231,0.187769,0.812231,529,39,1, merged,0,0,0
54446,1000070,2,1451,1233,218,0.849759,0.150241,1.661928,190,28,1452,1234,218,0.849862,0.150138,1.662094,190,28,1, merged,0,0,0
54455,1000003,1,1419,1179,240,0.830867,0.169133,0.830867,207,33,1420,1180,240,0.830986,0.169014,0.830986,207,33,-1, merged,0,0,0
54455,1000012,2,722,620,102,0.858726,0.141274,1.689593,99,3,724,622,102,0.859116,0.140884,1.690102,99,3,1, merged,0,0,0
54457,1000328,1,1058,785,273,0.741966,0.258034,0.741966,247,26,1061,787,274,0.741753,0.258247,0.741753,247,27,1, merged,1,0,0
54457,1000329,2,3512,2739,773,0.779897,0.220103,1.521863,661,112,3513,2740,773,0.77996,0.22004,1.521713,661,112,1, merged,0,0,0
54460,1000014,2,3030,2460,570,0.811881,0.188119,1.526167,531,39,3031,2461,570,0.811943,0.188057,1.529335,531,39,1, merged,0,0,0
54462,1000003,3,1420,1180,240,0.830986,0.169014,2.487552,207,33,1422,1182,240,0.831224,0.168776,2.484037,207,33,-1, merged,0,0,0
54462,1000026,1,615,534,81,0.868293,0.131707,0.868293,78,3,617,535,82,0.867099,0.132901,0.867099,79,3,-1, merged,1,0,0
54467,1000014,1,3031,2461,570,0.811943,0.188057,0.811943,531,39,3032,2462,570,0.812005,0.187995,0.812005,531,39,1, merged,0,0,0
54467,1000592,3,845,720,125,0.852071,0.147929,2.522505,78,47,846,721,125,0.852246,0.147754,2.524064,78,47,1, merged,0,0,0
54468,1000130,1,639,523,116,0.818466,0.181534,0.818466,84,32,640,524,116,0.81875,0.18125,0.81875,84,32,-1, merged,0,0,0
54471,1000014,2,3034,2463,571,0.8118,0.1882,1.59176,532,39,3037,2464,573,0.811327,0.188673,1.591065,534,39,1, merged,1,1,0
54471,1000110,3,619,558,61,0.901454,0.098546,2.493214,56,5,621,560,61,0.901771,0.098229,2.492836,56,5,-1, merged,0,0,0
54471,1000140,4,384,326,58,0.848958,0.151042,3.342172,50,8,386,327,59,0.84715,0.15285,3.339987,51,8,1, merged,1,1,0
54471,1000329,1,3513,2740,773,0.77996,0.22004,0.77996,661,112,3514,2740,774,0.779738,0.220262,0.779738,662,112,1, merged,1,1,0
54480,1000070,1,1454,1236,218,0.850069,0.149931,0.850069,190,28,1455,1237,218,0.850172,0.149828,0.850172,190,28,1, merged,0,0,0
54480,1000105,2,764,605,159,0.791885,0.208115,1.641954,140,19,765,606,159,0.792157,0.207843,1.642329,140,19,1, merged,0,0,0
54481,1000070,2,1455,1237,218,0.850172,0.149828,1.719737,190,28,1456,1238,218,0.850275,0.149725,1.725275,190,28,1, merged,0,0,0
54483,1000592,2,847,722,125,0.85242,0.14758,1.296865,78,47,848,723,125,0.852594,0.147406,1.352594,78,47,1, merged,0,0,0
54484,1000026,2,617,535,82,0.867099,0.132901,1.631467,79,3,619,537,82,0.867528,0.132472,1.632795,79,3,-1, merged,0,0,0
54484,1000534,1,522,399,123,0.764368,0.235632,0.764368,111,12,524,401,123,0.765267,0.234733,0.765267,111,12,-1, merged,0,0,0
54490,1000329,2,3514,2740,774,0.779738,0.220262,1.607607,662,112,3515,2741,774,0.779801,0.220199,1.608372,662,112,1, merged,0,0,0
54495,1000014,2,3039,2465,574,0.811122,0.188878,1.584785,534,40,3041,2466,575,0.810917,0.189083,1.583275,535,40,1, merged,1,1,0
54498,1000014,1,3043,2467,576,0.810713,0.189287,0.810713,535,41,3044,2468,576,0.810775,0.189225,0.810775,535,41,1, merged,0,0,0
54498,1000121,2,2461,2037,424,0.827712,0.172288,1.638425,394,30,2462,2038,424,0.827782,0.172218,1.638558,394,30,1, merged,0,0,0
54500,1000003,2,1422,1182,240,0.831224,0.168776,1.699536,207,33,1426,1185,241,0.830996,0.169004,1.69575,208,33,-1, merged,1,0,0
54504,1000015,1,2325,2072,253,0.891183,0.108817,0.891183,231,22,2326,2073,253,0.89123,0.10877,0.89123,231,22,1, merged,0,0,0
54505,1000140,1,387,328,59,0.847545,0.152455,0.847545,51,8,389,330,59,0.848329,0.151671,0.848329,51,8,1, merged,0,0,0
54518,1000011,2,910,836,74,0.918681,0.081319,1.778494,69,5,911,837,74,0.918771,0.081229,1.779882,69,5,1, merged,0,0,0
54520,1000592,2,848,723,125,0.852594,0.147406,1.30714,78,47,849,724,125,0.852768,0.147232,1.352768,78,47,1, merged,0,0,0
54529,1000004,1,4306,3790,516,0.880167,0.119833,0.880167,411,105,4307,3791,516,0.880195,0.119805,0.880195,411,105,1, merged,0,0,0
54529,1000120,2,2005,1749,256,0.872319,0.127681,1.752486,225,31,2006,1750,256,0.872383,0.127617,1.752578,225,31,1, merged,0,0,0
54533,1000007,2,1770,1422,348,0.80339,0.19661,1.708582,309,39,1771,1423,348,0.803501,0.196499,1.708906,309,39,1, merged,0,0,0
54535,1000054,1,1022,865,157,0.84638,0.15362,0.84638,141,16,1023,866,157,0.84653,0.15347,0.84653,141,16,1, merged,0,0,0
54535,1000166,3,500,374,126,0.748,0.252,2.266021,121,5,501,375,126,0.748503,0.251497,2.271503,121,5,1, merged,0,0,0
54536,1000592,1,849,724,125,0.852768,0.147232,0.852768,78,47,850,725,125,0.852941,0.147059,0.852941,78,47,1, merged,0,0,0
54537,1000026,1,619,537,82,0.867528,0.132472,0.867528,79,3,620,538,82,0.867742,0.132258,0.867742,79,3,1, merged,0,0,0
54538,1000003,1,1426,1185,241,0.830996,0.169004,0.830996,208,33,1427,1186,241,0.831114,0.168886,0.831114,208,33,-1, merged,0,0,0
54539,1000026,1,620,538,82,0.867742,0.132258,0.867742,79,3,621,539,82,0.867955,0.132045,0.867955,79,3,1, merged,0,0,0
54542,1000007,2,1771,1423,348,0.803501,0.196499,1.569215,309,39,1772,1424,348,0.803612,0.196388,1.570215,309,39,1, merged,0,0,0
54542,1000534,1,525,402,123,0.765714,0.234286,0.765714,111,12,527,404,123,0.766603,0.233397,0.766603,111,12,-1, merged,0,0,0
54544,1000140,1,389,330,59,0.848329,0.151671,0.848329,51,8,390,330,60,0.846154,0.153846,0.846154,52,8,1, abandoned,1,1,0
54544,1000328,2,1062,788,274,0.741996,0.258004,1.590325,247,27,1063,789,274,0.742239,0.257761,1.588393,247,27,-1, abandoned,0,0,0
54546,1000054,1,1023,866,157,0.84653,0.15347,0.84653,141,16,1024,867,157,0.84668,0.15332,0.84668,141,16,1, merged,0,0,0
54546,1000166,2,501,375,126,0.748503,0.251497,1.595033,121,5,502,376,126,0.749004,0.250996,1.595684,121,5,1, merged,0,0,0
54556,1000015,1,2327,2074,253,0.891276,0.108724,0.891276,231,22,2328,2075,253,0.891323,0.108677,0.891323,231,22,1, merged,0,0,0
54557,1000023,2,1440,1264,176,0.877778,0.122222,1.727053,156,20,1441,1265,176,0.877863,0.122137,1.727574,156,20,1, merged,0,0,0
54561,1000014,2,3050,2474,576,0.811148,0.188852,1.557626,535,41,3051,2475,576,0.811209,0.188791,1.558704,535,41,1, merged,0,0,0
54562,1000130,1,641,525,116,0.819033,0.180967,0.819033,84,32,642,526,116,0.819315,0.180685,0.819315,84,32,-1, merged,0,0,0
54562,1000140,2,391,331,60,0.846547,0.153453,1.66558,52,8,393,333,60,0.847328,0.152672,1.666643,52,8,-1, merged,0,0,0
54571,1000014,1,3051,2475,576,0.811209,0.188791,0.811209,535,41,3052,2476,576,0.811271,0.188729,0.811271,535,41,-1, merged,0,0,0
54571,1000070,2,1456,1238,218,0.850275,0.149725,1.661484,190,28,1457,1239,218,0.850377,0.149623,1.661649,190,28,1, merged,0,0,0
54574,1000110,1,623,562,61,0.902087,0.097913,0.902087,56,5,624,563,61,0.902244,0.097756,0.902244,56,5,1, merged,0,0,0
54583,1000003,2,1428,1187,241,0.831232,0.168768,1.616598,208,33,1430,1189,241,0.831469,0.168531,1.613022,208,33,-1, merged,0,0,0
54586,1000199,2,573,489,84,0.853403,0.146597,1.62998,77,7,574,490,84,0.853659,0.146341,1.630637,77,7,1, merged,0,0,0
54599,1000108,2,437,369,68,0.844394,0.155606,1.746637,63,5,438,369,69,0.842466,0.157534,1.745022,64,5,1, merged,1,1,0
54599,1000110,1,624,563,61,0.902244,0.097756,0.902244,56,5,626,565,61,0.902556,0.097444,0.902556,56,5,-1, merged,0,0,0
54604,1000014,1,3056,2479,577,0.811191,0.188809,0.811191,536,41,3058,2481,577,0.811315,0.188685,0.811315,536,41,1, merged,0,0,0
54606,1000054,1,1027,869,158,0.846154,0.153846,0.846154,142,16,1029,871,158,0.846453,0.153547,0.846453,142,16,-1, merged,0,0,0
54606,1000130,2,643,527,116,0.819596,0.180404,1.665749,84,32,644,528,116,0.819876,0.180124,1.666329,84,32,1, merged,0,0,0
54609,1000592,2,850,725,125,0.852941,0.147059,1.663965,78,47,851,726,125,0.853114,0.146886,1.651564,78,47,-1, abandoned,0,0,0
54610,1000014,1,3058,2481,577,0.811315,0.188685,0.811315,536,41,3059,2482,577,0.811376,0.188624,0.811376,536,41,1, merged,0,0,0
54611,1000014,3,3059,2482,577,0.811376,0.188624,2.137411,536,41,3061,2484,577,0.8115,0.1885,2.129114,536,41,-1, merged,0,0,0
54612,1000012,1,726,624,102,0.859504,0.140496,0.859504,99,3,727,625,102,0.859697,0.140303,0.859697,99,3,1, merged,0,0,0
54617,1000023,1,1442,1266,176,0.877947,0.122053,0.877947,156,20,1443,1267,176,0.878032,0.121968,0.878032,156,20,1, merged,0,0,0
54617,1000153,2,1257,1133,124,0.901352,0.098648,1.7793,91,33,1258,1134,124,0.901431,0.098569,1.779463,91,33,1, merged,0,0,0
54618,1000120,3,2008,1752,256,0.87251,0.12749,2.358752,225,31,2009,1753,256,0.872573,0.127427,2.362363,225,31,1, merged,0,0,0
54623,1000023,1,1443,1267,176,0.878032,0.121968,0.878032,156,20,1444,1267,177,0.877424,0.122576,0.877424,157,20,1, merged,1,1,0
54623,1000132,2,767,648,119,0.84485,0.15515,1.722882,97,22,769,649,120,0.843953,0.156047,1.721377,98,22,1, merged,1,1,0
54626,1000054,2,1029,871,158,0.846453,0.153547,1.595956,142,16,1030,871,159,0.845631,0.154369,1.593647,143,16,1, abandoned,1,1,0
54626,1000166,1,503,377,126,0.749503,0.250497,0.749503,121,5,504,377,127,0.748016,0.251984,0.748016,122,5,1, abandoned,1,1,0
54628,1000015,1,2332,2079,253,0.891509,0.108491,0.891509,231,22,2334,2080,254,0.891174,0.108826,0.891174,232,22,1, merged,1,1,0
54628,1000054,2,1030,871,159,0.845631,0.154369,1.737141,143,16,1032,873,159,0.84593,0.15407,1.737104,143,16,-1, merged,0,0,0
54635,1000004,1,4311,3795,516,0.880306,0.119694,0.880306,411,105,4312,3795,517,0.880102,0.119898,0.880102,412,105,1, merged,1,1,0
54635,1000329,2,3516,2742,774,0.779863,0.220137,1.66017,662,112,3517,2743,774,0.779926,0.220074,1.660028,662,112,1, merged,0,0,0
54636,1000004,1,4312,3795,517,0.880102,0.119898,0.880102,412,105,4313,3795,518,0.879898,0.120102,0.879898,412,106,-1, merged,1,1,0
54636,1000043,2,702,583,119,0.830484,0.169516,1.710586,104,15,703,583,120,0.829303,0.170697,1.709201,104,16,-1, merged,1,1,0
54644,1000023,2,1444,1267,177,0.877424,0.122576,1.739084,157,20,1445,1268,177,0.877509,0.122491,1.739713,157,20,1, merged,0,0,0
54645,1000003,3,1439,1197,242,0.831828,0.168172,2.694032,209,33,1440,1198,242,0.831944,0.168056,2.69469,209,33,1, merged,0,0,0
54645,1000109,4,655,561,94,0.856489,0.143511,3.550521,89,5,656,562,94,0.856707,0.143293,3.551397,89,5,1, merged,0,0,0
54651,1000108,2,438,369,69,0.842466,0.157534,1.745177,64,5,439,370,69,0.842825,0.157175,1.745691,64,5,1, merged,0,0,0
54651,1000110,1,627,566,61,0.902711,0.097289,0.902711,56,5,628,567,61,0.902866,0.097134,0.902866,56,5,1, merged,0,0,0
54656,1000108,1,441,372,69,0.843537,0.156463,0.843537,64,5,444,374,70,0.842342,0.157658,0.842342,65,5,-1, merged,1,0,0
54656,1000110,3,629,568,61,0.903021,0.096979,2.585916,56,5,630,569,61,0.903175,0.096825,2.585517,56,5,-1, merged,0,0,0
54663,1000110,2,630,569,61,0.903175,0.096825,1.623175,56,5,631,570,61,0.903328,0.096672,1.617614,56,5,-1, abandoned,0,0,0
54663,1000140,3,394,334,60,0.847716,0.152284,2.47089,52,8,397,337,60,0.848866,0.151134,2.46648,52,8,-1, abandoned,0,0,0
54669,1000054,1,1034,875,159,0.846228,0.153772,0.846228,143,16,1035,876,159,0.846377,0.153623,0.846377,143,16,1, merged,0,0,0
54673,1000199,2,576,492,84,0.854167,0.145833,1.631545,77,7,578,494,84,0.854671,0.145329,1.631457,77,7,-1, merged,0,0,0
54682,1000130,2,644,528,116,0.819876,0.180124,1.398823,84,32,646,530,116,0.820433,0.179567,1.395433,84,32,1, merged,0,0,0
54682,1000329,3,3518,2743,775,0.779704,0.220296,2.178528,663,112,3519,2744,775,0.779767,0.220233,2.1752,663,112,1, merged,0,0,0
54683,1000014,1,3061,2484,577,0.8115,0.1885,0.8115,536,41,3062,2485,577,0.811561,0.188439,0.811561,536,41,1, merged,0,0,0
54683,1000043,3,707,586,121,0.828854,0.171146,2.4751,105,16,708,587,121,0.829096,0.170904,2.4761,105,16,1, merged,0,0,0
54684,1000328,1,1063,789,274,0.742239,0.257761,0.742239,247,27,1064,790,274,0.742481,0.257519,0.742481,247,27,1, merged,0,0,0
54684,1000329,2,3519,2744,775,0.779767,0.220233,1.522006,663,112,3520,2745,775,0.77983,0.22017,1.522311,663,112,1, merged,0,0,0
54695,1000012,1,730,628,102,0.860274,0.139726,0.860274,99,3,731,628,103,0.859097,0.140903,0.859097,100,3,1, merged,1,1,0
54697,1000130,1,646,530,116,0.820433,0.179567,0.820433,84,32,649,532,117,0.819723,0.180277,0.819723,85,32,1, merged,1,1,0
54698,1000023,1,1449,1272,177,0.877847,0.122153,0.877847,157,20,1451,1273,178,0.877326,0.122674,0.877326,158,20,1, merged,1,1,0
54700,1000329,2,3520,2745,775,0.77983,0.22017,1.351258,663,112,3522,2746,776,0.779671,0.220329,1.325125,663,113,-1, merged,1,1,0
54706,1000108,1,446,376,70,0.843049,0.156951,0.843049,65,5,447,377,70,0.8434,0.1566,0.8434,65,5,1, merged,0,0,0
54706,1000110,2,631,570,61,0.903328,0.096672,1.746377,56,5,632,571,61,0.903481,0.096519,1.746881,56,5,1, merged,0,0,0
54709,1000012,2,731,628,103,0.859097,0.140903,1.714489,100,3,733,629,104,0.858117,0.141883,1.713863,101,3,1, merged,1,1,0
54709,1000014,3,3064,2487,577,0.811684,0.188316,2.526173,536,41,3065,2488,577,0.811746,0.188254,2.525609,536,41,1, merged,0,0,0
54711,1000130,2,649,532,117,0.819723,0.180277,1.614594,85,32,650,533,117,0.82,0.18,1.615276,85,32,1, merged,0,0,0
54713,1000023,2,1452,1274,178,0.87741,0.12259,1.741224,158,20,1453,1275,178,0.877495,0.122505,1.741836,158,20,1, merged,0,0,0
54716,1000003,1,1440,1198,242,0.831944,0.168056,0.831944,209,33,1442,1200,242,0.832178,0.167822,0.832178,209,33,1, merged,0,0,0
54716,1000329,2,3522,2746,776,0.779671,0.220329,1.611615,663,113,3523,2747,776,0.779733,0.220267,1.611911,663,113,1, merged,0,0,0
54718,1000009,1,1744,1448,296,0.830275,0.169725,0.830275,265,31,1745,1449,296,0.830372,0.169628,0.830372,265,31,-1, abandoned,0,0,0
54718,1000534,3,527,404,123,0.766603,0.233397,2.166109,111,12,528,405,123,0.767045,0.232955,2.164582,111,12,-1, abandoned,0,0,0
54719,1000003,1,1442,1200,242,0.832178,0.167822,0.832178,209,33,1443,1201,242,0.832294,0.167706,0.832294,209,33,1, merged,0,0,0
54719,1000153,2,1259,1135,124,0.901509,0.098491,1.733687,91,33,1260,1136,124,0.901587,0.098413,1.733881,91,33,1, merged,0,0,0
54725,1000054,1,1035,876,159,0.846377,0.153623,0.846377,143,16,1036,877,159,0.846525,0.153475,0.846525,143,16,1, merged,0,0,0
54732,1000023,1,1453,1275,178,0.877495,0.122505,0.877495,158,20,1454,1276,178,0.877579,0.122421,0.877579,158,20,1, merged,0,0,0
54748,1000003,1,1443,1201,242,0.832294,0.167706,0.832294,209,33,1445,1202,243,0.831834,0.168166,0.831834,210,33,1, abandoned,1,1,0
54748,1000329,2,3523,2747,776,0.779733,0.220267,1.612027,663,113,3524,2748,776,0.779796,0.220204,1.61163,663,113,-1, abandoned,0,0,0
54751,1000003,2,1445,1202,243,0.831834,0.168166,1.688759,210,33,1446,1203,243,0.83195,0.16805,1.687792,210,33,1, merged,0,0,0
54751,1000109,1,657,563,94,0.856925,0.143075,0.856925,89,5,659,564,95,0.855842,0.144158,0.855842,90,5,1, merged,1,1,0
54764,1000014,1,3065,2488,577,0.811746,0.188254,0.811746,536,41,3068,2491,577,0.81193,0.18807,0.81193,536,41,-1, merged,0,0,0
54764,1000121,2,2467,2043,424,0.828131,0.171869,1.639877,394,30,2468,2044,424,0.828201,0.171799,1.640131,394,30,1, merged,0,0,0
54766,1000003,2,1447,1203,244,0.831375,0.168625,1.686047,210,34,1448,1204,244,0.831492,0.168508,1.68494,210,34,1, merged,0,0,0
54766,1000109,3,659,564,95,0.855842,0.144158,2.541889,90,5,660,565,95,0.856061,0.143939,2.541001,90,5,1, merged,0,0,0
54766,1000199,1,578,494,84,0.854671,0.145329,0.854671,77,7,580,495,85,0.853448,0.146552,0.853448,78,7,1, merged,1,1,0
54767,1000108,1,448,378,70,0.84375,0.15625,0.84375,65,5,449,379,70,0.844098,0.155902,0.844098,65,5,-1, merged,0,0,0
54767,1000140,2,397,337,60,0.848866,0.151134,1.692616,52,8,398,338,60,0.849246,0.150754,1.693344,52,8,1, merged,0,0,0
54769,1000534,1,530,406,124,0.766038,0.233962,0.766038,112,12,533,408,125,0.765478,0.234522,0.765478,113,12,-1, merged,1,0,0
54780,1000009,3,1746,1450,296,0.83047,0.16953,2.095948,265,31,1747,1451,296,0.830567,0.169433,2.167913,265,31,-1, abandoned,0,0,0
54780,1000534,2,533,408,125,0.765478,0.234522,1.265478,113,12,534,409,125,0.765918,0.234082,1.337346,113,12,-1, abandoned,0,0,0
54789,1000108,2,450,380,70,0.844444,0.155556,1.62584,65,5,451,381,70,0.844789,0.155211,1.628199,65,5,1, merged,0,0,0
54794,1000329,1,3524,2748,776,0.779796,0.220204,0.779796,663,113,3525,2749,776,0.779858,0.220142,0.779858,663,113,1, merged,0,0,0
54799,1000110,2,634,573,61,0.903785,0.096215,1.75416,56,5,635,574,61,0.903937,0.096063,1.754683,56,5,1, merged,0,0,0
54799,1000140,1,401,341,60,0.850374,0.149626,0.850374,52,8,402,342,60,0.850746,0.149254,0.850746,52,8,-1, merged,0,0,0
54800,1000105,3,768,608,160,0.791667,0.208333,2.365527,141,19,769,609,160,0.791938,0.208062,2.366129,141,19,1, merged,0,0,0
54800,1000329,2,3525,2749,776,0.779858,0.220142,1.573861,663,113,3526,2750,776,0.779921,0.220079,1.574191,663,113,1, merged,0,0,0
54800,1002169,1,767,609,158,0.794003,0.205997,0.794003,121,37,768,610,158,0.794271,0.205729,0.794271,121,37,-1, merged,0,0,0
54803,1000004,1,4318,3800,518,0.880037,0.119963,0.880037,412,106,4319,3801,518,0.880065,0.119935,0.880065,412,106,1, merged,0,0,0
54803,1000120,2,2012,1756,256,0.872763,0.127237,1.7528,225,31,2013,1757,256,0.872827,0.127173,1.752891,225,31,1, merged,0,0,0
54806,1000023,1,1456,1278,178,0.877747,0.122253,0.877747,158,20,1457,1279,178,0.877831,0.122169,0.877831,158,20,-1, abandoned,0,0,0
54806,1000109,2,660,565,95,0.856061,0.143939,1.733808,90,5,661,565,96,0.854766,0.145234,1.732597,91,5,1, abandoned,1,1,0
54809,1000199,2,580,495,85,0.853448,0.146552,1.630234,78,7,581,495,86,0.851979,0.148021,1.625831,79,7,1, merged,1,1,0
54816,1000070,2,1462,1243,219,0.850205,0.149795,1.696895,191,28,1463,1243,220,0.849624,0.150376,1.693374,192,28,1, abandoned,1,1,0
54816,1000130,5,651,534,117,0.820276,0.179724,4.123831,85,32,652,534,118,0.819018,0.180982,4.108865,86,32,1, abandoned,1,1,0
54820,1000130,2,652,534,118,0.819018,0.180982,1.611175,86,32,654,536,118,0.819572,0.180428,1.612135,86,32,-1, merged,0,0,0
54822,1000054,1,1045,884,161,0.845933,0.154067,0.845933,145,16,1046,885,161,0.84608,0.15392,0.84608,145,16,1, merged,0,0,0
54826,1000534,1,534,409,125,0.765918,0.234082,0.765918,113,12,536,410,126,0.764925,0.235075,0.764925,114,12,-1, merged,1,0,0
54827,1000004,1,4322,3803,519,0.879917,0.120083,0.879917,412,107,4326,3805,521,0.879565,0.120435,0.879565,414,107,-1, merged,1,0,0
54827,1000023,2,1460,1281,179,0.877397,0.122603,1.757314,159,20,1466,1284,182,0.875853,0.124147,1.755418,162,20,-1, merged,1,0,0
54827,1000130,4,654,536,118,0.819572,0.180428,3.437148,86,32,655,536,119,0.818321,0.181679,3.432434,87,32,1, merged,1,1,0
54836,1000004,2,4326,3805,521,0.879565,0.120435,1.723721,414,107,4328,3807,521,0.879621,0.120379,1.722682,414,107,-1, merged,0,0,0
54836,1000132,1,770,650,120,0.844156,0.155844,0.844156,98,22,771,650,121,0.843061,0.156939,0.843061,99,22,1, merged,1,1,0
54838,1000003,1,1450,1205,245,0.831034,0.168966,0.831034,211,34,1451,1206,245,0.831151,0.168849,0.831151,211,34,-1, merged,0,0,0
54838,1000014,2,3068,2491,577,0.81193,0.18807,1.642964,536,41,3070,2491,579,0.811401,0.188599,1.642552,538,41,1, merged,1,1,0
54839,1000054,2,1046,885,161,0.84608,0.15392,1.509124,145,16,1047,886,161,0.846227,0.153773,1.505802,145,16,1, merged,0,0,0
54846,1000004,1,4328,3807,521,0.879621,0.120379,0.879621,414,107,4330,3809,521,0.879677,0.120323,0.879677,414,107,-1, merged,0,0,0
54861,1000120,1,2024,1766,258,0.87253,0.12747,0.87253,227,31,2025,1767,258,0.872593,0.127407,0.872593,227,31,1, merged,0,0,0
54870,1000110,2,636,575,61,0.904088,0.095912,1.753471,56,5,638,576,62,0.902821,0.097179,1.750112,57,5,1, merged,1,1,0
54870,1000140,1,405,344,61,0.849383,0.150617,0.849383,53,8,406,344,62,0.847291,0.152709,0.847291,54,8,1, merged,1,1,0
54872,1000130,1,656,537,119,0.818598,0.181402,0.818598,87,32,658,539,119,0.819149,0.180851,0.819149,87,32,-1, merged,0,0,0
54872,1000132,2,774,652,122,0.842377,0.157623,1.660975,100,22,775,653,122,0.842581,0.157419,1.66173,100,22,1, merged,0,0,0
54877,1000110,1,640,578,62,0.903125,0.096875,0.903125,57,5,642,580,62,0.903427,0.096573,0.903427,57,5,-1, merged,0,0,0
54883,1000009,1,1747,1451,296,0.830567,0.169433,0.830567,265,31,1748,1451,297,0.830092,0.169908,0.830092,266,31,1, abandoned,1,1,0
54886,1000004,2,4330,3809,521,0.879677,0.120323,1.77099,414,107,4331,3810,521,0.879704,0.120296,1.770637,414,107,1, merged,0,0,0
54886,1000015,1,2337,2083,254,0.891314,0.108686,0.891314,232,22,2338,2083,255,0.890932,0.109068,0.890932,233,22,1, merged,1,1,0
54893,1000009,2,1748,1451,297,0.830092,0.169908,1.698046,266,31,1749,1452,297,0.830189,0.169811,1.698356,266,31,1, merged,0,0,0
54893,1000026,1,621,539,82,0.867955,0.132045,0.867955,79,3,622,540,82,0.868167,0.131833,0.868167,79,3,1, merged,0,0,0
54898,1000023,2,1466,1284,182,0.875853,0.124147,1.732743,162,20,1467,1285,182,0.875937,0.124063,1.73308,162,20,-1, abandoned,0,0,0
54913,1000054,2,1047,886,161,0.846227,0.153773,1.527387,145,16,1048,887,161,0.846374,0.153626,1.532088,145,16,1, merged,0,0,0
54914,1000054,2,1048,887,161,0.846374,0.153626,1.658874,145,16,1049,888,161,0.84652,0.15348,1.67005,145,16,1, merged,0,0,0
54916,1000007,1,1772,1424,348,0.803612,0.196388,0.803612,309,39,1774,1425,349,0.803269,0.196731,0.803269,310,39,1, merged,1,1,0
54916,1000009,2,1749,1452,297,0.830189,0.169811,1.6338,266,31,1750,1452,298,0.829714,0.170286,1.632984,267,31,1, merged,1,1,0
54919,1000026,3,622,540,82,0.868167,0.131833,2.28177,79,3,624,541,83,0.866987,0.133013,2.26465,80,3,-1, merged,1,0,0
54919,1000534,1,544,417,127,0.766544,0.233456,0.766544,115,12,550,423,127,0.769091,0.230909,0.769091,115,12,-1, merged,0,0,0
54937,1000005,2,754,642,112,0.851459,0.148541,1.66286,103,9,755,643,112,0.851656,0.148344,1.663118,103,9,1, merged,0,0,0
54937,1000014,1,3070,2491,579,0.811401,0.188599,0.811401,538,41,3071,2492,579,0.811462,0.188538,0.811462,538,41,1, merged,0,0,0
54938,1000328,2,1066,792,274,0.742964,0.257036,1.546114,247,27,1067,793,274,0.743205,0.256795,1.54687,247,27,1, merged,0,0,0
54939,1000091,4,661,524,137,0.792738,0.207262,3.179269,115,22,662,525,137,0.793051,0.206949,3.178045,115,22,1, merged,0,0,0
54939,1000121,5,2471,2046,425,0.828005,0.171995,4.007274,395,30,2472,2047,425,0.828074,0.171926,4.00612,395,30,1, merged,0,0,0
54939,1000327,3,719,567,152,0.788595,0.211405,2.386531,118,34,720,568,152,0.788889,0.211111,2.384994,118,34,1, merged,0,0,0
54939,1002169,2,768,610,158,0.794271,0.205729,1.597936,121,37,769,611,158,0.794538,0.205462,1.596105,121,37,-1, merged,0,0,0
54940,1000091,4,662,525,137,0.793051,0.206949,3.204553,115,22,663,526,137,0.793363,0.206637,3.205494,115,22,1, merged,0,0,0
54940,1000121,3,2472,2047,425,0.828074,0.171926,2.411502,395,30,2473,2048,425,0.828144,0.171856,2.412131,395,30,1, merged,0,0,0
54940,1000327,2,720,568,152,0.788889,0.211111,1.583427,118,34,721,569,152,0.789182,0.210818,1.583987,118,34,1, merged,0,0,0
54940,1002169,1,769,611,158,0.794538,0.205462,0.794538,121,37,770,612,158,0.794805,0.205195,0.794805,121,37,-1, merged,0,0,0
54941,1000121,4,2473,2048,425,0.828144,0.171856,3.167721,395,30,2475,2050,425,0.828283,0.171717,3.166279,395,30,-1, merged,0,0,0
54941,1000328,3,1067,793,274,0.743205,0.256795,2.339577,247,27,1068,794,274,0.743446,0.256554,2.337996,247,27,-1, merged,0,0,0
54941,1002169,2,770,612,158,0.794805,0.205195,1.596372,121,37,771,613,158,0.795071,0.204929,1.594551,121,37,-1, merged,0,0,0
54942,1000121,3,2475,2050,425,0.828283,0.171717,2.422833,395,30,2476,2051,425,0.828352,0.171648,2.421092,395,30,1, merged,0,0,0
54942,1002169,2,771,613,158,0.795071,0.204929,1.594551,121,37,772,614,158,0.795337,0.204663,1.592739,121,37,-1, merged,0,0,0
54943,1000329,2,3528,2752,776,0.780045,0.219955,1.575382,663,113,3529,2753,776,0.780108,0.219892,1.575709,663,113,-1, merged,0,0,0
54943,1002169,1,772,614,158,0.795337,0.204663,0.795337,121,37,773,615,158,0.795602,0.204398,0.795602,121,37,-1, merged,0,0,0
54944,1000329,2,3529,2753,776,0.780108,0.219892,1.325562,663,113,3531,2755,776,0.780232,0.219768,1.313566,663,113,-1, merged,0,0,0
54947,1000004,2,4333,3811,522,0.879529,0.120471,1.764775,414,108,4335,3813,522,0.879585,0.120415,1.750553,414,108,1, merged,0,0,0
54949,1000091,2,663,526,137,0.793363,0.206637,1.621716,115,22,664,527,137,0.793675,0.206325,1.622096,115,22,1, merged,0,0,0
54949,1000121,1,2476,2051,425,0.828352,0.171648,0.828352,395,30,2477,2052,425,0.828421,0.171579,0.828421,395,30,1, merged,0,0,0
54950,1000327,2,721,569,152,0.789182,0.210818,1.61061,118,34,723,570,153,0.788382,0.211618,1.581485,118,35,-1, merged,1,1,0
54969,1000004,4,4336,3814,522,0.879613,0.120387,3.433394,414,108,4339,3816,523,0.879465,0.120535,3.43117,415,108,-1, merged,1,0,0
54969,1000023,1,1467,1285,182,0.875937,0.124063,0.875937,162,20,1470,1286,184,0.87483,0.12517,0.87483,164,20,1, merged,1,1,0
54969,1000130,3,658,539,119,0.819149,0.180851,2.553782,87,32,659,540,119,0.819423,0.180577,2.551705,87,32,-1, merged,0,0,0
54970,1000014,1,3071,2492,579,0.811462,0.188538,0.811462,538,41,3072,2493,579,0.811523,0.188477,0.811523,538,41,1, merged,0,0,0
54971,1000108,1,454,384,70,0.845815,0.154185,0.845815,65,5,455,385,70,0.846154,0.153846,0.846154,65,5,-1, merged,0,0,0
54971,1000110,2,642,580,62,0.903427,0.096573,1.749242,57,5,645,582,63,0.902326,0.097674,1.748479,58,5,1, merged,1,1,0
54983,1000014,2,3072,2493,579,0.811523,0.188477,1.607389,538,41,3076,2495,581,0.811118,0.188882,1.60751,540,41,-1, merged,1,0,0
54983,1002169,1,774,616,158,0.795866,0.204134,0.795866,121,37,776,618,158,0.796392,0.203608,0.796392,121,37,-1, merged,0,0,0
54996,1000023,1,1481,1293,188,0.873059,0.126941,0.873059,168,20,1482,1294,188,0.873144,0.126856,0.873144,168,20,1, merged,0,0,0
54996,1000140,2,407,345,62,0.847666,0.152334,1.720725,54,8,408,346,62,0.848039,0.151961,1.721184,54,8,1, merged,0,0,0
55002,1000327,2,723,570,153,0.788382,0.211618,1.581485,118,35,724,571,153,0.788674,0.211326,1.588674,118,35,1, merged,0,0,0
55003,1000023,1,1484,1296,188,0.873315,0.126685,0.873315,168,20,1485,1297,188,0.873401,0.126599,0.873401,168,20,1, merged,0,0,0
55003,1000130,2,659,540,119,0.819423,0.180577,1.692739,87,32,660,541,119,0.819697,0.180303,1.693098,87,32,1, merged,0,0,0
55005,1000054,1,1051,890,161,0.846813,0.153187,0.846813,145,16,1052,891,161,0.846958,0.153042,0.846958,145,16,1, merged,0,0,0
55011,1000011,2,914,840,74,0.919037,0.080963,1.448449,69,5,915,840,75,0.918033,0.081967,1.394223,70,5,1, abandoned,1,1,0
55015,1000014,2,3076,2495,581,0.811118,0.188882,1.60751,540,41,3078,2497,581,0.811241,0.188759,1.607895,540,41,-1, merged,0,0,0
55015,1000130,3,661,542,119,0.81997,0.18003,2.42748,87,32,662,542,120,0.818731,0.181269,2.426626,88,32,1, merged,1,1,0
55015,1002169,1,776,618,158,0.796392,0.203608,0.796392,121,37,777,619,158,0.796654,0.203346,0.796654,121,37,-1, merged,0,0,0
55023,1000004,1,4341,3817,524,0.87929,0.12071,0.87929,416,108,4342,3818,524,0.879318,0.120682,0.879318,416,108,1, merged,0,0,0
55023,1000070,2,1467,1247,220,0.850034,0.149966,1.729325,192,28,1468,1248,220,0.850136,0.149864,1.729455,192,28,1, merged,0,0,0
55024,1000009,2,1763,1464,299,0.830403,0.169597,1.397567,267,32,1764,1465,299,0.830499,0.169501,1.404028,267,32,1, merged,0,0,0
55030,1000121,2,2477,2052,425,0.828421,0.171579,1.625075,395,30,2478,2053,425,0.828491,0.171509,1.625406,395,30,1, merged,0,0,0
55030,1002169,1,777,619,158,0.796654,0.203346,0.796654,121,37,778,620,158,0.796915,0.203085,0.796915,121,37,-1, merged,0,0,0
55031,1000105,2,773,613,160,0.793014,0.206986,1.500707,141,19,774,614,160,0.793282,0.206718,1.497827,141,19,1, merged,0,0,0
55033,1000132,2,775,653,122,0.842581,0.157419,1.541733,100,22,776,654,122,0.842784,0.157216,1.543205,100,22,1, merged,0,0,0
55034,1000004,1,4342,3818,524,0.879318,0.120682,0.879318,416,108,4343,3819,524,0.879346,0.120654,0.879346,416,108,-1, merged,0,0,0
55034,1000132,2,776,654,122,0.842784,0.157216,1.722102,100,22,777,655,122,0.842986,0.157014,1.722332,100,22,1, merged,0,0,0
55035,1000023,1,1488,1300,188,0.873656,0.126344,0.873656,168,20,1491,1302,189,0.873239,0.126761,0.873239,169,20,-1, merged,1,0,0
55036,1000014,1,3078,2497,581,0.811241,0.188759,0.811241,540,41,3080,2497,583,0.810714,0.189286,0.810714,542,41,1, merged,1,1,0
55038,1000015,2,2341,2085,256,0.890645,0.109355,1.659736,234,22,2342,2086,256,0.890692,0.109308,1.660202,234,22,1, merged,0,0,0
55038,1000534,1,550,423,127,0.769091,0.230909,0.769091,115,12,551,424,127,0.76951,0.23049,0.76951,115,12,1, merged,0,0,0
55040,1000110,2,652,587,65,0.900307,0.099693,1.738889,60,5,653,588,65,0.900459,0.099541,1.739675,60,5,1, merged,0,0,0
55041,1000003,1,1451,1206,245,0.831151,0.168849,0.831151,211,34,1452,1207,245,0.831267,0.168733,0.831267,211,34,1, merged,0,0,0
55045,1000005,2,760,648,112,0.852632,0.147368,1.663346,103,9,761,649,112,0.852825,0.147175,1.663601,103,9,1, merged,0,0,0
55045,1000014,1,3080,2497,583,0.810714,0.189286,0.810714,542,41,3081,2498,583,0.810776,0.189224,0.810776,542,41,1, merged,0,0,0
55049,1000003,2,1452,1207,245,0.831267,0.168733,1.703921,211,34,1454,1208,246,0.830812,0.169188,1.702383,212,34,-1, merged,1,0,0
55049,1000023,1,1492,1302,190,0.872654,0.127346,0.872654,170,20,1495,1303,192,0.871572,0.128428,0.871572,172,20,1, merged,1,1,0
55050,1000023,1,1495,1303,192,0.871572,0.128428,0.871572,172,20,1496,1304,192,0.871658,0.128342,0.871658,172,20,1, merged,0,0,0
55055,1000109,2,661,565,96,0.854766,0.145234,1.629016,91,5,662,566,96,0.854985,0.145015,1.629633,91,5,1, merged,0,0,0
55058,1000003,2,1454,1208,246,0.830812,0.169188,1.689315,212,34,1456,1210,246,0.831044,0.168956,1.688574,212,34,-1, merged,0,0,0
55058,1000012,1,735,631,104,0.858503,0.141497,0.858503,101,3,737,632,105,0.857531,0.142469,0.857531,102,3,1, merged,1,1,0
55058,1000026,3,624,541,83,0.866987,0.133013,2.556302,80,3,627,544,83,0.867624,0.132376,2.556198,80,3,-1, merged,0,0,0
55059,1000004,2,4343,3819,524,0.879346,0.120654,1.740885,416,108,4344,3820,524,0.879374,0.120626,1.727859,416,108,1, merged,0,0,0
55060,1000004,2,4344,3820,524,0.879374,0.120626,1.727859,416,108,4345,3821,524,0.879402,0.120598,1.730148,416,108,1, merged,0,0,0
55064,1000070,2,1468,1248,220,0.850136,0.149864,1.6903,192,28,1469,1249,220,0.850238,0.149762,1.691055,192,28,1, merged,0,0,0
55067,1000014,1,3081,2498,583,0.810776,0.189224,0.810776,542,41,3083,2500,583,0.810898,0.189102,0.810898,542,41,-1, merged,0,0,0
55067,1000070,2,1469,1249,220,0.850238,0.149762,1.661014,192,28,1470,1250,220,0.85034,0.14966,1.661239,192,28,1, merged,0,0,0
55068,1000012,2,738,633,105,0.857724,0.142276,1.725347,102,3,739,634,105,0.857916,0.142084,1.724583,102,3,1, merged,0,0,0
55068,1000026,1,627,544,83,0.867624,0.132376,0.867624,80,3,630,546,84,0.866667,0.133333,0.866667,81,3,-1, merged,1,0,0
55069,1000004,2,4345,3821,524,0.879402,0.120598,1.726505,416,108,4346,3822,524,0.879429,0.120571,1.726678,416,108,1, merged,0,0,0
55069,1000054,1,1053,892,161,0.847104,0.152896,0.847104,145,16,1054,893,161,0.847249,0.152751,0.847249,145,16,1, merged,0,0,0
55073,1000130,2,662,542,120,0.818731,0.181269,1.615646,88,32,663,543,120,0.819005,0.180995,1.61618,88,32,1, merged,0,0,0
55073,1002169,1,778,620,158,0.796915,0.203085,0.796915,121,37,779,621,158,0.797176,0.202824,0.797176,121,37,-1, merged,0,0,0
55077,1000023,1,1497,1304,193,0.871075,0.128925,0.871075,173,20,1498,1304,194,0.870494,0.129506,0.870494,173,21,-1, merged,1,1,0
55079,1000166,2,506,379,127,0.749012,0.250988,1.401643,122,5,507,380,127,0.749507,0.250493,1.405757,122,5,1, merged,0,0,0
55083,1000108,1,456,386,70,0.846491,0.153509,0.846491,65,5,457,387,70,0.846827,0.153173,0.846827,65,5,1, merged,0,0,0
55083,1000110,2,653,588,65,0.900459,0.099541,1.746951,60,5,654,589,65,0.900612,0.099388,1.747439,60,5,1, merged,0,0,0
55089,1000004,1,4346,3822,524,0.879429,0.120571,0.879429,416,108,4352,3826,526,0.879136,0.120864,0.879136,418,108,-1, merged,1,0,0
55089,1000023,2,1498,1304,194,0.870494,0.129506,1.749923,173,21,1500,1305,195,0.87,0.13,1.749136,174,21,1, merged,1,1,0
55090,1000014,1,3083,2500,583,0.810898,0.189102,0.810898,542,41,3087,2501,586,0.810172,0.189828,0.810172,545,41,1, merged,1,1,0
55090,1000054,4,1054,893,161,0.847249,0.152751,3.293361,145,16,1055,894,161,0.847393,0.152607,3.293228,145,16,1, merged,0,0,0
55096,1000054,1,1055,894,161,0.847393,0.152607,0.847393,145,16,1057,895,162,0.846736,0.153264,0.846736,145,17,1, merged,1,0,0
55096,1000166,4,508,381,127,0.75,0.25,2.943784,122,5,509,382,127,0.750491,0.249509,2.951465,122,5,1, merged,0,0,0
55101,1000014,2,3087,2501,586,0.810172,0.189828,1.689753,545,41,3089,2502,587,0.809971,0.190029,1.6908,545,42,-1, merged,1,1,0
55107,1000054,2,1057,895,162,0.846736,0.153264,1.54118,145,17,1059,897,162,0.847025,0.152975,1.545656,145,17,1, merged,0,0,0
55108,1000054,2,1059,897,162,0.847025,0.152975,1.631166,145,17,1060,898,162,0.84717,0.15283,1.632258,145,17,1, merged,0,0,0
55109,1000130,2,663,543,120,0.819005,0.180995,1.613976,88,32,664,544,120,0.819277,0.180723,1.614644,88,32,1, merged,0,0,0
55110,1000005,3,761,649,112,0.852825,0.147175,2.433569,103,9,762,650,112,0.853018,0.146982,2.434333,103,9,1, merged,0,0,0
55110,1000329,1,3531,2755,776,0.780232,0.219768,0.780232,663,113,3532,2756,776,0.780294,0.219706,0.780294,663,113,1, merged,0,0,0
55111,1000004,1,4352,3826,526,0.879136,0.120864,0.879136,418,108,4353,3827,526,0.879164,0.120836,0.879164,418,108,1, merged,0,0,0
55111,1000014,2,3089,2502,587,0.809971,0.190029,1.689107,545,42,3090,2503,587,0.810032,0.189968,1.689196,545,42,1, merged,0,0,0
55117,1000153,1,1265,1141,124,0.901976,0.098024,0.901976,91,33,1267,1143,124,0.902131,0.097869,0.902131,91,33,-1, merged,0,0,0
55123,1000003,3,1457,1211,246,0.83116,0.16884,1.616248,212,34,1459,1213,246,0.831391,0.168609,2.110612,212,34,-1, merged,0,0,0
55129,1000009,2,1769,1470,299,0.830978,0.169022,1.600905,267,32,1770,1470,300,0.830508,0.169492,1.600852,268,32,1, merged,1,1,0
55129,1000026,3,630,546,84,0.866667,0.133333,2.467572,81,3,631,546,85,0.865293,0.134707,2.466145,82,3,1, merged,1,1,0
55129,1000534,1,552,425,127,0.769928,0.230072,0.769928,115,12,553,426,127,0.770344,0.229656,0.770344,115,12,-1, merged,0,0,0
55130,1000004,3,4355,3829,526,0.879219,0.120781,2.689252,418,108,4356,3830,526,0.879247,0.120753,2.355684,418,108,-1, abandoned,0,0,0
55130,1000014,2,3090,2503,587,0.810032,0.189968,1.810032,545,42,3091,2503,588,0.80977,0.19023,1.476437,546,42,1, abandoned,1,1,0
55130,1000121,4,2478,2053,425,0.828491,0.171509,3.517742,395,30,2479,2053,426,0.828157,0.171843,3.18384,396,30,1, abandoned,1,1,0
55131,1000014,2,3091,2503,588,0.80977,0.19023,1.679857,546,42,3092,2503,589,0.809508,0.190492,1.679682,547,42,1, abandoned,1,1,0
55131,1000023,1,1501,1306,195,0.870087,0.129913,0.870087,174,21,1502,1307,195,0.870173,0.129827,0.870173,174,21,-1, abandoned,0,0,0
55137,1000329,2,3532,2756,776,0.780294,0.219706,1.446961,663,113,3533,2757,776,0.780357,0.219643,1.405357,663,113,1, merged,0,0,0
55139,1000327,2,727,574,153,0.789546,0.210454,1.589546,118,35,728,575,153,0.789835,0.210165,1.602335,118,35,1, merged,0,0,0
55141,1000328,2,1068,794,274,0.743446,0.256554,1.540622,247,27,1070,796,274,0.743925,0.256075,1.541361,247,27,-1, merged,0,0,0
55141,1002169,1,779,621,158,0.797176,0.202824,0.797176,121,37,780,622,158,0.797436,0.202564,0.797436,121,37,-1, merged,0,0,0
55143,1000054,1,1060,898,162,0.84717,0.15283,0.84717,145,17,1061,899,162,0.847314,0.152686,0.847314,145,17,1, merged,0,0,0
55149,1000014,2,3092,2503,589,0.809508,0.190492,1.611539,547,42,3093,2504,589,0.80957,0.19043,1.612102,547,42,1, merged,0,0,0
55149,1000592,3,852,727,125,0.853286,0.146714,2.464825,78,47,853,728,125,0.853458,0.146542,2.46556,78,47,1, merged,0,0,0
55155,1000329,2,3534,2758,776,0.780419,0.219581,1.578114,663,113,3536,2760,776,0.780543,0.219457,1.578497,663,113,-1, merged,0,0,0
55155,1002169,1,781,623,158,0.797695,0.202305,0.797695,121,37,782,624,158,0.797954,0.202046,0.797954,121,37,-1, merged,0,0,0
55160,1000108,3,458,388,70,0.847162,0.152838,2.417775,65,5,459,389,70,0.847495,0.152505,2.423811,65,5,1, merged,0,0,0
55165,1000004,1,4357,3831,526,0.879275,0.120725,0.879275,418,108,4359,3833,526,0.87933,0.12067,0.87933,418,108,-1, merged,0,0,0
55166,1000014,2,3093,2504,589,0.80957,0.19043,1.50654,547,42,3094,2505,589,0.809632,0.190368,1.511124,547,42,1, merged,0,0,0
55167,1000009,2,1775,1474,301,0.830423,0.169577,1.403952,269,32,1776,1475,301,0.830518,0.169482,1.395735,269,32,-1, abandoned,0,0,0
55168,1000592,1,853,728,125,0.853458,0.146542,0.853458,78,47,854,729,125,0.85363,0.14637,0.85363,78,47,1, merged,0,0,0
55172,1000009,2,1776,1475,301,0.830518,0.169482,1.395735,269,32,1779,1477,302,0.830242,0.169758,1.387385,270,32,1, merged,1,1,0
55173,1000014,2,3094,2505,589,0.809632,0.190368,1.710546,547,42,3096,2506,590,0.809432,0.190568,1.710497,548,42,1, merged,1,1,0
55173,1000110,1,656,591,65,0.900915,0.099085,0.900915,60,5,657,592,65,0.901065,0.098935,0.901065,60,5,-1, merged,0,0,0
55182,1000014,2,3096,2506,590,0.809432,0.190568,1.586324,548,42,3097,2507,590,0.809493,0.190507,1.587271,548,42,1, merged,0,0,0
55185,1000121,3,2479,2053,426,0.828157,0.171843,2.37793,396,30,2480,2054,426,0.828226,0.171774,2.342164,396,30,1, merged,0,0,0
55185,1000329,2,3536,2760,776,0.780543,0.219457,1.549774,663,113,3537,2761,776,0.780605,0.219395,1.513938,663,113,-1, merged,0,0,0
55191,1000005,2,764,652,112,0.853403,0.146597,1.696407,103,9,765,653,112,0.853595,0.146405,1.697132,103,9,1, merged,0,0,0
55192,1000070,2,1473,1253,220,0.850645,0.149355,1.69275,192,28,1474,1254,220,0.850746,0.149254,1.693488,192,28,1, merged,0,0,0
55193,1000091,1,664,527,137,0.793675,0.206325,0.793675,115,22,665,527,138,0.792481,0.207519,0.792481,115,23,-1, merged,1,1,0
55193,1000329,2,3537,2761,776,0.780605,0.219395,1.57428,663,113,3538,2761,777,0.780384,0.219616,1.572866,663,114,-1, merged,1,1,0
55196,1000054,2,1062,900,162,0.847458,0.152542,1.748673,145,17,1065,902,163,0.846948,0.153052,1.746797,146,17,-1, merged,1,0,0
55196,1000110,1,658,593,65,0.901216,0.098784,0.901216,60,5,659,593,66,0.899848,0.100152,0.899848,61,5,1, merged,1,1,0
55196,1000140,3,411,349,62,0.849148,0.150852,2.597822,54,8,413,350,63,0.847458,0.152542,2.594254,55,8,1, merged,1,1,0
55201,1000070,1,1474,1254,220,0.850746,0.149254,0.850746,192,28,1475,1255,220,0.850847,0.149153,0.850847,192,28,1, merged,0,0,0
55201,1000130,3,664,544,120,0.819277,0.180723,2.513561,88,32,665,545,120,0.819549,0.180451,2.514464,88,32,1, merged,0,0,0
55205,1000011,2,916,841,75,0.918122,0.081878,1.783415,70,5,917,842,75,0.918212,0.081788,1.782136,70,5,1, merged,0,0,0
55205,1000026,1,631,546,85,0.865293,0.134707,0.865293,82,3,632,546,86,0.863924,0.136076,0.863924,83,3,1, merged,1,1,0
55208,1000132,1,779,657,122,0.843389,0.156611,0.843389,100,22,780,658,122,0.84359,0.15641,0.84359,100,22,1, merged,0,0,0
55213,1000007,1,1783,1432,351,0.803141,0.196859,0.803141,312,39,1784,1433,351,0.803251,0.196749,0.803251,312,39,-1, merged,0,0,0
55218,1000007,1,1784,1433,351,0.803251,0.196749,0.803251,312,39,1786,1434,352,0.802912,0.197088,0.802912,313,39,-1, merged,1,0,0
55218,1000009,2,1779,1477,302,0.830242,0.169758,1.633493,270,32,1780,1478,302,0.830337,0.169663,1.633249,270,32,1, merged,0,0,0
55219,1000130,1,665,545,120,0.819549,0.180451,0.819549,88,32,667,546,121,0.818591,0.181409,0.818591,89,32,1, merged,1,1,0
55220,1000004,2,4360,3834,526,0.879358,0.120642,1.592362,418,108,4361,3834,527,0.879156,0.120844,1.588978,419,108,1, abandoned,1,1,0
55221,1000121,2,2480,2054,426,0.828226,0.171774,1.529906,396,30,2481,2055,426,0.828295,0.171705,1.532462,396,30,1, merged,0,0,0
55222,1000003,2,1459,1213,246,0.831391,0.168609,1.68703,212,34,1460,1214,246,0.831507,0.168493,1.686297,212,34,1, merged,0,0,0
55222,1000109,1,665,569,96,0.855639,0.144361,0.855639,91,5,668,571,97,0.85479,0.14521,0.85479,92,5,-1, merged,1,0,0
55224,1000003,1,1460,1214,246,0.831507,0.168493,0.831507,212,34,1461,1215,246,0.831622,0.168378,0.831622,212,34,1, merged,0,0,0
55224,1000009,2,1780,1478,302,0.830337,0.169663,1.661844,270,32,1781,1479,302,0.830432,0.169568,1.662055,270,32,1, merged,0,0,0
55225,1000121,3,2481,2055,426,0.828295,0.171705,2.183064,396,30,2482,2056,426,0.828364,0.171636,2.189738,396,30,1, merged,0,0,0
55226,1000004,1,4361,3834,527,0.879156,0.120844,0.879156,419,108,4363,3836,527,0.879212,0.120788,0.879212,419,108,-1, merged,0,0,0
55226,1000592,2,854,729,125,0.85363,0.14637,1.732786,78,47,855,730,125,0.853801,0.146199,1.733013,78,47,1, merged,0,0,0
55227,1000592,2,855,730,125,0.853801,0.146199,1.353801,78,47,856,731,125,0.853972,0.146028,1.392434,78,47,1, merged,0,0,0
55228,1000054,5,1065,902,163,0.846948,0.153052,3.893734,146,17,1066,903,163,0.847092,0.152908,3.881685,146,17,1, merged,0,0,0
55228,1000132,3,780,658,122,0.84359,0.15641,2.248831,100,22,782,660,122,0.84399,0.15601,2.236883,100,22,-1, merged,0,0,0
55228,1002169,4,782,624,158,0.797954,0.202046,3.046785,121,37,786,627,159,0.79771,0.20229,3.034593,121,38,-1, merged,1,0,0
55230,1000003,3,1461,1215,246,0.831622,0.168378,2.405821,212,34,1462,1216,246,0.831737,0.168263,2.404977,212,34,-1, abandoned,0,0,0
55230,1000105,2,776,616,160,0.793814,0.206186,1.574199,141,19,777,616,161,0.792793,0.207207,1.573239,142,19,1, abandoned,1,1,0
55230,1000329,1,3538,2761,777,0.780384,0.219616,0.780384,663,114,3539,2762,777,0.780446,0.219554,0.780446,663,114,-1, abandoned,0,0,0
55233,1000121,2,2482,2056,426,0.828364,0.171636,1.608811,396,30,2484,2057,427,0.8281,0.1719,1.608732,397,30,1, merged,1,1,0
55233,1000329,1,3539,2762,777,0.780446,0.219554,0.780446,663,114,3542,2765,777,0.780632,0.219368,0.780632,663,114,-1, merged,0,0,0
55235,1000014,1,3098,2508,590,0.809555,0.190445,0.809555,548,42,3099,2509,590,0.809616,0.190384,0.809616,548,42,1, merged,0,0,0
55236,1000121,2,2484,2057,427,0.8281,0.1719,1.608732,397,30,2486,2058,428,0.827836,0.172164,1.608654,398,30,1, merged,1,1,0
55236,1000329,1,3542,2765,777,0.780632,0.219368,0.780632,663,114,3545,2768,777,0.780818,0.219182,0.780818,663,114,-1, merged,0,0,0
55237,1000004,2,4363,3836,527,0.879212,0.120788,1.752368,419,108,4364,3837,527,0.879239,0.120761,1.752458,419,108,1, merged,0,0,0
55237,1000120,1,2034,1776,258,0.873156,0.126844,0.873156,227,31,2035,1777,258,0.873219,0.126781,0.873219,227,31,-1, merged,0,0,0
55239,1000109,2,668,571,97,0.85479,0.14521,1.630622,92,5,669,572,97,0.855007,0.144993,1.631231,92,5,1, merged,0,0,0
55240,1000109,2,669,572,97,0.855007,0.144993,1.631231,92,5,670,573,97,0.855224,0.144776,1.632227,92,5,1, merged,0,0,0
55245,1000004,2,4366,3839,527,0.879295,0.120705,1.732236,419,108,4367,3840,527,0.879322,0.120678,1.734395,419,108,1, merged,0,0,0
55247,1000003,1,1462,1216,246,0.831737,0.168263,0.831737,212,34,1463,1217,246,0.831852,0.168148,0.831852,212,34,-1, merged,0,0,0
55254,1000023,1,1504,1309,195,0.870346,0.129654,0.870346,174,21,1505,1310,195,0.870432,0.129568,0.870432,174,21,1, merged,0,0,0
55263,1000003,1,1463,1217,246,0.831852,0.168148,0.831852,212,34,1464,1218,246,0.831967,0.168033,0.831967,212,34,1, merged,0,0,0
55263,1000199,2,582,496,86,0.852234,0.147766,1.684086,79,7,583,497,86,0.852487,0.147513,1.684454,79,7,1, merged,0,0,0
55267,1000009,3,1784,1481,303,0.830157,0.169843,2.403902,271,32,1785,1482,303,0.830252,0.169748,2.400776,271,32,-1, abandoned,0,0,0
55267,1000026,2,632,546,86,0.863924,0.136076,1.573745,83,3,633,546,87,0.862559,0.137441,1.570524,84,3,1, abandoned,1,1,0
55272,1000003,2,1464,1218,246,0.831967,0.168033,1.608971,212,34,1465,1219,246,0.832082,0.167918,1.609473,212,34,1, merged,0,0,0
55272,1000132,3,782,660,122,0.84399,0.15601,2.45296,100,22,783,661,122,0.844189,0.155811,2.453662,100,22,1, merged,0,0,0
55273,1000026,2,633,546,87,0.862559,0.137441,1.796357,84,3,635,547,88,0.861417,0.138583,1.795673,85,3,1, merged,1,1,0
55276,1000054,2,1066,903,163,0.847092,0.152908,1.691281,146,17,1069,905,164,0.846586,0.153414,1.691172,147,17,-1, merged,1,0,0
55276,1000132,1,783,661,122,0.844189,0.155811,0.844189,100,22,785,663,122,0.844586,0.155414,0.844586,100,22,-1, merged,0,0,0
55283,1000015,1,2346,2090,256,0.890878,0.109122,0.890878,234,22,2347,2091,256,0.890925,0.109075,0.890925,234,22,1, merged,0,0,0
55284,1000105,3,777,616,161,0.792793,0.207207,2.424483,142,19,779,618,161,0.793325,0.206675,2.42109,142,19,-1, abandoned,0,0,0
55286,1000054,3,1069,905,164,0.846586,0.153414,2.371024,147,17,1071,907,164,0.846872,0.153128,2.376083,147,17,1, merged,0,0,0
55288,1000109,1,670,573,97,0.855224,0.144776,0.855224,92,5,671,574,97,0.85544,0.14456,0.85544,92,5,1, merged,0,0,0
55288,1000199,2,583,497,86,0.852487,0.147513,1.707711,79,7,584,498,86,0.85274,0.14726,1.708179,79,7,1, merged,0,0,0
55295,1000004,2,4371,3844,527,0.879433,0.120567,1.587397,419,108,4372,3845,527,0.87946,0.12054,1.588711,419,108,1, merged,0,0,0
55295,1000015,3,2347,2091,256,0.890925,0.109075,2.478322,234,22,2348,2092,256,0.890971,0.109029,2.479682,234,22,1, merged,0,0,0
55296,1000132,2,787,665,122,0.844981,0.155019,1.709132,100,22,788,666,122,0.845178,0.154822,1.709839,100,22,1, merged,0,0,0
55298,1000003,2,1465,1219,246,0.832082,0.167918,1.690382,212,34,1466,1220,246,0.832196,0.167804,1.690687,212,34,1, merged,0,0,0
55298,1000012,1,741,636,105,0.8583,0.1417,0.8583,102,3,742,637,105,0.858491,0.141509,0.858491,102,3,1, merged,0,0,0
55303,1000023,2,1508,1312,196,0.870027,0.129973,1.734688,175,21,1509,1313,196,0.870113,0.129887,1.735281,175,21,1, merged,0,0,0
55308,1000132,2,789,667,122,0.845374,0.154626,1.50194,100,22,790,668,122,0.84557,0.15443,1.499035,100,22,1, merged,0,0,0
55312,1000003,1,1466,1220,246,0.832196,0.167804,0.832196,212,34,1467,1221,246,0.832311,0.167689,0.832311,212,34,1, merged,0,0,0
55317,1000110,2,661,595,66,0.900151,0.099849,1.747041,61,5,662,595,67,0.898792,0.101208,1.74403,62,5,1, merged,1,1,0
55317,1000140,1,418,354,64,0.84689,0.15311,0.84689,56,8,420,355,65,0.845238,0.154762,0.845238,57,8,1, merged,1,1,0
55318,1000329,2,3547,2770,777,0.780942,0.219058,1.578652,663,114,3550,2772,778,0.780845,0.219155,1.578812,664,114,-1, merged,1,0,0
55318,1002169,1,786,627,159,0.79771,0.20229,0.79771,121,38,787,628,159,0.797967,0.202033,0.797967,121,38,-1, merged,0,0,0
55323,1000091,2,665,527,138,0.792481,0.207519,1.367481,115,23,666,528,138,0.792793,0.207207,1.353768,115,23,1, merged,0,0,0
55327,1000005,1,769,657,112,0.854356,0.145644,0.854356,103,9,770,658,112,0.854545,0.145455,0.854545,103,9,-1, merged,0,0,0
55327,1000121,2,2486,2058,428,0.827836,0.172164,1.682192,398,30,2487,2059,428,0.827905,0.172095,1.682451,398,30,1, merged,0,0,0
55338,1000004,1,4372,3845,527,0.87946,0.12054,0.87946,419,108,4373,3846,527,0.879488,0.120512,0.879488,419,108,1, merged,0,0,0
55339,1000054,3,1071,907,164,0.846872,0.153128,2.193671,147,17,1072,908,164,0.847015,0.152985,2.201246,147,17,1, merged,0,0,0
55340,1000054,2,1072,908,164,0.847015,0.152985,1.544383,147,17,1073,909,164,0.847158,0.152842,1.548456,147,17,1, merged,0,0,0
55341,1000054,2,1073,909,164,0.847158,0.152842,1.548456,147,17,1074,910,164,0.8473,0.1527,1.552428,147,17,1, merged,0,0,0
55344,1000070,2,1476,1256,220,0.850949,0.149051,1.850949,192,28,1477,1257,220,0.851049,0.148951,1.601049,192,28,1, merged,0,0,0
55346,1000004,1,4373,3846,527,0.879488,0.120512,0.879488,419,108,4374,3847,527,0.879515,0.120485,0.879515,419,108,1, merged,0,0,0
55346,1000023,2,1510,1314,196,0.870199,0.129801,1.749686,175,21,1511,1315,196,0.870285,0.129715,1.7498,175,21,1, merged,0,0,0
55346,1000329,3,3553,2775,778,0.78103,0.21897,2.530717,664,114,3554,2776,778,0.781092,0.218908,2.530892,664,114,1, merged,0,0,0
55347,1000004,1,4374,3847,527,0.879515,0.120485,0.879515,419,108,4375,3848,527,0.879543,0.120457,0.879543,419,108,1, merged,0,0,0
55347,1000023,2,1511,1315,196,0.870285,0.129715,1.7498,175,21,1512,1316,196,0.87037,0.12963,1.749913,175,21,1, merged,0,0,0
55347,1000329,3,3554,2776,778,0.781092,0.218908,2.530892,664,114,3555,2777,778,0.781153,0.218847,2.531067,664,114,1, merged,0,0,0
55348,1000004,1,4375,3848,527,0.879543,0.120457,0.879543,419,108,4376,3848,528,0.879342,0.120658,0.879342,420,108,1, merged,1,1,0
55348,1000023,2,1512,1316,196,0.87037,0.12963,1.749913,175,21,1513,1317,196,0.870456,0.129544,1.749798,175,21,1, merged,0,0,0
55348,1000329,3,3555,2777,778,0.781153,0.218847,2.531067,664,114,3556,2778,778,0.781215,0.218785,2.531013,664,114,1, merged,0,0,0
55358,1000329,1,3557,2778,779,0.780995,0.219005,0.780995,665,114,3558,2779,779,0.781057,0.218943,0.781057,665,114,1, merged,0,0,0
55359,1000005,2,775,663,112,0.855484,0.144516,1.683389,103,9,776,664,112,0.85567,0.14433,1.683644,103,9,1, merged,0,0,0
55359,1000121,1,2487,2059,428,0.827905,0.172095,0.827905,398,30,2488,2060,428,0.827974,0.172026,0.827974,398,30,-1, merged,0,0,0
55361,1000004,1,4378,3850,528,0.879397,0.120603,0.879397,420,108,4379,3851,528,0.879425,0.120575,0.879425,420,108,-1, merged,0,0,0
55361,1000120,2,2035,1777,258,0.873219,0.126781,1.752616,227,31,2036,1777,259,0.87279,0.12721,1.752214,227,32,-1, merged,1,1,0
55363,1000329,1,3562,2781,781,0.780741,0.219259,0.780741,665,116,3564,2783,781,0.780864,0.219136,0.780864,665,116,-1, merged,0,0,0
55364,1000329,1,3564,2783,781,0.780864,0.219136,0.780864,665,116,3566,2785,781,0.780987,0.219013,0.780987,665,116,-1, merged,0,0,0
55365,1000004,2,4379,3851,528,0.879425,0.120575,1.623828,420,108,4380,3852,528,0.879452,0.120548,1.624093,420,108,1, merged,0,0,0
55365,1000328,1,1072,798,274,0.744403,0.255597,0.744403,247,27,1073,799,274,0.744641,0.255359,0.744641,247,27,1, merged,0,0,0
55369,1000054,2,1075,911,164,0.847442,0.152558,1.55257,147,17,1076,912,164,0.847584,0.152416,1.543786,147,17,-1, abandoned,0,0,0
55379,1000014,1,3099,2509,590,0.809616,0.190384,0.809616,548,42,3100,2509,591,0.809355,0.190645,0.809355,549,42,1, abandoned,1,1,0
55380,1000014,1,3100,2509,591,0.809355,0.190645,0.809355,549,42,3101,2509,592,0.809094,0.190906,0.809094,550,42,1, merged,1,1,0
55387,1000534,5,553,426,127,0.770344,0.229656,4.198861,115,12,554,426,128,0.768953,0.231047,4.145147,115,13,-1, merged,1,1,0
55397,1000009,1,1791,1487,304,0.830262,0.169738,0.830262,272,32,1793,1487,306,0.829336,0.170664,0.829336,274,32,1, merged,1,1,0
55397,1000026,3,635,547,88,0.861417,0.138583,2.248823,85,3,636,548,88,0.861635,0.138365,2.232638,85,3,1, merged,0,0,0
55400,1000009,1,1793,1487,306,0.829336,0.170664,0.829336,274,32,1794,1487,307,0.828874,0.171126,0.828874,275,32,1, abandoned,1,1,0
55412,1000012,1,743,638,105,0.858681,0.141319,0.858681,102,3,744,639,105,0.858871,0.141129,0.858871,102,3,1, merged,0,0,0
55412,1000054,3,1078,914,164,0.847866,0.152134,2.547817,147,17,1079,915,164,0.848007,0.151993,2.550628,147,17,1, merged,0,0,0
55413,1000534,1,554,426,128,0.768953,0.231047,0.768953,115,13,556,427,129,0.767986,0.232014,0.767986,116,13,1, merged,1,1,0
55415,1000003,1,1468,1222,246,0.832425,0.167575,0.832425,212,34,1470,1223,247,0.831973,0.168027,0.831973,212,35,-1, merged,1,0,0
55415,1000012,2,744,639,105,0.858871,0.141129,1.691296,102,3,745,640,105,0.85906,0.14094,1.691033,102,3,1, merged,0,0,0
55417,1000003,2,1470,1223,247,0.831973,0.168027,1.619754,212,35,1471,1223,248,0.831407,0.168593,1.61735,213,35,1, merged,1,1,0
55420,1000004,1,4380,3852,528,0.879452,0.120548,0.879452,420,108,4381,3853,528,0.87948,0.12052,0.87948,420,108,-1, abandoned,0,0,0
55420,1000023,3,1515,1319,196,0.870627,0.129373,2.605993,175,21,1516,1319,197,0.870053,0.129947,2.60361,176,21,1, abandoned,1,1,0
55420,1000329,4,3566,2785,781,0.780987,0.219013,3.38698,665,116,3567,2786,781,0.781049,0.218951,3.384658,665,116,-1, abandoned,0,0,0
55428,1000012,2,745,640,105,0.85906,0.14094,1.716203,102,3,746,641,105,0.859249,0.140751,1.716737,102,3,1, merged,0,0,0
55431,1000003,1,1471,1223,248,0.831407,0.168593,0.831407,213,35,1473,1225,248,0.831636,0.168364,0.831636,213,35,-1, merged,0,0,0
55432,1000007,1,1792,1439,353,0.803013,0.196987,0.803013,314,39,1794,1440,354,0.802676,0.197324,0.802676,315,39,1, merged,1,1,0
55432,1000132,2,790,668,122,0.84557,0.15443,1.648583,100,22,792,669,123,0.844697,0.155303,1.647373,101,22,1, merged,1,1,0
55433,1000003,2,1473,1225,248,0.831636,0.168364,1.701689,213,35,1474,1226,248,0.83175,0.16825,1.70123,213,35,-1, abandoned,0,0,0
55433,1000023,1,1516,1319,197,0.870053,0.129947,0.870053,176,21,1517,1319,198,0.869479,0.130521,0.869479,177,21,1, abandoned,1,1,0
55448,1000054,1,1079,915,164,0.848007,0.151993,0.848007,147,17,1080,916,164,0.848148,0.151852,0.848148,147,17,1, merged,0,0,0
55450,1000026,1,636,548,88,0.861635,0.138365,0.861635,85,3,637,549,88,0.861852,0.138148,0.861852,85,3,1, merged,0,0,0
55450,1000054,2,1080,916,164,0.848148,0.151852,1.709783,147,17,1081,917,164,0.848289,0.151711,1.710141,147,17,1, merged,0,0,0
55457,1000121,3,2488,2060,428,0.827974,0.172026,2.324687,398,30,2489,2061,428,0.828043,0.171957,2.336414,398,30,1, merged,0,0,0
55458,1000070,1,1477,1257,220,0.851049,0.148951,0.851049,192,28,1481,1259,222,0.850101,0.149899,0.850101,194,28,1, merged,1,1,0
55458,1000592,2,857,732,125,0.854142,0.145858,1.705192,78,47,859,734,125,0.854482,0.145518,1.704583,78,47,-1, merged,0,0,0
55461,1000009,1,1794,1487,307,0.828874,0.171126,0.828874,275,32,1796,1487,309,0.827951,0.172049,0.827951,277,32,1, abandoned,1,1,0
55461,1000011,2,918,843,75,0.918301,0.081699,1.747175,70,5,919,844,75,0.91839,0.08161,1.746341,70,5,-1, abandoned,0,0,0
55468,1000014,1,3101,2509,592,0.809094,0.190906,0.809094,550,42,3102,2510,592,0.809155,0.190845,0.809155,550,42,1, merged,0,0,0
55473,1000534,1,556,427,129,0.767986,0.232014,0.767986,116,13,557,428,129,0.768402,0.231598,0.768402,116,13,1, merged,0,0,0
55475,1000121,2,2490,2062,428,0.828112,0.171888,1.609161,398,30,2491,2063,428,0.828181,0.171819,1.609291,398,30,1, merged,0,0,0
55475,1000329,1,3567,2786,781,0.781049,0.218951,0.781049,665,116,3568,2787,781,0.78111,0.21889,0.78111,665,116,1, merged,0,0,0
55476,1000004,2,4383,3855,528,0.879535,0.120465,1.660644,420,108,4384,3856,528,0.879562,0.120438,1.660733,420,108,1, merged,0,0,0
55476,1000121,4,2491,2063,428,0.828181,0.171819,3.292352,398,30,2492,2063,429,0.827849,0.172151,3.29009,398,31,-1, merged,1,1,0
55476,1000329,1,3568,2787,781,0.78111,0.21889,0.78111,665,116,3569,2788,781,0.781171,0.218829,0.781171,665,116,1, merged,0,0,0
55477,1000121,2,2492,2063,429,0.827849,0.172151,1.60902,398,31,2493,2064,429,0.827918,0.172082,1.609151,398,31,1, merged,0,0,0
55477,1000329,1,3569,2788,781,0.781171,0.218829,0.781171,665,116,3570,2789,781,0.781232,0.218768,0.781232,665,116,1, merged,0,0,0
55478,1000054,1,1081,917,164,0.848289,0.151711,0.848289,147,17,1082,918,164,0.848429,0.151571,0.848429,147,17,1, merged,0,0,0
55478,1000110,3,664,597,67,0.899096,0.100904,2.540946,62,5,665,598,67,0.899248,0.100752,2.541628,62,5,1, merged,0,0,0
55480,1000534,1,557,428,129,0.768402,0.231598,0.768402,116,13,558,429,129,0.768817,0.231183,0.768817,116,13,1, merged,0,0,0
55484,1000166,1,514,387,127,0.752918,0.247082,0.752918,122,5,515,388,127,0.753398,0.246602,0.753398,122,5,1, merged,0,0,0
55485,1000140,2,420,355,65,0.845238,0.154762,1.745238,57,8,422,356,66,0.843602,0.156398,1.718602,58,8,1, merged,1,1,0
55492,1000026,2,637,549,88,0.861852,0.138148,1.61525,85,3,638,550,88,0.862069,0.137931,1.615945,85,3,1, merged,0,0,0
55492,1000166,1,515,388,127,0.753398,0.246602,0.753398,122,5,516,389,127,0.753876,0.246124,0.753876,122,5,1, merged,0,0,0
55495,1000009,2,1796,1487,309,0.827951,0.172049,1.374618,277,32,1797,1488,309,0.828047,0.171953,1.380678,277,32,1, merged,0,0,0
55498,1000009,2,1797,1488,309,0.828047,0.171953,1.380678,277,32,1798,1489,309,0.828142,0.171858,1.386584,277,32,1, merged,0,0,0
55502,1000009,2,1798,1489,309,0.828142,0.171858,1.386584,277,32,1799,1490,309,0.828238,0.171762,1.3852,277,32,1, merged,0,0,0
55503,1000009,2,1799,1490,309,0.828238,0.171762,1.3852,277,32,1800,1491,309,0.828333,0.171667,1.390833,277,32,1, merged,0,0,0
55505,1000009,2,1800,1491,309,0.828333,0.171667,1.390833,277,32,1801,1492,309,0.828429,0.171571,1.39633,277,32,1, merged,0,0,0
55506,1000009,2,1801,1492,309,0.828429,0.171571,1.39633,277,32,1803,1494,309,0.828619,0.171381,1.389595,277,32,-1, merged,0,0,0
55509,1000329,1,3572,2790,782,0.781075,0.218925,0.781075,665,117,3573,2791,782,0.781136,0.218864,0.781136,665,117,1, merged,0,0,0
55516,1000026,1,638,550,88,0.862069,0.137931,0.862069,85,3,639,551,88,0.862285,0.137715,0.862285,85,3,1, merged,0,0,0
55519,1000108,2,465,395,70,0.849462,0.150538,1.693907,65,5,466,396,70,0.849785,0.150215,1.695939,65,5,1, merged,0,0,0
55520,1000054,2,1082,918,164,0.848429,0.151571,1.646396,147,17,1083,919,164,0.848569,0.151431,1.645523,147,17,1, merged,0,0,0
55520,1002169,1,787,628,159,0.797967,0.202033,0.797967,121,38,788,628,160,0.796954,0.203046,0.796954,121,39,-1, merged,1,1,0
55521,1000328,1,1074,800,274,0.744879,0.255121,0.744879,247,27,1076,801,275,0.744424,0.255576,0.744424,248,27,1, merged,1,1,0
55521,1000329,2,3573,2791,782,0.781136,0.218864,1.526015,665,117,3575,2793,782,0.781259,0.218741,1.525683,665,117,-1, merged,0,0,0
55527,1000108,2,466,396,70,0.849785,0.150215,1.545988,65,5,467,397,70,0.850107,0.149893,1.541465,65,5,1, merged,0,0,0
55536,1000014,2,3102,2510,592,0.809155,0.190845,1.604268,550,42,3103,2511,592,0.809217,0.190783,1.603609,550,42,-1, abandoned,0,0,0
55544,1000011,2,919,844,75,0.91839,0.08161,1.779501,70,5,920,845,75,0.918478,0.081522,1.782115,70,5,-1, merged,0,0,0
55553,1000009,3,1803,1494,309,0.828619,0.171381,2.522836,277,32,1804,1495,309,0.828714,0.171286,2.523304,277,32,1, merged,0,0,0
55553,1000014,1,3103,2511,592,0.809217,0.190783,0.809217,550,42,3105,2512,593,0.809018,0.190982,0.809018,551,42,-1, merged,1,0,0
55559,1000014,1,3105,2512,593,0.809018,0.190982,0.809018,551,42,3106,2513,593,0.809079,0.190921,0.809079,551,42,1, merged,0,0,0
55560,1000026,3,640,552,88,0.8625,0.1375,2.273715,85,3,641,553,88,0.862715,0.137285,2.277735,85,3,1, merged,0,0,0
55560,1000166,2,517,390,127,0.754352,0.245648,1.411215,122,5,518,391,127,0.754826,0.245174,1.41502,122,5,1, merged,0,0,0
55561,1000026,1,641,553,88,0.862715,0.137285,0.862715,85,3,642,554,88,0.862928,0.137072,0.862928,85,3,1, merged,0,0,0
55564,1000026,2,642,554,88,0.862928,0.137072,1.617755,85,3,643,555,88,0.863142,0.136858,1.61844,85,3,1, merged,0,0,0
55564,1000166,1,518,391,127,0.754826,0.245174,0.754826,122,5,519,392,127,0.755299,0.244701,0.755299,122,5,1, merged,0,0,0
55565,1000026,3,643,555,88,0.863142,0.136858,2.309798,85,3,644,556,88,0.863354,0.136646,2.314245,85,3,1, merged,0,0,0
55565,1000166,2,519,392,127,0.755299,0.244701,1.446657,122,5,520,393,127,0.755769,0.244231,1.450891,122,5,1, merged,0,0,0
55576,1000009,3,1804,1495,309,0.828714,0.171286,2.257196,277,32,1805,1496,309,0.828809,0.171191,2.259642,277,32,1, merged,0,0,0
55577,1000004,1,4392,3863,529,0.879554,0.120446,0.879554,421,108,4393,3864,529,0.879581,0.120419,0.879581,421,108,-1, merged,0,0,0
55577,1000007,3,1799,1445,354,0.803224,0.196776,2.527475,315,39,1800,1446,354,0.803333,0.196667,2.527807,315,39,1, merged,0,0,0
55577,1000132,2,792,669,123,0.844697,0.155303,1.724251,101,22,793,670,123,0.844893,0.155107,1.724474,101,22,1, merged,0,0,0
55583,1000054,3,1083,919,164,0.848569,0.151431,2.388584,147,17,1084,920,164,0.848708,0.151292,2.391332,147,17,1, merged,0,0,0
55583,1000132,1,793,670,123,0.844893,0.155107,0.844893,101,22,794,670,124,0.843829,0.156171,0.843829,102,22,1, merged,1,1,0
55585,1000023,1,1521,1323,198,0.869822,0.130178,0.869822,177,21,1522,1324,198,0.869908,0.130092,0.869908,177,21,1, merged,0,0,0
55585,1000132,2,794,670,124,0.843829,0.156171,1.713651,102,22,795,671,124,0.844025,0.155975,1.713933,102,22,1, merged,0,0,0
55590,1000070,3,1481,1259,222,0.850101,0.149899,2.515142,194,28,1482,1260,222,0.850202,0.149798,2.516028,194,28,1, merged,0,0,0
55590,1000130,2,670,549,121,0.819403,0.180597,1.665041,89,32,671,550,121,0.819672,0.180328,1.665826,89,32,1, merged,0,0,0
55598,1000109,2,672,575,97,0.855655,0.144345,1.633433,92,5,673,576,97,0.855869,0.144131,1.634032,92,5,1, merged,0,0,0
55603,1000004,3,4394,3865,529,0.879609,0.120391,1.752523,421,108,4396,3866,530,0.879436,0.120564,2.251985,422,108,1, merged,1,1,0
55603,1000120,2,2038,1779,259,0.872915,0.127085,0.872915,227,32,2040,1780,260,0.872549,0.127451,1.372549,228,32,1, merged,1,1,0
55606,1000329,1,3575,2793,782,0.781259,0.218741,0.781259,665,117,3577,2794,783,0.781101,0.218899,0.781101,666,117,1, merged,1,1,0
55609,1000329,2,3577,2794,783,0.781101,0.218899,1.578056,666,117,3579,2796,783,0.781224,0.218776,1.578435,666,117,-1, merged,0,0,0
55609,1002169,1,788,628,160,0.796954,0.203046,0.796954,121,39,789,629,160,0.797212,0.202788,0.797212,121,39,-1, merged,0,0,0
55610,1000329,2,3579,2796,783,0.781224,0.218776,1.609224,666,117,3580,2797,783,0.781285,0.218715,1.605986,666,117,1, merged,0,0,0
55616,1000009,2,1807,1498,309,0.828998,0.171002,1.596855,277,32,1809,1498,311,0.828082,0.171918,1.596353,279,32,1, abandoned,1,1,0
55616,1000534,1,560,430,130,0.767857,0.232143,0.767857,116,14,561,431,130,0.768271,0.231729,0.768271,116,14,-1, abandoned,0,0,0
55617,1000014,1,3107,2514,593,0.809141,0.190859,0.809141,551,42,3108,2515,593,0.809202,0.190798,0.809202,551,42,1, merged,0,0,0
55618,1000054,2,1086,922,164,0.848987,0.151013,1.691092,147,17,1087,923,164,0.849126,0.150874,1.699126,147,17,1, merged,0,0,0
55620,1000329,1,3580,2797,783,0.781285,0.218715,0.781285,666,117,3581,2798,783,0.781346,0.218654,0.781346,666,117,1, merged,0,0,0
55621,1000329,1,3581,2798,783,0.781346,0.218654,0.781346,666,117,3582,2799,783,0.781407,0.218593,0.781407,666,117,1, merged,0,0,0
55622,1000329,1,3582,2799,783,0.781407,0.218593,0.781407,666,117,3583,2800,783,0.781468,0.218532,0.781468,666,117,1, merged,0,0,0
55626,1000329,1,3584,2801,783,0.781529,0.218471,0.781529,666,117,3585,2802,783,0.78159,0.21841,0.78159,666,117,1, merged,0,0,0
55627,1000329,1,3585,2802,783,0.78159,0.21841,0.78159,666,117,3586,2803,783,0.781651,0.218349,0.781651,666,117,1, merged,0,0,0
55628,1000329,1,3586,2803,783,0.781651,0.218349,0.781651,666,117,3587,2804,783,0.781712,0.218288,0.781712,666,117,1, merged,0,0,0
55629,1000329,1,3587,2804,783,0.781712,0.218288,0.781712,666,117,3588,2805,783,0.781773,0.218227,0.781773,666,117,1, merged,0,0,0
55630,1000329,1,3588,2805,783,0.781773,0.218227,0.781773,666,117,3589,2806,783,0.781833,0.218167,0.781833,666,117,1, merged,0,0,0
55631,1000329,1,3589,2806,783,0.781833,0.218167,0.781833,666,117,3590,2807,783,0.781894,0.218106,0.781894,666,117,1, merged,0,0,0
55636,1000054,1,1087,923,164,0.849126,0.150874,0.849126,147,17,1088,924,164,0.849265,0.150735,0.849265,147,17,1, merged,0,0,0
55636,1000105,2,781,620,161,0.793854,0.206146,1.64298,142,19,782,621,161,0.794118,0.205882,1.643382,142,19,1, merged,0,0,0
55646,1000005,2,783,671,112,0.85696,0.14304,1.685292,103,9,784,672,112,0.857143,0.142857,1.685212,103,9,1, merged,0,0,0
55646,1000121,1,2499,2070,429,0.828331,0.171669,0.828331,398,31,2501,2071,430,0.828069,0.171931,0.828069,398,32,-1, merged,1,0,0
55658,1000328,1,1076,801,275,0.744424,0.255576,0.744424,248,27,1077,802,275,0.744661,0.255339,0.744661,248,27,1, merged,0,0,0
55658,1000329,2,3590,2807,783,0.781894,0.218106,1.526318,666,117,3591,2808,783,0.781955,0.218045,1.526616,666,117,1, merged,0,0,0
55668,1000109,2,673,576,97,0.855869,0.144131,1.708609,92,5,674,577,97,0.856083,0.143917,1.709075,92,5,1, merged,0,0,0
55668,1000199,1,584,498,86,0.85274,0.14726,0.85274,79,7,585,499,86,0.852991,0.147009,0.852991,79,7,1, merged,0,0,0
55676,1000007,2,1801,1447,354,0.803443,0.196557,1.631524,315,39,1802,1448,354,0.803552,0.196448,1.631366,315,39,-1, abandoned,0,0,0
55676,1000009,1,1809,1498,311,0.828082,0.171918,0.828082,279,32,1812,1500,312,0.827815,0.172185,0.827815,280,32,1, abandoned,1,1,0
55676,1000026,3,644,556,88,0.863354,0.136646,2.494878,85,3,646,557,89,0.862229,0.137771,2.493595,86,3,-1, abandoned,1,0,0
55682,1000003,1,1478,1229,249,0.831529,0.168471,0.831529,213,36,1481,1231,250,0.831195,0.168805,0.831195,214,36,-1, merged,1,0,0
55682,1000023,2,1522,1324,198,0.869908,0.130092,1.701437,177,21,1525,1325,200,0.868852,0.131148,1.700048,179,21,1, merged,1,1,0
55688,1000004,2,4399,3869,530,0.879518,0.120482,1.720578,422,108,4400,3870,530,0.879545,0.120455,1.72113,422,108,1, merged,0,0,0
55691,1000014,1,3110,2517,593,0.809325,0.190675,0.809325,551,42,3113,2519,594,0.809187,0.190813,0.809187,552,42,-1, merged,1,0,0
55694,1000014,1,3113,2519,594,0.809187,0.190813,0.809187,552,42,3114,2519,595,0.808927,0.191073,0.808927,553,42,1, merged,1,1,0
55695,1000054,2,1088,924,164,0.849265,0.150735,1.605503,147,17,1089,925,164,0.849403,0.150597,1.606108,147,17,1, merged,0,0,0
55695,1000166,1,521,394,127,0.756238,0.243762,0.756238,122,5,522,395,127,0.756705,0.243295,0.756705,122,5,1, merged,0,0,0
55712,1000023,1,1525,1325,200,0.868852,0.131148,0.868852,179,21,1526,1326,200,0.868938,0.131062,0.868938,179,21,1, merged,0,0,0
55712,1000054,2,1089,925,164,0.849403,0.150597,1.718256,147,17,1090,926,164,0.849541,0.150459,1.71848,147,17,1, merged,0,0,0
55715,1000004,1,4401,3871,530,0.879573,0.120427,0.879573,422,108,4402,3872,530,0.8796,0.1204,0.8796,422,108,1, merged,0,0,0
55715,1000329,3,3592,2809,783,0.782016,0.217984,2.503173,666,117,3593,2810,783,0.782076,0.217924,2.503782,666,117,1, merged,0,0,0
55716,1000004,1,4402,3872,530,0.8796,0.1204,0.8796,422,108,4403,3873,530,0.879628,0.120372,0.879628,422,108,1, merged,0,0,0
55716,1000329,3,3593,2810,783,0.782076,0.217924,2.503782,666,117,3594,2811,783,0.782137,0.217863,2.504387,666,117,1, merged,0,0,0
55722,1000120,1,2040,1780,260,0.872549,0.127451,0.872549,228,32,2041,1781,260,0.872611,0.127389,0.872611,228,32,1, merged,0,0,0
55725,1000014,1,3114,2519,595,0.808927,0.191073,0.808927,553,42,3115,2520,595,0.808989,0.191011,0.808989,553,42,1, merged,0,0,0
55725,1000015,2,2359,2103,256,0.891479,0.108521,1.700407,234,22,2360,2104,256,0.891525,0.108475,1.700514,234,22,1, merged,0,0,0
55736,1000054,5,1090,926,164,0.849541,0.150459,4.022235,147,17,1091,927,164,0.849679,0.150321,4.015781,147,17,1, merged,0,0,0
55736,1000121,1,2501,2071,430,0.828069,0.171931,0.828069,398,32,2503,2071,432,0.827407,0.172593,0.827407,400,32,1, merged,1,1,0
55746,1000012,2,746,641,105,0.859249,0.140751,1.721478,102,3,748,643,105,0.859626,0.140374,1.722068,102,3,1, merged,0,0,0
55746,1000026,1,646,557,89,0.862229,0.137771,0.862229,86,3,647,558,89,0.862442,0.137558,0.862442,86,3,1, merged,0,0,0
55751,1000328,3,1077,802,275,0.744661,0.255339,2.276737,248,27,1081,804,277,0.743756,0.256244,2.292751,250,27,1, merged,1,1,0
55751,1002169,1,795,635,160,0.798742,0.201258,0.798742,121,39,796,636,160,0.798995,0.201005,0.798995,121,39,-1, merged,0,0,0
55755,1000105,3,782,621,161,0.794118,0.205882,2.312527,142,19,784,622,162,0.793367,0.206633,2.307098,143,19,-1, abandoned,1,0,0
55760,1000014,2,3115,2520,595,0.808989,0.191011,1.375254,553,42,3116,2521,595,0.80905,0.19095,1.380479,553,42,1, merged,0,0,0
55761,1000009,1,1812,1500,312,0.827815,0.172185,0.827815,280,32,1813,1500,313,0.827358,0.172642,0.827358,281,32,1, abandoned,1,1,0
55761,1000534,2,561,431,130,0.768271,0.231729,1.596086,116,14,562,432,130,0.768683,0.231317,1.596041,116,14,-1, abandoned,0,0,0
55764,1000014,2,3116,2521,595,0.80905,0.19095,1.521379,553,42,3117,2522,595,0.809111,0.190889,1.525328,553,42,1, merged,0,0,0
55768,1000014,1,3117,2522,595,0.809111,0.190889,0.809111,553,42,3119,2523,596,0.808913,0.191087,0.808913,554,42,1, merged,1,1,0
55768,1000070,2,1486,1264,222,0.850606,0.149394,1.659717,194,28,1487,1265,222,0.850706,0.149294,1.659619,194,28,1, merged,0,0,0
55771,1000329,2,3594,2811,783,0.782137,0.217863,1.581132,666,117,3595,2812,783,0.782197,0.217803,1.581445,666,117,-1, abandoned,0,0,0
55771,1002169,1,796,636,160,0.798995,0.201005,0.798995,121,39,797,637,160,0.799247,0.200753,0.799247,121,39,-1, abandoned,0,0,0
55777,1000014,1,3119,2523,596,0.808913,0.191087,0.808913,554,42,3120,2523,597,0.808654,0.191346,0.808654,555,42,1, abandoned,1,1,0
55784,1000329,1,3595,2812,783,0.782197,0.217803,0.782197,666,117,3596,2813,783,0.782258,0.217742,0.782258,666,117,1, merged,0,0,0
55788,1000329,1,3596,2813,783,0.782258,0.217742,0.782258,666,117,3597,2814,783,0.782319,0.217681,0.782319,666,117,1, merged,0,0,0
55793,1000592,1,860,735,125,0.854651,0.145349,0.854651,78,47,862,737,125,0.854988,0.145012,0.854988,78,47,-1, abandoned,0,0,0
55805,1000004,2,4404,3874,530,0.879655,0.120345,1.531829,422,108,4405,3875,530,0.879682,0.120318,1.522539,422,108,-1, abandoned,0,0,0
55806,1000329,2,3599,2816,783,0.78244,0.21756,1.647246,666,117,3600,2817,783,0.7825,0.2175,1.647596,666,117,-1, abandoned,0,0,0
55808,1000014,1,3120,2523,597,0.808654,0.191346,0.808654,555,42,3121,2524,597,0.808715,0.191285,0.808715,555,42,-1, abandoned,0,0,0
55812,1000054,1,1092,928,164,0.849817,0.150183,0.849817,147,17,1093,928,165,0.849039,0.150961,0.849039,148,17,1, abandoned,1,1,0
55812,1000329,2,3600,2817,783,0.7825,0.2175,1.632317,666,117,3601,2818,783,0.78256,0.21744,1.6316,666,117,-1, abandoned,0,0,0
55813,1002169,1,797,637,160,0.799247,0.200753,0.799247,121,39,798,638,160,0.799499,0.200501,0.799499,121,39,-1, merged,0,0,0
55815,1000023,2,1527,1327,200,0.869024,0.130976,1.669024,179,21,1528,1328,200,0.86911,0.13089,1.66473,179,21,1, merged,0,0,0
55816,1000054,2,1093,928,165,0.849039,0.150961,1.698019,148,17,1094,929,165,0.849177,0.150823,1.696428,148,17,1, merged,0,0,0
55822,1000014,2,3121,2524,597,0.808715,0.191285,1.677343,555,42,3122,2525,597,0.808776,0.191224,1.67749,555,42,1, merged,0,0,0
55822,1000023,1,1530,1329,201,0.868627,0.131373,0.868627,180,21,1531,1330,201,0.868713,0.131287,0.868713,180,21,1, merged,0,0,0
55832,1000026,2,647,558,89,0.862442,0.137558,1.572968,86,3,648,558,90,0.861111,0.138889,1.572902,87,3,1, abandoned,1,1,0
55834,1000014,1,3122,2525,597,0.808776,0.191224,0.808776,555,42,3123,2526,597,0.808838,0.191162,0.808838,555,42,1, merged,0,0,0
55835,1000054,2,1094,929,165,0.849177,0.150823,1.605882,148,17,1100,932,168,0.847273,0.152727,1.60109,151,17,-1, abandoned,1,0,0
55835,1000166,1,522,395,127,0.756705,0.243295,0.756705,122,5,524,395,129,0.753817,0.246183,0.753817,124,5,1, abandoned,1,1,0
55836,1000105,1,784,622,162,0.793367,0.206633,0.793367,143,19,786,623,163,0.792621,0.207379,0.792621,144,19,-1, abandoned,1,0,0
55836,1002169,2,798,638,160,0.799499,0.200501,1.592866,121,39,799,639,160,0.79975,0.20025,1.592371,121,39,-1, abandoned,0,0,0
55837,1000054,1,1100,932,168,0.847273,0.152727,0.847273,151,17,1101,933,168,0.847411,0.152589,0.847411,151,17,1, merged,0,0,0
55841,1000009,2,1813,1500,313,0.827358,0.172642,1.398787,281,32,1814,1501,313,0.827453,0.172547,1.403924,281,32,1, merged,0,0,0
55852,1000054,1,1101,933,168,0.847411,0.152589,0.847411,151,17,1102,934,168,0.84755,0.15245,0.84755,151,17,1, merged,0,0,0
55852,1000121,2,2510,2078,432,0.827888,0.172112,1.6753,400,32,2511,2079,432,0.827957,0.172043,1.675507,400,32,1, merged,0,0,0
55853,1000054,1,1102,934,168,0.84755,0.15245,0.84755,151,17,1103,935,168,0.847688,0.152312,0.847688,151,17,1, merged,0,0,0
55853,1000121,2,2511,2079,432,0.827957,0.172043,1.675507,400,32,2512,2080,432,0.828025,0.171975,1.675714,400,32,1, merged,0,0,0
55856,1000004,1,4411,3881,530,0.879846,0.120154,0.879846,422,108,4413,3882,531,0.879674,0.120326,0.879674,423,108,1, merged,1,1,0
55856,1000120,2,2041,1781,260,0.872611,0.127389,1.752457,228,32,2042,1782,260,0.872674,0.127326,1.752348,228,32,1, merged,0,0,0
55857,1000328,1,1081,804,277,0.743756,0.256244,0.743756,250,27,1082,805,277,0.743993,0.256007,0.743993,250,27,1, merged,0,0,0
55859,1000023,1,1531,1330,201,0.868713,0.131287,0.868713,180,21,1532,1331,201,0.868799,0.131201,0.868799,180,21,-1, merged,0,0,0
55859,1000110,2,669,602,67,0.899851,0.100149,1.768564,62,5,673,604,69,0.897474,0.102526,1.766273,64,5,1, merged,1,1,0
55862,1000120,2,2043,1783,260,0.872736,0.127264,1.655357,228,32,2044,1784,260,0.872798,0.127202,1.65548,228,32,1, merged,0,0,0
55862,1000329,1,3602,2819,783,0.782621,0.217379,0.782621,666,117,3603,2820,783,0.782681,0.217319,0.782681,666,117,1, merged,0,0,0
55863,1000120,2,2044,1784,260,0.872798,0.127202,1.65548,228,32,2045,1785,260,0.872861,0.127139,1.655602,228,32,1, merged,0,0,0
55863,1000329,1,3603,2820,783,0.782681,0.217319,0.782681,666,117,3604,2821,783,0.782741,0.217259,0.782741,666,117,1, merged,0,0,0
55888,1000108,2,477,407,70,0.853249,0.146751,1.695769,65,5,478,408,70,0.853556,0.146444,1.692772,65,5,1, merged,0,0,0
55889,1000004,2,4417,3886,531,0.879783,0.120217,1.739851,423,108,4418,3886,532,0.879584,0.120416,1.73989,424,108,1, abandoned,1,1,0
55892,1000132,2,796,672,124,0.844221,0.155779,1.691472,102,22,797,673,124,0.844417,0.155583,1.691978,102,22,-1, abandoned,0,0,0
55898,1000004,2,4419,3887,532,0.879611,0.120389,1.379611,424,108,4420,3888,532,0.879638,0.120362,1.546305,424,108,1, merged,0,0,0
55899,1000108,3,478,408,70,0.853556,0.146444,2.581021,65,5,479,409,70,0.853862,0.146138,2.583321,65,5,1, merged,0,0,0
55905,1000014,1,3125,2527,598,0.80864,0.19136,0.80864,556,42,3128,2529,599,0.808504,0.191496,0.808504,557,42,-1, merged,1,0,0
55905,1000105,2,786,623,163,0.792621,0.207379,1.601261,144,19,788,625,163,0.793147,0.206853,1.601651,144,19,-1, merged,0,0,0
55909,1000004,2,4421,3889,532,0.879665,0.120335,1.74855,424,108,4422,3890,532,0.879692,0.120308,1.748662,424,108,1, merged,0,0,0
55909,1000023,1,1533,1332,201,0.868885,0.131115,0.868885,180,21,1534,1333,201,0.86897,0.13103,0.86897,180,21,1, merged,0,0,0
55915,1000023,1,1534,1333,201,0.86897,0.13103,0.86897,180,21,1536,1335,201,0.869141,0.130859,0.869141,180,21,1, merged,0,0,0
55917,1000121,1,2518,2086,432,0.828435,0.171565,0.828435,400,32,2519,2087,432,0.828503,0.171497,0.828503,400,32,1, merged,0,0,0
55917,1000592,2,862,737,125,0.854988,0.145012,1.683424,78,47,863,738,125,0.855156,0.144844,1.68366,78,47,1, merged,0,0,0
55925,1000054,1,1107,938,169,0.847335,0.152665,0.847335,152,17,1108,939,169,0.847473,0.152527,0.847473,152,17,1, merged,0,0,0
55927,1000004,2,4422,3890,532,0.879692,0.120308,1.688196,424,108,4423,3891,532,0.87972,0.12028,1.688407,424,108,-1, merged,0,0,0
55927,1000014,1,3128,2529,599,0.808504,0.191496,0.808504,557,42,3131,2532,599,0.808687,0.191313,0.808687,557,42,-1, merged,0,0,0
55930,1000023,1,1538,1337,201,0.869311,0.130689,0.869311,180,21,1539,1338,201,0.869396,0.130604,0.869396,180,21,1, merged,0,0,0
55954,1000023,1,1539,1338,201,0.869396,0.130604,0.869396,180,21,1540,1338,202,0.868831,0.131169,0.868831,181,21,1, merged,1,1,0
55954,1000132,2,797,673,124,0.844417,0.155583,1.713812,102,22,798,673,125,0.843358,0.156642,1.71219,103,22,1, merged,1,1,0
55962,1000132,1,798,673,125,0.843358,0.156642,0.843358,103,22,800,674,126,0.8425,0.1575,0.8425,104,22,1, merged,1,1,0
55963,1000003,2,1483,1233,250,0.831423,0.168577,1.666009,214,36,1484,1234,250,0.831536,0.168464,1.666742,214,36,-1, abandoned,0,0,0
55964,1000003,1,1484,1234,250,0.831536,0.168464,0.831536,214,36,1485,1235,250,0.83165,0.16835,0.83165,214,36,1, merged,0,0,0
55964,1000054,2,1110,941,169,0.847748,0.152252,1.679284,152,17,1111,942,169,0.847885,0.152115,1.679535,152,17,1, merged,0,0,0
55969,1000003,2,1485,1235,250,0.83165,0.16835,1.699507,214,36,1487,1237,250,0.831876,0.168124,1.700204,214,36,1, merged,0,0,0
55971,1000003,1,1487,1237,250,0.831876,0.168124,0.831876,214,36,1488,1238,250,0.831989,0.168011,0.831989,214,36,1, merged,0,0,0
55976,1000132,1,800,674,126,0.8425,0.1575,0.8425,104,22,801,675,126,0.842697,0.157303,0.842697,104,22,-1, abandoned,0,0,0
55978,1000004,1,4427,3895,532,0.879828,0.120172,0.879828,424,108,4428,3895,533,0.87963,0.12037,0.87963,424,109,-1, merged,1,1,0
55978,1000120,2,2047,1787,260,0.872985,0.127015,1.752813,228,32,2048,1787,261,0.872559,0.127441,1.752188,228,33,-1, merged,1,1,0
55982,1000054,1,1111,942,169,0.847885,0.152115,0.847885,152,17,1112,943,169,0.848022,0.151978,0.848022,152,17,1, merged,0,0,0
55982,1000199,2,586,500,86,0.853242,0.146758,1.701127,79,7,587,501,86,0.853492,0.146508,1.701514,79,7,1, merged,0,0,0
55988,1000054,1,1112,943,169,0.848022,0.151978,0.848022,152,17,1113,944,169,0.848158,0.151842,0.848158,152,17,1, merged,0,0,0
55988,1000199,2,587,501,86,0.853492,0.146508,1.701514,79,7,588,502,86,0.853741,0.146259,1.7019,79,7,1, merged,0,0,0
55991,1000534,2,567,436,131,0.768959,0.231041,1.632596,117,14,568,437,131,0.769366,0.230634,1.634231,117,14,1, merged,0,0,0
55996,1000054,1,1113,944,169,0.848158,0.151842,0.848158,152,17,1114,945,169,0.848294,0.151706,0.848294,152,17,1, merged,0,0,0
55996,1000329,2,3606,2823,783,0.782862,0.217138,1.63102,666,117,3607,2824,783,0.782922,0.217078,1.631217,666,117,1, merged,0,0,0
55998,1000130,2,674,552,122,0.818991,0.181009,1.662963,90,32,675,553,122,0.819259,0.180741,1.663965,90,32,-1, abandoned,0,0,0
55998,1000140,1,423,357,66,0.843972,0.156028,0.843972,58,8,425,359,66,0.844706,0.155294,0.844706,58,8,-1, abandoned,0,0,0
55999,1000014,2,3131,2532,599,0.808687,0.191313,1.651825,557,42,3132,2533,599,0.808748,0.191252,1.652397,557,42,1, merged,0,0,0
56005,1000004,1,4428,3895,533,0.87963,0.12037,0.87963,424,109,4429,3896,533,0.879657,0.120343,0.879657,424,109,1, merged,0,0,0
56005,1000120,2,2048,1787,261,0.872559,0.127441,1.752188,228,33,2049,1788,261,0.872621,0.127379,1.752278,228,33,1, merged,0,0,0
56016,1000004,2,4435,3902,533,0.87982,0.12018,1.748614,424,109,4436,3903,533,0.879847,0.120153,1.749105,424,109,1, merged,0,0,0
56020,1000004,5,4437,3904,533,0.879874,0.120126,4.014781,424,109,4438,3905,533,0.879901,0.120099,4.031172,424,109,1, merged,0,0,0
56020,1000132,3,803,677,126,0.843088,0.156912,2.254907,104,22,804,677,127,0.84204,0.15796,2.299419,105,22,1, merged,1,1,0
56022,1000003,2,1488,1238,250,0.831989,0.168011,1.701708,214,36,1489,1239,250,0.832102,0.167898,1.702278,214,36,1, merged,0,0,0
56034,1000023,1,1543,1341,202,0.869086,0.130914,0.869086,181,21,1544,1341,203,0.868523,0.131477,0.868523,182,21,1, merged,1,1,0
56036,1000007,2,1806,1452,354,0.803987,0.196013,1.713078,315,39,1809,1455,354,0.804312,0.195688,1.716592,315,39,-1, merged,0,0,0
56036,1000132,3,804,677,127,0.84204,0.15796,2.555117,105,22,806,678,128,0.841191,0.158809,2.557784,106,22,-1, merged,1,0,0
56037,1000003,2,1490,1240,250,0.832215,0.167785,1.702844,214,36,1492,1241,251,0.831769,0.168231,1.699825,215,36,1, merged,1,1,0
56038,1000004,1,4438,3905,533,0.879901,0.120099,0.879901,424,109,4440,3907,533,0.879955,0.120045,0.879955,424,109,-1, merged,0,0,0
56038,1000132,2,806,678,128,0.841191,0.158809,1.721092,106,22,807,679,128,0.841388,0.158612,1.721343,106,22,1, merged,0,0,0
56040,1000004,1,4440,3907,533,0.879955,0.120045,0.879955,424,109,4443,3909,534,0.879811,0.120189,0.879811,425,109,-1, merged,1,0,0
56040,1000132,2,807,679,128,0.841388,0.158612,1.721343,106,22,809,680,129,0.840544,0.159456,1.720355,107,22,1, merged,1,1,0
56046,1000120,2,2049,1788,261,0.872621,0.127379,1.733086,228,33,2050,1789,261,0.872683,0.127317,1.73361,228,33,1, merged,0,0,0
56055,1000110,1,686,616,70,0.897959,0.102041,0.897959,65,5,687,617,70,0.898108,0.101892,0.898108,65,5,1, merged,0,0,0
56055,1000140,2,425,359,66,0.844706,0.155294,1.742665,58,8,426,360,66,0.84507,0.15493,1.743178,58,8,1, merged,0,0,0
56064,1000091,3,668,530,138,0.793413,0.206587,2.337155,115,23,669,531,138,0.793722,0.206278,2.337264,115,23,1, merged,0,0,0
56064,1000328,1,1082,805,277,0.743993,0.256007,0.743993,250,27,1084,806,278,0.743542,0.256458,0.743542,251,27,1, merged,1,1,0
56064,1002169,2,799,639,160,0.79975,0.20025,1.543742,121,39,800,640,160,0.8,0.2,1.543542,121,39,-1, merged,0,0,0
56065,1000110,3,687,617,70,0.898108,0.101892,2.529847,65,5,688,618,70,0.898256,0.101744,2.530983,65,5,1, merged,0,0,0
56066,1000054,2,1115,946,169,0.84843,0.15157,1.555197,152,17,1116,947,169,0.848566,0.151434,1.557522,152,17,1, merged,0,0,0
56068,1000140,2,426,360,66,0.84507,0.15493,1.641367,58,8,427,361,66,0.845433,0.154567,1.640636,58,8,1, merged,0,0,0
56070,1000014,1,3133,2534,599,0.808809,0.191191,0.808809,557,42,3134,2535,599,0.80887,0.19113,0.80887,557,42,1, merged,0,0,0
56071,1000105,2,790,627,163,0.793671,0.206329,1.641497,144,19,791,628,163,0.793932,0.206068,1.64258,144,19,1, merged,0,0,0
56072,1000329,3,3607,2824,783,0.782922,0.217078,2.488714,666,117,3608,2825,783,0.782982,0.217018,2.507445,666,117,1, merged,0,0,0
56074,1000592,2,863,738,125,0.855156,0.144844,1.645633,78,47,864,739,125,0.855324,0.144676,1.647777,78,47,1, merged,0,0,0
56075,1000592,2,864,739,125,0.855324,0.144676,1.647777,78,47,865,739,126,0.854335,0.145665,1.639382,79,47,1, abandoned,1,1,0
56077,1000004,2,4444,3910,534,0.879838,0.120162,1.688708,425,109,4445,3911,534,0.879865,0.120135,1.688796,425,109,1, merged,0,0,0
56077,1000014,1,3134,2535,599,0.80887,0.19113,0.80887,557,42,3135,2536,599,0.808931,0.191069,0.808931,557,42,1, merged,0,0,0
56079,1000014,1,3137,2538,599,0.809053,0.190947,0.809053,557,42,3139,2539,600,0.808856,0.191144,0.808856,558,42,-1, abandoned,1,0,0
56079,1000091,2,669,531,138,0.793722,0.206278,1.602775,115,23,671,533,138,0.794337,0.205663,1.603193,115,23,-1, abandoned,0,0,0
56081,1000199,2,589,503,86,0.85399,0.14601,1.630806,79,7,592,506,86,0.85473,0.14527,1.632316,79,7,-1, merged,0,0,0
56083,1000054,1,1116,947,169,0.848566,0.151434,0.848566,152,17,1118,948,170,0.847943,0.152057,0.847943,153,17,1, merged,1,1,0
56086,1000014,1,3139,2539,600,0.808856,0.191144,0.808856,558,42,3141,2540,601,0.80866,0.19134,0.80866,559,42,1, merged,1,1,0
56091,1000014,1,3141,2540,601,0.80866,0.19134,0.80866,559,42,3142,2541,601,0.808721,0.191279,0.808721,559,42,1, merged,0,0,0
56091,1000070,2,1491,1269,222,0.851107,0.148893,1.659766,194,28,1492,1270,222,0.851206,0.148794,1.659927,194,28,1, merged,0,0,0
56093,1002169,1,800,640,160,0.8,0.2,0.8,121,39,801,641,160,0.80025,0.19975,0.80025,121,39,-1, merged,0,0,0
56096,1000054,1,1118,948,170,0.847943,0.152057,0.847943,153,17,1121,951,170,0.84835,0.15165,0.84835,153,17,-1, merged,0,0,0
56096,1000105,2,791,628,163,0.793932,0.206068,1.641874,144,19,793,630,163,0.794451,0.205549,1.642801,144,19,-1, merged,0,0,0
56097,1000014,2,3142,2541,601,0.808721,0.191279,1.467599,559,42,3143,2542,601,0.808781,0.191219,1.469247,559,42,1, merged,0,0,0
56098,1000014,2,3143,2542,601,0.808781,0.191219,1.469247,559,42,3144,2543,601,0.808842,0.191158,1.470879,559,42,1, merged,0,0,0
56100,1000009,1,1815,1502,313,0.827548,0.172452,0.827548,281,32,1816,1503,313,0.827643,0.172357,0.827643,281,32,1, merged,0,0,0
56100,1000120,2,2051,1790,261,0.872745,0.127255,1.700293,228,33,2052,1791,261,0.872807,0.127193,1.70045,228,33,1, merged,0,0,0
56102,1000329,1,3608,2825,783,0.782982,0.217018,0.782982,666,117,3609,2826,783,0.783042,0.216958,0.783042,666,117,-1, abandoned,0,0,0
56111,1000070,2,1492,1270,222,0.851206,0.148794,1.724522,194,28,1493,1271,222,0.851306,0.148694,1.724962,194,28,1, merged,0,0,0
56114,1000004,2,4445,3911,534,0.879865,0.120135,1.740792,425,109,4446,3912,534,0.879892,0.120108,1.741278,425,109,1, merged,0,0,0
56122,1000023,1,1544,1341,203,0.868523,0.131477,0.868523,182,21,1545,1342,203,0.868608,0.131392,0.868608,182,21,1, merged,0,0,0
56122,1000329,2,3609,2826,783,0.783042,0.216958,1.651566,666,117,3610,2827,783,0.783102,0.216898,1.651711,666,117,1, merged,0,0,0
56126,1000054,2,1122,952,170,0.848485,0.151515,1.694279,153,17,1124,954,170,0.848754,0.151246,1.693302,153,17,-1, merged,0,0,0
56126,1000110,3,688,618,70,0.898256,0.101744,2.592535,65,5,689,619,70,0.898403,0.101597,2.591705,65,5,1, merged,0,0,0
56126,1000140,1,428,362,66,0.845794,0.154206,0.845794,58,8,431,364,67,0.844548,0.155452,0.844548,59,8,-1, merged,1,0,0
56127,1000014,2,3145,2544,601,0.808903,0.191097,1.69407,559,42,3146,2545,601,0.808964,0.191036,1.69048,559,42,1, merged,0,0,0
56130,1000109,1,674,577,97,0.856083,0.143917,0.856083,92,5,675,578,97,0.856296,0.143704,0.856296,92,5,-1, merged,0,0,0
56130,1000199,2,592,506,86,0.85473,0.14527,1.710813,79,7,593,507,86,0.854975,0.145025,1.711271,79,7,1, merged,0,0,0
56137,1000007,1,1813,1458,355,0.804192,0.195808,0.804192,315,40,1814,1459,355,0.8043,0.1957,0.8043,315,40,1, merged,0,0,0
56137,1000026,2,648,558,90,0.861111,0.138889,1.665303,87,3,649,559,90,0.861325,0.138675,1.665625,87,3,1, merged,0,0,0
56142,1000003,2,1496,1245,251,0.832219,0.167781,1.712219,215,36,1498,1247,251,0.832443,0.167557,1.712273,215,36,-1, abandoned,0,0,0
56142,1000004,1,4450,3916,534,0.88,0.12,0.88,425,109,4452,3917,535,0.879829,0.120171,0.879829,426,109,-1, abandoned,1,0,0
56148,1000070,1,1493,1271,222,0.851306,0.148694,0.851306,194,28,1494,1272,222,0.851406,0.148594,0.851406,194,28,1, merged,0,0,0
56158,1000534,2,572,438,134,0.765734,0.234266,1.496503,120,14,573,438,135,0.764398,0.235602,1.485917,121,14,1, abandoned,1,1,0
56159,1000592,2,865,739,126,0.854335,0.145665,1.632113,79,47,866,740,126,0.854503,0.145497,1.63432,79,47,1, merged,0,0,0
56163,1000014,1,3146,2545,601,0.808964,0.191036,0.808964,559,42,3147,2546,601,0.809024,0.190976,0.809024,559,42,1, merged,0,0,0
56163,1000120,2,2053,1792,261,0.872869,0.127131,1.681833,228,33,2054,1793,261,0.872931,0.127069,1.681955,228,33,1, merged,0,0,0
56166,1000004,1,4452,3917,535,0.879829,0.120171,0.879829,426,109,4453,3918,535,0.879856,0.120144,0.879856,426,109,-1, merged,0,0,0
56167,1000004,2,4453,3918,535,0.879856,0.120144,1.7204,426,109,4455,3920,535,0.87991,0.12009,1.717549,426,109,-1, merged,0,0,0
56167,1000132,1,809,680,129,0.840544,0.159456,0.840544,107,22,813,681,132,0.837638,0.162362,0.837638,110,22,1, merged,1,1,0
56171,1000014,2,3147,2546,601,0.809024,0.190976,1.657779,559,42,3148,2547,601,0.809085,0.190915,1.658108,559,42,1, merged,0,0,0
56171,1000054,1,1124,954,170,0.848754,0.151246,0.848754,153,17,1126,956,170,0.849023,0.150977,0.849023,153,17,1, merged,0,0,0
56176,1000007,1,1816,1461,355,0.804515,0.195485,0.804515,315,40,1818,1461,357,0.80363,0.19637,0.80363,317,40,1, abandoned,1,1,0
56176,1000009,2,1820,1506,314,0.827473,0.172527,1.631988,282,32,1821,1506,315,0.827018,0.172982,1.630648,283,32,1, abandoned,1,1,0
56192,1000110,2,689,619,70,0.898403,0.101597,1.732352,65,5,690,620,70,0.898551,0.101449,1.73311,65,5,1, merged,0,0,0
56197,1000014,2,3149,2548,601,0.809146,0.190854,1.690662,559,42,3150,2549,601,0.809206,0.190794,1.691282,559,42,1, merged,0,0,0
56199,1000003,2,1498,1247,251,0.832443,0.167557,1.609366,215,36,1499,1248,251,0.832555,0.167445,1.610333,215,36,1, merged,0,0,0
56201,1000120,2,2054,1793,261,0.872931,0.127069,1.656033,228,33,2055,1794,261,0.872993,0.127007,1.656155,228,33,1, merged,0,0,0
56201,1000329,1,3610,2827,783,0.783102,0.216898,0.783102,666,117,3611,2828,783,0.783163,0.216837,0.783163,666,117,1, merged,0,0,0
56203,1000120,2,2056,1795,261,0.873054,0.126946,1.727558,228,33,2057,1796,261,0.873116,0.126884,1.727787,228,33,1, merged,0,0,0
56203,1000592,1,866,740,126,0.854503,0.145497,0.854503,79,47,867,741,126,0.854671,0.145329,0.854671,79,47,1, merged,0,0,0
56209,1000004,1,4455,3920,535,0.87991,0.12009,0.87991,426,109,4456,3921,535,0.879937,0.120063,0.879937,426,109,1, merged,0,0,0
56211,1000329,2,3611,2828,783,0.783163,0.216837,1.489285,666,117,3612,2829,783,0.783223,0.216777,1.49054,666,117,1, merged,0,0,0
56216,1000007,1,1819,1462,357,0.803738,0.196262,0.803738,317,40,1820,1463,357,0.803846,0.196154,0.803846,317,40,1, merged,0,0,0
56216,1000009,2,1822,1507,315,0.827113,0.172887,1.630851,283,32,1823,1508,315,0.827208,0.172792,1.631054,283,32,1, merged,0,0,0
56219,1000054,2,1130,960,170,0.849558,0.150442,1.70463,153,17,1131,961,170,0.849691,0.150309,1.705062,153,17,1, merged,0,0,0
56219,1000108,1,483,413,70,0.855072,0.144928,0.855072,65,5,484,414,70,0.855372,0.144628,0.855372,65,5,1, merged,0,0,0
56220,1000130,3,675,553,122,0.819259,0.180741,2.351993,90,32,676,554,122,0.819527,0.180473,2.350579,90,32,1, merged,0,0,0
56220,1000329,1,3612,2829,783,0.783223,0.216777,0.783223,666,117,3613,2829,784,0.783006,0.216994,0.783006,667,117,1, merged,1,1,0
56221,1000130,3,676,554,122,0.819527,0.180473,2.350579,90,32,678,556,122,0.820059,0.179941,2.349497,90,32,-1, merged,0,0,0
56221,1000329,1,3613,2829,784,0.783006,0.216994,0.783006,667,117,3615,2830,785,0.782849,0.217151,0.782849,668,117,-1, merged,1,0,0
56224,1000026,2,650,559,91,0.86,0.14,1.544783,88,3,651,560,91,0.860215,0.139785,1.548387,88,3,1, merged,0,0,0
56227,1000105,1,795,632,163,0.794969,0.205031,0.794969,144,19,796,633,163,0.795226,0.204774,0.795226,144,19,-1, abandoned,0,0,0
56227,1000108,2,484,414,70,0.855372,0.144628,1.65034,65,5,485,415,70,0.85567,0.14433,1.650896,65,5,-1, abandoned,0,0,0
56231,1002169,2,801,641,160,0.80025,0.19975,1.546838,121,39,802,642,160,0.800499,0.199501,1.547114,121,39,-1, merged,0,0,0
56239,1000121,3,2530,2098,432,0.829249,0.170751,2.437113,400,32,2531,2099,432,0.829316,0.170684,2.44336,400,32,1, merged,0,0,0
56253,1000534,1,574,439,135,0.764808,0.235192,0.764808,121,14,576,440,136,0.763889,0.236111,0.763889,122,14,-1, merged,1,0,0
56254,1000534,1,576,440,136,0.763889,0.236111,0.763889,122,14,579,440,139,0.759931,0.240069,0.759931,125,14,1, merged,1,1,0
56255,1000014,1,3150,2549,601,0.809206,0.190794,0.809206,559,42,3151,2550,601,0.809267,0.190733,0.809267,559,42,-1, merged,0,0,0
56259,1000110,2,690,620,70,0.898551,0.101449,1.730053,65,5,691,621,70,0.898698,0.101302,1.730814,65,5,1, merged,0,0,0
56265,1000023,1,1549,1345,204,0.868302,0.131698,0.868302,183,21,1550,1345,205,0.867742,0.132258,0.867742,184,21,1, abandoned,1,1,0
56266,1000109,2,675,578,97,0.856296,0.143704,1.708148,92,5,676,579,97,0.856509,0.143491,1.713652,92,5,1, merged,0,0,0
56272,1000014,1,3151,2550,601,0.809267,0.190733,0.809267,559,42,3152,2551,601,0.809327,0.190673,0.809327,559,42,-1, merged,0,0,0
56274,1000004,1,4456,3921,535,0.879937,0.120063,0.879937,426,109,4457,3922,535,0.879964,0.120036,0.879964,426,109,1, merged,0,0,0
56274,1000015,3,2383,2126,257,0.892153,0.107847,2.679815,235,22,2384,2127,257,0.892198,0.107802,2.680085,235,22,1, merged,0,0,0
56277,1000110,2,691,621,70,0.898698,0.101302,1.730814,65,5,692,622,70,0.898844,0.101156,1.731571,65,5,1, merged,0,0,0
56284,1000004,2,4457,3922,535,0.879964,0.120036,1.717602,426,109,4458,3923,535,0.879991,0.120009,1.717829,426,109,1, merged,0,0,0
56284,1000132,1,813,681,132,0.837638,0.162362,0.837638,110,22,814,682,132,0.837838,0.162162,0.837838,110,22,-1, merged,0,0,0
56297,1000026,2,652,561,91,0.860429,0.139571,1.658409,88,3,653,562,91,0.860643,0.139357,1.660643,88,3,1, merged,0,0,0
56300,1000109,4,676,579,97,0.856509,0.143491,3.274612,92,5,677,580,97,0.856721,0.143279,3.311196,92,5,1, merged,0,0,0
56300,1000132,3,814,682,132,0.837838,0.162162,2.418103,110,22,815,683,132,0.838037,0.161963,2.454475,110,22,1, merged,0,0,0
56301,1000140,4,434,367,67,0.845622,0.154378,3.1835,59,8,439,369,70,0.840547,0.159453,3.18376,62,8,1, merged,1,1,0
56301,1002169,2,802,642,160,0.800499,0.199501,1.596119,121,39,803,643,160,0.800747,0.199253,1.600747,121,39,-1, merged,0,0,0
56309,1000120,2,2064,1803,261,0.873547,0.126453,1.717496,228,33,2065,1804,261,0.873608,0.126392,1.718052,228,33,1, merged,0,0,0
56315,1000007,1,1823,1465,358,0.80362,0.19638,0.80362,317,41,1824,1466,358,0.803728,0.196272,0.803728,317,41,1, merged,0,0,0
56315,1000120,2,2070,1809,261,0.873913,0.126087,1.677533,228,33,2071,1810,261,0.873974,0.126026,1.677702,228,33,1, merged,0,0,0
56318,1000109,2,677,580,97,0.856721,0.143279,1.634307,92,5,678,581,97,0.856932,0.143068,1.634901,92,5,1, merged,0,0,0
56320,1000110,2,692,622,70,0.898844,0.101156,1.739391,65,5,693,623,70,0.89899,0.10101,1.74026,65,5,1, merged,0,0,0
56320,1000140,1,439,369,70,0.840547,0.159453,0.840547,62,8,441,371,70,0.84127,0.15873,0.84127,62,8,-1, merged,0,0,0
56332,1000009,2,1824,1509,315,0.827303,0.172697,1.455874,283,32,1825,1510,315,0.827397,0.172603,1.466286,283,32,1, merged,0,0,0
56335,1000007,2,1824,1466,358,0.803728,0.196272,1.677702,317,41,1825,1466,359,0.803288,0.196712,1.677322,317,42,-1, merged,1,1,0
56335,1000120,1,2071,1810,261,0.873974,0.126026,0.873974,228,33,2072,1811,261,0.874035,0.125965,0.874035,228,33,1, merged,0,0,0
56337,1000007,2,1825,1466,359,0.803288,0.196712,1.677322,317,42,1826,1467,359,0.803395,0.196605,1.677491,317,42,1, merged,0,0,0
56337,1000120,1,2072,1811,261,0.874035,0.125965,0.874035,228,33,2073,1812,261,0.874096,0.125904,0.874096,228,33,1, merged,0,0,0
56342,1000004,1,4458,3923,535,0.879991,0.120009,0.879991,426,109,4459,3923,536,0.879794,0.120206,0.879794,427,109,1, merged,1,1,0
56342,1000007,2,1826,1467,359,0.803395,0.196605,1.683386,317,42,1827,1468,359,0.803503,0.196497,1.683297,317,42,1, merged,0,0,0
56349,1000004,2,4459,3923,536,0.879794,0.120206,1.683512,427,109,4460,3924,536,0.879821,0.120179,1.683753,427,109,1, merged,0,0,0
56349,1000007,1,1829,1470,359,0.803718,0.196282,0.803718,317,42,1831,1472,359,0.803932,0.196068,0.803932,317,42,-1, merged,0,0,0
56351,1000120,2,2082,1821,261,0.87464,0.12536,1.634571,228,33,2083,1822,261,0.8747,0.1253,1.635045,228,33,1, merged,0,0,0
56351,1000534,1,579,440,139,0.759931,0.240069,0.759931,125,14,580,441,139,0.760345,0.239655,0.760345,125,14,1, merged,0,0,0
56352,1000120,2,2083,1822,261,0.8747,0.1253,1.635045,228,33,2084,1823,261,0.87476,0.12524,1.63421,228,33,1, merged,0,0,0
56352,1000534,1,580,441,139,0.760345,0.239655,0.760345,125,14,582,442,140,0.75945,0.24055,0.75945,126,14,1, merged,1,1,0
56353,1000007,2,1831,1472,359,0.803932,0.196068,1.678692,317,42,1832,1473,359,0.804039,0.195961,1.678859,317,42,1, merged,0,0,0
56353,1000120,1,2084,1823,261,0.87476,0.12524,0.87476,228,33,2085,1824,261,0.87482,0.12518,0.87482,228,33,1, merged,0,0,0
56354,1000014,2,3155,2554,601,0.809509,0.190491,1.523794,559,42,3157,2556,601,0.809629,0.190371,1.507304,559,42,-1, merged,0,0,0
56363,1000007,2,1832,1473,359,0.804039,0.195961,1.613789,317,42,1833,1474,359,0.804146,0.195854,1.613956,317,42,1, merged,0,0,0
56363,1000014,1,3159,2558,601,0.80975,0.19025,0.80975,559,42,3160,2559,601,0.80981,0.19019,0.80981,559,42,1, merged,0,0,0
56373,1000199,2,593,507,86,0.854975,0.145025,1.721413,79,7,594,508,86,0.855219,0.144781,1.722113,79,7,1, merged,0,0,0
56376,1000014,1,3164,2560,604,0.809102,0.190898,0.809102,562,42,3166,2561,605,0.808907,0.191093,0.808907,563,42,-1, abandoned,1,0,0
56376,1000026,2,653,562,91,0.860643,0.139357,1.669746,88,3,654,562,92,0.859327,0.140673,1.668234,89,3,1, abandoned,1,1,0
56379,1000007,1,1837,1477,360,0.804028,0.195972,0.804028,318,42,1839,1479,360,0.804241,0.195759,0.804241,318,42,-1, merged,0,0,0
56379,1000009,2,1826,1511,315,0.827492,0.172508,1.63152,283,32,1827,1512,315,0.827586,0.172414,1.631828,283,32,1, merged,0,0,0
56382,1000199,2,594,508,86,0.855219,0.144781,1.722113,79,7,595,509,86,0.855462,0.144538,1.722809,79,7,1, merged,0,0,0
56389,1000054,4,1131,961,170,0.849691,0.150309,2.920255,153,17,1132,961,171,0.84894,0.15106,2.88925,154,17,1, merged,1,1,0
56389,1000130,5,679,557,122,0.820324,0.179676,3.740579,90,32,682,558,124,0.818182,0.181818,3.707432,92,32,1, merged,1,1,0
56389,1002169,2,803,643,160,0.800747,0.199253,1.508064,121,39,807,647,160,0.801735,0.198265,1.510898,121,39,-1, merged,0,0,0
56404,1000199,2,596,510,86,0.855705,0.144295,1.723052,79,7,597,511,86,0.855946,0.144054,1.723743,79,7,1, merged,0,0,0
56413,1000328,1,1086,808,278,0.744015,0.255985,0.744015,251,27,1087,809,278,0.74425,0.25575,0.74425,251,27,1, merged,0,0,0
56420,1000120,2,2085,1824,261,0.87482,0.12518,1.657789,228,33,2086,1825,261,0.87488,0.12512,1.657909,228,33,1, merged,0,0,0
56420,1000329,1,3617,2832,785,0.782969,0.217031,0.782969,668,117,3618,2833,785,0.783029,0.216971,0.783029,668,117,-1, merged,0,0,0
56421,1000120,2,2086,1825,261,0.87488,0.12512,1.657909,228,33,2087,1826,261,0.87494,0.12506,1.657753,228,33,1, merged,0,0,0
56421,1000329,1,3618,2833,785,0.783029,0.216971,0.783029,668,117,3619,2833,786,0.782813,0.217187,0.782813,669,117,1, merged,1,1,0
56423,1000329,1,3620,2834,786,0.782873,0.217127,0.782873,669,117,3621,2835,786,0.782933,0.217067,0.782933,669,117,1, merged,0,0,0
56424,1000054,1,1132,961,171,0.84894,0.15106,0.84894,154,17,1133,962,171,0.849073,0.150927,0.849073,154,17,1, merged,0,0,0
56430,1000005,2,801,689,112,0.860175,0.139825,0.860175,103,9,802,690,112,0.860349,0.139651,1.860349,103,9,1, merged,0,0,0
56433,1000105,3,797,634,163,0.795483,0.204517,1.596478,144,19,798,634,164,0.794486,0.205514,2.593494,144,20,-1, merged,1,1,0
56435,1000070,2,1502,1278,224,0.850866,0.149134,1.785648,196,28,1505,1280,225,0.850498,0.149502,1.785982,196,29,1, merged,1,0,0
56439,1000121,2,2532,2100,432,0.829384,0.170616,1.612317,400,32,2533,2101,432,0.829451,0.170549,1.612444,400,32,1, merged,0,0,0
56439,1000329,1,3621,2835,786,0.782933,0.217067,0.782933,669,117,3622,2836,786,0.782993,0.217007,0.782993,669,117,1, merged,0,0,0
56450,1000014,2,3176,2570,606,0.809194,0.190806,1.58782,564,42,3177,2571,606,0.809254,0.190746,1.585769,564,42,1, merged,0,0,0
56457,1000328,1,1088,810,278,0.744485,0.255515,0.744485,251,27,1090,811,279,0.744037,0.255963,0.744037,252,27,1, merged,1,1,0
56457,1000329,2,3622,2836,786,0.782993,0.217007,1.527478,669,117,3624,2836,788,0.782561,0.217439,1.526597,671,117,1, merged,1,1,0
56458,1000110,2,693,623,70,0.89899,0.10101,1.740619,65,5,694,624,70,0.899135,0.100865,1.741122,65,5,1, merged,0,0,0
56458,1000140,1,442,372,70,0.841629,0.158371,0.841629,62,8,443,373,70,0.841986,0.158014,0.841986,62,8,1, merged,0,0,0
56462,1000105,2,798,634,164,0.794486,0.205514,1.302683,144,20,799,635,164,0.794743,0.205257,1.294743,144,20,1, merged,0,0,0
56463,1000005,2,802,690,112,0.860349,0.139651,1.689868,103,9,803,691,112,0.860523,0.139477,1.690109,103,9,1, merged,0,0,0
56463,1000121,1,2534,2102,432,0.829519,0.170481,0.829519,400,32,2535,2103,432,0.829586,0.170414,0.829586,400,32,1, merged,0,0,0
56468,1000009,2,1830,1515,315,0.827869,0.172131,1.729521,283,32,1831,1516,315,0.827963,0.172037,1.729062,283,32,1, merged,0,0,0
56468,1000153,1,1271,1146,125,0.901652,0.098348,0.901652,92,33,1274,1148,126,0.901099,0.098901,0.901099,93,33,-1, merged,1,0,0
56477,1000121,1,2535,2103,432,0.829586,0.170414,0.829586,400,32,2537,2105,432,0.82972,0.17028,0.82972,400,32,1, merged,0,0,0
56478,1000023,2,1555,1349,206,0.867524,0.132476,1.706155,185,21,1556,1350,206,0.867609,0.132391,1.706437,185,21,1, merged,0,0,0
56478,1000132,1,818,686,132,0.838631,0.161369,0.838631,110,22,819,687,132,0.838828,0.161172,0.838828,110,22,1, merged,0,0,0
56480,1000023,2,1556,1350,206,0.867609,0.132391,1.725621,185,21,1557,1351,206,0.867694,0.132306,1.725994,185,21,1, merged,0,0,0
56482,1000023,2,1557,1351,206,0.867694,0.132306,1.725994,185,21,1558,1352,206,0.867779,0.132221,1.724922,185,21,1, merged,0,0,0
56484,1000023,1,1559,1353,206,0.867864,0.132136,0.867864,185,21,1560,1354,206,0.867949,0.132051,0.867949,185,21,1, merged,0,0,0
56484,1000109,2,678,581,97,0.856932,0.143068,1.724796,92,5,679,582,97,0.857143,0.142857,1.725092,92,5,1, merged,0,0,0
56485,1000023,2,1560,1354,206,0.867949,0.132051,1.725092,185,21,1561,1355,206,0.868033,0.131967,1.725463,185,21,1, merged,0,0,0
56486,1000023,2,1561,1355,206,0.868033,0.131967,1.725463,185,21,1562,1356,206,0.868118,0.131882,1.725833,185,21,1, merged,0,0,0
56487,1000023,2,1562,1356,206,0.868118,0.131882,1.725833,185,21,1563,1357,206,0.868202,0.131798,1.726202,185,21,1, merged,0,0,0
56488,1000023,2,1563,1357,206,0.868202,0.131798,1.726202,185,21,1564,1358,206,0.868286,0.131714,1.72657,185,21,1, merged,0,0,0
56489,1000023,2,1564,1358,206,0.868286,0.131714,1.72657,185,21,1565,1359,206,0.868371,0.131629,1.726936,185,21,1, merged,0,0,0
56490,1000023,2,1565,1359,206,0.868371,0.131629,1.726936,185,21,1566,1360,206,0.868455,0.131545,1.727302,185,21,1, merged,0,0,0
56491,1000023,2,1566,1360,206,0.868455,0.131545,1.727302,185,21,1567,1361,206,0.868539,0.131461,1.727666,185,21,1, merged,0,0,0
56493,1000023,2,1567,1361,206,0.868539,0.131461,1.727666,185,21,1568,1362,206,0.868622,0.131378,1.728028,185,21,1, merged,0,0,0
56508,1000534,2,584,444,140,0.760274,0.239726,1.642903,126,14,586,445,141,0.759386,0.240614,1.633804,127,14,1, merged,1,1,0
56511,1000023,1,1568,1362,206,0.868622,0.131378,0.868622,185,21,1569,1363,206,0.868706,0.131294,0.868706,185,21,1, merged,0,0,0
56512,1000023,1,1569,1363,206,0.868706,0.131294,0.868706,185,21,1570,1364,206,0.86879,0.13121,0.86879,185,21,1, merged,0,0,0
56513,1000023,1,1570,1364,206,0.86879,0.13121,0.86879,185,21,1571,1365,206,0.868873,0.131127,0.868873,185,21,1, merged,0,0,0
56514,1000023,2,1571,1365,206,0.868873,0.131127,1.72911,185,21,1572,1366,206,0.868957,0.131043,1.729468,185,21,1, merged,0,0,0
56515,1000023,2,1572,1366,206,0.868957,0.131043,1.729468,185,21,1573,1367,206,0.86904,0.13096,1.729824,185,21,1, merged,0,0,0
56525,1000026,1,654,562,92,0.859327,0.140673,0.859327,89,3,655,562,93,0.858015,0.141985,0.858015,90,3,1, merged,1,1,0
56526,1000023,1,1573,1367,206,0.86904,0.13096,0.86904,185,21,1575,1369,206,0.869206,0.130794,0.869206,185,21,-1, merged,0,0,0
56528,1000012,1,755,649,106,0.859603,0.140397,0.859603,103,3,756,650,106,0.859788,0.140212,0.859788,103,3,1, merged,0,0,0
56549,1000023,2,1576,1370,206,0.869289,0.130711,1.725256,185,21,1577,1371,206,0.869372,0.130628,1.725635,185,21,1, merged,0,0,0
56549,1000108,1,486,416,70,0.855967,0.144033,0.855967,65,5,487,417,70,0.856263,0.143737,0.856263,65,5,1, merged,0,0,0
56550,1000023,1,1577,1371,206,0.869372,0.130628,0.869372,185,21,1578,1372,206,0.869455,0.130545,0.869455,185,21,-1, abandoned,0,0,0
56551,1000054,2,1133,962,171,0.849073,0.150927,1.400797,154,17,1134,963,171,0.849206,0.150794,1.415873,154,17,1, merged,0,0,0
56554,1000014,1,3177,2571,606,0.809254,0.190746,0.809254,564,42,3178,2572,606,0.809314,0.190686,0.809314,564,42,1, merged,0,0,0
56555,1000014,2,3178,2572,606,0.809314,0.190686,1.571219,564,42,3179,2573,606,0.809374,0.190626,1.576816,564,42,1, merged,0,0,0
56557,1000140,2,444,374,70,0.842342,0.157658,1.69261,62,8,445,375,70,0.842697,0.157303,1.69376,62,8,1, merged,0,0,0
56559,1000012,1,757,651,106,0.859974,0.140026,0.859974,103,3,758,652,106,0.860158,0.139842,0.860158,103,3,1, merged,0,0,0
56559,1000153,2,1274,1148,126,0.901099,0.098901,1.761072,93,33,1275,1149,126,0.901176,0.098824,1.761335,93,33,1, merged,0,0,0
56563,1000004,2,4463,3927,536,0.879901,0.120099,1.588235,427,109,4464,3928,536,0.879928,0.120072,1.594214,427,109,1, merged,0,0,0
56564,1000023,1,1579,1373,206,0.869538,0.130462,0.869538,185,21,1580,1374,206,0.86962,0.13038,0.86962,185,21,1, merged,0,0,0
56564,1000132,2,819,687,132,0.838828,0.161172,1.708366,110,22,820,688,132,0.839024,0.160976,1.708645,110,22,1, merged,0,0,0
56579,1000012,1,758,652,106,0.860158,0.139842,0.860158,103,3,760,653,107,0.859211,0.140789,0.859211,104,3,1, merged,1,1,0
56580,1000004,2,4464,3928,536,0.879928,0.120072,1.747275,427,109,4465,3929,536,0.879955,0.120045,1.747976,427,109,-1, merged,0,0,0
56580,1000009,3,1832,1517,315,0.828057,0.171943,2.575332,283,32,1833,1518,315,0.828151,0.171849,2.576126,283,32,1, merged,0,0,0
56581,1000153,2,1277,1151,126,0.901331,0.098669,1.769352,93,33,1278,1152,126,0.901408,0.098592,1.76757,93,33,1, merged,0,0,0
56592,1000004,1,4465,3929,536,0.879955,0.120045,0.879955,427,109,4466,3930,536,0.879982,0.120018,0.879982,427,109,1, merged,0,0,0
56593,1000140,1,446,376,70,0.843049,0.156951,0.843049,62,8,448,377,71,0.841518,0.158482,0.841518,63,8,-1, merged,1,0,0
56597,1000070,1,1508,1283,225,0.850796,0.149204,0.850796,196,29,1509,1284,225,0.850895,0.149105,0.850895,196,29,1, merged,0,0,0
56597,1000105,2,800,636,164,0.795,0.205,1.645796,144,20,801,637,164,0.795256,0.204744,1.646151,144,20,1, merged,0,0,0
56603,1000009,3,1834,1519,315,0.828244,0.171756,2.497155,283,32,1835,1520,315,0.828338,0.171662,2.498221,283,32,1, merged,0,0,0
56603,1000014,2,3180,2574,606,0.809434,0.190566,1.668911,564,42,3181,2575,606,0.809494,0.190506,1.669883,564,42,1, merged,0,0,0
56608,1000105,2,801,637,164,0.795256,0.204744,1.795256,144,20,803,639,164,0.795766,0.204234,1.795766,144,20,-1, merged,0,0,0
56613,1000023,1,1580,1374,206,0.86962,0.13038,0.86962,185,21,1583,1376,207,0.869236,0.130764,0.869236,186,21,1, merged,1,1,0
56614,1000054,2,1134,963,171,0.849206,0.150794,1.621934,154,17,1136,965,171,0.849472,0.150528,1.569472,154,17,-1, merged,0,0,0
56615,1000023,1,1583,1376,207,0.869236,0.130764,0.869236,186,21,1584,1377,207,0.869318,0.130682,0.869318,186,21,1, merged,0,0,0
56617,1000023,1,1584,1377,207,0.869318,0.130682,0.869318,186,21,1585,1378,207,0.869401,0.130599,0.869401,186,21,1, merged,0,0,0
56618,1000023,2,1585,1378,207,0.869401,0.130599,1.708425,186,21,1588,1379,209,0.868388,0.131612,1.705569,188,21,1, merged,1,1,0
56618,1000132,1,820,688,132,0.839024,0.160976,0.839024,110,22,823,689,134,0.837181,0.162819,0.837181,112,22,1, merged,1,1,0
56623,1000023,1,1588,1379,209,0.868388,0.131612,0.868388,188,21,1589,1380,209,0.868471,0.131529,0.868471,188,21,1, merged,0,0,0
56624,1000023,1,1589,1380,209,0.868471,0.131529,0.868471,188,21,1590,1381,209,0.868553,0.131447,0.868553,188,21,1, merged,0,0,0
56627,1000023,1,1590,1381,209,0.868553,0.131447,0.868553,188,21,1591,1382,209,0.868636,0.131364,0.868636,188,21,1, merged,0,0,0
56628,1000014,3,3181,2575,606,0.809494,0.190506,2.576827,564,42,3182,2576,606,0.809554,0.190446,2.573537,564,42,1, merged,0,0,0
56628,1000015,1,2387,2130,257,0.892333,0.107667,0.892333,235,22,2389,2132,257,0.892424,0.107576,0.892424,235,22,-1, merged,0,0,0
56629,1000023,1,1591,1382,209,0.868636,0.131364,0.868636,188,21,1592,1383,209,0.868719,0.131281,0.868719,188,21,1, merged,0,0,0
56636,1000023,2,1593,1384,209,0.868801,0.131199,1.729222,188,21,1594,1385,209,0.868883,0.131117,1.72957,188,21,1, merged,0,0,0
56639,1000023,3,1594,1385,209,0.868883,0.131117,2.574015,188,21,1595,1386,209,0.868966,0.131034,2.577744,188,21,-1, abandoned,0,0,0
56640,1000023,2,1595,1386,209,0.868966,0.131034,1.729918,188,21,1596,1387,209,0.869048,0.130952,1.730264,188,21,1, merged,0,0,0
56641,1000014,1,3183,2577,606,0.809614,0.190386,0.809614,564,42,3185,2579,606,0.809733,0.190267,0.809733,564,42,-1, merged,0,0,0
56641,1000054,2,1136,965,171,0.849472,0.150528,1.659085,154,17,1137,966,171,0.849604,0.150396,1.659337,154,17,1, merged,0,0,0
56642,1000023,2,1596,1387,209,0.869048,0.130952,1.730264,188,21,1597,1388,209,0.86913,0.13087,1.73061,188,21,1, merged,0,0,0
56655,1000023,3,1598,1389,209,0.869212,0.130788,1.560701,188,21,1599,1390,209,0.869293,0.130707,1.897363,188,21,1, merged,0,0,0
56659,1000054,1,1137,966,171,0.849604,0.150396,0.849604,154,17,1138,966,172,0.848858,0.151142,0.848858,155,17,1, abandoned,1,1,0
56659,1000105,2,803,639,164,0.795766,0.204234,1.64537,144,20,804,640,164,0.79602,0.20398,1.644878,144,20,-1, abandoned,0,0,0
56660,1000004,4,4468,3932,536,0.880036,0.119964,3.37804,427,109,4469,3933,536,0.880063,0.119937,3.377685,427,109,1, merged,0,0,0
56660,1000014,1,3185,2579,606,0.809733,0.190267,0.809733,564,42,3188,2580,608,0.809285,0.190715,0.809285,566,42,1, merged,1,1,0
56660,1000023,3,1599,1390,209,0.869293,0.130707,2.498005,188,21,1601,1391,210,0.868832,0.131168,2.497622,189,21,1, merged,1,1,0
56660,1000130,2,685,561,124,0.818978,0.181022,1.628711,92,32,687,563,124,0.819505,0.180495,1.62879,92,32,-1, merged,0,0,0
56665,1002169,1,807,647,160,0.801735,0.198265,0.801735,121,39,808,647,161,0.800743,0.199257,0.800743,121,40,-1, merged,1,1,0
56668,1000003,1,1504,1252,252,0.832447,0.167553,0.832447,216,36,1505,1252,253,0.831894,0.168106,0.831894,216,37,-1, merged,1,1,0
56668,1000153,2,1278,1152,126,0.901408,0.098592,1.733855,93,33,1279,1152,127,0.900704,0.099296,1.732597,93,34,-1, merged,1,1,0
56677,1000023,1,1601,1391,210,0.868832,0.131168,0.868832,189,21,1604,1392,212,0.86783,0.13217,0.86783,191,21,-1, merged,1,0,0
56679,1000014,1,3188,2580,608,0.809285,0.190715,0.809285,566,42,3189,2581,608,0.809345,0.190655,0.809345,566,42,1, merged,0,0,0
56683,1000110,2,696,625,71,0.897989,0.102011,1.757512,66,5,697,626,71,0.898135,0.101865,1.751563,66,5,-1, merged,0,0,0
56683,1000140,3,450,379,71,0.842222,0.157778,2.599735,63,8,452,380,72,0.840708,0.159292,2.592271,64,8,1, merged,1,1,0
56735,1000014,2,3190,2582,608,0.809404,0.190596,1.621744,566,42,3191,2583,608,0.809464,0.190536,1.622763,566,42,1, merged,0,0,0
56738,1000108,3,489,419,70,0.856851,0.143149,1.69791,65,5,490,420,70,0.857143,0.142857,1.698901,65,5,1, merged,0,0,0
56738,1000140,1,453,381,72,0.84106,0.15894,0.84106,64,8,455,383,72,0.841758,0.158242,0.841758,64,8,-1, merged,0,0,0
56742,1000070,2,1517,1292,225,0.851681,0.148319,1.652424,196,29,1518,1292,226,0.85112,0.14888,1.650873,196,30,-1, merged,1,1,0
56742,1002169,1,808,647,161,0.800743,0.199257,0.800743,121,40,809,647,162,0.799753,0.200247,0.799753,121,41,-1, merged,1,1,0
56747,1000109,2,679,582,97,0.857143,0.142857,1.72583,92,5,680,583,97,0.857353,0.142647,1.723125,92,5,-1, merged,0,0,0
56754,1000023,1,1608,1396,212,0.868159,0.131841,0.868159,191,21,1609,1397,212,0.868241,0.131759,0.868241,191,21,1, merged,0,0,0
56754,1000109,2,680,583,97,0.857353,0.142647,1.725512,92,5,681,584,97,0.857562,0.142438,1.725804,92,5,1, merged,0,0,0
56756,1000004,2,4471,3935,536,0.880116,0.119884,1.78082,427,109,4472,3936,536,0.880143,0.119857,1.780924,427,109,1, merged,0,0,0
56756,1000011,3,922,847,75,0.918655,0.081345,2.699475,70,5,923,848,75,0.918743,0.081257,2.699668,70,5,1, merged,0,0,0
56756,1000153,1,1279,1152,127,0.900704,0.099296,0.900704,93,34,1280,1153,127,0.900781,0.099219,0.900781,93,34,1, merged,0,0,0
56762,1000012,1,764,657,107,0.859948,0.140052,0.859948,104,3,765,657,108,0.858824,0.141176,0.858824,105,3,1, merged,1,1,0
56766,1000108,3,490,420,70,0.857143,0.142857,2.222008,65,5,491,421,70,0.857434,0.142566,2.215841,65,5,1, merged,0,0,0
56775,1000023,1,1610,1398,212,0.868323,0.131677,0.868323,191,21,1611,1398,213,0.867784,0.132216,0.867784,192,21,1, abandoned,1,1,0
56778,1000011,1,924,849,75,0.918831,0.081169,0.918831,70,5,926,850,76,0.917927,0.082073,0.917927,71,5,1, merged,1,1,0
56778,1000120,2,2091,1830,261,0.875179,0.124821,1.794011,228,33,2092,1831,261,0.875239,0.124761,1.793166,228,33,1, merged,0,0,0
56781,1000023,1,1611,1398,213,0.867784,0.132216,0.867784,192,21,1612,1399,213,0.867866,0.132134,0.867866,192,21,1, merged,0,0,0
56784,1000023,1,1612,1399,213,0.867866,0.132134,0.867866,192,21,1615,1400,215,0.866873,0.133127,0.866873,192,23,-1, merged,1,1,0
56788,1000023,1,1615,1400,215,0.866873,0.133127,0.866873,192,23,1616,1401,215,0.866955,0.133045,0.866955,192,23,1, merged,0,0,0
56788,1000109,2,682,585,97,0.857771,0.142229,1.724644,92,5,683,586,97,0.85798,0.14202,1.724935,92,5,1, merged,0,0,0
56789,1000004,2,4472,3936,536,0.880143,0.119857,1.717916,427,109,4474,3938,536,0.880197,0.119803,1.718165,427,109,1, merged,0,0,0
56789,1000132,1,826,692,134,0.837772,0.162228,0.837772,112,22,827,693,134,0.837969,0.162031,0.837969,112,22,1, merged,0,0,0
56794,1000026,3,657,564,93,0.858447,0.141553,2.487916,90,3,658,564,94,0.857143,0.142857,2.484212,91,3,1, merged,1,1,0
56794,1000132,1,828,694,134,0.838164,0.161836,0.838164,112,22,829,694,135,0.837153,0.162847,0.837153,113,22,1, merged,1,1,0
56809,1000009,4,1841,1526,315,0.828897,0.171103,2.977917,283,32,1842,1527,315,0.82899,0.17101,2.970146,283,32,1, merged,0,0,0
56809,1000014,3,3192,2584,608,0.809524,0.190476,2.14902,566,42,3194,2586,608,0.809643,0.190357,2.141155,566,42,-1, merged,0,0,0
56809,1000534,1,595,454,141,0.763025,0.236975,0.763025,127,14,596,454,142,0.761745,0.238255,0.761745,128,14,1, merged,1,1,0
56816,1000004,5,4474,3938,536,0.880197,0.119803,4.124077,427,109,4475,3939,536,0.880223,0.119777,4.1281,427,109,1, merged,0,0,0
56816,1000023,4,1631,1414,217,0.866953,0.133047,3.243881,194,23,1632,1415,217,0.867034,0.132966,3.247876,194,23,1, merged,0,0,0
56816,1000054,1,1138,966,172,0.848858,0.151142,0.848858,155,17,1139,967,172,0.84899,0.15101,0.84899,155,17,1, merged,0,0,0
56818,1000026,2,658,564,94,0.857143,0.142857,1.706133,91,3,659,565,94,0.85736,0.14264,1.706482,91,3,1, merged,0,0,0
56818,1000054,1,1139,967,172,0.84899,0.15101,0.84899,155,17,1140,968,172,0.849123,0.150877,0.849123,155,17,1, merged,0,0,0
56832,1000329,2,3625,2837,788,0.782621,0.217379,1.491784,671,117,3626,2838,788,0.782681,0.217319,1.48903,671,117,1, merged,0,0,0
56835,1000023,2,1632,1415,217,0.867034,0.132966,1.686539,194,23,1633,1415,218,0.866503,0.133497,1.686271,194,24,-1, merged,1,1,0
56835,1000130,1,687,563,124,0.819505,0.180495,0.819505,92,32,688,564,124,0.819767,0.180233,0.819767,92,32,1, merged,0,0,0
56837,1000009,2,1843,1528,315,0.829083,0.170917,1.685578,283,32,1845,1529,316,0.828726,0.171274,1.68393,284,32,1, merged,1,1,0
56837,1000026,1,662,567,95,0.856495,0.143505,0.856495,92,3,663,567,96,0.855204,0.144796,0.855204,93,3,1, merged,1,1,0
56841,1000011,2,927,851,76,0.918015,0.081985,1.818874,71,5,928,852,76,0.918103,0.081897,1.819039,71,5,1, merged,0,0,0
56841,1000153,1,1281,1154,127,0.900859,0.099141,0.900859,93,34,1282,1155,127,0.900936,0.099064,0.900936,93,34,1, merged,0,0,0
56870,1000105,1,805,641,164,0.796273,0.203727,0.796273,144,20,806,642,164,0.796526,0.203474,0.796526,144,20,1, merged,0,0,0
56872,1000110,2,703,630,73,0.896159,0.103841,1.74272,68,5,704,631,73,0.896307,0.103693,1.738412,68,5,1, merged,0,0,0
56877,1000023,2,1637,1419,218,0.86683,0.13317,1.749183,194,24,1638,1420,218,0.866911,0.133089,1.750406,194,24,1, merged,0,0,0
56879,1000009,3,1845,1529,316,0.828726,0.171274,2.208196,284,32,1847,1530,317,0.82837,0.17163,2.194697,285,32,1, merged,1,1,0
56879,1000014,2,3195,2587,608,0.809703,0.190297,1.37947,566,42,3197,2588,609,0.809509,0.190491,1.366327,567,42,1, merged,1,1,0
56891,1000003,4,1507,1254,253,0.832117,0.167883,3.057088,216,37,1508,1255,253,0.832228,0.167772,3.157488,216,37,1, merged,0,0,0
56891,1000023,3,1639,1421,218,0.866992,0.133008,2.224972,194,24,1640,1422,218,0.867073,0.132927,2.32526,194,24,1, merged,0,0,0
56891,1000109,2,683,586,97,0.85798,0.14202,1.35798,92,5,684,587,97,0.858187,0.141813,1.458187,92,5,1, merged,0,0,0
56896,1000004,2,4476,3940,536,0.88025,0.11975,1.795913,427,109,4477,3941,536,0.880277,0.119723,1.796944,427,109,1, merged,0,0,0
56910,1000023,1,1643,1425,218,0.867316,0.132684,0.867316,194,24,1645,1426,219,0.866869,0.133131,0.866869,195,24,1, merged,1,1,0
56916,1000015,1,2399,2142,257,0.892872,0.107128,0.892872,235,22,2400,2143,257,0.892917,0.107083,0.892917,235,22,1, merged,0,0,0
56917,1000199,2,602,516,86,0.857143,0.142857,1.554817,79,7,603,517,86,0.85738,0.14262,1.561925,79,7,1, merged,0,0,0
56918,1000132,1,830,695,135,0.837349,0.162651,0.837349,113,22,831,696,135,0.837545,0.162455,0.837545,113,22,1, merged,0,0,0
56920,1000130,1,689,565,124,0.820029,0.179971,0.820029,92,32,690,566,124,0.82029,0.17971,0.82029,92,32,1, merged,0,0,0
56920,1000329,3,3627,2839,788,0.782741,0.217259,2.395453,671,117,3628,2840,788,0.7828,0.2172,2.398271,671,117,1, merged,0,0,0
56923,1000009,2,1847,1530,317,0.82837,0.17163,1.637879,285,32,1848,1531,317,0.828463,0.171537,1.638032,285,32,1, merged,0,0,0
56923,1000014,1,3197,2588,609,0.809509,0.190491,0.809509,567,42,3198,2589,609,0.809568,0.190432,0.809568,567,42,1, merged,0,0,0
56937,1000026,2,663,567,96,0.855204,0.144796,1.716906,93,3,664,568,96,0.855422,0.144578,1.717856,93,3,1, merged,0,0,0
56941,1000023,2,1646,1427,219,0.86695,0.13305,1.733617,195,24,1647,1428,219,0.867031,0.132969,1.734141,195,24,1, merged,0,0,0
56943,1000005,2,825,711,114,0.861818,0.138182,1.692007,105,9,827,712,115,0.860943,0.139057,1.691199,106,9,1, merged,1,1,0
56943,1000121,1,2544,2112,432,0.830189,0.169811,0.830189,400,32,2545,2113,432,0.830255,0.169745,0.830255,400,32,-1, merged,0,0,0
56949,1000130,2,690,566,124,0.82029,0.17971,1.65937,92,32,691,567,124,0.82055,0.17945,1.657052,92,32,1, merged,0,0,0
56950,1000005,2,827,712,115,0.860943,0.139057,1.691199,106,9,828,713,115,0.861111,0.138889,1.691433,106,9,1, merged,0,0,0
56950,1000121,1,2545,2113,432,0.830255,0.169745,0.830255,400,32,2546,2114,432,0.830322,0.169678,0.830322,400,32,1, merged,0,0,0
56951,1000132,2,831,696,135,0.837545,0.162455,1.629212,113,22,832,696,136,0.836538,0.163462,1.621662,114,22,1, abandoned,1,1,0
56956,1000003,3,1509,1256,253,0.832339,0.167661,2.561839,216,37,1510,1257,253,0.83245,0.16755,2.561775,216,37,1, merged,0,0,0
56956,1000015,1,2401,2144,257,0.892961,0.107039,0.892961,235,22,2402,2144,258,0.89259,0.10741,0.89259,236,22,1, merged,1,1,0
56956,1000132,2,832,696,136,0.836538,0.163462,1.7295,114,22,833,697,136,0.836735,0.163265,1.729324,114,22,1, merged,0,0,0
56957,1000003,2,1510,1257,253,0.83245,0.16755,1.72504,216,37,1512,1258,254,0.832011,0.167989,1.724229,217,37,1, merged,1,1,0
56957,1000015,1,2402,2144,258,0.89259,0.10741,0.89259,236,22,2403,2144,259,0.892218,0.107782,0.892218,237,22,1, merged,1,1,0
56958,1000132,1,833,697,136,0.836735,0.163265,0.836735,114,22,834,697,137,0.835731,0.164269,0.835731,115,22,1, abandoned,1,1,0
56967,1000003,1,1513,1259,254,0.832122,0.167878,0.832122,217,37,1514,1259,255,0.831572,0.168428,0.831572,218,37,1, merged,1,1,0
56967,1000014,3,3201,2592,609,0.809747,0.190253,2.543036,567,42,3204,2594,610,0.809613,0.190387,2.540952,568,42,1, merged,1,1,0
56967,1000153,2,1285,1158,127,0.901167,0.098833,1.733289,93,34,1287,1158,129,0.899767,0.100233,1.731339,95,34,1, merged,1,1,0
56980,1000014,1,3204,2594,610,0.809613,0.190387,0.809613,568,42,3206,2596,610,0.809732,0.190268,0.809732,568,42,-1, merged,0,0,0
56981,1000109,2,685,588,97,0.858394,0.141606,1.725504,92,5,686,589,97,0.858601,0.141399,1.72615,92,5,1, merged,0,0,0
56998,1000004,2,4480,3943,537,0.880134,0.119866,1.752745,427,110,4481,3944,537,0.880161,0.119839,1.753177,427,110,1, merged,0,0,0
57006,1000534,2,596,454,142,0.761745,0.238255,1.636184,128,14,597,455,142,0.762144,0.237856,1.637144,128,14,1, merged,0,0,0
57014,1000005,2,829,714,115,0.861279,0.138721,1.691601,106,9,830,715,115,0.861446,0.138554,1.691834,106,9,1, merged,0,0,0
57014,1000121,1,2546,2114,432,0.830322,0.169678,0.830322,400,32,2547,2115,432,0.830389,0.169611,0.830389,400,32,1, merged,0,0,0
57023,1000015,1,2404,2145,259,0.892263,0.107737,0.892263,237,22,2405,2145,260,0.891892,0.108108,0.891892,238,22,1, merged,1,1,0
57023,1000026,2,664,568,96,0.855422,0.144578,1.747685,93,3,665,569,96,0.855639,0.144361,1.747531,93,3,1, merged,0,0,0
57025,1000054,3,1141,969,172,0.849255,0.150745,2.646131,155,17,1142,970,172,0.849387,0.150613,2.647391,155,17,1, merged,0,0,0
57038,1000015,2,2405,2145,260,0.891892,0.108108,1.891892,238,22,2406,2146,260,0.891937,0.108063,1.891937,238,22,1, merged,0,0,0
57044,1000108,1,497,427,70,0.859155,0.140845,0.859155,65,5,498,428,70,0.859438,0.140562,0.859438,65,5,1, merged,0,0,0
57051,1000140,2,460,388,72,0.843478,0.156522,1.643231,64,8,463,391,72,0.844492,0.155508,1.644492,64,8,-1, merged,0,0,0
57051,1002169,1,809,647,162,0.799753,0.200247,0.799753,121,41,810,648,162,0.8,0.2,0.8,121,41,-1, merged,0,0,0
57056,1000014,1,3206,2596,610,0.809732,0.190268,0.809732,568,42,3207,2597,610,0.809791,0.190209,0.809791,568,42,1, merged,0,0,0
57058,1000023,1,1658,1439,219,0.867913,0.132087,0.867913,195,24,1659,1439,220,0.86739,0.13261,0.86739,196,24,1, merged,1,1,0
57058,1000108,2,499,429,70,0.859719,0.140281,1.727633,65,5,501,430,71,0.858283,0.141717,1.725673,66,5,1, merged,1,1,0
57058,1000110,4,708,635,73,0.896893,0.103107,3.467457,68,5,709,636,73,0.897038,0.102962,3.466462,68,5,1, merged,0,0,0
57068,1000054,1,1142,970,172,0.849387,0.150613,0.849387,155,17,1143,971,172,0.849519,0.150481,0.849519,155,17,1, merged,0,0,0
57070,1000054,1,1143,971,172,0.849519,0.150481,0.849519,155,17,1144,971,173,0.848776,0.151224,0.848776,156,17,1, abandoned,1,1,0
57072,1000014,1,3207,2597,610,0.809791,0.190209,0.809791,568,42,3209,2599,610,0.80991,0.19009,0.80991,568,42,1, merged,0,0,0
57072,1000153,2,1291,1162,129,0.900077,0.099923,1.709869,95,34,1292,1163,129,0.900155,0.099845,1.710064,95,34,1, merged,0,0,0
57085,1000108,2,501,430,71,0.858283,0.141717,1.695405,66,5,502,431,71,0.858566,0.141434,1.696302,66,5,1, merged,0,0,0
57094,1000009,2,1852,1535,317,0.828834,0.171166,1.5905,285,32,1853,1536,317,0.828926,0.171074,1.590989,285,32,1, merged,0,0,0
57094,1000534,1,600,457,143,0.761667,0.238333,0.761667,129,14,601,458,143,0.762063,0.237937,0.762063,129,14,1, merged,0,0,0
57097,1000009,2,1853,1536,317,0.828926,0.171074,1.684565,285,32,1854,1537,317,0.829018,0.170982,1.684874,285,32,1, merged,0,0,0
57097,1000026,1,665,569,96,0.855639,0.144361,0.855639,93,3,666,570,96,0.855856,0.144144,0.855856,93,3,1, merged,0,0,0
57098,1000140,2,464,392,72,0.844828,0.155172,1.678763,64,8,465,393,72,0.845161,0.154839,1.679694,64,8,1, merged,0,0,0
57101,1000007,2,1854,1491,363,0.804207,0.195793,1.639939,321,42,1856,1493,363,0.804418,0.195582,1.639149,321,42,-1, merged,0,0,0
57101,1000109,3,686,589,97,0.858601,0.141399,2.498539,92,5,688,591,97,0.859012,0.140988,2.49816,92,5,-1, merged,0,0,0
57101,1000132,1,834,697,137,0.835731,0.164269,0.835731,115,22,835,697,138,0.834731,0.165269,0.834731,116,22,1, merged,1,1,0
57108,1000023,1,1663,1442,221,0.867108,0.132892,0.867108,197,24,1664,1443,221,0.867188,0.132812,0.867188,197,24,1, merged,0,0,0
57108,1000109,2,688,591,97,0.859012,0.140988,1.726119,92,5,689,592,97,0.859216,0.140784,1.726404,92,5,1, merged,0,0,0
57109,1000014,1,3209,2599,610,0.80991,0.19009,0.80991,568,42,3211,2601,610,0.810028,0.189972,0.810028,568,42,-1, merged,0,0,0
57111,1000004,1,4481,3944,537,0.880161,0.119839,0.880161,427,110,4483,3946,537,0.880214,0.119786,0.880214,427,110,-1, merged,0,0,0
57111,1000140,3,465,393,72,0.845161,0.154839,2.625477,64,8,466,394,72,0.845494,0.154506,2.62594,64,8,1, merged,0,0,0
57111,1000153,2,1292,1163,129,0.900155,0.099845,1.780315,95,34,1293,1164,129,0.900232,0.099768,1.780446,95,34,1, merged,0,0,0
57116,1000054,1,1144,971,173,0.848776,0.151224,0.848776,156,17,1145,972,173,0.848908,0.151092,0.848908,156,17,1, merged,0,0,0
57121,1000014,2,3212,2602,610,0.810087,0.189913,1.702114,568,42,3213,2603,610,0.810146,0.189854,1.702218,568,42,1, merged,0,0,0
57121,1000015,1,2408,2148,260,0.892027,0.107973,0.892027,238,22,2409,2149,260,0.892071,0.107929,0.892071,238,22,1, merged,0,0,0
57123,1000007,2,1856,1493,363,0.804418,0.195582,1.566481,321,42,1858,1494,364,0.80409,0.19591,1.564888,322,42,1, merged,1,1,0
57123,1000534,1,601,458,143,0.762063,0.237937,0.762063,129,14,602,458,144,0.760797,0.239203,0.760797,130,14,1, merged,1,1,0
57124,1000108,2,504,433,71,0.859127,0.140873,1.707892,66,5,506,435,71,0.859684,0.140316,1.70631,66,5,-1, merged,0,0,0
57135,1000054,2,1146,972,174,0.848168,0.151832,1.622815,157,17,1147,973,174,0.8483,0.1517,1.619328,157,17,-1, abandoned,0,0,0
57138,1000109,1,690,593,97,0.85942,0.14058,0.85942,92,5,691,594,97,0.859624,0.140376,0.859624,92,5,1, merged,0,0,0
57140,1000109,1,691,594,97,0.859624,0.140376,0.859624,92,5,692,595,97,0.859827,0.140173,0.859827,92,5,1, merged,0,0,0
57141,1000007,2,1858,1494,364,0.80409,0.19591,1.564888,322,42,1860,1496,364,0.804301,0.195699,1.563837,322,42,-1, merged,0,0,0
57141,1000534,1,602,458,144,0.760797,0.239203,0.760797,130,14,603,458,145,0.759536,0.240464,0.759536,131,14,1, merged,1,1,0
57142,1000109,2,692,595,97,0.859827,0.140173,1.718146,92,5,693,596,97,0.860029,0.139971,1.718581,92,5,1, merged,0,0,0
57142,1000199,1,607,521,86,0.85832,0.14168,0.85832,79,7,608,522,86,0.858553,0.141447,0.858553,79,7,1, merged,0,0,0
57143,1000109,1,693,596,97,0.860029,0.139971,0.860029,92,5,694,596,98,0.85879,0.14121,0.85879,93,5,1, merged,1,1,0
57145,1000109,3,694,596,98,0.85879,0.14121,2.497206,93,5,695,597,98,0.858993,0.141007,2.496982,93,5,1, merged,0,0,0
57145,1000199,1,608,522,86,0.858553,0.141447,0.858553,79,7,610,523,87,0.857377,0.142623,0.857377,80,7,1, merged,1,1,0
57146,1000014,2,3214,2604,610,0.810205,0.189795,1.577647,568,42,3219,2607,612,0.809879,0.190121,1.597113,570,42,1, merged,1,1,0
57147,1000014,2,3219,2607,612,0.809879,0.190121,1.597113,570,42,3223,2608,615,0.809184,0.190816,1.584694,573,42,1, merged,1,1,0
57148,1000014,2,3223,2608,615,0.809184,0.190816,1.584694,573,42,3228,2609,619,0.80824,0.19176,1.53901,577,42,1, merged,1,1,0
57149,1000014,2,3228,2609,619,0.80824,0.19176,1.53901,577,42,3231,2610,621,0.807799,0.192201,1.51689,579,42,1, merged,1,1,0
57149,1002169,4,810,648,162,0.8,0.2,3.034662,121,41,813,650,163,0.799508,0.200492,2.997249,121,42,-1, merged,1,0,0
57150,1000014,2,3231,2610,621,0.807799,0.192201,1.51689,579,42,3233,2611,622,0.807609,0.192391,1.509363,580,42,1, merged,1,1,0
57158,1000007,2,1860,1496,364,0.804301,0.195699,1.639032,322,42,1861,1497,364,0.804406,0.195594,1.639334,322,42,1, merged,0,0,0
57158,1000132,1,835,697,138,0.834731,0.165269,0.834731,116,22,836,698,138,0.834928,0.165072,0.834928,116,22,1, merged,0,0,0
57175,1000120,1,2094,1833,261,0.875358,0.124642,0.875358,228,33,2095,1834,261,0.875418,0.124582,0.875418,228,33,1, merged,0,0,0
57175,1000153,2,1293,1164,129,0.900232,0.099768,1.77559,95,34,1294,1165,129,0.900309,0.099691,1.775727,95,34,1, merged,0,0,0
57176,1000014,1,3233,2611,622,0.807609,0.192391,0.807609,580,42,3234,2612,622,0.807669,0.192331,0.807669,580,42,-1, merged,0,0,0
57176,1000534,2,603,458,145,0.759536,0.240464,1.567145,131,14,606,461,145,0.760726,0.239274,1.568395,131,14,-1, merged,0,0,0
57177,1000009,3,1858,1541,317,0.829386,0.170614,2.15191,285,32,1860,1543,317,0.82957,0.17043,2.156105,285,32,1, merged,0,0,0
57177,1000534,1,606,461,145,0.760726,0.239274,0.760726,131,14,608,462,146,0.759868,0.240132,0.759868,132,14,1, merged,1,1,0
57178,1000004,3,4483,3946,537,0.880214,0.119786,2.647748,427,110,4484,3947,537,0.880241,0.119759,2.647879,427,110,1, merged,0,0,0
57178,1000015,2,2410,2150,260,0.892116,0.107884,1.767534,238,22,2411,2151,260,0.892161,0.107839,1.767638,238,22,1, merged,0,0,0
57178,1000120,1,2095,1834,261,0.875418,0.124582,0.875418,228,33,2096,1835,261,0.875477,0.124523,0.875477,228,33,1, merged,0,0,0
57179,1000004,3,4484,3947,537,0.880241,0.119759,2.58007,427,110,4485,3948,537,0.880268,0.119732,2.580201,427,110,1, merged,0,0,0
57179,1000014,1,3234,2612,622,0.807669,0.192331,0.807669,580,42,3235,2613,622,0.807728,0.192272,0.807728,580,42,1, merged,0,0,0
57179,1000015,2,2411,2151,260,0.892161,0.107839,1.699829,238,22,2412,2152,260,0.892206,0.107794,1.699934,238,22,1, merged,0,0,0
57180,1000004,4,4485,3948,537,0.880268,0.119732,3.407819,427,110,4486,3949,537,0.880294,0.119706,3.408344,427,110,1, merged,0,0,0
57180,1000015,3,2412,2152,260,0.892206,0.107794,2.527551,238,22,2413,2153,260,0.89225,0.10775,2.52805,238,22,1, merged,0,0,0
57180,1000120,2,2096,1835,261,0.875477,0.124523,1.635346,228,33,2097,1836,261,0.875536,0.124464,1.635799,228,33,1, merged,0,0,0
57180,1000534,1,608,462,146,0.759868,0.240132,0.759868,132,14,609,463,146,0.760263,0.239737,0.760263,132,14,1, merged,0,0,0
57181,1000004,2,4486,3949,537,0.880294,0.119706,1.772545,427,110,4487,3950,537,0.880321,0.119679,1.772616,427,110,1, merged,0,0,0
57181,1000015,1,2413,2153,260,0.89225,0.10775,0.89225,238,22,2414,2154,260,0.892295,0.107705,0.892295,238,22,1, merged,0,0,0
57182,1000004,2,4487,3950,537,0.880321,0.119679,1.772616,427,110,4488,3951,537,0.880348,0.119652,1.772687,427,110,1, merged,0,0,0
57182,1000015,1,2414,2154,260,0.892295,0.107705,0.892295,238,22,2415,2155,260,0.89234,0.10766,0.89234,238,22,1, merged,0,0,0
57183,1000004,3,4488,3951,537,0.880348,0.119652,2.53295,427,110,4489,3952,537,0.880374,0.119626,2.533414,427,110,1, merged,0,0,0
57183,1000015,2,2415,2155,260,0.89234,0.10766,1.652602,238,22,2416,2156,260,0.892384,0.107616,1.65304,238,22,1, merged,0,0,0
57183,1000534,1,609,463,146,0.760263,0.239737,0.760263,132,14,610,464,146,0.760656,0.239344,0.760656,132,14,1, merged,0,0,0
57184,1000004,3,4489,3952,537,0.880374,0.119626,2.648295,427,110,4490,3953,537,0.880401,0.119599,2.648425,427,110,1, merged,0,0,0
57184,1000015,2,2416,2156,260,0.892384,0.107616,1.767921,238,22,2417,2157,260,0.892429,0.107571,1.768024,238,22,1, merged,0,0,0
57184,1000120,1,2097,1836,261,0.875536,0.124464,0.875536,228,33,2098,1837,261,0.875596,0.124404,0.875596,228,33,1, merged,0,0,0
57185,1000004,2,4490,3953,537,0.880401,0.119599,1.77283,427,110,4491,3954,537,0.880428,0.119572,1.772901,427,110,1, merged,0,0,0
57185,1000015,1,2417,2157,260,0.892429,0.107571,0.892429,238,22,2418,2158,260,0.892473,0.107527,0.892473,238,22,1, merged,0,0,0
57186,1000004,2,4491,3954,537,0.880428,0.119572,1.772901,427,110,4492,3955,537,0.880454,0.119546,1.772972,427,110,1, merged,0,0,0
57186,1000015,1,2418,2158,260,0.892473,0.107527,0.892473,238,22,2419,2159,260,0.892518,0.107482,0.892518,238,22,1, merged,0,0,0
57189,1000014,1,3235,2613,622,0.807728,0.192272,0.807728,580,42,3237,2613,624,0.807229,0.192771,0.807229,582,42,1, abandoned,1,1,0
57189,1000153,3,1294,1165,129,0.900309,0.099691,2.346926,95,34,1295,1166,129,0.900386,0.099614,2.36551,95,34,-1, abandoned,0,0,0
57191,1000009,2,1861,1544,317,0.829661,0.170339,1.63689,285,32,1862,1545,317,0.829753,0.170247,1.637041,285,32,1, merged,0,0,0
57191,1000014,1,3237,2613,624,0.807229,0.192771,0.807229,582,42,3238,2614,624,0.807288,0.192712,0.807288,582,42,1, merged,0,0,0
57200,1000004,1,4492,3955,537,0.880454,0.119546,0.880454,427,110,4493,3955,538,0.880258,0.119742,0.880258,428,110,1, abandoned,1,1,0
57200,1000132,2,836,698,138,0.834928,0.165072,1.715382,116,22,837,699,138,0.835125,0.164875,1.715384,116,22,-1, abandoned,0,0,0
57204,1000140,2,468,396,72,0.846154,0.153846,1.681868,64,8,470,397,73,0.844681,0.155319,1.677421,65,8,1, abandoned,1,1,0
57208,1000054,1,1147,973,174,0.8483,0.1517,0.8483,157,17,1148,974,174,0.848432,0.151568,0.848432,157,17,1, merged,0,0,0
57209,1000054,1,1148,974,174,0.848432,0.151568,0.848432,157,17,1149,975,174,0.848564,0.151436,0.848564,157,17,1, merged,0,0,0
57210,1000004,2,4493,3955,538,0.880258,0.119742,1.715384,428,110,4494,3956,538,0.880285,0.119715,1.715803,428,110,-1, abandoned,0,0,0
57210,1000132,1,837,699,138,0.835125,0.164875,0.835125,116,22,839,701,138,0.835518,0.164482,0.835518,116,22,-1, abandoned,0,0,0
57211,1000004,2,4494,3956,538,0.880285,0.119715,1.630285,428,110,4495,3957,538,0.880311,0.119689,1.546978,428,110,1, merged,0,0,0
57217,1000023,2,1670,1449,221,0.867665,0.132335,1.71636,197,24,1671,1450,221,0.867744,0.132256,1.716571,197,24,1, merged,0,0,0
57217,1000054,1,1150,976,174,0.848696,0.151304,0.848696,157,17,1151,977,174,0.848827,0.151173,0.848827,157,17,1, merged,0,0,0
57225,1000110,1,719,644,75,0.895688,0.104312,0.895688,70,5,720,645,75,0.895833,0.104167,0.895833,70,5,1, merged,0,0,0
57229,1000026,1,666,570,96,0.855856,0.144144,0.855856,93,3,667,570,97,0.854573,0.145427,0.854573,94,3,1, merged,1,1,0
57235,1000003,2,1514,1259,255,0.831572,0.168428,1.699474,218,37,1515,1260,255,0.831683,0.168317,1.699146,218,37,-1, abandoned,0,0,0
57235,1000023,1,1673,1452,221,0.867902,0.132098,0.867902,197,24,1675,1453,222,0.867463,0.132537,0.867463,198,24,1, abandoned,1,1,0
57235,1000153,3,1295,1166,129,0.900386,0.099614,2.59986,95,34,1296,1167,129,0.900463,0.099537,2.599609,95,34,-1, abandoned,0,0,0
57238,1000140,2,471,398,73,0.845011,0.154989,1.678344,65,8,472,399,73,0.845339,0.154661,1.679261,65,8,1, merged,0,0,0
57245,1000023,1,1678,1456,222,0.8677,0.1323,0.8677,198,24,1681,1459,222,0.867936,0.132064,0.867936,198,24,-1, merged,0,0,0
57246,1000110,1,720,645,75,0.895833,0.104167,0.895833,70,5,721,646,75,0.895978,0.104022,0.895978,70,5,-1, merged,0,0,0
57246,1000140,2,472,399,73,0.845339,0.154661,1.741172,65,8,473,400,73,0.845666,0.154334,1.741644,65,8,1, merged,0,0,0
57252,1000009,2,1862,1545,317,0.829753,0.170247,1.643052,285,32,1863,1546,317,0.829844,0.170156,1.642027,285,32,1, merged,0,0,0
57258,1000009,2,1863,1546,317,0.829844,0.170156,1.642027,285,32,1864,1547,317,0.829936,0.170064,1.642594,285,32,1, merged,0,0,0
57259,1000009,2,1864,1547,317,0.829936,0.170064,1.642594,285,32,1865,1548,317,0.830027,0.169973,1.643158,285,32,1, merged,0,0,0
57267,1000110,2,721,646,75,0.895978,0.104022,1.741644,70,5,722,647,75,0.896122,0.103878,1.742438,70,5,1, merged,0,0,0
57267,1000140,1,473,400,73,0.845666,0.154334,0.845666,65,8,475,402,73,0.846316,0.153684,0.846316,65,8,-1, merged,0,0,0
57268,1000014,1,3239,2615,624,0.807348,0.192652,0.807348,582,42,3240,2616,624,0.807407,0.192593,0.807407,582,42,1, merged,0,0,0
57272,1000011,1,929,853,76,0.918192,0.081808,0.918192,71,5,930,854,76,0.91828,0.08172,0.91828,71,5,-1, abandoned,0,0,0
57272,1000153,2,1297,1168,129,0.90054,0.09946,1.818731,95,34,1298,1169,129,0.900616,0.099384,1.818896,95,34,-1, abandoned,0,0,0
57275,1000004,1,4496,3958,538,0.880338,0.119662,0.880338,428,110,4497,3959,538,0.880365,0.119635,0.880365,428,110,1, merged,0,0,0
57276,1000108,2,509,436,73,0.856582,0.143418,1.631811,68,5,510,437,73,0.856863,0.143137,1.633118,68,5,1, merged,0,0,0
57280,1000166,2,526,397,129,0.754753,0.245247,1.612648,124,5,527,398,129,0.755218,0.244782,1.613857,124,5,1, merged,0,0,0
57286,1000004,1,4497,3959,538,0.880365,0.119635,0.880365,428,110,4499,3960,539,0.880196,0.119804,0.880196,429,110,1, merged,1,1,0
57288,1000054,1,1157,982,175,0.848747,0.151253,0.848747,158,17,1158,982,176,0.848014,0.151986,0.848014,159,17,1, abandoned,1,1,0
57288,1000166,2,527,398,129,0.755218,0.244782,1.603965,124,5,528,398,130,0.753788,0.246212,1.601802,125,5,1, abandoned,1,1,0
57293,1000014,1,3241,2616,625,0.807158,0.192842,0.807158,583,42,3242,2617,625,0.807218,0.192782,0.807218,583,42,1, merged,0,0,0
57293,1000105,2,807,642,165,0.795539,0.204461,1.602697,144,21,808,643,165,0.795792,0.204208,1.60301,144,21,1, merged,0,0,0
57296,1000023,1,1687,1464,223,0.867813,0.132187,0.867813,198,25,1688,1465,223,0.867891,0.132109,0.867891,198,25,-1, merged,0,0,0
57297,1000014,2,3242,2617,625,0.807218,0.192782,1.707834,583,42,3243,2618,625,0.807277,0.192723,1.70797,583,42,1, merged,0,0,0
57297,1000153,1,1298,1169,129,0.900616,0.099384,0.900616,95,34,1299,1170,129,0.900693,0.099307,0.900693,95,34,1, merged,0,0,0
57304,1000166,2,528,398,130,0.753788,0.246212,1.534008,125,5,529,399,130,0.754253,0.245747,1.535275,125,5,1, merged,0,0,0
57305,1000108,2,510,437,73,0.856863,0.143137,1.703179,68,5,511,438,73,0.857143,0.142857,1.703782,68,5,1, merged,0,0,0
57305,1000140,1,475,402,73,0.846316,0.153684,0.846316,65,8,476,403,73,0.846639,0.153361,0.846639,65,8,1, merged,0,0,0
57311,1000014,1,3243,2618,625,0.807277,0.192723,0.807277,583,42,3244,2619,625,0.807337,0.192663,0.807337,583,42,1, merged,0,0,0
57312,1000009,2,1866,1549,317,0.830118,0.169882,1.591165,285,32,1867,1550,317,0.830209,0.169791,1.591647,285,32,1, merged,0,0,0
57312,1000011,4,930,854,76,0.91828,0.08172,3.316782,71,5,931,855,76,0.918367,0.081633,3.31741,71,5,1, merged,0,0,0
57312,1000014,3,3244,2619,625,0.807337,0.192663,2.398502,583,42,3245,2620,625,0.807396,0.192604,2.399043,583,42,1, merged,0,0,0
57312,1000534,1,611,465,146,0.761047,0.238953,0.761047,132,14,612,466,146,0.761438,0.238562,0.761438,132,14,1, merged,0,0,0
57313,1000009,2,1867,1550,317,0.830209,0.169791,1.591647,285,32,1868,1551,317,0.8303,0.1697,1.592127,285,32,1, merged,0,0,0
57313,1000534,1,612,466,146,0.761438,0.238562,0.761438,132,14,613,467,146,0.761827,0.238173,0.761827,132,14,1, merged,0,0,0
57314,1000009,2,1868,1551,317,0.8303,0.1697,1.592127,285,32,1869,1552,317,0.830391,0.169609,1.592606,285,32,1, merged,0,0,0
57314,1000014,3,3245,2620,625,0.807396,0.192604,2.399523,583,42,3246,2621,625,0.807455,0.192545,2.400061,583,42,1, merged,0,0,0
57314,1000534,1,613,467,146,0.761827,0.238173,0.761827,132,14,614,468,146,0.762215,0.237785,0.762215,132,14,1, merged,0,0,0
57318,1000014,2,3246,2621,625,0.807455,0.192545,1.600874,583,42,3247,2622,625,0.807515,0.192485,1.60131,583,42,-1, merged,0,0,0
57319,1000140,1,477,404,73,0.84696,0.15304,0.84696,65,8,478,405,73,0.84728,0.15272,0.84728,65,8,1, merged,0,0,0
57320,1000109,1,695,597,98,0.858993,0.141007,0.858993,93,5,697,598,99,0.857963,0.142037,0.857963,94,5,1, merged,1,1,0
57320,1000199,2,611,524,87,0.85761,0.14239,1.716603,80,7,613,526,87,0.858075,0.141925,1.716038,80,7,-1, merged,0,0,0
57323,1000110,1,722,647,75,0.896122,0.103878,0.896122,70,5,723,648,75,0.896266,0.103734,0.896266,70,5,1, merged,0,0,0
57330,1000004,3,4501,3961,540,0.880027,0.119973,2.605909,430,110,4503,3962,541,0.879858,0.120142,2.604594,431,110,-1, merged,1,0,0
57330,1000011,2,931,855,76,0.918367,0.081633,1.725882,71,5,933,856,77,0.917471,0.082529,1.724737,72,5,-1, merged,1,0,0
57330,1000014,1,3247,2622,625,0.807515,0.192485,0.807515,583,42,3248,2622,626,0.807266,0.192734,0.807266,584,42,1, merged,1,1,0
57330,1000153,4,1299,1170,129,0.900693,0.099307,3.506601,95,34,1301,1171,130,0.900077,0.099923,3.504671,96,34,1, merged,1,1,0
57345,1000004,2,4514,3973,541,0.880151,0.119849,1.740655,431,110,4515,3974,541,0.880177,0.119823,1.740915,431,110,1, merged,0,0,0
57363,1000120,2,2103,1842,261,0.875892,0.124108,1.658536,228,33,2105,1843,262,0.875534,0.124466,1.658239,229,33,1, merged,1,1,0
57363,1000329,1,3630,2841,789,0.782645,0.217355,0.782645,672,117,3631,2842,789,0.782704,0.217296,0.782704,672,117,-1, merged,0,0,0
57377,1000004,1,4522,3981,541,0.880363,0.119637,0.880363,431,110,4523,3982,541,0.880389,0.119611,0.880389,431,110,-1, abandoned,0,0,0
57377,1000023,2,1691,1468,223,0.868125,0.131875,1.748488,198,25,1692,1469,223,0.868203,0.131797,1.748592,198,25,-1, abandoned,0,0,0
57378,1000014,1,3248,2622,626,0.807266,0.192734,0.807266,584,42,3249,2623,626,0.807325,0.192675,0.807325,584,42,1, merged,0,0,0
57378,1000534,2,614,468,146,0.762215,0.237785,1.569481,132,14,615,469,146,0.762602,0.237398,1.569927,132,14,1, merged,0,0,0
57383,1000005,1,833,718,115,0.861945,0.138055,0.861945,106,9,834,719,115,0.86211,0.13789,0.86211,106,9,-1, abandoned,0,0,0
57385,1000121,3,2553,2121,432,0.830787,0.169213,2.550949,400,32,2554,2122,432,0.830854,0.169146,2.527304,400,32,1, merged,0,0,0
57389,1000054,2,1158,982,176,0.848014,0.151986,1.703186,159,17,1159,983,176,0.848145,0.151855,1.703484,159,17,1, merged,0,0,0
57389,1000592,1,870,744,126,0.855172,0.144828,0.855172,79,47,871,745,126,0.855339,0.144661,0.855339,79,47,1, merged,0,0,0
57393,1000054,3,1159,983,176,0.848145,0.151855,2.295387,159,17,1160,984,176,0.848276,0.151724,2.299449,159,17,1, merged,0,0,0
57404,1000054,2,1160,984,176,0.848276,0.151724,1.642821,159,17,1162,985,177,0.847676,0.152324,1.642595,160,17,1, merged,1,1,0
57405,1000054,3,1162,985,177,0.847676,0.152324,2.475928,160,17,1163,986,177,0.847807,0.152193,2.475569,160,17,1, merged,0,0,0
57408,1000023,2,1693,1470,223,0.868281,0.131719,1.716089,198,25,1694,1471,223,0.868359,0.131641,1.716297,198,25,1, merged,0,0,0
57408,1000054,1,1163,986,177,0.847807,0.152193,0.847807,160,17,1164,987,177,0.847938,0.152062,0.847938,160,17,1, merged,0,0,0
57409,1000004,1,4525,3984,541,0.880442,0.119558,0.880442,431,110,4527,3986,541,0.880495,0.119505,0.880495,431,110,-1, merged,0,0,0
57411,1000054,2,1164,987,177,0.847938,0.152062,1.681848,160,17,1165,988,177,0.848069,0.151931,1.682551,160,17,1, merged,0,0,0
57416,1000004,1,4527,3986,541,0.880495,0.119505,0.880495,431,110,4528,3987,541,0.880521,0.119479,0.880521,431,110,1, merged,0,0,0
57416,1000120,2,2113,1850,263,0.875532,0.124468,1.756027,230,33,2114,1851,263,0.875591,0.124409,1.756112,230,33,1, merged,0,0,0
57420,1000014,3,3249,2623,626,0.807325,0.192675,2.296141,584,42,3250,2624,626,0.807385,0.192615,2.301829,584,42,1, merged,0,0,0
57425,1000054,2,1166,989,177,0.848199,0.151801,1.683251,160,17,1168,991,177,0.848459,0.151541,1.684075,160,17,1, merged,0,0,0
57430,1000070,1,1521,1295,226,0.851414,0.148586,0.851414,196,30,1522,1295,227,0.850854,0.149146,0.850854,196,31,-1, merged,1,1,0
57432,1000005,2,836,721,115,0.86244,0.13756,1.726794,106,9,838,723,115,0.862768,0.137232,1.725268,106,9,-1, merged,0,0,0
57433,1000004,2,4528,3987,541,0.880521,0.119479,1.748958,431,110,4529,3988,541,0.880548,0.119452,1.749062,431,110,1, merged,0,0,0
57433,1000023,1,1695,1472,223,0.868437,0.131563,0.868437,198,25,1696,1473,223,0.868514,0.131486,0.868514,198,25,-1, merged,0,0,0
57435,1000004,1,4529,3988,541,0.880548,0.119452,0.880548,431,110,4530,3989,541,0.880574,0.119426,0.880574,431,110,1, merged,0,0,0
57435,1000120,2,2114,1851,263,0.875591,0.124409,1.756139,230,33,2115,1852,263,0.87565,0.12435,1.756224,230,33,1, merged,0,0,0
57442,1000012,1,772,662,110,0.857513,0.142487,0.857513,107,3,773,662,111,0.856404,0.143596,0.856404,108,3,1, merged,1,1,0
57447,1000070,2,1522,1295,227,0.850854,0.149146,1.686675,196,31,1523,1295,228,0.850295,0.149705,1.683009,197,31,1, abandoned,1,1,0
57456,1000110,2,723,648,75,0.896266,0.103734,1.396266,70,5,724,649,75,0.896409,0.103591,1.563076,70,5,1, merged,0,0,0
57457,1000054,2,1169,992,177,0.848589,0.151411,1.64244,160,17,1170,993,177,0.848718,0.151282,1.641137,160,17,1, merged,0,0,0
57458,1000003,2,1515,1260,255,0.831683,0.168317,1.662164,218,37,1516,1261,255,0.831794,0.168206,1.661922,218,37,1, merged,0,0,0
57458,1000009,1,1870,1553,317,0.830481,0.169519,0.830481,285,32,1872,1554,318,0.830128,0.169872,0.830128,286,32,1, merged,1,1,0
57458,1000534,3,615,469,146,0.762602,0.237398,2.424766,132,14,616,470,146,0.762987,0.237013,2.424909,132,14,1, merged,0,0,0
57459,1000007,2,1865,1501,364,0.804826,0.195174,1.64054,322,42,1866,1502,364,0.80493,0.19507,1.64084,322,42,1, merged,0,0,0
57459,1000132,1,840,702,138,0.835714,0.164286,0.835714,116,22,841,703,138,0.83591,0.16409,0.83591,116,22,1, merged,0,0,0
57460,1000109,2,697,598,99,0.857963,0.142037,1.638575,94,5,698,599,99,0.858166,0.141834,1.639151,94,5,1, merged,0,0,0
57461,1000023,1,1697,1474,223,0.868592,0.131408,0.868592,198,25,1698,1475,223,0.868669,0.131331,0.868669,198,25,1, merged,0,0,0
57466,1000005,2,841,725,116,0.862069,0.137931,1.692989,107,9,842,726,116,0.862233,0.137767,1.693351,107,9,-1, merged,0,0,0
57466,1000121,1,2555,2123,432,0.83092,0.16908,0.83092,400,32,2558,2126,432,0.831118,0.168882,0.831118,400,32,-1, merged,0,0,0
57469,1000004,2,4532,3990,542,0.880406,0.119594,1.66323,432,110,4535,3992,543,0.880265,0.119735,1.663053,433,110,1, merged,1,1,0
57469,1000329,1,3633,2844,789,0.782824,0.217176,0.782824,672,117,3637,2847,790,0.782788,0.217212,0.782788,673,117,-1, merged,1,0,0
57470,1000108,2,512,439,73,0.857422,0.142578,1.753831,68,5,513,440,73,0.8577,0.1423,1.754252,68,5,1, merged,0,0,0
57470,1000110,1,724,649,75,0.896409,0.103591,0.896409,70,5,725,650,75,0.896552,0.103448,0.896552,70,5,-1, merged,0,0,0
57472,1000014,1,3250,2624,626,0.807385,0.192615,0.807385,584,42,3252,2625,627,0.807196,0.192804,0.807196,585,42,1, merged,1,1,0
57481,1000005,2,842,726,116,0.862233,0.137767,1.693417,107,9,843,727,116,0.862396,0.137604,1.693646,107,9,1, merged,0,0,0
57481,1000121,1,2559,2127,432,0.831184,0.168816,0.831184,400,32,2560,2128,432,0.83125,0.16875,0.83125,400,32,1, merged,0,0,0
57482,1000108,2,513,440,73,0.8577,0.1423,1.754394,68,5,514,441,73,0.857977,0.142023,1.754813,68,5,1, merged,0,0,0
57482,1000110,1,726,651,75,0.896694,0.103306,0.896694,70,5,727,652,75,0.896836,0.103164,0.896836,70,5,1, merged,0,0,0
57495,1000026,1,667,570,97,0.854573,0.145427,0.854573,94,3,669,572,97,0.855007,0.144993,0.855007,94,3,-1, merged,0,0,0
57495,1000153,2,1302,1172,130,0.900154,0.099846,1.754726,96,34,1303,1173,130,0.90023,0.09977,1.755238,96,34,1, merged,0,0,0
57500,1000110,2,728,653,75,0.896978,0.103022,1.744258,70,5,729,654,75,0.897119,0.102881,1.743273,70,5,1, merged,0,0,0
57500,1000140,1,478,405,73,0.84728,0.15272,0.84728,65,8,481,407,74,0.846154,0.153846,0.846154,66,8,1, merged,1,1,0
57501,1000110,2,729,654,75,0.897119,0.102881,1.743273,70,5,731,655,76,0.896033,0.103967,1.742506,70,6,-1, merged,1,1,0
57501,1000140,1,481,407,74,0.846154,0.153846,0.846154,66,8,482,408,74,0.846473,0.153527,0.846473,66,8,1, merged,0,0,0
57509,1000121,2,2560,2128,432,0.83125,0.16875,1.614938,400,32,2561,2129,432,0.831316,0.168684,1.616527,400,32,-1, abandoned,0,0,0
57513,1000023,1,1700,1477,223,0.868824,0.131176,0.868824,198,25,1701,1478,223,0.868901,0.131099,0.868901,198,25,1, merged,0,0,0
57513,1000132,2,841,703,138,0.83591,0.16409,1.704733,116,22,842,704,138,0.836105,0.163895,1.705005,116,22,1, merged,0,0,0
57517,1000023,3,1701,1478,223,0.868901,0.131099,2.390954,198,25,1702,1479,223,0.868978,0.131022,2.375572,198,25,1, merged,0,0,0
57524,1000004,3,4535,3992,543,0.880265,0.119735,2.205108,433,110,4537,3994,543,0.880317,0.119683,2.194141,433,110,-1, merged,0,0,0
57529,1000054,3,1171,994,177,0.848847,0.151153,2.487739,160,17,1172,995,177,0.848976,0.151024,2.486758,160,17,1, merged,0,0,0
57529,1000140,2,482,408,74,0.846473,0.153527,1.638892,66,8,483,409,74,0.846791,0.153209,1.637782,66,8,1, merged,0,0,0
57532,1000108,3,517,444,73,0.858801,0.141199,2.541208,68,5,519,445,74,0.857418,0.142582,2.533482,69,5,1, merged,1,1,0
57532,1000140,1,483,409,74,0.846791,0.153209,0.846791,66,8,485,409,76,0.843299,0.156701,0.843299,68,8,1, merged,1,1,0
57534,1000153,2,1303,1173,130,0.90023,0.09977,1.857677,96,34,1305,1175,130,0.900383,0.099617,1.8483,96,34,1, merged,0,0,0
57539,1000108,2,519,445,74,0.857418,0.142582,1.648409,69,5,520,446,74,0.857692,0.142308,1.649807,69,5,1, merged,0,0,0
57541,1000003,2,1516,1261,255,0.831794,0.168206,1.700849,218,37,1517,1262,255,0.831905,0.168095,1.701037,218,37,1, merged,0,0,0
57541,1000023,1,1703,1480,223,0.869055,0.130945,0.869055,198,25,1704,1481,223,0.869131,0.130869,0.869131,198,25,1, merged,0,0,0
57545,1000009,3,1873,1555,318,0.830219,0.169781,2.482554,286,32,1874,1556,318,0.830309,0.169691,2.481242,286,32,1, merged,0,0,0
57545,1000011,2,936,858,78,0.916667,0.083333,1.652335,73,5,937,859,78,0.916756,0.083244,1.650933,73,5,1, merged,0,0,0
57553,1000004,1,4537,3994,543,0.880317,0.119683,0.880317,433,110,4539,3995,544,0.88015,0.11985,0.88015,434,110,1, merged,1,1,0
57553,1000091,2,672,534,138,0.794643,0.205357,1.67496,115,23,675,535,140,0.792593,0.207407,1.672742,117,23,1, merged,1,1,0
57557,1000009,3,1874,1556,318,0.830309,0.169691,2.599179,286,32,1875,1557,318,0.8304,0.1696,2.599671,286,32,1, merged,0,0,0
57557,1000153,2,1305,1175,130,0.900383,0.099617,1.768869,96,34,1306,1176,130,0.900459,0.099541,1.769271,96,34,1, merged,0,0,0
57561,1000054,3,1172,995,177,0.848976,0.151024,2.352566,160,17,1174,997,177,0.849233,0.150767,2.35483,160,17,1, merged,0,0,0
57561,1002169,1,813,650,163,0.799508,0.200492,0.799508,121,42,814,650,164,0.798526,0.201474,0.798526,121,43,-1, merged,1,1,0
57562,1000166,3,530,400,130,0.754717,0.245283,2.265324,125,5,531,401,130,0.755179,0.244821,2.26966,125,5,1, merged,0,0,0
57563,1000004,2,4539,3995,544,0.88015,0.11985,1.58015,434,110,4540,3996,544,0.880176,0.119824,1.607449,434,110,1, merged,0,0,0
57568,1000015,1,2429,2169,260,0.89296,0.10704,0.89296,238,22,2430,2170,260,0.893004,0.106996,0.893004,238,22,1, merged,0,0,0
57572,1000130,3,693,568,125,0.819625,0.180375,2.44538,93,32,694,568,126,0.818444,0.181556,2.43939,94,32,1, merged,1,1,0
57572,1000140,1,485,409,76,0.843299,0.156701,0.843299,68,8,487,411,76,0.843943,0.156057,0.843943,68,8,-1, merged,0,0,0
57574,1000015,1,2430,2170,260,0.893004,0.106996,0.893004,238,22,2434,2171,263,0.891947,0.108053,0.891947,241,22,1, merged,1,1,0
57574,1000153,2,1307,1177,130,0.900536,0.099464,1.79354,96,34,1309,1179,130,0.900688,0.099312,1.792635,96,34,-1, merged,0,0,0
57578,1000004,2,4540,3996,544,0.880176,0.119824,1.676245,434,110,4543,3998,545,0.880035,0.119965,1.674153,435,110,-1, abandoned,1,0,0
57583,1000004,3,4543,3998,545,0.880035,0.119965,2.611123,435,110,4544,3999,545,0.880062,0.119938,2.610095,435,110,-1, merged,0,0,0
57583,1000007,4,1873,1507,366,0.804592,0.195408,3.415714,323,43,1875,1509,366,0.8048,0.1952,3.414895,323,43,-1, merged,0,0,0
57583,1000009,2,1875,1557,318,0.8304,0.1696,1.731088,286,32,1876,1557,319,0.829957,0.170043,1.730034,287,32,1, merged,1,1,0
57583,1000153,1,1309,1179,130,0.900688,0.099312,0.900688,96,34,1311,1180,131,0.900076,0.099924,0.900076,97,34,-1, merged,1,0,0
57601,1000023,2,1706,1483,223,0.869285,0.130715,1.705584,198,25,1707,1484,223,0.869361,0.130639,1.705854,198,25,1, merged,0,0,0
57601,1000132,1,843,705,138,0.836299,0.163701,0.836299,116,22,844,706,138,0.836493,0.163507,0.836493,116,22,1, merged,0,0,0
57616,1000004,1,4544,3999,545,0.880062,0.119938,0.880062,435,110,4545,4000,545,0.880088,0.119912,0.880088,435,110,1, merged,0,0,0
57616,1000054,2,1177,1000,177,0.849618,0.150382,1.729679,160,17,1178,1001,177,0.849745,0.150255,1.729833,160,17,1, merged,0,0,0
57621,1000012,1,780,667,113,0.855128,0.144872,0.855128,110,3,781,668,113,0.855314,0.144686,0.855314,110,3,1, merged,0,0,0
57664,1000110,1,735,659,76,0.896599,0.103401,0.896599,70,6,736,660,76,0.896739,0.103261,0.896739,70,6,1, merged,0,0,0
57665,1000110,3,736,660,76,0.896739,0.103261,2.522752,70,6,737,661,76,0.896879,0.103121,2.523825,70,6,1, merged,0,0,0
57674,1000014,3,3255,2628,627,0.807373,0.192627,2.596513,585,42,3256,2629,627,0.807432,0.192568,2.596457,585,42,1, merged,0,0,0
57674,1000054,1,1178,1001,177,0.849745,0.150255,0.849745,160,17,1179,1001,178,0.849025,0.150975,0.849025,161,17,1, merged,1,1,0
57680,1000140,3,487,411,76,0.843943,0.156057,2.408598,68,8,488,412,76,0.844262,0.155738,2.403643,68,8,1, merged,0,0,0
57705,1000105,2,814,649,165,0.797297,0.202703,1.582705,144,21,816,651,165,0.797794,0.202206,1.576518,144,21,-1, merged,0,0,0
57705,1000108,4,522,447,75,0.856322,0.143678,3.212999,70,5,523,448,75,0.856597,0.143403,3.205223,70,5,1, merged,0,0,0
57706,1000054,2,1179,1001,178,0.849025,0.150975,1.680538,161,17,1180,1002,178,0.849153,0.150847,1.680731,161,17,1, merged,0,0,0
57706,1000121,1,2564,2132,432,0.831513,0.168487,0.831513,400,32,2565,2133,432,0.831579,0.168421,0.831579,400,32,1, merged,0,0,0
57714,1000023,2,1713,1490,223,0.869819,0.130181,1.536486,198,25,1714,1491,223,0.869895,0.130105,1.469895,198,25,1, merged,0,0,0
57723,1000014,1,3257,2630,627,0.807492,0.192508,0.807492,585,42,3258,2631,627,0.807551,0.192449,0.807551,585,42,1, merged,0,0,0
57733,1000003,1,1518,1263,255,0.832016,0.167984,0.832016,218,37,1519,1264,255,0.832126,0.167874,0.832126,218,37,-1, abandoned,0,0,0
57733,1000153,2,1316,1184,132,0.899696,0.100304,1.731712,98,34,1317,1185,132,0.899772,0.100228,1.731899,98,34,-1, abandoned,0,0,0
57741,1000009,2,1881,1562,319,0.830409,0.169591,1.397076,287,32,1882,1563,319,0.830499,0.169501,1.401928,287,32,1, merged,0,0,0
57742,1000009,2,1882,1563,319,0.830499,0.169501,1.401928,287,32,1883,1564,319,0.830589,0.169411,1.400482,287,32,1, merged,0,0,0
57744,1000014,2,3258,2631,627,0.807551,0.192449,1.585328,585,42,3259,2632,627,0.80761,0.19239,1.586207,585,42,1, merged,0,0,0
57749,1000005,2,852,736,116,0.86385,0.13615,1.69556,107,9,853,737,116,0.864009,0.135991,1.695461,107,9,1, merged,0,0,0
57749,1000121,1,2567,2135,432,0.83171,0.16829,0.83171,400,32,2569,2136,433,0.831452,0.168548,0.831452,400,33,-1, merged,1,0,0
57757,1000009,3,1886,1567,319,0.830859,0.169141,2.256191,287,32,1887,1568,319,0.830949,0.169051,2.261071,287,32,1, merged,0,0,0
57757,1000026,2,671,574,97,0.85544,0.14456,1.425332,94,3,672,575,97,0.855655,0.144345,1.430123,94,3,1, merged,0,0,0
57760,1000026,1,672,575,97,0.855655,0.144345,0.855655,94,3,673,575,98,0.854383,0.145617,0.854383,95,3,1, merged,1,1,0
57760,1000120,3,2116,1853,263,0.875709,0.124291,2.591013,230,33,2117,1854,263,0.875768,0.124232,2.591021,230,33,1, merged,0,0,0
57767,1002169,1,814,650,164,0.798526,0.201474,0.798526,121,43,816,652,164,0.79902,0.20098,0.79902,121,43,-1, merged,0,0,0
57776,1000108,1,523,448,75,0.856597,0.143403,0.856597,70,5,524,448,76,0.854962,0.145038,0.854962,71,5,1, merged,1,1,0
57776,1000140,2,488,412,76,0.844262,0.155738,1.700859,68,8,489,413,76,0.844581,0.155419,1.699543,68,8,1, merged,0,0,0
57777,1000004,2,4547,4001,546,0.879921,0.120079,1.756844,436,110,4548,4002,546,0.879947,0.120053,1.754565,436,110,1, merged,0,0,0
57777,1000023,3,1720,1496,224,0.869767,0.130233,2.626611,199,25,1721,1497,224,0.869843,0.130157,2.624408,199,25,1, merged,0,0,0
57778,1000007,2,1877,1511,366,0.805008,0.194992,1.70425,323,43,1878,1512,366,0.805112,0.194888,1.704431,323,43,1, merged,0,0,0
57778,1000153,1,1320,1187,133,0.899242,0.100758,0.899242,99,34,1321,1188,133,0.899319,0.100681,0.899319,99,34,1, merged,0,0,0
57779,1000007,2,1878,1512,366,0.805112,0.194888,1.704431,323,43,1879,1513,366,0.805216,0.194784,1.70461,323,43,1, merged,0,0,0
57779,1000153,1,1321,1188,133,0.899319,0.100681,0.899319,99,34,1322,1189,133,0.899395,0.100605,0.899395,99,34,1, merged,0,0,0
57784,1000015,2,2442,2179,263,0.892301,0.107699,1.619574,241,22,2443,2180,263,0.892345,0.107655,1.642345,241,22,1, merged,0,0,0
57785,1000009,2,1887,1568,319,0.830949,0.169051,1.405417,287,32,1888,1569,319,0.831038,0.168962,1.409986,287,32,1, merged,0,0,0
57788,1000003,1,1519,1264,255,0.832126,0.167874,0.832126,218,37,1521,1266,255,0.832347,0.167653,0.832347,218,37,-1, abandoned,0,0,0
57794,1000108,1,524,448,76,0.854962,0.145038,0.854962,71,5,525,449,76,0.855238,0.144762,0.855238,71,5,-1, merged,0,0,0
57794,1000110,3,737,661,76,0.896879,0.103121,2.596422,70,6,738,662,76,0.897019,0.102981,2.597155,70,6,1, merged,0,0,0
57794,1000140,2,489,413,76,0.844581,0.155419,1.699543,68,8,490,414,76,0.844898,0.155102,1.700136,68,8,1, merged,0,0,0
57795,1000007,3,1879,1513,366,0.805216,0.194784,2.377721,323,43,1881,1515,366,0.805423,0.194577,2.378365,323,43,1, merged,0,0,0
57795,1000014,2,3259,2632,627,0.80761,0.19239,1.572505,585,42,3260,2633,627,0.807669,0.192331,1.572942,585,42,1, merged,0,0,0
57795,1000534,1,621,475,146,0.764895,0.235105,0.764895,132,14,622,476,146,0.765273,0.234727,0.765273,132,14,-1, merged,0,0,0
57803,1000009,2,1888,1569,319,0.831038,0.168962,0.831038,287,32,1889,1570,319,0.831128,0.168872,1.331128,287,32,1, merged,0,0,0
57806,1000004,1,4548,4002,546,0.879947,0.120053,0.879947,436,110,4549,4002,547,0.879754,0.120246,0.879754,437,110,1, merged,1,1,0
57806,1000120,2,2117,1854,263,0.875768,0.124232,1.755715,230,33,2118,1855,263,0.875826,0.124174,1.75558,230,33,-1, merged,0,0,0
57815,1000108,2,525,449,76,0.855238,0.144762,1.648095,71,5,526,450,76,0.855513,0.144487,1.64874,71,5,1, merged,0,0,0
57817,1000023,2,1721,1497,224,0.869843,0.130157,1.744843,199,25,1722,1498,224,0.869919,0.130081,1.742259,199,25,1, merged,0,0,0
57819,1000026,1,678,580,98,0.855457,0.144543,0.855457,95,3,680,581,99,0.854412,0.145588,0.854412,96,3,1, merged,1,1,0
57819,1000153,2,1322,1189,133,0.899395,0.100605,1.754852,99,34,1324,1191,133,0.899547,0.100453,1.753959,99,34,-1, merged,0,0,0
57822,1000004,3,4549,4002,547,0.879754,0.120246,2.69641,437,110,4550,4002,548,0.87956,0.12044,2.693886,438,110,1, abandoned,1,1,0
57822,1000011,2,941,863,78,0.917109,0.082891,1.816656,73,5,942,863,79,0.916136,0.083864,1.814326,74,5,1, abandoned,1,1,0
57822,1000153,1,1324,1191,133,0.899547,0.100453,0.899547,99,34,1326,1191,135,0.89819,0.10181,0.89819,101,34,1, abandoned,1,1,0
57825,1000009,1,1889,1570,319,0.831128,0.168872,0.831128,287,32,1890,1571,319,0.831217,0.168783,0.831217,287,32,1, merged,0,0,0
57830,1000004,1,4550,4002,548,0.87956,0.12044,0.87956,438,110,4551,4003,548,0.879587,0.120413,0.879587,438,110,1, merged,0,0,0
57830,1000329,2,3640,2850,790,0.782967,0.217033,1.662527,673,117,3641,2851,790,0.783027,0.216973,1.662614,673,117,1, merged,0,0,0
57831,1000023,3,1722,1498,224,0.869919,0.130081,2.520318,199,25,1723,1499,224,0.869994,0.130006,2.493071,199,25,1, merged,0,0,0
57839,1000108,1,526,450,76,0.855513,0.144487,0.855513,71,5,527,451,76,0.855787,0.144213,0.855787,71,5,1, merged,0,0,0
57839,1000110,2,740,664,76,0.897297,0.102703,1.752811,70,6,741,665,76,0.897436,0.102564,1.753223,70,6,1, merged,0,0,0
57841,1000003,1,1521,1266,255,0.832347,0.167653,0.832347,218,37,1522,1266,256,0.8318,0.1682,0.8318,219,37,1, merged,1,1,0
57841,1000007,2,1881,1515,366,0.805423,0.194577,1.63777,323,43,1883,1517,366,0.805629,0.194371,1.63743,323,43,-1, merged,0,0,0
57844,1000534,2,622,476,146,0.765273,0.234727,1.344221,132,14,623,477,146,0.76565,0.23435,1.348983,132,14,1, merged,0,0,0
57845,1000004,2,4552,4004,548,0.879613,0.120387,1.721198,438,110,4553,4005,548,0.87964,0.12036,1.718664,438,110,1, merged,0,0,0
57852,1000007,1,1885,1519,366,0.805836,0.194164,0.805836,323,43,1888,1521,367,0.805614,0.194386,0.805614,324,43,-1, merged,1,0,0
57852,1000014,2,3260,2633,627,0.807669,0.192331,1.613504,585,42,3262,2635,627,0.807787,0.192213,1.613401,585,42,-1, merged,0,0,0
57861,1000009,2,1890,1571,319,0.831217,0.168783,1.596867,287,32,1891,1572,319,0.831306,0.168694,1.597706,287,32,1, merged,0,0,0
57861,1000534,1,623,477,146,0.76565,0.23435,0.76565,132,14,625,479,146,0.7664,0.2336,0.7664,132,14,1, merged,0,0,0
57862,1000009,2,1891,1572,319,0.831306,0.168694,1.597706,287,32,1893,1574,319,0.831484,0.168516,1.597035,287,32,1, merged,0,0,0
57862,1000534,1,625,479,146,0.7664,0.2336,0.7664,132,14,627,480,147,0.76555,0.23445,0.76555,132,15,-1, merged,1,1,0
57863,1000009,2,1893,1574,319,0.831484,0.168516,1.597035,287,32,1894,1575,319,0.831573,0.168427,1.597497,287,32,1, merged,0,0,0
57863,1000534,1,627,480,147,0.76555,0.23445,0.76555,132,15,628,481,147,0.765924,0.234076,0.765924,132,15,1, merged,0,0,0
57867,1000329,2,3641,2851,790,0.783027,0.216973,1.692118,673,117,3642,2852,790,0.783086,0.216914,1.694851,673,117,1, merged,0,0,0
57872,1000004,1,4553,4005,548,0.87964,0.12036,0.87964,438,110,4555,4005,550,0.879254,0.120746,0.879254,438,112,-1, merged,1,1,0
57872,1000120,2,2119,1856,263,0.875885,0.124115,1.755525,230,33,2121,1858,263,0.876002,0.123998,1.755255,230,33,1, merged,0,0,0
57887,1000003,2,1522,1266,256,0.8318,0.1682,1.698467,219,37,1523,1266,257,0.831254,0.168746,1.695786,220,37,1, merged,1,1,0
57909,1000054,2,1186,1008,178,0.849916,0.150084,1.686582,161,17,1187,1009,178,0.850042,0.149958,1.683929,161,17,1, merged,0,0,0
57911,1000108,3,527,451,76,0.855787,0.144213,2.528699,71,5,528,452,76,0.856061,0.143939,2.528323,71,5,1, merged,0,0,0
57922,1000023,1,1727,1503,224,0.870295,0.129705,0.870295,199,25,1728,1503,225,0.869792,0.130208,0.869792,200,25,1, abandoned,1,1,0
57927,1000054,1,1188,1010,178,0.850168,0.149832,0.850168,161,17,1190,1011,179,0.84958,0.15042,0.84958,162,17,1, merged,1,1,0
57929,1000026,2,680,581,99,0.854412,0.145588,1.540458,96,3,681,582,99,0.854626,0.145374,1.544281,96,3,1, merged,0,0,0
57930,1000003,2,1523,1266,257,0.831254,0.168746,1.72869,220,37,1529,1271,258,0.831262,0.168738,1.726564,221,37,-1, abandoned,1,0,0
57930,1000110,1,741,665,76,0.897436,0.102564,0.897436,70,6,745,667,78,0.895302,0.104698,0.895302,72,6,-1, abandoned,1,0,0
57932,1000054,1,1190,1011,179,0.84958,0.15042,0.84958,162,17,1192,1013,179,0.849832,0.150168,0.849832,162,17,-1, merged,0,0,0
57934,1000003,2,1529,1271,258,0.831262,0.168738,1.611668,221,37,1533,1274,259,0.83105,0.16895,1.610314,221,38,-1, merged,1,0,0
57934,1000109,3,700,601,99,0.858571,0.141429,2.470239,94,5,701,602,99,0.858773,0.141227,2.469088,94,5,1, merged,0,0,0
57935,1000153,2,1329,1194,135,0.89842,0.10158,1.61065,101,34,1330,1195,135,0.898496,0.101504,1.612782,101,34,1, merged,0,0,0
57941,1000054,5,1192,1013,179,0.849832,0.150168,3.748557,162,17,1193,1014,179,0.849958,0.150042,3.775651,162,17,1, merged,0,0,0
57941,1000166,4,531,401,130,0.755179,0.244821,2.898724,125,5,532,402,130,0.755639,0.244361,2.925693,125,5,1, merged,0,0,0
57944,1000004,2,4557,4007,550,0.879307,0.120693,1.819307,438,112,4560,4009,551,0.879167,0.120833,1.810539,439,112,1, merged,1,1,0
57947,1000011,2,943,864,79,0.916225,0.083775,1.778294,74,5,945,865,80,0.915344,0.084656,1.770045,75,5,1, merged,1,1,0
57982,1000003,1,1533,1274,259,0.83105,0.16895,0.83105,221,38,1534,1275,259,0.83116,0.16884,0.83116,221,38,1, merged,0,0,0
57982,1000120,2,2122,1859,263,0.87606,0.12394,1.707111,230,33,2123,1860,263,0.876119,0.123881,1.707279,230,33,1, merged,0,0,0
57984,1000009,2,1896,1577,319,0.831751,0.168249,1.415084,287,32,1897,1578,319,0.83184,0.16816,1.419469,287,32,1, merged,0,0,0
57985,1000009,2,1897,1578,319,0.83184,0.16816,1.419469,287,32,1898,1579,319,0.831928,0.168072,1.407686,287,32,1, merged,0,0,0
57986,1000009,2,1898,1579,319,0.831928,0.168072,1.598595,287,32,1900,1579,321,0.831053,0.168947,1.596037,288,33,1, merged,1,1,0
57986,1000026,3,681,582,99,0.854626,0.145374,2.453221,96,3,683,584,99,0.855051,0.144949,2.451088,96,3,-1, merged,0,0,0
57986,1000534,1,630,483,147,0.766667,0.233333,0.766667,132,15,634,485,149,0.764984,0.235016,0.764984,134,15,-1, merged,1,0,0
57990,1000009,2,1900,1579,321,0.831053,0.168947,1.595943,288,33,1901,1580,321,0.831142,0.168858,1.597132,288,33,1, merged,0,0,0
57990,1000534,1,638,488,150,0.76489,0.23511,0.76489,135,15,641,491,150,0.765991,0.234009,0.765991,135,15,1, merged,0,0,0
57996,1000009,2,1901,1580,321,0.831142,0.168858,1.406899,288,33,1902,1581,321,0.83123,0.16877,1.41123,288,33,1, merged,0,0,0
57997,1000009,2,1902,1581,321,0.83123,0.16877,1.41123,288,33,1903,1582,321,0.831319,0.168681,1.415477,288,33,1, merged,0,0,0
58007,1000054,2,1194,1015,179,0.850084,0.149916,1.417651,162,17,1195,1016,179,0.850209,0.149791,1.429157,162,17,1, merged,0,0,0
58008,1000004,2,4570,4018,552,0.879212,0.120788,1.645203,440,112,4571,4018,553,0.87902,0.12098,1.642995,441,112,1, merged,1,1,0
58008,1000153,3,1331,1196,135,0.898573,0.101427,2.543775,101,34,1332,1197,135,0.898649,0.101351,2.541644,101,34,1, merged,0,0,0
58008,1000534,1,641,491,150,0.765991,0.234009,0.765991,135,15,644,492,152,0.763975,0.236025,0.763975,137,15,1, merged,1,1,0
58010,1000003,1,1534,1275,259,0.83116,0.16884,0.83116,221,38,1535,1276,259,0.83127,0.16873,0.83127,221,38,1, merged,0,0,0
58010,1000153,2,1332,1197,135,0.898649,0.101351,1.729809,101,34,1333,1198,135,0.898725,0.101275,1.729995,101,34,1, merged,0,0,0
58011,1000140,3,490,414,76,0.844898,0.155102,2.405478,68,8,491,415,76,0.845214,0.154786,2.412522,68,8,1, merged,0,0,0
58012,1000015,2,2445,2182,263,0.892434,0.107566,1.747485,241,22,2446,2183,263,0.892478,0.107522,1.747741,241,22,1, merged,0,0,0
58012,1000026,1,683,584,99,0.855051,0.144949,0.855051,96,3,684,585,99,0.855263,0.144737,0.855263,96,3,1, merged,0,0,0
58013,1000011,1,946,866,80,0.915433,0.084567,0.915433,75,5,948,867,81,0.914557,0.085443,0.914557,76,5,1, merged,1,1,0
58013,1000120,2,2123,1860,263,0.876119,0.123881,1.791552,230,33,2124,1861,263,0.876177,0.123823,1.790734,230,33,-1, merged,0,0,0
58014,1000130,2,717,590,127,0.822873,0.177127,1.616099,94,33,718,591,127,0.82312,0.17688,1.616714,94,33,1, merged,0,0,0
58016,1000140,1,491,415,76,0.845214,0.154786,0.845214,68,8,493,417,76,0.845842,0.154158,0.845842,68,8,1, merged,0,0,0
58023,1000009,1,1903,1582,321,0.831319,0.168681,0.831319,288,33,1904,1582,322,0.830882,0.169118,0.830882,289,33,1, merged,1,1,0
58023,1000015,2,2446,2183,263,0.892478,0.107522,1.723796,241,22,2448,2185,263,0.892565,0.107435,1.723448,241,22,1, merged,0,0,0
58034,1000012,2,789,676,113,0.856781,0.143219,1.706665,110,3,790,677,113,0.856962,0.143038,1.705238,110,3,1, merged,0,0,0
58036,1000023,2,1728,1503,225,0.869792,0.130208,1.766617,200,25,1730,1504,226,0.869364,0.130636,1.760837,201,25,1, merged,1,1,0
58037,1000166,2,532,402,130,0.755639,0.244361,1.57822,125,5,533,403,130,0.756098,0.243902,1.579249,125,5,1, merged,0,0,0
58039,1000014,2,3265,2638,627,0.807963,0.192037,1.684199,585,42,3266,2639,627,0.808022,0.191978,1.684316,585,42,1, merged,0,0,0
58039,1000120,1,2125,1862,263,0.876235,0.123765,0.876235,230,33,2126,1863,263,0.876294,0.123706,0.876294,230,33,1, merged,0,0,0
58040,1000004,1,4575,4021,554,0.878907,0.121093,0.878907,441,113,4576,4022,554,0.878934,0.121066,0.878934,441,113,1, merged,0,0,0
58040,1000592,2,874,748,126,0.855835,0.144165,1.734742,79,47,875,749,126,0.856,0.144,1.734934,79,47,1, merged,0,0,0
58048,1000108,2,530,454,76,0.856604,0.143396,1.711305,71,5,531,455,76,0.856874,0.143126,1.712806,71,5,-1, abandoned,0,0,0
58050,1000026,1,684,585,99,0.855263,0.144737,0.855263,96,3,685,586,99,0.855474,0.144526,0.855474,96,3,1, merged,0,0,0
58050,1000153,2,1336,1201,135,0.898952,0.101048,1.754215,101,34,1337,1202,135,0.899028,0.100972,1.754502,101,34,1, merged,0,0,0
58055,1000014,2,3267,2640,627,0.808081,0.191919,1.602198,585,42,3271,2641,630,0.807398,0.192602,1.600081,588,42,1, merged,1,1,0
58055,1000329,3,3643,2853,790,0.783146,0.216854,2.385344,673,117,3644,2853,791,0.782931,0.217069,2.383012,674,117,1, merged,1,1,0
58056,1000130,1,722,595,127,0.8241,0.1759,0.8241,94,33,723,596,127,0.824343,0.175657,0.824343,94,33,1, merged,0,0,0
58056,1002169,2,816,652,164,0.79902,0.20098,1.623119,121,43,817,652,165,0.798042,0.201958,1.622385,121,44,-1, merged,1,1,0
58089,1000105,1,819,654,165,0.798535,0.201465,0.798535,144,21,820,655,165,0.79878,0.20122,0.79878,144,21,1, merged,0,0,0
58090,1000328,2,1091,812,279,0.744271,0.255729,1.578804,252,27,1092,812,280,0.74359,0.25641,1.578715,252,28,-1, merged,1,1,0
58093,1000009,2,1908,1586,322,0.831237,0.168763,1.415395,289,33,1909,1587,322,0.831325,0.168675,1.409757,289,33,1, merged,0,0,0
58094,1000153,2,1338,1203,135,0.899103,0.100897,1.477535,101,34,1339,1204,135,0.899178,0.100822,1.471994,101,34,-1, merged,0,0,0
58098,1000009,2,1909,1587,322,0.831325,0.168675,1.404141,289,33,1910,1588,322,0.831414,0.168586,1.408337,289,33,1, merged,0,0,0
58112,1000121,1,2586,2153,433,0.83256,0.16744,0.83256,400,33,2587,2154,433,0.832625,0.167375,0.832625,400,33,-1, merged,0,0,0
58112,1000328,2,1092,812,280,0.74359,0.25641,1.57615,252,28,1094,814,280,0.744059,0.255941,1.576683,252,28,-1, merged,0,0,0
58113,1000110,1,745,667,78,0.895302,0.104698,0.895302,72,6,747,668,79,0.894244,0.105756,0.894244,73,6,1, merged,1,1,0
58116,1000009,2,1910,1588,322,0.831414,0.168586,1.408337,289,33,1911,1589,322,0.831502,0.168498,1.412454,289,33,1, merged,0,0,0
58117,1000009,2,1911,1589,322,0.831502,0.168498,1.412454,289,33,1912,1590,322,0.83159,0.16841,1.407062,289,33,1, merged,0,0,0
58124,1000023,1,1731,1505,226,0.86944,0.13056,0.86944,201,25,1732,1506,226,0.869515,0.130485,0.869515,201,25,1, merged,0,0,0
58125,1000026,2,685,586,99,0.855474,0.144526,1.716051,96,3,687,588,99,0.855895,0.144105,1.715095,96,3,-1, merged,0,0,0
58125,1000199,1,624,537,87,0.860577,0.139423,0.860577,80,7,625,537,88,0.8592,0.1408,0.8592,81,7,1, merged,1,1,0
58130,1000026,1,687,588,99,0.855895,0.144105,0.855895,96,3,688,589,99,0.856105,0.143895,0.856105,96,3,-1, merged,0,0,0
58130,1000120,2,2130,1867,263,0.876526,0.123474,1.732421,230,33,2132,1869,263,0.876642,0.123358,1.732746,230,33,-1, merged,0,0,0
58134,1000120,2,2133,1870,263,0.876699,0.123301,1.738488,230,33,2134,1871,263,0.876757,0.123243,1.73966,230,33,1, merged,0,0,0
58140,1000026,2,688,589,99,0.856105,0.143895,1.620446,96,3,693,593,100,0.8557,0.1443,1.620769,97,3,-1, merged,1,0,0
58140,1000534,1,645,493,152,0.764341,0.235659,0.764341,137,15,647,495,152,0.76507,0.23493,0.76507,137,15,-1, merged,0,0,0
58147,1000014,1,3274,2644,630,0.807575,0.192425,0.807575,588,42,3275,2645,630,0.807634,0.192366,0.807634,588,42,1, merged,0,0,0
58147,1000328,2,1094,814,280,0.744059,0.255941,1.551633,252,28,1095,815,280,0.744292,0.255708,1.551926,252,28,1, merged,0,0,0
58152,1000534,1,651,497,154,0.763441,0.236559,0.763441,139,15,652,498,154,0.763804,0.236196,0.763804,139,15,-1, merged,0,0,0
58155,1000153,2,1340,1205,135,0.899254,0.100746,1.764119,101,34,1341,1206,135,0.899329,0.100671,1.764525,101,34,1, merged,0,0,0
58161,1000120,3,2135,1872,263,0.876815,0.123185,2.401006,230,33,2136,1873,263,0.876873,0.123127,2.40256,230,33,1, merged,0,0,0
58163,1000004,1,4580,4026,554,0.879039,0.120961,0.879039,441,113,4581,4027,554,0.879066,0.120934,0.879066,441,113,1, merged,0,0,0
58164,1000004,1,4581,4027,554,0.879066,0.120934,0.879066,441,113,4582,4028,554,0.879092,0.120908,0.879092,441,113,1, merged,0,0,0
58172,1000110,2,747,668,79,0.894244,0.105756,1.673655,73,6,749,669,80,0.893191,0.106809,1.664619,74,6,1, merged,1,1,0
58175,1000012,1,797,684,113,0.858218,0.141782,0.858218,110,3,798,685,113,0.858396,0.141604,0.858396,110,3,1, merged,0,0,0
58176,1000026,1,693,593,100,0.8557,0.1443,0.8557,97,3,694,594,100,0.855908,0.144092,0.855908,97,3,1, merged,0,0,0
58181,1000005,2,863,745,118,0.863268,0.136732,1.692364,108,10,864,746,118,0.863426,0.136574,1.691353,108,10,1, merged,0,0,0
58181,1000043,1,708,587,121,0.829096,0.170904,0.829096,105,16,709,587,122,0.827927,0.172073,0.827927,106,16,1, merged,1,1,0
58183,1000120,2,2136,1873,263,0.876873,0.123127,1.684565,230,33,2137,1874,263,0.87693,0.12307,1.662645,230,33,1, merged,0,0,0
58184,1000054,1,1197,1018,179,0.850459,0.149541,0.850459,162,17,1198,1019,179,0.850584,0.149416,0.850584,162,17,-1, merged,0,0,0
58184,1000110,3,749,669,80,0.893191,0.106809,2.304626,74,6,750,670,80,0.893333,0.106667,2.315346,74,6,1, merged,0,0,0
58196,1000153,1,1342,1207,135,0.899404,0.100596,0.899404,101,34,1345,1208,137,0.898141,0.101859,0.898141,103,34,1, merged,1,1,0
58200,1000004,1,4583,4029,554,0.879118,0.120882,0.879118,441,113,4584,4030,554,0.879145,0.120855,0.879145,441,113,1, merged,0,0,0
58206,1000015,2,2457,2194,263,0.892959,0.107041,1.656763,241,22,2458,2195,263,0.893002,0.106998,1.656361,241,22,1, merged,0,0,0
58206,1000534,1,652,498,154,0.763804,0.236196,0.763804,139,15,655,500,155,0.763359,0.236641,0.763359,140,15,-1, merged,1,0,0
58214,1000004,2,4584,4030,554,0.879145,0.120855,1.791645,441,113,4585,4031,554,0.879171,0.120829,1.791944,441,113,1, merged,0,0,0
58216,1000014,1,3275,2645,630,0.807634,0.192366,0.807634,588,42,3277,2647,630,0.807751,0.192249,0.807751,588,42,-1, merged,0,0,0
58225,1000534,1,655,500,155,0.763359,0.236641,0.763359,140,15,656,501,155,0.76372,0.23628,0.76372,140,15,-1, merged,0,0,0
58228,1000015,1,2458,2195,263,0.893002,0.106998,0.893002,241,22,2459,2196,263,0.893046,0.106954,0.893046,241,22,1, merged,0,0,0
58234,1000011,2,954,873,81,0.915094,0.084906,1.795094,76,5,955,874,81,0.915183,0.084817,1.799799,76,5,1, merged,0,0,0
58238,1000003,2,1536,1277,259,0.83138,0.16862,1.605467,221,38,1538,1278,260,0.830949,0.169051,1.602472,222,38,1, merged,1,1,0
58240,1000003,2,1538,1278,260,0.830949,0.169051,1.602472,222,38,1539,1279,260,0.831059,0.168941,1.603336,222,38,1, merged,0,0,0
58240,1000004,3,4585,4031,554,0.879171,0.120829,2.481644,441,113,4586,4032,554,0.879198,0.120802,2.482534,441,113,1, merged,0,0,0
58241,1000592,2,876,750,126,0.856164,0.143836,1.41172,79,47,877,751,126,0.856328,0.143672,1.421546,79,47,1, merged,0,0,0
58249,1000004,1,4586,4032,554,0.879198,0.120802,0.879198,441,113,4587,4033,554,0.879224,0.120776,0.879224,441,113,-1, merged,0,0,0
58250,1000014,1,3277,2647,630,0.807751,0.192249,0.807751,588,42,3278,2648,630,0.80781,0.19219,0.80781,588,42,1, merged,0,0,0
58251,1000004,3,4587,4033,554,0.879224,0.120776,2.274014,441,113,4588,4034,554,0.87925,0.12075,2.307171,441,113,1, merged,0,0,0
58251,1000592,2,877,751,126,0.856328,0.143672,1.39479,79,47,878,752,126,0.856492,0.143508,1.427921,79,47,1, merged,0,0,0
58267,1000166,1,534,404,130,0.756554,0.243446,0.756554,125,5,535,404,131,0.75514,0.24486,0.75514,126,5,1, abandoned,1,1,0
58273,1000105,1,820,655,165,0.79878,0.20122,0.79878,144,21,821,656,165,0.799026,0.200974,0.799026,144,21,1, merged,0,0,0
58275,1000015,1,2459,2196,263,0.893046,0.106954,0.893046,241,22,2460,2197,263,0.893089,0.106911,0.893089,241,22,1, merged,0,0,0
58276,1000109,1,702,603,99,0.858974,0.141026,0.858974,94,5,703,604,99,0.859175,0.140825,0.859175,94,5,1, merged,0,0,0
58276,1000199,2,627,539,88,0.859649,0.140351,1.718623,81,7,628,540,88,0.859873,0.140127,1.719048,81,7,1, merged,0,0,0
58286,1000105,1,822,657,165,0.79927,0.20073,0.79927,144,21,826,659,167,0.797821,0.202179,0.797821,146,21,-1, merged,1,0,0
58298,1000004,1,4588,4034,554,0.87925,0.12075,0.87925,441,113,4589,4035,554,0.879277,0.120723,0.879277,441,113,-1, merged,0,0,0
58298,1000120,2,2140,1877,263,0.877103,0.122897,1.756353,230,33,2141,1878,263,0.87716,0.12284,1.756437,230,33,1, merged,0,0,0
58306,1000011,1,956,875,81,0.915272,0.084728,0.915272,76,5,957,876,81,0.915361,0.084639,0.915361,76,5,1, merged,0,0,0
58308,1000014,2,3278,2648,630,0.80781,0.19219,1.700943,588,42,3279,2649,630,0.807868,0.192132,1.701045,588,42,-1, abandoned,0,0,0
58308,1000015,1,2461,2198,263,0.893133,0.106867,0.893133,241,22,2462,2199,263,0.893176,0.106824,0.893176,241,22,-1, abandoned,0,0,0
58342,1000009,2,1913,1591,322,0.831678,0.168322,1.595398,289,33,1914,1592,322,0.831766,0.168234,1.595845,289,33,1, merged,0,0,0
58342,1000534,1,656,501,155,0.76372,0.23628,0.76372,140,15,657,502,155,0.764079,0.235921,0.764079,140,15,-1, merged,0,0,0
58344,1000009,2,1914,1592,322,0.831766,0.168234,1.407238,289,33,1915,1593,322,0.831854,0.168146,1.411293,289,33,1, merged,0,0,0
58345,1000534,1,657,502,155,0.764079,0.235921,0.764079,140,15,659,504,155,0.764795,0.235205,0.764795,140,15,-1, merged,0,0,0
58348,1000009,3,1915,1593,322,0.831854,0.168146,2.050861,289,33,1916,1594,322,0.831942,0.168058,2.06376,289,33,1, merged,0,0,0
58351,1000015,2,2465,2202,263,0.893306,0.106694,1.658101,241,22,2466,2203,263,0.89335,0.10665,1.656986,241,22,1, merged,0,0,0
58351,1000534,1,659,504,155,0.764795,0.235205,0.764795,140,15,660,504,156,0.763636,0.236364,0.763636,140,16,-1, merged,1,1,0
58355,1000009,2,1916,1594,322,0.831942,0.168058,1.595578,289,33,1918,1596,322,0.832117,0.167883,1.596467,289,33,-1, merged,0,0,0
58355,1000534,1,660,504,156,0.763636,0.236364,0.763636,140,16,662,506,156,0.76435,0.23565,0.76435,140,16,-1, merged,0,0,0
58370,1000054,1,1198,1019,179,0.850584,0.149416,0.850584,162,17,1199,1020,179,0.850709,0.149291,0.850709,162,17,1, merged,0,0,0
58370,1000105,2,826,659,167,0.797821,0.202179,1.648405,146,21,827,660,167,0.798065,0.201935,1.648774,146,21,1, merged,0,0,0
58371,1000004,1,4589,4035,554,0.879277,0.120723,0.879277,441,113,4590,4036,554,0.879303,0.120697,0.879303,441,113,1, merged,0,0,0
58371,1000592,2,878,752,126,0.856492,0.143508,1.735769,79,47,879,753,126,0.856655,0.143345,1.735958,79,47,1, merged,0,0,0
58375,1000054,2,1199,1020,179,0.850709,0.149291,1.605849,162,17,1200,1021,179,0.850833,0.149167,1.60643,162,17,1, merged,0,0,0
58375,1000166,1,535,404,131,0.75514,0.24486,0.75514,126,5,536,405,131,0.755597,0.244403,0.755597,126,5,1, merged,0,0,0
58385,1000026,1,694,594,100,0.855908,0.144092,0.855908,97,3,697,595,102,0.853659,0.146341,0.853659,99,3,1, merged,1,1,0
58385,1000534,2,663,507,156,0.764706,0.235294,1.620614,140,16,667,510,157,0.764618,0.235382,1.618276,141,16,-1, merged,1,0,0
58400,1000023,1,1741,1515,226,0.87019,0.12981,0.87019,201,25,1742,1516,226,0.870264,0.129736,0.870264,201,25,1, merged,0,0,0
58403,1000054,2,1202,1023,179,0.851082,0.148918,1.606679,162,17,1203,1024,179,0.851205,0.148795,1.607257,162,17,1, merged,0,0,0
58403,1000166,1,536,405,131,0.755597,0.244403,0.755597,126,5,537,406,131,0.756052,0.243948,0.756052,126,5,1, merged,0,0,0
58417,1000007,2,1890,1523,367,0.80582,0.19418,1.687453,324,43,1891,1524,367,0.805923,0.194077,1.684465,324,43,1, merged,0,0,0
58433,1000009,2,1919,1597,322,0.832204,0.167796,1.41779,289,33,1920,1598,322,0.832292,0.167708,1.421577,289,33,1, merged,0,0,0
58439,1000011,2,960,879,81,0.915625,0.084375,1.792957,76,5,961,880,81,0.915713,0.084287,1.793102,76,5,1, merged,0,0,0
58439,1000120,1,2144,1881,263,0.877332,0.122668,0.877332,230,33,2145,1882,263,0.877389,0.122611,0.877389,230,33,-1, merged,0,0,0
58440,1000009,2,1920,1598,322,0.832292,0.167708,1.68616,289,33,1922,1599,323,0.831946,0.168054,1.684593,290,33,1, merged,1,1,0
58440,1000026,1,698,596,102,0.853868,0.146132,0.853868,99,3,699,596,103,0.852647,0.147353,0.852647,100,3,1, merged,1,1,0
58443,1000014,4,3283,2653,630,0.808102,0.191898,3.025475,588,42,3285,2654,631,0.807915,0.192085,3.027886,589,42,1, merged,1,1,0
58443,1002169,1,817,652,165,0.798042,0.201958,0.798042,121,44,818,653,165,0.798289,0.201711,0.798289,121,44,-1, merged,0,0,0
58446,1000009,3,1922,1599,323,0.831946,0.168054,2.185849,290,33,1924,1601,323,0.832121,0.167879,2.190011,290,33,1, merged,0,0,0
58446,1000534,1,667,510,157,0.764618,0.235382,0.764618,141,16,668,511,157,0.76497,0.23503,0.76497,141,16,1, merged,0,0,0
58457,1000004,3,4590,4036,554,0.879303,0.120697,2.520466,441,113,4591,4036,555,0.879111,0.120889,2.520384,442,113,1, merged,1,1,0
58457,1000108,2,536,460,76,0.858209,0.141791,1.641163,71,5,537,461,76,0.858473,0.141527,1.641272,71,5,-1, merged,0,0,0
58457,1000329,1,3649,2857,792,0.782954,0.217046,0.782954,675,117,3651,2858,793,0.782799,0.217201,0.782799,676,117,-1, merged,1,0,0
58458,1000121,2,2607,2172,435,0.833142,0.166858,1.555988,402,33,2608,2173,435,0.833206,0.166794,1.554395,402,33,1, merged,0,0,0
58464,1000329,1,3651,2858,793,0.782799,0.217201,0.782799,676,117,3652,2859,793,0.782859,0.217141,0.782859,676,117,1, merged,0,0,0
58466,1000108,1,537,461,76,0.858473,0.141527,0.858473,71,5,538,462,76,0.858736,0.141264,0.858736,71,5,1, merged,0,0,0
58467,1000534,1,668,511,157,0.76497,0.23503,0.76497,141,16,673,516,157,0.766716,0.233284,0.766716,141,16,-1, merged,0,0,0
58471,1000329,2,3652,2859,793,0.782859,0.217141,1.581147,676,117,3654,2859,795,0.78243,0.21757,1.580965,678,117,1, abandoned,1,1,0
58471,1002169,1,818,653,165,0.798289,0.201711,0.798289,121,44,819,654,165,0.798535,0.201465,0.798535,121,44,-1, abandoned,0,0,0
58473,1000023,2,1743,1517,226,0.870338,0.129662,1.699722,201,25,1745,1519,226,0.870487,0.129513,1.696778,201,25,-1, merged,0,0,0
58474,1000110,1,754,674,80,0.893899,0.106101,0.893899,74,6,755,675,80,0.89404,0.10596,0.89404,74,6,1, merged,0,0,0
58475,1000014,2,3285,2654,631,0.807915,0.192085,1.701394,589,42,3286,2655,631,0.807973,0.192027,1.701495,589,42,1, merged,0,0,0
58475,1000015,1,2469,2206,263,0.893479,0.106521,0.893479,241,22,2470,2207,263,0.893522,0.106478,0.893522,241,22,1, merged,0,0,0
58479,1000054,1,1203,1024,179,0.851205,0.148795,0.851205,162,17,1204,1025,179,0.851329,0.148671,0.851329,162,17,1, merged,0,0,0
58480,1000014,1,3286,2655,631,0.807973,0.192027,0.807973,589,42,3287,2656,631,0.808032,0.191968,0.808032,589,42,1, merged,0,0,0
58480,1000130,2,727,600,127,0.825309,0.174691,1.633283,94,33,728,601,127,0.825549,0.174451,1.633581,94,33,1, merged,0,0,0
58495,1000109,1,703,604,99,0.859175,0.140825,0.859175,94,5,704,604,100,0.857955,0.142045,0.857955,95,5,1, merged,1,1,0
58495,1000199,2,628,540,88,0.859873,0.140127,1.719048,81,7,629,541,88,0.860095,0.139905,1.71805,81,7,1, merged,0,0,0
58506,1000007,5,1891,1524,367,0.805923,0.194077,4.191199,324,43,1892,1525,367,0.806025,0.193975,4.213498,324,43,1, merged,0,0,0
58506,1000153,4,1347,1210,137,0.898293,0.101707,3.385276,103,34,1348,1211,137,0.898368,0.101632,3.407472,103,34,1, merged,0,0,0
58512,1000026,1,699,596,103,0.852647,0.147353,0.852647,100,3,702,598,104,0.851852,0.148148,0.851852,101,3,-1, merged,1,0,0
58514,1000108,1,538,462,76,0.858736,0.141264,0.858736,71,5,539,463,76,0.858998,0.141002,0.858998,71,5,1, merged,0,0,0
58514,1000110,2,755,675,80,0.89404,0.10596,1.752776,74,6,756,676,80,0.89418,0.10582,1.753178,74,6,1, merged,0,0,0
58516,1000014,1,3288,2657,631,0.80809,0.19191,0.80809,589,42,3289,2658,631,0.808148,0.191852,0.808148,589,42,1, merged,0,0,0
58516,1000054,2,1206,1027,179,0.851575,0.148425,1.659665,162,17,1207,1028,179,0.851698,0.148302,1.659847,162,17,1, merged,0,0,0
58517,1000004,2,4592,4037,555,0.879138,0.120862,1.730836,442,113,4593,4038,555,0.879164,0.120836,1.730985,442,113,1, merged,0,0,0
58517,1000014,3,3289,2658,631,0.808148,0.191852,2.538984,589,42,3290,2659,631,0.808207,0.191793,2.539192,589,42,1, merged,0,0,0
58517,1000054,1,1207,1028,179,0.851698,0.148302,0.851698,162,17,1208,1029,179,0.851821,0.148179,0.851821,162,17,1, merged,0,0,0
58518,1000004,1,4593,4038,555,0.879164,0.120836,0.879164,442,113,4596,4039,557,0.878808,0.121192,0.878808,444,113,-1, abandoned,1,0,0
58518,1000014,2,3290,2659,631,0.808207,0.191793,1.687371,589,42,3292,2659,633,0.807716,0.192284,1.686523,591,42,1, abandoned,1,1,0
58519,1000109,2,704,604,100,0.857955,0.142045,1.638685,95,5,705,604,101,0.856738,0.143262,1.633597,96,5,1, merged,1,1,0
58519,1000199,3,629,541,88,0.860095,0.139905,2.498781,81,7,631,543,88,0.860539,0.139461,2.494136,81,7,-1, merged,0,0,0
58523,1000328,1,1095,815,280,0.744292,0.255708,0.744292,252,28,1096,816,280,0.744526,0.255474,0.744526,252,28,1, merged,0,0,0
58523,1000329,2,3656,2861,795,0.782549,0.217451,1.526841,678,117,3657,2862,795,0.782609,0.217391,1.527134,678,117,1, merged,0,0,0
58525,1000011,1,962,881,81,0.9158,0.0842,0.9158,76,5,963,882,81,0.915888,0.084112,0.915888,76,5,1, merged,0,0,0
58525,1000012,2,803,690,113,0.859278,0.140722,1.775078,110,3,804,691,113,0.859453,0.140547,1.775341,110,3,1, merged,0,0,0
58542,1000120,1,2147,1884,263,0.877503,0.122497,0.877503,230,33,2148,1885,263,0.877561,0.122439,0.877561,230,33,1, merged,0,0,0
58547,1000105,2,827,660,167,0.798065,0.201935,1.569033,146,21,828,661,167,0.798309,0.201691,1.570013,146,21,1, merged,0,0,0
58549,1000004,2,4596,4039,557,0.878808,0.121192,1.658469,444,113,4600,4043,557,0.878913,0.121087,1.660426,444,113,-1, merged,0,0,0
58552,1000004,1,4600,4043,557,0.878913,0.121087,0.878913,444,113,4601,4044,557,0.878939,0.121061,0.878939,444,113,1, merged,0,0,0
58552,1000007,2,1892,1525,367,0.806025,0.193975,1.684938,324,43,1893,1526,367,0.806128,0.193872,1.685067,324,43,1, merged,0,0,0
58553,1000004,1,4601,4044,557,0.878939,0.121061,0.878939,444,113,4602,4045,557,0.878966,0.121034,0.878966,444,113,1, merged,0,0,0
58553,1000015,2,2472,2209,263,0.893608,0.106392,1.772548,241,22,2473,2210,263,0.893651,0.106349,1.772617,241,22,1, merged,0,0,0
58558,1000011,2,963,882,81,0.915888,0.084112,1.793562,76,5,965,884,81,0.916062,0.083938,1.793793,76,5,-1, merged,0,0,0
58558,1000120,1,2150,1887,263,0.877674,0.122326,0.877674,230,33,2151,1888,263,0.877731,0.122269,0.877731,230,33,-1, merged,0,0,0
58578,1000120,2,2163,1899,264,0.877947,0.122053,1.660615,231,33,2164,1900,264,0.878004,0.121996,1.660731,231,33,1, merged,0,0,0
58578,1000329,1,3658,2863,795,0.782668,0.217332,0.782668,678,117,3659,2864,795,0.782728,0.217272,0.782728,678,117,1, merged,0,0,0
58579,1000054,1,1210,1030,180,0.85124,0.14876,0.85124,163,17,1211,1031,180,0.851363,0.148637,0.851363,163,17,1, merged,0,0,0
58579,1000120,3,2164,1900,264,0.878004,0.121996,2.482011,231,33,2165,1901,264,0.87806,0.12194,2.483099,231,33,1, merged,0,0,0
58579,1000166,2,542,408,134,0.752768,0.247232,1.604007,129,5,544,410,134,0.753676,0.246324,1.605039,129,5,1, merged,0,0,0
58586,1000007,2,1893,1526,367,0.806128,0.193872,1.613598,324,43,1894,1527,367,0.80623,0.19377,1.613759,324,43,1, merged,0,0,0
58586,1000014,1,3293,2659,634,0.80747,0.19253,0.80747,592,42,3294,2660,634,0.807529,0.192471,0.807529,592,42,1, merged,0,0,0
58587,1000009,2,1937,1611,326,0.831699,0.168301,1.431699,293,33,1938,1612,326,0.831785,0.168215,1.430076,293,33,1, merged,0,0,0
58598,1000014,1,3294,2660,634,0.807529,0.192471,0.807529,592,42,3298,2663,635,0.807459,0.192541,0.807459,593,42,-1, merged,1,0,0
58598,1000140,3,502,424,78,0.844622,0.155378,2.454967,70,8,503,425,78,0.84493,0.15507,2.456585,70,8,1, merged,0,0,0
58612,1000109,3,705,604,101,0.856738,0.143262,2.494136,96,5,706,605,101,0.856941,0.143059,2.495295,96,5,1, merged,0,0,0
58612,1000199,2,631,543,88,0.860539,0.139461,1.637398,81,7,632,544,88,0.860759,0.139241,1.638354,81,7,1, merged,0,0,0
58618,1000003,1,1539,1279,260,0.831059,0.168941,0.831059,222,38,1540,1280,260,0.831169,0.168831,0.831169,222,38,-1, abandoned,0,0,0
58622,1000009,3,1940,1614,326,0.831959,0.168041,2.406134,293,33,1941,1615,326,0.832045,0.167955,2.406625,293,33,1, merged,0,0,0
58622,1000014,1,3298,2663,635,0.807459,0.192541,0.807459,593,42,3299,2664,635,0.807517,0.192483,0.807517,593,42,1, merged,0,0,0
58622,1000534,2,673,516,157,0.766716,0.233284,1.574175,141,16,674,517,157,0.767062,0.232938,1.57458,141,16,1, merged,0,0,0
58634,1000014,1,3299,2664,635,0.807517,0.192483,0.807517,593,42,3300,2665,635,0.807576,0.192424,0.807576,593,42,1, merged,0,0,0
58635,1000108,1,539,463,76,0.858998,0.141002,0.858998,71,5,540,464,76,0.859259,0.140741,0.859259,71,5,1, merged,0,0,0
58648,1000199,1,632,544,88,0.860759,0.139241,0.860759,81,7,634,546,88,0.861199,0.138801,0.861199,81,7,-1, merged,0,0,0
58649,1000009,2,1941,1615,326,0.832045,0.167955,1.430336,293,33,1942,1616,326,0.832132,0.167868,1.433827,293,33,1, merged,0,0,0
58650,1000009,1,1942,1616,326,0.832132,0.167868,0.832132,293,33,1943,1616,327,0.831704,0.168296,0.831704,294,33,1, abandoned,1,1,0
58650,1000534,3,674,517,157,0.767062,0.232938,2.200889,141,16,675,518,157,0.767407,0.232593,2.19575,141,16,-1, abandoned,0,0,0
58652,1000009,1,1943,1616,327,0.831704,0.168296,0.831704,294,33,1946,1618,328,0.831449,0.168551,0.831449,295,33,1, merged,1,1,0
58652,1000026,2,705,601,104,0.852482,0.147518,1.684186,101,3,706,601,105,0.851275,0.148725,1.682724,102,3,1, merged,1,1,0
58652,1000153,3,1351,1214,137,0.898594,0.101406,2.582779,103,34,1352,1215,137,0.898669,0.101331,2.581393,103,34,1, merged,0,0,0
58665,1000011,1,966,885,81,0.916149,0.083851,0.916149,76,5,967,886,81,0.916236,0.083764,0.916236,76,5,1, merged,0,0,0
58665,1000153,2,1352,1215,137,0.898669,0.101331,1.814818,103,34,1353,1216,137,0.898744,0.101256,1.814979,103,34,1, merged,0,0,0
58667,1000004,1,4605,4047,558,0.878827,0.121173,0.878827,444,114,4606,4048,558,0.878854,0.121146,0.878854,444,114,1, merged,0,0,0
58667,1000592,2,881,755,126,0.856981,0.143019,1.735808,79,47,882,756,126,0.857143,0.142857,1.735997,79,47,1, merged,0,0,0
58670,1000014,2,3300,2665,635,0.807576,0.192424,1.666835,593,42,3301,2666,635,0.807634,0.192366,1.667153,593,42,1, merged,0,0,0
58670,1000108,1,540,464,76,0.859259,0.140741,0.859259,71,5,541,465,76,0.859519,0.140481,0.859519,71,5,1, merged,0,0,0
58672,1000014,1,3301,2666,635,0.807634,0.192366,0.807634,593,42,3303,2667,636,0.807448,0.192552,0.807448,594,42,1, merged,1,1,0
58674,1000014,1,3303,2667,636,0.807448,0.192552,0.807448,594,42,3304,2668,636,0.807506,0.192494,0.807506,594,42,1, merged,0,0,0
58674,1000110,3,756,676,80,0.89418,0.10582,2.53528,74,6,757,677,80,0.89432,0.10568,2.535541,74,6,1, merged,0,0,0
58674,1000121,2,2615,2180,435,0.833652,0.166348,1.6411,402,33,2616,2181,435,0.833716,0.166284,1.641222,402,33,1, merged,0,0,0
58677,1000003,1,1541,1281,260,0.831278,0.168722,0.831278,222,38,1542,1281,261,0.830739,0.169261,0.830739,223,38,1, merged,1,1,0
58689,1000015,2,2477,2214,263,0.893823,0.106177,1.801268,241,22,2478,2215,263,0.893866,0.106134,1.799489,241,22,1, merged,0,0,0
58690,1000140,1,504,426,78,0.845238,0.154762,0.845238,70,8,505,427,78,0.845545,0.154455,0.845545,70,8,1, merged,0,0,0
58691,1000004,1,4606,4048,558,0.878854,0.121146,0.878854,444,114,4607,4049,558,0.87888,0.12112,0.87888,444,114,1, merged,0,0,0
58696,1000007,2,1895,1528,367,0.806332,0.193668,1.711955,324,43,1896,1528,368,0.805907,0.194093,1.711719,324,44,-1, merged,1,1,0
58696,1000153,3,1353,1216,137,0.898744,0.101256,2.610698,103,34,1354,1216,138,0.89808,0.10192,2.609799,103,35,-1, merged,1,1,0
58697,1000026,1,706,601,105,0.851275,0.148725,0.851275,102,3,707,602,105,0.851485,0.148515,0.851485,102,3,1, merged,0,0,0
58698,1000009,1,1947,1619,328,0.831536,0.168464,0.831536,295,33,1948,1620,328,0.831622,0.168378,0.831622,295,33,1, merged,0,0,0
58699,1000004,1,4607,4049,558,0.87888,0.12112,0.87888,444,114,4608,4050,558,0.878906,0.121094,0.878906,444,114,1, merged,0,0,0
58699,1000120,2,2167,1902,265,0.877711,0.122289,1.756591,232,33,2168,1903,265,0.877768,0.122232,1.756674,232,33,1, merged,0,0,0
58710,1000120,1,2168,1903,265,0.877768,0.122232,0.877768,232,33,2169,1904,265,0.877824,0.122176,0.877824,232,33,1, merged,0,0,0
58710,1000329,2,3660,2865,795,0.782787,0.217213,1.660554,678,117,3661,2866,795,0.782846,0.217154,1.66067,678,117,1, merged,0,0,0
58712,1000004,1,4608,4050,558,0.878906,0.121094,0.878906,444,114,4609,4050,559,0.878716,0.121284,0.878716,444,115,-1, merged,1,1,0
58712,1000121,2,2617,2182,435,0.833779,0.166221,1.712685,402,33,2618,2183,435,0.833843,0.166157,1.712558,402,33,1, merged,0,0,0
58712,1000329,3,3662,2867,795,0.782906,0.217094,2.495591,678,117,3663,2867,796,0.782692,0.217308,2.49525,678,118,-1, merged,1,1,0
58717,1000023,1,1752,1526,226,0.871005,0.128995,0.871005,201,25,1753,1527,226,0.871078,0.128922,0.871078,201,25,1, merged,0,0,0
58717,1000130,3,737,610,127,0.82768,0.17232,1.698684,94,33,738,611,127,0.827913,0.172087,2.698991,94,33,1, merged,0,0,0
58728,1000014,1,3304,2668,636,0.807506,0.192494,0.807506,594,42,3305,2669,636,0.807564,0.192436,0.807564,594,42,1, merged,0,0,0
58729,1000014,1,3305,2669,636,0.807564,0.192436,0.807564,594,42,3307,2670,637,0.807378,0.192622,0.807378,595,42,1, merged,1,1,0
58733,1000110,2,757,677,80,0.89432,0.10568,1.723512,74,6,758,678,80,0.894459,0.105541,1.72162,74,6,-1, merged,0,0,0
58733,1000130,3,744,617,127,0.829301,0.170699,2.552813,94,33,745,618,127,0.82953,0.17047,2.55115,94,33,1, merged,0,0,0
58734,1000004,2,4610,4051,559,0.878742,0.121258,1.378742,444,115,4611,4052,559,0.878768,0.121232,1.378768,444,115,1, merged,0,0,0
58735,1000009,1,1949,1621,328,0.831709,0.168291,0.831709,295,33,1950,1621,329,0.831282,0.168718,0.831282,296,33,1, abandoned,1,1,0
58735,1000534,2,675,518,157,0.767407,0.232593,1.599116,141,16,676,519,157,0.767751,0.232249,1.599034,141,16,-1, abandoned,0,0,0
58739,1000004,1,4611,4052,559,0.878768,0.121232,0.878768,444,115,4612,4052,560,0.878578,0.121422,0.878578,445,115,1, merged,1,1,0
58739,1000011,2,967,886,81,0.916236,0.083764,1.795004,76,5,968,887,81,0.916322,0.083678,1.7949,76,5,1, merged,0,0,0
58744,1000011,2,968,887,81,0.916322,0.083678,1.794202,76,5,969,888,81,0.916409,0.083591,1.79348,76,5,1, merged,0,0,0
58744,1000120,1,2170,1905,265,0.87788,0.12212,0.87788,232,33,2172,1905,267,0.877072,0.122928,0.877072,234,33,1, merged,1,1,0
58749,1000009,2,1951,1622,329,0.831369,0.168631,1.59912,296,33,1952,1623,329,0.831455,0.168545,1.599549,296,33,1, merged,0,0,0
58749,1000534,1,676,519,157,0.767751,0.232249,0.767751,141,16,677,520,157,0.768095,0.231905,0.768095,141,16,1, merged,0,0,0
58751,1000004,1,4612,4052,560,0.878578,0.121422,0.878578,445,115,4613,4052,561,0.878387,0.121613,0.878387,446,115,1, merged,1,1,0
58751,1000091,3,675,535,140,0.792593,0.207407,2.453921,117,23,676,536,140,0.792899,0.207101,2.453824,117,23,1, merged,0,0,0
58751,1000329,2,3664,2868,796,0.782751,0.217249,1.661329,678,118,3665,2868,797,0.782538,0.217462,1.660925,679,118,1, merged,1,1,0
58752,1000023,2,1754,1528,226,0.871152,0.128848,1.698312,201,25,1755,1528,227,0.870655,0.129345,1.693285,201,26,-1, merged,1,1,0
58755,1000166,1,544,410,134,0.753676,0.246324,0.753676,129,5,545,410,135,0.752294,0.247706,0.752294,130,5,1, abandoned,1,1,0
58760,1000534,1,677,520,157,0.768095,0.231905,0.768095,141,16,678,521,157,0.768437,0.231563,0.768437,141,16,1, merged,0,0,0
58765,1000105,1,830,663,167,0.798795,0.201205,0.798795,146,21,831,664,167,0.799037,0.200963,0.799037,146,21,-1, abandoned,0,0,0
58799,1000105,1,831,664,167,0.799037,0.200963,0.799037,146,21,834,666,168,0.798561,0.201439,0.798561,146,22,-1, merged,1,0,0
58799,1000132,3,847,708,139,0.835891,0.164109,2.502804,117,22,848,708,140,0.834906,0.165094,2.501684,117,23,-1, merged,1,1,0
58807,1000004,2,4618,4057,561,0.878519,0.121481,1.685955,446,115,4622,4061,561,0.878624,0.121376,1.685816,446,115,-1, merged,0,0,0
58807,1000014,1,3308,2671,637,0.807437,0.192563,0.807437,595,42,3309,2671,638,0.807193,0.192807,0.807193,596,42,1, merged,1,1,0
58807,1000132,4,848,708,140,0.834906,0.165094,3.34439,117,23,849,709,140,0.8351,0.1649,3.35425,117,23,1, merged,0,0,0
58811,1000110,2,758,678,80,0.894459,0.105541,1.740309,74,6,759,679,80,0.894598,0.105402,1.740752,74,6,1, merged,0,0,0
58811,1000140,1,506,428,78,0.84585,0.15415,0.84585,70,8,507,429,78,0.846154,0.153846,0.846154,70,8,1, merged,0,0,0
58815,1000329,2,3665,2868,797,0.782538,0.217462,1.516304,679,118,3666,2868,798,0.782324,0.217676,1.511356,680,118,1, abandoned,1,1,0
58817,1000105,3,834,666,168,0.798561,0.201439,2.27829,146,22,835,667,168,0.798802,0.201198,2.265187,146,22,1, merged,0,0,0
58829,1000005,2,879,761,118,0.865757,0.134243,1.620595,108,10,882,764,118,0.866213,0.133787,1.622102,108,10,-1, merged,0,0,0
58835,1000054,1,1211,1031,180,0.851363,0.148637,0.851363,163,17,1212,1031,181,0.85066,0.14934,0.85066,164,17,1, merged,1,1,0
58835,1000130,3,745,618,127,0.82953,0.17047,2.210304,94,33,746,619,127,0.829759,0.170241,2.180419,94,33,1, merged,0,0,0
58836,1000054,2,1212,1031,181,0.85066,0.14934,1.35066,164,17,1213,1031,182,0.849959,0.150041,1.332102,165,17,1, merged,1,1,0
58836,1000130,3,746,619,127,0.829759,0.170241,2.180419,94,33,748,621,127,0.830214,0.169786,2.162316,94,33,-1, merged,0,0,0
58856,1000108,1,541,465,76,0.859519,0.140481,0.859519,71,5,542,465,77,0.857934,0.142066,0.857934,72,5,1, merged,1,1,0
58876,1000110,2,759,679,80,0.894598,0.105402,0.894598,74,6,760,680,80,0.894737,0.105263,1.894737,74,6,1, merged,0,0,0
58880,1000329,2,3667,2869,798,0.782383,0.217617,1.639526,680,118,3668,2870,798,0.782443,0.217557,1.657443,680,118,1, merged,0,0,0
58884,1000004,1,4624,4063,561,0.878676,0.121324,0.878676,446,115,4625,4064,561,0.878703,0.121297,0.878703,446,115,1, merged,0,0,0
58884,1000026,3,712,607,105,0.852528,0.147472,2.483952,102,3,713,608,105,0.852735,0.147265,2.484637,102,3,1, merged,0,0,0
58884,1000166,2,546,411,135,0.752747,0.247253,1.631424,130,5,547,412,135,0.753199,0.246801,1.631902,130,5,1, merged,0,0,0
58887,1000026,2,713,608,105,0.852735,0.147265,1.606385,102,3,714,609,105,0.852941,0.147059,1.605668,102,3,1, merged,0,0,0
58887,1000054,3,1213,1031,182,0.849959,0.150041,2.456343,165,17,1214,1032,182,0.850082,0.149918,2.455751,165,17,1, merged,0,0,0
58887,1000166,1,548,413,135,0.75365,0.24635,0.75365,130,5,550,414,136,0.752727,0.247273,0.752727,130,6,-1, merged,1,1,0
58892,1000009,2,1957,1628,329,0.831886,0.168114,1.428524,296,33,1958,1629,329,0.831971,0.168029,1.430332,296,33,1, merged,0,0,0
58892,1000534,3,679,521,158,0.767305,0.232695,2.195829,142,16,680,522,158,0.767647,0.232353,2.197979,142,16,1, merged,0,0,0
58895,1000121,4,2626,2191,435,0.834349,0.165651,3.335634,402,33,2628,2192,436,0.834094,0.165906,3.322661,402,34,-1, merged,1,0,0
58897,1000009,3,1958,1629,329,0.831971,0.168029,2.492163,296,33,1959,1629,330,0.831547,0.168453,2.490811,297,33,1, merged,1,1,0
58897,1000014,2,3310,2672,638,0.807251,0.192749,1.660192,596,42,3311,2673,638,0.807309,0.192691,1.659264,596,42,-1, merged,0,0,0
58897,1000026,1,714,609,105,0.852941,0.147059,0.852941,102,3,716,610,106,0.851955,0.148045,0.851955,103,3,-1, merged,1,0,0
58897,1000534,4,680,522,158,0.767647,0.232353,3.25981,142,16,681,523,158,0.767988,0.232012,3.258799,142,16,1, merged,0,0,0
58898,1000009,2,1959,1629,330,0.831547,0.168453,1.429907,297,33,1960,1630,330,0.831633,0.168367,1.433259,297,33,1, merged,0,0,0
58899,1000009,2,1960,1630,330,0.831633,0.168367,1.433259,297,33,1961,1631,330,0.831719,0.168281,1.436557,297,33,1, merged,0,0,0
58900,1000054,1,1214,1032,182,0.850082,0.149918,0.850082,165,17,1215,1033,182,0.850206,0.149794,0.850206,165,17,1, merged,0,0,0
58900,1000329,2,3668,2870,798,0.782443,0.217557,1.632525,680,118,3669,2871,798,0.782502,0.217498,1.632708,680,118,1, merged,0,0,0
58900,1000592,3,882,756,126,0.857143,0.142857,2.489668,79,47,883,757,126,0.857305,0.142695,2.490012,79,47,1, merged,0,0,0
58902,1000015,2,2483,2220,263,0.89408,0.10592,1.583735,241,22,2484,2221,263,0.894122,0.105878,1.587304,241,22,1, merged,0,0,0
58912,1000199,2,635,547,88,0.861417,0.138583,1.640996,81,7,636,547,89,0.860063,0.139937,1.63838,81,8,-1, merged,1,1,0
58916,1000004,2,4625,4064,561,0.878703,0.121297,1.781093,446,115,4628,4066,562,0.878565,0.121435,1.781536,446,116,-1, merged,1,0,0
58916,1000014,3,3311,2673,638,0.807309,0.192691,2.588402,596,42,3312,2674,638,0.807367,0.192633,2.588903,596,42,1, merged,0,0,0
58918,1000004,3,4628,4066,562,0.878565,0.121435,2.654523,446,116,4629,4067,562,0.878591,0.121409,2.654681,446,116,1, merged,0,0,0
58918,1000120,2,2185,1918,267,0.877803,0.122197,1.775958,234,33,2186,1919,267,0.877859,0.122141,1.776089,234,33,1, merged,0,0,0
58918,1000153,1,1355,1217,138,0.898155,0.101845,0.898155,103,35,1356,1218,138,0.89823,0.10177,0.89823,103,35,1, merged,0,0,0
58920,1000023,1,1767,1539,228,0.870968,0.129032,0.870968,202,26,1768,1540,228,0.871041,0.128959,0.871041,202,26,-1, merged,0,0,0
58924,1000108,2,542,465,77,0.857934,0.142066,1.688383,72,5,543,466,77,0.858195,0.141805,1.685781,72,5,1, merged,0,0,0
58934,1000023,1,1768,1540,228,0.871041,0.128959,0.871041,202,26,1771,1542,229,0.870695,0.129305,0.870695,203,26,1, merged,1,1,0
58935,1000534,2,681,523,158,0.767988,0.232012,1.696132,142,16,682,524,158,0.768328,0.231672,1.694582,142,16,1, merged,0,0,0
58937,1000121,2,2630,2193,437,0.83384,0.16616,1.616342,403,34,2631,2194,437,0.833903,0.166097,1.616465,403,34,1, merged,0,0,0
58937,1000329,1,3669,2871,798,0.782502,0.217498,0.782502,680,118,3670,2872,798,0.782561,0.217439,0.782561,680,118,-1, merged,0,0,0
58938,1000153,2,1356,1218,138,0.89823,0.10177,1.767416,103,35,1357,1219,138,0.898305,0.101695,1.764972,103,35,1, merged,0,0,0
58944,1000015,2,2484,2221,263,0.894122,0.105878,1.894122,241,22,2485,2222,263,0.894165,0.105835,1.894165,241,22,1, merged,0,0,0
58950,1000003,2,1545,1283,262,0.830421,0.169579,1.68075,224,38,1546,1284,262,0.83053,0.16947,1.680982,224,38,1, merged,0,0,0
58950,1000054,1,1216,1034,182,0.850329,0.149671,0.850329,165,17,1217,1035,182,0.850452,0.149548,0.850452,165,17,1, merged,0,0,0
58951,1000014,1,3313,2675,638,0.807425,0.192575,0.807425,596,42,3314,2676,638,0.807483,0.192517,0.807483,596,42,1, merged,0,0,0
58951,1000110,2,760,680,80,0.894737,0.105263,1.702162,74,6,761,681,80,0.894875,0.105125,1.702359,74,6,1, merged,0,0,0
58952,1000007,2,1898,1530,368,0.806112,0.193888,1.709465,324,44,1899,1531,368,0.806214,0.193786,1.709757,324,44,1, merged,0,0,0
58954,1000015,2,2485,2222,263,0.894165,0.105835,1.738523,241,22,2486,2223,263,0.894208,0.105792,1.738868,241,22,1, merged,0,0,0
58954,1000153,3,1357,1219,138,0.898305,0.101695,2.636828,103,35,1358,1220,138,0.89838,0.10162,2.637248,103,35,1, merged,0,0,0
58957,1000009,1,1963,1633,330,0.83189,0.16811,0.83189,297,33,1965,1633,332,0.831043,0.168957,0.831043,299,33,1, abandoned,1,1,0
58957,1000153,3,1358,1220,138,0.89838,0.10162,2.498598,103,35,1359,1221,138,0.898455,0.101545,2.497381,103,35,-1, abandoned,0,0,0
58957,1000534,2,682,524,158,0.768328,0.231672,1.600218,142,16,685,526,159,0.767883,0.232117,1.598926,143,16,-1, abandoned,1,0,0
58961,1000009,2,1965,1633,332,0.831043,0.168957,1.638527,299,33,1966,1634,332,0.831129,0.168871,1.638369,299,33,1, merged,0,0,0
58961,1000014,1,3314,2676,638,0.807483,0.192517,0.807483,596,42,3315,2676,639,0.80724,0.19276,0.80724,597,42,1, merged,1,1,0
58967,1000043,2,709,587,122,0.827927,0.172073,1.686122,106,16,710,587,123,0.826761,0.173239,1.685216,107,16,1, abandoned,1,1,0
58967,1000108,1,543,466,77,0.858195,0.141805,0.858195,72,5,544,467,77,0.858456,0.141544,0.858456,72,5,-1, abandoned,0,0,0
58971,1000014,1,3315,2676,639,0.80724,0.19276,0.80724,597,42,3318,2679,639,0.807414,0.192586,0.807414,597,42,-1, merged,0,0,0
58971,1000120,2,2186,1919,267,0.877859,0.122141,1.685099,234,33,2189,1920,269,0.877113,0.122887,1.684527,236,33,1, merged,1,1,0
58976,1000003,1,1548,1285,263,0.830103,0.169897,0.830103,225,38,1549,1286,263,0.830213,0.169787,0.830213,225,38,-1, merged,0,0,0
58979,1000004,7,4629,4067,562,0.878591,0.121409,5.751875,446,116,4630,4068,562,0.878618,0.121382,5.574211,446,116,-1, merged,0,0,0
58979,1000011,6,974,893,81,0.916838,0.083162,4.873284,76,5,976,894,82,0.915984,0.084016,4.695593,77,5,-1, merged,1,0,0
58979,1000014,5,3319,2680,639,0.807472,0.192528,3.956446,597,42,3321,2682,639,0.807588,0.192412,3.77961,597,42,-1, merged,0,0,0
58979,1000329,10,3670,2872,798,0.782561,0.217439,8.270364,680,118,3672,2873,799,0.782407,0.217593,8.103593,681,118,1, merged,1,1,0
58979,1002169,1,819,654,165,0.798535,0.201465,0.798535,121,44,832,667,165,0.801683,0.198317,0.801683,121,44,-1, merged,0,0,0
58980,1002169,1,832,667,165,0.801683,0.198317,0.801683,121,44,834,669,165,0.802158,0.197842,0.802158,121,44,-1, abandoned,0,0,0
58992,1000329,2,3673,2874,799,0.782467,0.217533,1.585098,681,118,3674,2875,799,0.782526,0.217474,1.585628,681,118,-1, abandoned,0,0,0
58992,1002169,1,836,671,165,0.802632,0.197368,0.802632,121,44,838,673,165,0.803103,0.196897,0.803103,121,44,-1, abandoned,0,0,0
58995,1000329,2,3674,2875,799,0.782526,0.217474,1.585628,681,118,3675,2876,799,0.782585,0.217415,1.587087,681,118,-1, abandoned,0,0,0
58995,1002169,1,838,673,165,0.803103,0.196897,0.803103,121,44,844,679,165,0.804502,0.195498,0.804502,121,44,-1, abandoned,0,0,0
58999,1000023,2,1773,1544,229,0.87084,0.12916,1.537507,203,26,1774,1545,229,0.870913,0.129087,1.585199,203,26,1, merged,0,0,0
59003,1000120,3,2192,1923,269,0.877281,0.122719,2.325197,236,33,2193,1924,269,0.877337,0.122663,2.323728,236,33,1, merged,0,0,0
59003,1000329,1,3676,2877,799,0.782644,0.217356,0.782644,681,118,3678,2878,800,0.78249,0.21751,0.78249,682,118,1, merged,1,1,0
59005,1000120,2,2193,1924,269,0.877337,0.122663,1.659887,236,33,2194,1925,269,0.877393,0.122607,1.660002,236,33,1, merged,0,0,0
59005,1000329,1,3679,2879,800,0.78255,0.21745,0.78255,682,118,3680,2880,800,0.782609,0.217391,0.782609,682,118,1, merged,0,0,0
59006,1000120,2,2194,1925,269,0.877393,0.122607,1.660002,236,33,2195,1926,269,0.877449,0.122551,1.660117,236,33,1, merged,0,0,0
59006,1000329,1,3680,2880,800,0.782609,0.217391,0.782609,682,118,3681,2881,800,0.782668,0.217332,0.782668,682,118,1, merged,0,0,0
59007,1000120,3,2195,1926,269,0.877449,0.122551,2.445831,236,33,2196,1927,269,0.877505,0.122495,2.460231,236,33,1, merged,0,0,0
59007,1000329,1,3681,2881,800,0.782668,0.217332,0.782668,682,118,3682,2882,800,0.782727,0.217273,0.782727,682,118,1, merged,0,0,0
59008,1000120,2,2196,1927,269,0.877505,0.122495,1.660231,236,33,2197,1928,269,0.87756,0.12244,1.660346,236,33,1, merged,0,0,0
59008,1000329,1,3682,2882,800,0.782727,0.217273,0.782727,682,118,3683,2883,800,0.782786,0.217214,0.782786,682,118,1, merged,0,0,0
59009,1000004,3,4630,4068,562,0.878618,0.121382,2.566165,446,116,4631,4069,562,0.878644,0.121356,2.525302,446,116,-1, merged,0,0,0
59009,1000329,1,3683,2883,800,0.782786,0.217214,0.782786,682,118,3687,2887,800,0.783021,0.216979,0.783021,682,118,-1, merged,0,0,0
59009,1002169,4,844,679,165,0.804502,0.195498,3.370668,121,44,846,680,166,0.803783,0.196217,3.329084,121,45,-1, merged,1,0,0
59010,1000004,1,4631,4069,562,0.878644,0.121356,0.878644,446,116,4632,4070,562,0.87867,0.12133,0.87867,446,116,1, merged,0,0,0
59010,1000132,2,849,709,140,0.8351,0.1649,1.713744,117,23,850,710,140,0.835294,0.164706,1.713964,117,23,1, merged,0,0,0
59012,1000140,2,508,430,78,0.846457,0.153543,1.647827,70,8,509,431,78,0.846758,0.153242,1.652127,70,8,-1, abandoned,0,0,0
59013,1000140,3,509,431,78,0.846758,0.153242,2.500612,70,8,513,434,79,0.846004,0.153996,2.506461,71,8,-1, merged,1,0,0
59014,1000026,2,718,612,106,0.852368,0.147632,1.778838,103,3,719,613,106,0.852573,0.147427,1.779687,103,3,1, merged,0,0,0
59015,1000121,1,2634,2197,437,0.834093,0.165907,0.834093,403,34,2635,2198,437,0.834156,0.165844,0.834156,403,34,-1, abandoned,0,0,0
59029,1000009,1,1969,1637,332,0.831386,0.168614,0.831386,299,33,1973,1640,333,0.831221,0.168779,0.831221,300,33,-1, abandoned,1,0,0
59029,1000534,2,685,526,159,0.767883,0.232117,1.59927,143,16,686,527,159,0.768222,0.231778,1.599443,143,16,-1, abandoned,0,0,0
59034,1000009,2,1973,1640,333,0.831221,0.168779,1.43606,300,33,1974,1641,333,0.831307,0.168693,1.431307,300,33,-1, abandoned,0,0,0
59044,1000054,2,1218,1036,182,0.850575,0.149425,1.634248,165,17,1219,1037,182,0.850697,0.149303,1.63525,165,17,1, merged,0,0,0
59045,1002169,3,846,680,166,0.803783,0.196217,2.377811,121,45,847,681,166,0.804014,0.195986,2.375739,121,45,-1, merged,0,0,0
59058,1000105,1,835,667,168,0.798802,0.201198,0.798802,146,22,836,668,168,0.799043,0.200957,0.799043,146,22,-1, abandoned,0,0,0
59063,1000109,1,709,608,101,0.857546,0.142454,0.857546,96,5,710,609,101,0.857746,0.142254,0.857746,96,5,1, merged,0,0,0
59063,1000199,2,636,547,89,0.860063,0.139937,1.717609,81,8,637,548,89,0.860283,0.139717,1.718029,81,8,1, merged,0,0,0
59070,1000014,1,3321,2682,639,0.807588,0.192412,0.807588,597,42,3322,2683,639,0.807646,0.192354,0.807646,597,42,1, merged,0,0,0
59070,1000015,2,2487,2224,263,0.89425,0.10575,1.701838,241,22,2488,2225,263,0.894293,0.105707,1.701939,241,22,1, merged,0,0,0
59089,1000054,1,1219,1037,182,0.850697,0.149303,0.850697,165,17,1220,1038,182,0.85082,0.14918,0.85082,165,17,1, merged,0,0,0
59093,1000054,2,1220,1038,182,0.85082,0.14918,1.67399,165,17,1221,1039,182,0.850942,0.149058,1.67465,165,17,1, merged,0,0,0
59094,1000004,1,4634,4072,562,0.878722,0.121278,0.878722,446,116,4635,4073,562,0.878749,0.121251,0.878749,446,116,1, merged,0,0,0
59095,1000109,2,710,609,101,0.857746,0.142254,1.636422,96,5,711,610,101,0.857947,0.142053,1.636979,96,5,1, merged,0,0,0
59095,1000199,3,642,552,90,0.859813,0.140187,2.496235,81,9,643,553,90,0.860031,0.139969,2.49701,81,9,1, merged,0,0,0
59107,1000110,2,761,681,80,0.894875,0.105125,1.772713,74,6,762,682,80,0.895013,0.104987,1.772907,74,6,1, merged,0,0,0
59107,1000120,1,2202,1933,269,0.877838,0.122162,0.877838,236,33,2203,1934,269,0.877894,0.122106,0.877894,236,33,1, merged,0,0,0
59108,1000110,2,762,682,80,0.895013,0.104987,1.772907,74,6,763,683,80,0.895151,0.104849,1.7731,74,6,1, merged,0,0,0
59108,1000120,1,2203,1934,269,0.877894,0.122106,0.877894,236,33,2204,1935,269,0.877949,0.122051,0.877949,236,33,1, merged,0,0,0
59109,1000110,2,763,683,80,0.895151,0.104849,1.7731,74,6,764,684,80,0.895288,0.104712,1.773292,74,6,1, merged,0,0,0
59109,1000120,1,2204,1935,269,0.877949,0.122051,0.877949,236,33,2205,1936,269,0.878005,0.121995,0.878005,236,33,1, merged,0,0,0
59110,1000009,2,1979,1646,333,0.831733,0.168267,1.709738,300,33,1980,1647,333,0.831818,0.168182,1.709933,300,33,1, merged,0,0,0
59110,1000026,3,720,614,106,0.852778,0.147222,2.562516,103,3,721,615,106,0.852982,0.147018,2.562915,103,3,1, merged,0,0,0
59110,1000120,1,2205,1936,269,0.878005,0.121995,0.878005,236,33,2207,1938,269,0.878115,0.121885,0.878115,236,33,1, merged,0,0,0
59111,1000026,3,721,615,106,0.852982,0.147018,2.492263,103,3,722,616,106,0.853186,0.146814,2.491428,103,3,1, merged,0,0,0
59111,1000199,1,644,554,90,0.860248,0.139752,0.860248,81,9,645,555,90,0.860465,0.139535,0.860465,81,9,1, merged,0,0,0
59114,1000199,2,645,555,90,0.860465,0.139535,1.638243,81,9,646,556,90,0.860681,0.139319,1.638816,81,9,1, merged,0,0,0
59119,1000110,3,764,684,80,0.895288,0.104712,2.5653,74,6,765,685,80,0.895425,0.104575,2.566269,74,6,1, merged,0,0,0
59119,1000140,1,514,435,79,0.846304,0.153696,0.846304,71,8,515,436,79,0.846602,0.153398,0.846602,71,8,-1, merged,0,0,0
59124,1000327,2,730,577,153,0.790411,0.209589,1.576125,118,35,732,579,153,0.790984,0.209016,1.558425,118,35,-1, merged,0,0,0
59130,1000109,2,711,610,101,0.857947,0.142053,1.635547,96,5,712,611,101,0.858146,0.141854,1.634861,96,5,1, merged,0,0,0
59136,1000015,1,2489,2226,263,0.894335,0.105665,0.894335,241,22,2490,2227,263,0.894378,0.105622,0.894378,241,22,1, merged,0,0,0
59140,1000110,3,765,685,80,0.895425,0.104575,2.123298,74,6,766,686,80,0.895561,0.104439,2.10399,74,6,-1, abandoned,0,0,0
59140,1000130,4,749,622,127,0.830441,0.169559,2.953739,94,33,751,624,127,0.830892,0.169108,2.934882,94,33,-1, abandoned,0,0,0
59145,1000121,1,2639,2202,437,0.834407,0.165593,0.834407,403,34,2640,2202,438,0.834091,0.165909,0.834091,404,34,1, abandoned,1,1,0
59146,1000023,1,1786,1556,230,0.871221,0.128779,0.871221,204,26,1787,1557,230,0.871293,0.128707,0.871293,204,26,1, merged,0,0,0
59146,1000166,2,552,416,136,0.753623,0.246377,1.624844,130,6,553,417,136,0.754069,0.245931,1.625361,130,6,1, merged,0,0,0
59154,1000120,2,2209,1940,269,0.878225,0.121775,1.621612,236,33,2210,1941,269,0.878281,0.121719,1.622344,236,33,1, merged,0,0,0
59164,1000023,1,1788,1558,230,0.871365,0.128635,0.871365,204,26,1789,1558,231,0.870878,0.129122,0.870878,205,26,1, abandoned,1,1,0
59166,1000004,1,4635,4073,562,0.878749,0.121251,0.878749,446,116,4637,4075,562,0.878801,0.121199,0.878801,446,116,-1, merged,0,0,0
59166,1000120,2,2210,1941,269,0.878281,0.121719,1.757029,236,33,2211,1942,269,0.878336,0.121664,1.757137,236,33,1, merged,0,0,0
59167,1000004,2,4637,4075,562,0.878801,0.121199,1.647023,446,116,4638,4075,563,0.878611,0.121389,1.647507,446,117,-1, merged,1,1,0
59167,1000534,1,686,527,159,0.768222,0.231778,0.768222,143,16,688,529,159,0.768895,0.231105,0.768895,143,16,-1, merged,0,0,0
59176,1000110,2,766,686,80,0.895561,0.104439,1.742163,74,6,768,688,80,0.895833,0.104167,1.740795,74,6,-1, merged,0,0,0
59176,1000140,1,515,436,79,0.846602,0.153398,0.846602,71,8,516,436,80,0.844961,0.155039,0.844961,72,8,1, merged,1,1,0
59178,1000004,4,4638,4075,563,0.878611,0.121389,3.173668,446,117,4639,4076,563,0.878638,0.121362,3.162906,446,117,-1, abandoned,0,0,0
59178,1000166,1,553,417,136,0.754069,0.245931,0.754069,130,6,554,417,137,0.752708,0.247292,0.752708,131,6,1, abandoned,1,1,0
59183,1000012,2,809,695,114,0.859085,0.140915,1.75754,111,3,810,696,114,0.859259,0.140741,1.757789,111,3,1, merged,0,0,0
59183,1000153,1,1359,1221,138,0.898455,0.101545,0.898455,103,35,1360,1222,138,0.898529,0.101471,0.898529,103,35,1, merged,0,0,0
59190,1000199,1,647,557,90,0.860896,0.139104,0.860896,81,9,648,558,90,0.861111,0.138889,0.861111,81,9,1, merged,0,0,0
59191,1000199,1,648,558,90,0.861111,0.138889,0.861111,81,9,649,559,90,0.861325,0.138675,0.861325,81,9,1, merged,0,0,0
59192,1000199,1,649,559,90,0.861325,0.138675,0.861325,81,9,651,560,91,0.860215,0.139785,0.860215,82,9,1, merged,1,1,0
59193,1000199,2,651,560,91,0.860215,0.139785,1.63676,82,9,652,561,91,0.860429,0.139571,1.638382,82,9,1, merged,0,0,0
59196,1000054,1,1222,1040,182,0.851064,0.148936,0.851064,165,17,1223,1041,182,0.851186,0.148814,0.851186,165,17,1, merged,0,0,0
59197,1000054,1,1223,1041,182,0.851186,0.148814,0.851186,165,17,1224,1042,182,0.851307,0.148693,0.851307,165,17,1, merged,0,0,0
59197,1000166,3,554,417,137,0.752708,0.247292,2.315432,131,6,555,418,137,0.753153,0.246847,2.318746,131,6,1, merged,0,0,0
59198,1000004,2,4639,4076,563,0.878638,0.121362,1.631791,446,117,4640,4077,563,0.878664,0.121336,1.632261,446,117,1, merged,0,0,0
59198,1000166,1,555,418,137,0.753153,0.246847,0.753153,131,6,556,419,137,0.753597,0.246403,0.753597,131,6,1, merged,0,0,0
59201,1000153,1,1362,1224,138,0.898678,0.101322,0.898678,103,35,1364,1226,138,0.898827,0.101173,0.898827,103,35,-1, merged,0,0,0
59202,1000011,2,979,896,83,0.91522,0.08478,1.779881,78,5,980,897,83,0.915306,0.084694,1.781973,78,5,1, merged,0,0,0
59216,1000011,2,980,897,83,0.915306,0.084694,1.781973,78,5,981,898,83,0.915392,0.084608,1.78304,78,5,1, merged,0,0,0
59232,1000007,1,1901,1533,368,0.806418,0.193582,0.806418,324,44,1903,1534,369,0.806096,0.193904,0.806096,325,44,1, merged,1,1,0
59234,1000120,2,2213,1944,269,0.878446,0.121554,1.730619,236,33,2214,1945,269,0.8785,0.1215,1.731949,236,33,-1, merged,0,0,0
59236,1000120,2,2215,1946,269,0.878555,0.121445,1.736021,236,33,2216,1947,269,0.87861,0.12139,1.735269,236,33,1, merged,0,0,0
59236,1000592,1,884,758,126,0.857466,0.142534,0.857466,79,47,886,759,127,0.856659,0.143341,0.856659,80,47,-1, merged,1,0,0
59237,1000004,2,4640,4077,563,0.878664,0.121336,1.757274,446,117,4641,4078,563,0.87869,0.12131,1.757355,446,117,1, merged,0,0,0
59237,1000120,1,2216,1947,269,0.87861,0.12139,0.87861,236,33,2217,1948,269,0.878665,0.121335,0.878665,236,33,1, merged,0,0,0
59247,1000004,1,4641,4078,563,0.87869,0.12131,0.87869,446,117,4642,4079,563,0.878716,0.121284,0.878716,446,117,-1, merged,0,0,0
59247,1000120,2,2219,1949,270,0.878324,0.121676,1.757014,237,33,2221,1951,270,0.878433,0.121567,1.757149,237,33,-1, merged,0,0,0
59251,1000026,1,723,617,106,0.853389,0.146611,0.853389,103,3,724,617,107,0.85221,0.14779,0.85221,104,3,1, merged,1,1,0
59251,1000534,2,688,529,159,0.768895,0.231105,1.622284,143,16,690,530,160,0.768116,0.231884,1.620326,144,16,1, merged,1,1,0
59253,1000054,1,1224,1042,182,0.851307,0.148693,0.851307,165,17,1225,1042,183,0.850612,0.149388,0.850612,166,17,1, merged,1,1,0
59253,1000132,3,850,710,140,0.835294,0.164706,2.400887,117,23,851,711,140,0.835488,0.164512,2.403081,117,23,1, merged,0,0,0
59254,1000012,2,811,697,114,0.859433,0.140567,1.709091,111,3,812,698,114,0.859606,0.140394,1.709606,111,3,1, merged,0,0,0
59255,1000153,1,1364,1226,138,0.898827,0.101173,0.898827,103,35,1367,1228,139,0.898317,0.101683,0.898317,104,35,1, merged,1,1,0
59257,1000054,3,1225,1042,183,0.850612,0.149388,2.379282,166,17,1226,1043,183,0.850734,0.149266,2.383263,166,17,1, merged,0,0,0
59258,1000005,2,902,783,119,0.868071,0.131929,1.663525,109,10,903,784,119,0.868217,0.131783,1.66521,109,10,1, merged,0,0,0
59272,1000120,3,2221,1951,270,0.878433,0.121567,2.426806,237,33,2222,1952,270,0.878488,0.121512,2.439721,237,33,1, merged,0,0,0
59272,1000121,4,2645,2207,438,0.834405,0.165595,3.26121,404,34,2646,2208,438,0.834467,0.165533,3.274188,404,34,1, merged,0,0,0
59272,1000329,1,3698,2898,800,0.783667,0.216333,0.783667,682,118,3699,2898,801,0.783455,0.216545,0.783455,682,119,-1, merged,1,1,0
59278,1000011,2,981,898,83,0.915392,0.084608,1.809812,78,5,982,899,83,0.915479,0.084521,1.809941,78,5,1, merged,0,0,0
59278,1000015,1,2491,2228,263,0.89442,0.10558,0.89442,241,22,2492,2229,263,0.894462,0.105538,0.894462,241,22,1, merged,0,0,0
59286,1000329,2,3699,2898,801,0.783455,0.216545,1.587469,682,119,3703,2901,802,0.783419,0.216581,1.587664,683,119,-1, merged,1,0,0
59286,1002169,1,847,681,166,0.804014,0.195986,0.804014,121,45,848,682,166,0.804245,0.195755,0.804245,121,45,-1, merged,0,0,0
59288,1000004,1,4642,4079,563,0.878716,0.121284,0.878716,446,117,4643,4080,563,0.878742,0.121258,0.878742,446,117,-1, merged,0,0,0
59288,1000329,2,3706,2904,802,0.783594,0.216406,1.66231,683,119,3708,2905,803,0.783441,0.216559,1.662183,684,119,1, merged,1,1,0
59309,1000003,2,1550,1287,263,0.830323,0.169677,1.701846,225,38,1552,1288,264,0.829897,0.170103,1.700936,226,38,1, merged,1,1,0
59309,1000023,1,1798,1567,231,0.871524,0.128476,0.871524,205,26,1799,1567,232,0.871039,0.128961,0.871039,206,26,1, merged,1,1,0
59309,1000329,3,3717,2913,804,0.783697,0.216303,2.485543,685,119,3718,2913,805,0.783486,0.216514,2.484422,686,119,1, merged,1,1,0
59312,1000109,2,712,611,101,0.858146,0.141854,1.636099,96,5,714,613,101,0.858543,0.141457,1.635623,96,5,-1, merged,0,0,0
59321,1000014,1,3332,2692,640,0.807923,0.192077,0.807923,598,42,3333,2693,640,0.807981,0.192019,0.807981,598,42,1, merged,0,0,0
59324,1000120,1,2225,1955,270,0.878652,0.121348,0.878652,237,33,2226,1956,270,0.878706,0.121294,0.878706,237,33,1, merged,0,0,0
59325,1000054,1,1226,1043,183,0.850734,0.149266,0.850734,166,17,1228,1044,184,0.850163,0.149837,0.850163,167,17,1, merged,1,1,0
59326,1000004,2,4644,4081,563,0.878768,0.121232,1.665917,446,117,4646,4083,563,0.87882,0.12118,1.663681,446,117,-1, merged,0,0,0
59328,1000003,2,1552,1288,264,0.829897,0.170103,1.688638,226,38,1553,1288,265,0.829363,0.170637,1.688301,226,39,-1, merged,1,1,0
59328,1000109,1,715,614,101,0.858741,0.141259,0.858741,96,5,716,615,101,0.858939,0.141061,0.858939,96,5,1, merged,0,0,0
59336,1000003,2,1553,1288,265,0.829363,0.170637,1.708069,226,39,1556,1290,266,0.829049,0.170951,1.70736,227,39,-1, abandoned,1,0,0
59336,1000004,3,4646,4083,563,0.87882,0.12118,2.586889,446,117,4647,4084,563,0.878847,0.121153,2.586207,446,117,-1, abandoned,0,0,0
59336,1000120,1,2226,1956,270,0.878706,0.121294,0.878706,237,33,2227,1956,271,0.878312,0.121688,0.878312,238,33,1, abandoned,1,1,0
59342,1000105,2,837,669,168,0.799283,0.200717,1.575357,146,22,838,670,168,0.799523,0.200477,1.576281,146,22,1, merged,0,0,0
59342,1000140,3,516,436,80,0.844961,0.155039,2.420318,72,8,517,436,81,0.843327,0.156673,2.419608,72,9,-1, merged,1,1,0
59343,1000004,2,4647,4084,563,0.878847,0.121153,1.74746,446,117,4648,4085,563,0.878873,0.121127,1.749376,446,117,-1, merged,0,0,0
59343,1000120,3,2227,1956,271,0.878312,0.121688,2.625771,238,33,2230,1959,271,0.878475,0.121525,2.627852,238,33,-1, merged,0,0,0
59344,1000004,2,4648,4085,563,0.878873,0.121127,1.703277,446,117,4649,4086,563,0.878899,0.121101,1.704342,446,117,-1, abandoned,0,0,0
59362,1000007,2,1903,1534,369,0.806096,0.193904,1.65713,325,44,1904,1535,369,0.806197,0.193803,1.657437,325,44,1, merged,0,0,0
59362,1000026,1,725,617,108,0.851034,0.148966,0.851034,105,3,726,618,108,0.85124,0.14876,0.85124,105,3,1, merged,0,0,0
59370,1000592,2,886,759,127,0.856659,0.143341,1.600249,80,47,887,760,127,0.856821,0.143179,1.606821,80,47,1, merged,0,0,0
59372,1000003,1,1556,1290,266,0.829049,0.170951,0.829049,227,39,1557,1291,266,0.829159,0.170841,0.829159,227,39,1, merged,0,0,0
59372,1000120,2,2234,1963,271,0.878693,0.121307,1.707742,238,33,2235,1964,271,0.878747,0.121253,1.707906,238,33,1, merged,0,0,0
59388,1000023,1,1800,1568,232,0.871111,0.128889,0.871111,206,26,1802,1570,232,0.871254,0.128746,0.871254,206,26,1, merged,0,0,0
59399,1000009,1,2001,1665,336,0.832084,0.167916,0.832084,301,35,2002,1666,336,0.832168,0.167832,0.832168,301,35,1, merged,0,0,0
59399,1000153,2,1371,1231,140,0.897885,0.102115,1.729969,105,35,1372,1232,140,0.897959,0.102041,1.730127,105,35,1, merged,0,0,0
59405,1000014,1,3339,2698,641,0.808026,0.191974,0.808026,599,42,3340,2699,641,0.808084,0.191916,0.808084,599,42,1, merged,0,0,0
59405,1000091,4,676,536,140,0.792899,0.207101,3.193343,117,23,677,537,140,0.793205,0.206795,3.194417,117,23,1, merged,0,0,0
59405,1000132,2,851,711,140,0.835488,0.164512,1.643514,117,23,852,712,140,0.835681,0.164319,1.643765,117,23,1, merged,0,0,0
59409,1000003,3,1557,1291,266,0.829159,0.170841,2.467444,227,39,1558,1292,266,0.829268,0.170732,2.465023,227,39,-1, abandoned,0,0,0
59409,1000199,1,654,563,91,0.860856,0.139144,0.860856,82,9,655,563,92,0.859542,0.140458,0.859542,83,9,1, abandoned,1,1,0
59413,1000004,2,4654,4091,563,0.879029,0.120971,1.750354,446,117,4655,4092,563,0.879055,0.120945,1.749897,446,117,-1, abandoned,0,0,0
59413,1000023,1,1803,1571,232,0.871326,0.128674,0.871326,206,26,1804,1571,233,0.870843,0.129157,0.870843,207,26,1, abandoned,1,1,0
59414,1000110,3,768,688,80,0.895833,0.104167,2.552667,74,6,769,689,80,0.895969,0.104031,2.554302,74,6,1, merged,0,0,0
59414,1000140,2,519,438,81,0.843931,0.156069,1.656834,72,9,520,439,81,0.844231,0.155769,1.658333,72,9,1, merged,0,0,0
59415,1000110,2,769,689,80,0.895969,0.104031,1.7402,74,6,770,690,80,0.896104,0.103896,1.740634,74,6,1, merged,0,0,0
59415,1000140,1,520,439,81,0.844231,0.155769,0.844231,72,9,521,440,81,0.84453,0.15547,0.84453,72,9,1, merged,0,0,0
59417,1000003,2,1558,1292,266,0.829268,0.170732,1.605481,227,39,1559,1293,266,0.829378,0.170622,1.60594,227,39,1, merged,0,0,0
59418,1000110,2,770,690,80,0.896104,0.103896,1.740634,74,6,771,691,80,0.896239,0.103761,1.739451,74,6,1, merged,0,0,0
59418,1000140,1,521,440,81,0.84453,0.15547,0.84453,72,9,523,441,82,0.843212,0.156788,0.843212,73,9,1, merged,1,1,0
59419,1000110,2,771,691,80,0.896239,0.103761,1.739451,74,6,772,692,80,0.896373,0.103627,1.740183,74,6,1, merged,0,0,0
59419,1000140,1,523,441,82,0.843212,0.156788,0.843212,73,9,525,443,82,0.84381,0.15619,0.84381,73,9,-1, merged,0,0,0
59425,1000132,4,852,712,140,0.835681,0.164319,3.018739,117,23,853,713,140,0.835873,0.164127,3.01347,117,23,1, merged,0,0,0
59426,1000026,2,726,618,108,0.85124,0.14876,1.637864,105,3,727,619,108,0.851444,0.148556,1.635571,105,3,1, merged,0,0,0
59427,1000110,2,772,692,80,0.896373,0.103627,1.740183,74,6,773,693,80,0.896507,0.103493,1.740614,74,6,1, merged,0,0,0
59427,1000140,1,525,443,82,0.84381,0.15619,0.84381,73,9,526,444,82,0.844106,0.155894,0.844106,73,9,1, merged,0,0,0
59444,1000121,2,2647,2209,438,0.83453,0.16547,1.600421,404,34,2648,2210,438,0.834592,0.165408,1.600846,404,34,1, merged,0,0,0
59446,1000592,2,892,763,129,0.855381,0.144619,1.669484,82,47,893,764,129,0.855543,0.144457,1.67083,82,47,1, merged,0,0,0
59454,1000121,2,2648,2210,438,0.834592,0.165408,1.600846,404,34,2649,2211,438,0.834655,0.165345,1.60127,404,34,1, merged,0,0,0
59463,1000004,2,4657,4093,564,0.878892,0.121108,1.737866,446,118,4658,4094,564,0.878918,0.121082,1.73815,446,118,1, merged,0,0,0
59463,1000091,3,677,537,140,0.793205,0.206795,2.531072,117,23,678,538,140,0.79351,0.20649,2.53166,117,23,1, merged,0,0,0
59463,1000108,1,546,469,77,0.858974,0.141026,0.858974,72,5,547,470,77,0.859232,0.140768,0.859232,72,5,1, merged,0,0,0
59469,1000004,1,4658,4094,564,0.878918,0.121082,0.878918,446,118,4660,4096,564,0.87897,0.12103,0.87897,446,118,-1, merged,0,0,0
59469,1000120,2,2237,1966,271,0.878856,0.121144,1.757774,238,33,2238,1967,271,0.87891,0.12109,1.75788,238,33,1, merged,0,0,0
59474,1000132,1,853,713,140,0.835873,0.164127,0.835873,117,23,855,714,141,0.835088,0.164912,0.835088,117,24,-1, merged,1,1,0
59484,1000105,2,839,671,168,0.799762,0.200238,0.799762,146,22,841,673,168,0.800238,0.199762,1.050238,146,22,-1, merged,0,0,0
59490,1000329,2,3722,2917,805,0.783718,0.216282,1.633718,686,119,3725,2920,805,0.783893,0.216107,1.625477,686,119,-1, merged,0,0,0
59491,1000004,2,4660,4096,564,0.87897,0.12103,1.777152,446,118,4662,4097,565,0.878807,0.121193,1.776411,447,118,1, merged,1,1,0
59491,1000153,1,1375,1235,140,0.898182,0.101818,0.898182,105,35,1377,1236,141,0.897603,0.102397,0.897603,106,35,1, merged,1,1,0
59495,1000026,1,728,620,108,0.851648,0.148352,0.851648,105,3,729,621,108,0.851852,0.148148,0.851852,105,3,1, merged,0,0,0
59499,1000054,1,1229,1045,184,0.850285,0.149715,0.850285,167,17,1230,1045,185,0.849593,0.150407,0.849593,168,17,1, merged,1,1,0
59501,1000140,2,530,447,83,0.843396,0.156604,1.66884,73,10,531,448,83,0.843691,0.156309,1.66965,73,10,1, merged,0,0,0
59505,1000153,1,1377,1236,141,0.897603,0.102397,0.897603,106,35,1378,1237,141,0.897678,0.102322,0.897678,106,35,-1, merged,0,0,0
59507,1000007,3,1909,1540,369,0.806705,0.193295,2.518058,325,44,1910,1540,370,0.806283,0.193717,2.517112,326,44,1, merged,1,1,0
59507,1000009,1,2004,1668,336,0.832335,0.167665,0.832335,301,35,2009,1671,338,0.831757,0.168243,0.831757,303,35,-1, merged,1,0,0
59507,1000120,2,2240,1969,271,0.879018,0.120982,1.711353,238,33,2241,1970,271,0.879072,0.120928,1.710829,238,33,-1, merged,0,0,0
59510,1000009,1,2009,1671,338,0.831757,0.168243,0.831757,303,35,2010,1672,338,0.831841,0.168159,0.831841,303,35,1, merged,0,0,0
59516,1000328,3,1097,817,280,0.744758,0.255242,2.322909,252,28,1098,818,280,0.744991,0.255009,2.319647,252,28,1, merged,0,0,0
59516,1000329,2,3725,2920,805,0.783893,0.216107,1.578151,686,119,3726,2920,806,0.783682,0.216318,1.574656,687,119,1, merged,1,1,0
59524,1000108,2,547,470,77,0.859232,0.140768,1.637348,72,5,548,471,77,0.859489,0.140511,1.635924,72,5,1, merged,0,0,0
59549,1000007,2,1916,1545,371,0.806367,0.193633,1.5354,327,44,1917,1546,371,0.806468,0.193532,1.537238,327,44,1, merged,0,0,0
59550,1000007,2,1917,1546,371,0.806468,0.193532,1.537238,327,44,1918,1547,371,0.806569,0.193431,1.539053,327,44,1, merged,0,0,0
59561,1000023,2,1804,1571,233,0.870843,0.129157,1.741346,207,26,1805,1572,233,0.870914,0.129086,1.742343,207,26,1, merged,0,0,0
59566,1000023,2,1805,1572,233,0.870914,0.129086,1.5852,207,26,1806,1573,233,0.870986,0.129014,1.57274,207,26,1, merged,0,0,0
59574,1000329,2,3726,2920,806,0.783682,0.216318,1.574656,687,119,3728,2922,806,0.783798,0.216202,1.572898,687,119,-1, abandoned,0,0,0
59584,1000023,1,1806,1573,233,0.870986,0.129014,0.870986,207,26,1807,1574,233,0.871057,0.128943,0.871057,207,26,1, merged,0,0,0
59584,1000121,2,2661,2223,438,0.8354,0.1646,1.706386,404,34,2662,2224,438,0.835462,0.164538,1.706519,404,34,1, merged,0,0,0
59588,1000004,1,4672,4107,565,0.879067,0.120933,0.879067,447,118,4673,4108,565,0.879093,0.120907,0.879093,447,118,1, merged,0,0,0
59593,1000105,3,841,673,168,0.800238,0.199762,2.0968,146,22,842,674,168,0.800475,0.199525,2.105275,146,22,1, merged,0,0,0
59599,1000023,2,1810,1577,233,0.871271,0.128729,1.742699,207,26,1811,1578,233,0.871342,0.128658,1.743682,207,26,1, merged,0,0,0
59605,1000105,3,842,674,168,0.800475,0.199525,2.462806,146,22,843,675,168,0.800712,0.199288,2.462095,146,22,-1, merged,0,0,0
59605,1000329,4,3728,2922,806,0.783798,0.216202,3.246604,687,119,3730,2923,807,0.783646,0.216354,3.245742,687,120,-1, merged,1,0,0
59605,1002169,1,848,682,166,0.804245,0.195755,0.804245,121,45,849,683,166,0.804476,0.195524,0.804476,121,45,-1, merged,0,0,0
59619,1000110,1,776,696,80,0.896907,0.103093,0.896907,74,6,777,697,80,0.89704,0.10296,0.89704,74,6,1, merged,0,0,0
59621,1000110,2,777,697,80,0.89704,0.10296,1.72351,74,6,778,698,80,0.897172,0.102828,1.724658,74,6,1, merged,0,0,0
59627,1000009,2,2014,1676,338,0.832175,0.167825,1.435349,303,35,2015,1677,338,0.832258,0.167742,1.433821,303,35,1, merged,0,0,0
59631,1000091,3,678,538,140,0.79351,0.20649,2.434064,117,23,679,539,140,0.793814,0.206186,2.433492,117,23,1, merged,0,0,0
59631,1000329,2,3730,2923,807,0.783646,0.216354,1.640554,687,120,3731,2924,807,0.783704,0.216296,1.639678,687,120,1, merged,0,0,0
59633,1000130,2,768,640,128,0.833333,0.166667,1.69697,95,33,769,641,128,0.83355,0.16645,1.697872,95,33,1, merged,0,0,0
59640,1000054,1,1232,1047,185,0.849838,0.150162,0.849838,168,17,1234,1048,186,0.849271,0.150729,0.849271,169,17,1, merged,1,1,0
59641,1000110,2,778,698,80,0.897172,0.102828,1.725939,74,6,779,699,80,0.897304,0.102696,1.726656,74,6,1, merged,0,0,0
59647,1000054,1,1234,1048,186,0.849271,0.150729,0.849271,169,17,1236,1050,186,0.849515,0.150485,0.849515,169,17,-1, merged,0,0,0
59649,1000005,3,916,797,119,0.870087,0.129913,2.577412,109,10,917,798,119,0.870229,0.129771,2.577757,109,10,1, merged,0,0,0
59649,1000023,1,1814,1581,233,0.871555,0.128445,0.871555,207,26,1816,1583,233,0.871696,0.128304,0.871696,207,26,-1, merged,0,0,0
59649,1000121,2,2667,2229,438,0.835771,0.164229,1.707325,404,34,2668,2230,438,0.835832,0.164168,1.707528,404,34,1, merged,0,0,0
59651,1000004,1,4674,4109,565,0.879119,0.120881,0.879119,447,118,4675,4110,565,0.879144,0.120856,0.879144,447,118,1, merged,0,0,0
59653,1000153,2,1380,1239,141,0.897826,0.102174,1.231159,106,35,1382,1241,141,0.897974,0.102026,1.147974,106,35,-1, merged,0,0,0
59657,1000004,1,4675,4110,565,0.879144,0.120856,0.879144,447,118,4677,4112,565,0.879196,0.120804,0.879196,447,118,-1, abandoned,0,0,0
59657,1000120,2,2243,1972,271,0.87918,0.12082,1.758324,238,33,2244,1973,271,0.879234,0.120766,1.75843,238,33,-1, abandoned,0,0,0
59658,1000004,1,4677,4112,565,0.879196,0.120804,0.879196,447,118,4678,4113,565,0.879222,0.120778,0.879222,447,118,-1, merged,0,0,0
59658,1000091,2,679,539,140,0.793814,0.206186,1.67301,117,23,681,540,141,0.792952,0.207048,1.672173,118,23,-1, merged,1,0,0
59661,1000023,1,1816,1583,233,0.871696,0.128304,0.871696,207,26,1818,1585,233,0.871837,0.128163,0.871837,207,26,1, merged,0,0,0
59670,1000004,1,4680,4115,565,0.879274,0.120726,0.879274,447,118,4681,4116,565,0.879299,0.120701,0.879299,447,118,1, merged,0,0,0
59670,1000329,3,3732,2925,807,0.783762,0.216238,2.569076,687,120,3733,2926,807,0.78382,0.21618,2.569369,687,120,1, merged,0,0,0
59673,1000110,2,779,699,80,0.897304,0.102696,1.763501,74,6,780,700,80,0.897436,0.102564,1.764569,74,6,1, merged,0,0,0
59675,1000110,1,780,700,80,0.897436,0.102564,0.897436,74,6,781,701,80,0.897567,0.102433,0.897567,74,6,1, merged,0,0,0
59680,1000109,1,718,617,101,0.859331,0.140669,0.859331,96,5,719,618,101,0.859527,0.140473,0.859527,96,5,1, merged,0,0,0
59681,1000004,1,4681,4116,565,0.879299,0.120701,0.879299,447,118,4682,4117,565,0.879325,0.120675,0.879325,447,118,-1, merged,0,0,0
59681,1000120,2,2245,1974,271,0.879287,0.120713,1.758587,238,33,2247,1976,271,0.879395,0.120605,1.75872,238,33,-1, merged,0,0,0
59682,1000007,2,1918,1547,371,0.806569,0.193431,1.620729,327,44,1919,1547,372,0.806149,0.193851,1.606149,328,44,1, merged,1,1,0
59707,1000003,1,1560,1294,266,0.829487,0.170513,0.829487,227,39,1561,1294,267,0.828956,0.171044,0.828956,228,39,1, merged,1,1,0
59707,1000004,2,4683,4118,565,0.879351,0.120649,1.708838,447,118,4685,4120,565,0.879402,0.120598,1.708358,447,118,-1, merged,0,0,0
59710,1000007,2,1919,1547,372,0.806149,0.193851,1.700487,328,44,1920,1548,372,0.80625,0.19375,1.700232,328,44,1, merged,0,0,0
59710,1000015,1,2508,2243,265,0.894338,0.105662,0.894338,243,22,2509,2243,266,0.893982,0.106018,0.893982,244,22,1, merged,1,1,0
59712,1000012,2,817,701,116,0.858017,0.141983,1.658729,113,3,818,702,116,0.858191,0.141809,1.659374,113,3,1, merged,0,0,0
59712,1000105,1,843,675,168,0.800712,0.199288,0.800712,146,22,845,677,168,0.801183,0.198817,0.801183,146,22,-1, merged,0,0,0
59713,1000009,2,2016,1678,338,0.832341,0.167659,1.640483,303,35,2017,1678,339,0.831929,0.168071,1.639886,304,35,1, merged,1,1,0
59713,1000014,1,3341,2700,641,0.808141,0.191859,0.808141,599,42,3343,2701,642,0.807957,0.192043,0.807957,600,42,1, merged,1,1,0
59717,1000328,3,1099,819,280,0.745223,0.254777,2.319137,252,28,1100,819,281,0.744545,0.255455,2.316507,252,29,-1, merged,1,1,0
59717,1000329,2,3733,2926,807,0.78382,0.21618,1.573914,687,120,3736,2928,808,0.783726,0.216274,1.571961,688,120,-1, merged,1,0,0
59718,1000132,1,855,714,141,0.835088,0.164912,0.835088,117,24,857,715,142,0.834306,0.165694,0.834306,117,25,1, merged,1,0,0
59719,1000003,2,1561,1294,267,0.828956,0.171044,1.708511,228,39,1562,1295,267,0.829065,0.170935,1.708284,228,39,1, merged,0,0,0
59719,1000004,3,4685,4120,565,0.879402,0.120598,2.587914,447,118,4686,4121,565,0.879428,0.120572,2.587712,447,118,1, merged,0,0,0
59719,1000120,1,2250,1979,271,0.879556,0.120444,0.879556,238,33,2252,1980,272,0.879218,0.120782,0.879218,239,33,1, merged,1,1,0
59737,1000110,2,782,702,80,0.897698,0.102302,1.897698,74,6,783,703,80,0.897829,0.102171,1.897829,74,6,1, merged,0,0,0
59738,1000003,1,1562,1295,267,0.829065,0.170935,0.829065,228,39,1564,1297,267,0.829284,0.170716,0.829284,228,39,-1, merged,0,0,0
59738,1000004,3,4686,4121,565,0.879428,0.120572,2.573282,447,118,4688,4123,565,0.87948,0.12052,2.571123,447,118,-1, merged,0,0,0
59738,1000023,4,1825,1591,234,0.871781,0.128219,3.445063,208,26,1826,1592,234,0.871851,0.128149,3.442974,208,26,1, merged,0,0,0
59739,1000004,2,4688,4123,565,0.87948,0.12052,1.776538,447,118,4689,4123,566,0.879292,0.120708,1.76335,448,118,1, abandoned,1,1,0
59743,1000132,1,857,715,142,0.834306,0.165694,0.834306,117,25,858,715,143,0.833333,0.166667,0.833333,118,25,1, abandoned,1,1,0
59744,1000004,2,4689,4123,566,0.879292,0.120708,1.646664,448,118,4690,4124,566,0.879318,0.120682,1.64739,448,118,1, merged,0,0,0
59750,1000109,2,721,620,101,0.859917,0.140083,1.634762,96,5,722,621,101,0.860111,0.139889,1.635305,96,5,1, merged,0,0,0
59751,1000054,1,1236,1050,186,0.849515,0.150485,0.849515,169,17,1238,1051,187,0.84895,0.15105,0.84895,170,17,1, merged,1,1,0
59751,1000166,3,556,419,137,0.753597,0.246403,2.493737,131,6,557,419,138,0.752244,0.247756,2.479982,132,6,1, merged,1,1,0
59752,1000023,1,1826,1592,234,0.871851,0.128149,0.871851,208,26,1827,1593,234,0.871921,0.128079,0.871921,208,26,1, merged,0,0,0
59753,1000054,1,1238,1051,187,0.84895,0.15105,0.84895,170,17,1239,1052,187,0.849072,0.150928,0.849072,170,17,1, merged,0,0,0
59753,1000166,2,557,419,138,0.752244,0.247756,1.601194,132,6,558,420,138,0.752688,0.247312,1.60176,132,6,1, merged,0,0,0
59757,1000023,1,1827,1593,234,0.871921,0.128079,0.871921,208,26,1828,1594,234,0.871991,0.128009,0.871991,208,26,1, merged,0,0,0
59773,1000004,2,4690,4124,566,0.879318,0.120682,1.683794,448,118,4692,4126,566,0.879369,0.120631,1.684075,448,118,-1, merged,0,0,0
59773,1000329,5,3736,2928,808,0.783726,0.216274,3.90921,688,120,3737,2929,808,0.783784,0.216216,3.915363,688,120,1, merged,0,0,0
59773,1002169,1,849,683,166,0.804476,0.195524,0.804476,121,45,850,684,166,0.804706,0.195294,0.804706,121,45,-1, merged,0,0,0
59779,1000005,2,923,804,119,0.871073,0.128927,1.707089,109,10,924,805,119,0.871212,0.128788,1.70729,109,10,1, merged,0,0,0
59779,1000121,1,2671,2233,438,0.836016,0.163984,0.836016,404,34,2672,2234,438,0.836078,0.163922,0.836078,404,34,1, merged,0,0,0
59781,1000120,2,2253,1981,272,0.879272,0.120728,1.665833,239,33,2254,1982,272,0.879326,0.120674,1.666727,239,33,1, merged,0,0,0
59782,1000153,2,1387,1246,141,0.898342,0.101658,1.667128,106,35,1389,1247,142,0.897768,0.102232,1.666446,107,35,1, merged,1,1,0
59782,1000534,1,692,532,160,0.768786,0.231214,0.768786,144,16,696,535,161,0.768678,0.231322,0.768678,145,16,-1, merged,1,0,0
59790,1000121,2,2672,2234,438,0.836078,0.163922,1.619862,404,34,2673,2235,438,0.836139,0.163861,1.619981,404,34,1, merged,0,0,0
59790,1000329,1,3737,2929,808,0.783784,0.216216,0.783784,688,120,3738,2930,808,0.783842,0.216158,0.783842,688,120,1, merged,0,0,0
59793,1000004,1,4694,4128,566,0.879421,0.120579,0.879421,448,118,4695,4128,567,0.879233,0.120767,0.879233,449,118,1, merged,1,1,0
59793,1000329,2,3738,2930,808,0.783842,0.216158,1.663262,688,120,3740,2932,808,0.783957,0.216043,1.66319,688,120,-1, merged,0,0,0
59795,1000004,1,4695,4128,567,0.879233,0.120767,0.879233,449,118,4696,4129,567,0.879259,0.120741,0.879259,449,118,1, merged,0,0,0
59795,1000329,2,3740,2932,808,0.783957,0.216043,1.66319,688,120,3741,2933,808,0.784015,0.215985,1.663274,688,120,1, merged,0,0,0
59801,1000004,3,4696,4129,567,0.879259,0.120741,2.581013,449,118,4697,4130,567,0.879285,0.120715,2.581139,449,118,1, merged,0,0,0
59801,1000014,1,3345,2702,643,0.807773,0.192227,0.807773,601,42,3346,2703,643,0.80783,0.19217,0.80783,601,42,1, merged,0,0,0
59801,1000015,2,2509,2243,266,0.893982,0.106018,1.701754,244,22,2510,2244,266,0.894024,0.105976,1.701854,244,22,1, merged,0,0,0
59803,1000004,2,4697,4130,567,0.879285,0.120715,1.74825,449,118,4698,4131,567,0.87931,0.12069,1.749173,449,118,1, merged,0,0,0
59803,1000011,3,988,905,83,0.915992,0.084008,2.664242,78,5,989,906,83,0.916077,0.083923,2.66525,78,5,1, merged,0,0,0
59808,1000014,2,3346,2703,643,0.80783,0.19217,1.551226,601,42,3354,2710,644,0.80799,0.19201,1.550472,602,42,-1, merged,1,0,0
59808,1002169,5,850,684,166,0.804706,0.195294,3.543672,121,45,857,691,166,0.806301,0.193699,3.550712,121,45,-1, merged,0,0,0
59818,1000009,2,2018,1679,339,0.832012,0.167988,1.735673,304,35,2019,1680,339,0.832095,0.167905,1.734394,304,35,1, merged,0,0,0
59819,1000014,1,3354,2710,644,0.80799,0.19201,0.80799,602,42,3355,2711,644,0.808048,0.191952,0.808048,602,42,1, merged,0,0,0
59819,1000110,2,784,704,80,0.897959,0.102041,1.70595,74,6,785,705,80,0.898089,0.101911,1.706137,74,6,1, merged,0,0,0
59820,1000007,2,1920,1548,372,0.80625,0.19375,1.704018,328,44,1921,1549,372,0.806351,0.193649,1.704266,328,44,1, merged,0,0,0
59820,1000153,1,1389,1247,142,0.897768,0.102232,0.897768,107,35,1391,1249,142,0.897915,0.102085,0.897915,107,35,-1, merged,0,0,0
59825,1000005,2,929,810,119,0.871905,0.128095,1.707542,109,10,930,811,119,0.872043,0.127957,1.707741,109,10,1, merged,0,0,0
59825,1000121,1,2677,2237,440,0.835637,0.164363,0.835637,406,34,2678,2238,440,0.835698,0.164302,0.835698,406,34,1, merged,0,0,0
59826,1000005,2,930,811,119,0.872043,0.127957,1.707741,109,10,931,812,119,0.87218,0.12782,1.70794,109,10,1, merged,0,0,0
59826,1000121,1,2678,2238,440,0.835698,0.164302,0.835698,406,34,2679,2239,440,0.83576,0.16424,0.83576,406,34,1, merged,0,0,0
59838,1000004,3,4700,4133,567,0.879362,0.120638,2.550832,449,118,4701,4134,567,0.879387,0.120613,2.551653,449,118,1, merged,0,0,0
59838,1000110,4,785,705,80,0.898089,0.101911,3.448921,74,6,786,706,80,0.898219,0.101781,3.449872,74,6,1, merged,0,0,0
59838,1000140,2,532,449,83,0.843985,0.156015,1.67147,73,10,533,450,83,0.844278,0.155722,1.672266,73,10,1, merged,0,0,0
59846,1000004,2,4702,4135,567,0.879413,0.120587,1.777402,449,118,4704,4137,567,0.879464,0.120536,1.776955,449,118,-1, merged,0,0,0
59846,1000153,1,1392,1250,142,0.897989,0.102011,0.897989,107,35,1395,1252,143,0.897491,0.102509,0.897491,108,35,-1, merged,1,0,0
59848,1000120,2,2255,1983,272,0.879379,0.120621,1.63251,239,33,2256,1984,272,0.879433,0.120567,1.633004,239,33,1, merged,0,0,0
59848,1000166,1,559,421,138,0.753131,0.246869,0.753131,132,6,560,422,138,0.753571,0.246429,0.753571,132,6,1, merged,0,0,0
59849,1000054,2,1239,1052,187,0.849072,0.150928,1.602643,170,17,1241,1054,187,0.849315,0.150685,1.601984,170,17,-1, merged,0,0,0
59849,1000166,1,560,422,138,0.753571,0.246429,0.753571,132,6,562,423,139,0.752669,0.247331,0.752669,133,6,1, merged,1,1,0
59851,1000166,2,563,423,140,0.751332,0.248668,1.57932,134,6,564,424,140,0.751773,0.248227,1.580261,134,6,1, merged,0,0,0
59854,1000130,2,784,655,129,0.835459,0.164541,1.73295,96,33,785,656,129,0.835669,0.164331,1.733233,96,33,1, merged,0,0,0
59854,1000153,1,1395,1252,143,0.897491,0.102509,0.897491,108,35,1396,1253,143,0.897564,0.102436,0.897564,108,35,1, merged,0,0,0
59856,1000166,2,567,426,141,0.751323,0.248677,1.685285,135,6,568,427,141,0.751761,0.248239,1.68634,135,6,1, merged,0,0,0
59858,1000166,2,568,427,141,0.751761,0.248239,1.580249,135,6,569,428,141,0.752197,0.247803,1.581182,135,6,1, merged,0,0,0
59859,1000054,1,1242,1055,187,0.849436,0.150564,0.849436,170,17,1243,1055,188,0.848753,0.151247,0.848753,171,17,1, merged,1,1,0
59859,1000166,2,569,428,141,0.752197,0.247803,1.601633,135,6,571,429,142,0.751313,0.248687,1.600067,136,6,1, merged,1,1,0
59863,1000014,1,3355,2711,644,0.808048,0.191952,0.808048,602,42,3356,2712,644,0.808105,0.191895,0.808105,602,42,1, merged,0,0,0
59863,1000166,2,575,432,143,0.751304,0.248696,1.559352,137,6,576,433,143,0.751736,0.248264,1.559841,137,6,1, merged,0,0,0
59864,1000166,2,576,433,143,0.751736,0.248264,1.494217,137,6,577,434,143,0.752166,0.247834,1.495131,137,6,1, merged,0,0,0
59880,1000054,3,1243,1055,188,0.848753,0.151247,2.403001,171,17,1244,1056,188,0.848875,0.151125,2.398247,171,17,1, merged,0,0,0
59880,1000132,2,859,716,143,0.833527,0.166473,1.554248,118,25,860,716,144,0.832558,0.167442,1.549372,119,25,1, merged,1,1,0
59882,1000166,1,578,435,143,0.752595,0.247405,0.752595,137,6,579,435,144,0.751295,0.248705,0.751295,138,6,1, merged,1,1,0
59889,1000534,1,696,535,161,0.768678,0.231322,0.768678,145,16,697,536,161,0.76901,0.23099,0.76901,145,16,1, merged,0,0,0
59890,1000023,1,1832,1598,234,0.872271,0.127729,0.872271,208,26,1835,1599,236,0.87139,0.12861,0.87139,208,28,-1, merged,1,1,0
59897,1000003,2,1565,1298,267,0.829393,0.170607,1.635694,228,39,1566,1299,267,0.829502,0.170498,1.636029,228,39,-1, abandoned,0,0,0
59897,1002169,1,857,691,166,0.806301,0.193699,0.806301,121,45,858,692,166,0.806527,0.193473,0.806527,121,45,-1, abandoned,0,0,0
59898,1000012,1,819,703,116,0.858364,0.141636,0.858364,113,3,820,704,116,0.858537,0.141463,0.858537,113,3,1, merged,0,0,0
59898,1000105,2,845,677,168,0.801183,0.198817,1.659547,146,22,846,678,168,0.801418,0.198582,1.659955,146,22,1, merged,0,0,0
59902,1000054,1,1244,1056,188,0.848875,0.151125,0.848875,171,17,1245,1057,188,0.848996,0.151004,0.848996,171,17,1, merged,0,0,0
59905,1000014,1,3361,2716,645,0.808093,0.191907,0.808093,603,42,3364,2718,646,0.807967,0.192033,0.807967,604,42,-1, merged,1,0,0
59905,1000120,2,2257,1985,272,0.879486,0.120514,1.687579,239,33,2258,1986,272,0.879539,0.120461,1.687506,239,33,1, merged,0,0,0
59906,1000004,1,4704,4137,567,0.879464,0.120536,0.879464,449,118,4705,4138,567,0.87949,0.12051,0.87949,449,118,-1, merged,0,0,0
59906,1000592,2,893,764,129,0.855543,0.144457,1.735007,82,47,894,765,129,0.855705,0.144295,1.735195,82,47,1, merged,0,0,0
59911,1000054,2,1245,1057,188,0.848996,0.151004,1.601573,171,17,1247,1058,189,0.848436,0.151564,1.601861,172,17,1, merged,1,1,0
59911,1000166,1,582,438,144,0.752577,0.247423,0.752577,138,6,584,440,144,0.753425,0.246575,0.753425,138,6,-1, merged,0,0,0
59912,1000105,1,846,678,168,0.801418,0.198582,0.801418,146,22,847,678,169,0.800472,0.199528,0.800472,147,22,1, merged,1,1,0
59921,1000132,2,860,716,144,0.832558,0.167442,1.678118,119,25,861,717,144,0.832753,0.167247,1.67861,119,25,1, merged,0,0,0
59932,1000015,4,2510,2244,266,0.894024,0.105976,3.295523,244,22,2511,2245,266,0.894066,0.105934,3.298914,244,22,1, merged,0,0,0
59932,1000153,3,1397,1254,143,0.897638,0.102362,2.401499,108,35,1398,1255,143,0.897711,0.102289,2.404848,108,35,1, merged,0,0,0
59940,1000108,2,548,471,77,0.859489,0.140511,1.730237,72,5,550,472,78,0.858182,0.141818,1.723954,73,5,-1, abandoned,1,0,0
59948,1000329,1,3743,2935,808,0.78413,0.21587,0.78413,688,120,3744,2936,808,0.784188,0.215812,0.784188,688,120,1, merged,0,0,0
59955,1000120,2,2259,1987,272,0.879593,0.120407,1.633859,239,33,2260,1988,272,0.879646,0.120354,1.634331,239,33,1, merged,0,0,0
59955,1000166,1,586,442,144,0.754266,0.245734,0.754266,138,6,587,443,144,0.754685,0.245315,0.754685,138,6,1, merged,0,0,0
59959,1000003,1,1566,1299,267,0.829502,0.170498,0.829502,228,39,1567,1299,268,0.828973,0.171027,0.828973,229,39,1, merged,1,1,0
59959,1000004,2,4705,4138,567,0.87949,0.12051,1.708992,449,118,4707,4140,567,0.879541,0.120459,1.708514,449,118,-1, merged,0,0,0
59959,1000329,4,3744,2936,808,0.784188,0.215812,3.216584,688,120,3746,2938,808,0.784303,0.215697,3.219133,688,120,-1, merged,0,0,0
59960,1000014,1,3364,2718,646,0.807967,0.192033,0.807967,604,42,3365,2718,647,0.807727,0.192273,0.807727,605,42,1, abandoned,1,1,0
59960,1000140,2,533,450,83,0.844278,0.155722,1.652244,73,10,534,451,83,0.844569,0.155431,1.652296,73,10,-1, abandoned,0,0,0
59977,1000004,1,4713,4145,568,0.879482,0.120518,0.879482,450,118,4716,4148,568,0.879559,0.120441,0.879559,450,118,-1, merged,0,0,0
59978,1000329,1,3746,2938,808,0.784303,0.215697,0.784303,688,120,3747,2939,808,0.784361,0.215639,0.784361,688,120,1, merged,0,0,0
59980,1000014,1,3365,2718,647,0.807727,0.192273,0.807727,605,42,3366,2719,647,0.807784,0.192216,0.807784,605,42,1, merged,0,0,0
59980,1000120,2,2264,1992,272,0.879859,0.120141,1.687585,239,33,2265,1993,272,0.879912,0.120088,1.687695,239,33,1, merged,0,0,0
59980,1000153,4,1398,1255,143,0.897711,0.102289,3.511642,108,35,1399,1256,143,0.897784,0.102216,3.51224,108,35,1, merged,0,0,0
59995,1000130,1,790,661,129,0.836709,0.163291,0.836709,96,33,791,661,130,0.835651,0.164349,0.835651,97,33,1, abandoned,1,1,0
59998,1000004,1,4718,4149,569,0.879398,0.120602,0.879398,451,118,4719,4150,569,0.879424,0.120576,0.879424,451,118,1, merged,0,0,0
59998,1000592,2,894,765,129,0.855705,0.144295,1.735103,82,47,895,766,129,0.855866,0.144134,1.73529,82,47,1, merged,0,0,0
59999,1000004,2,4719,4150,569,0.879424,0.120576,1.728103,451,118,4720,4151,569,0.879449,0.120551,1.727449,451,118,-1, abandoned,0,0,0
59999,1000054,1,1249,1060,189,0.848679,0.151321,0.848679,172,17,1250,1060,190,0.848,0.152,0.848,173,17,1, abandoned,1,1,0
60002,1000130,2,794,664,130,0.836272,0.163728,1.626155,97,33,796,666,130,0.836683,0.163317,1.628189,97,33,-1, merged,0,0,0
60008,1000004,3,4720,4151,569,0.879449,0.120551,2.586058,451,118,4721,4152,569,0.879475,0.120525,2.583293,451,118,-1, merged,0,0,0
60008,1000012,1,820,704,116,0.858537,0.141463,0.858537,113,3,822,705,117,0.857664,0.142336,0.857664,114,3,1, merged,1,1,0
60010,1000003,2,1567,1299,268,0.828973,0.171027,1.686637,229,39,1568,1300,268,0.829082,0.170918,1.685878,229,39,1, merged,0,0,0
60010,1000012,1,822,705,117,0.857664,0.142336,0.857664,114,3,824,706,118,0.856796,0.143204,0.856796,115,3,1, merged,1,1,0
60014,1000109,1,724,623,101,0.860497,0.139503,0.860497,96,5,726,624,102,0.859504,0.140496,0.859504,96,6,-1, merged,1,1,0
60014,1000199,3,655,563,92,0.859542,0.140458,2.496962,83,9,656,564,92,0.859756,0.140244,2.494145,83,9,1, merged,0,0,0
60021,1000108,2,550,472,78,0.858182,0.141818,1.687167,73,5,551,473,78,0.858439,0.141561,1.687919,73,5,1, merged,0,0,0
60022,1000014,1,3367,2720,647,0.807841,0.192159,0.807841,605,42,3368,2721,647,0.807898,0.192102,0.807898,605,42,1, merged,0,0,0
60022,1000015,2,2514,2248,266,0.894193,0.105807,1.702033,244,22,2515,2249,266,0.894235,0.105765,1.702132,244,22,1, merged,0,0,0
60022,1000153,3,1400,1257,143,0.897857,0.102143,2.59989,108,35,1401,1258,143,0.89793,0.10207,2.600063,108,35,1, merged,0,0,0
60028,1000004,2,4721,4152,569,0.879475,0.120525,1.737808,451,118,4723,4154,569,0.879526,0.120474,1.735481,451,118,1, merged,0,0,0
60034,1000004,1,4728,4158,570,0.879442,0.120558,0.879442,452,118,4730,4159,571,0.879281,0.120719,0.879281,453,118,-1, merged,1,0,0
60034,1000329,2,3747,2939,808,0.784361,0.215639,1.663802,688,120,3749,2941,808,0.784476,0.215524,1.663757,688,120,-1, merged,0,0,0
60037,1000003,1,1568,1300,268,0.829082,0.170918,0.829082,229,39,1569,1301,268,0.829191,0.170809,0.829191,229,39,1, merged,0,0,0
60039,1000140,1,534,451,83,0.844569,0.155431,0.844569,73,10,535,451,84,0.842991,0.157009,0.842991,74,10,1, merged,1,1,0
60046,1000329,1,3749,2941,808,0.784476,0.215524,0.784476,688,120,3750,2942,808,0.784533,0.215467,0.784533,688,120,1, merged,0,0,0
60047,1000130,2,796,666,130,0.836683,0.163317,1.64321,97,33,797,667,130,0.836888,0.163112,1.64364,97,33,1, merged,0,0,0
60047,1002169,1,858,692,166,0.806527,0.193473,0.806527,121,45,859,693,166,0.806752,0.193248,0.806752,121,45,-1, merged,0,0,0
60059,1000014,1,3368,2721,647,0.807898,0.192102,0.807898,605,42,3369,2722,647,0.807955,0.192045,0.807955,605,42,1, merged,0,0,0
60059,1000015,2,2517,2251,266,0.894319,0.105681,1.702216,244,22,2518,2252,266,0.894361,0.105639,1.702315,244,22,1, merged,0,0,0
60063,1000015,2,2519,2253,266,0.894403,0.105597,1.644403,244,22,2520,2254,266,0.894444,0.105556,1.694444,244,22,1, merged,0,0,0
60070,1000014,2,3369,2722,647,0.807955,0.192045,1.6795,605,42,3370,2723,647,0.808012,0.191988,1.679626,605,42,1, merged,0,0,0
60070,1000023,1,1845,1608,237,0.871545,0.128455,0.871545,209,28,1846,1609,237,0.871614,0.128386,0.871614,209,28,-1, merged,0,0,0
60073,1000534,2,698,537,161,0.769341,0.230659,1.696307,145,16,699,537,162,0.76824,0.23176,1.69261,145,17,-1, merged,1,1,0
60078,1000105,2,847,678,169,0.800472,0.199528,1.477395,147,22,848,679,169,0.800708,0.199292,1.482526,147,22,1, merged,0,0,0
60080,1000003,1,1569,1301,268,0.829191,0.170809,0.829191,229,39,1570,1302,268,0.829299,0.170701,0.829299,229,39,1, merged,0,0,0
60080,1000120,2,2270,1998,272,0.880176,0.119824,1.709367,239,33,2271,1999,272,0.880229,0.119771,1.709528,239,33,1, merged,0,0,0
60082,1000003,2,1570,1302,268,0.829299,0.170701,1.709528,229,39,1571,1303,268,0.829408,0.170592,1.70969,229,39,1, merged,0,0,0
60082,1000120,1,2271,1999,272,0.880229,0.119771,0.880229,239,33,2272,2000,272,0.880282,0.119718,0.880282,239,33,1, merged,0,0,0
60086,1000054,2,1251,1061,190,0.848122,0.151878,1.642015,173,17,1253,1063,190,0.848364,0.151636,1.639238,173,17,-1, merged,0,0,0
60090,1000004,1,4731,4159,572,0.879095,0.120905,0.879095,453,119,4732,4159,573,0.87891,0.12109,0.87891,454,119,1, abandoned,1,1,0
60093,1000014,4,3370,2723,647,0.808012,0.191988,2.854531,605,42,3372,2724,648,0.807829,0.192171,2.846336,606,42,1, merged,1,1,0
60093,1000130,1,797,667,130,0.836888,0.163112,0.836888,97,33,799,668,131,0.836045,0.163955,0.836045,98,33,1, merged,1,1,0
60094,1000007,2,1922,1550,372,0.806452,0.193548,1.639204,328,44,1924,1552,372,0.806653,0.193347,1.637671,328,44,-1, abandoned,0,0,0
60094,1000132,1,861,717,144,0.832753,0.167247,0.832753,119,25,864,718,146,0.831019,0.168981,0.831019,121,25,1, abandoned,1,1,0
60108,1000011,2,992,908,84,0.915323,0.084677,1.781989,79,5,993,909,84,0.915408,0.084592,1.782958,79,5,1, merged,0,0,0
60122,1000015,2,2522,2256,266,0.894528,0.105472,1.792531,244,22,2523,2257,266,0.89457,0.10543,1.792646,244,22,1, merged,0,0,0
60122,1000153,1,1402,1259,143,0.898003,0.101997,0.898003,108,35,1403,1260,143,0.898076,0.101924,0.898076,108,35,1, merged,0,0,0
60124,1000004,2,4733,4160,573,0.878935,0.121065,1.746485,454,119,4734,4161,573,0.878961,0.121039,1.747382,454,119,1, merged,0,0,0
60127,1000004,2,4734,4161,573,0.878961,0.121039,1.704854,454,119,4735,4162,573,0.878986,0.121014,1.705653,454,119,1, merged,0,0,0
60128,1000004,2,4735,4162,573,0.878986,0.121014,1.705653,454,119,4736,4162,574,0.878801,0.121199,1.702589,455,119,1, merged,1,1,0
60129,1000108,1,552,474,78,0.858696,0.141304,0.858696,73,5,553,475,78,0.858951,0.141049,0.858951,73,5,1, merged,0,0,0
60134,1000108,2,554,476,78,0.859206,0.140794,1.859206,73,5,555,477,78,0.859459,0.140541,1.859459,73,5,1, merged,0,0,0
60135,1000110,2,787,707,80,0.898348,0.101652,1.76459,74,6,788,708,80,0.898477,0.101523,1.765566,74,6,1, merged,0,0,0
60140,1000007,1,1924,1552,372,0.806653,0.193347,0.806653,328,44,1925,1553,372,0.806753,0.193247,0.806753,328,44,1, merged,0,0,0
60140,1000012,3,825,706,119,0.855758,0.144242,2.560486,116,3,826,707,119,0.855932,0.144068,2.560834,116,3,1, merged,0,0,0
60140,1000153,2,1403,1260,143,0.898076,0.101924,1.704728,108,35,1404,1261,143,0.898148,0.101852,1.704901,108,35,1, merged,0,0,0
60141,1000023,2,1846,1609,237,0.871614,0.128386,1.707659,209,28,1847,1610,237,0.871684,0.128316,1.707934,209,28,1, merged,0,0,0
60141,1000130,1,799,668,131,0.836045,0.163955,0.836045,98,33,800,669,131,0.83625,0.16375,0.83625,98,33,1, merged,0,0,0
60150,1000328,2,1100,819,281,0.744545,0.255455,1.562156,252,29,1102,821,281,0.745009,0.254991,1.559824,252,29,-1, merged,0,0,0
60151,1000130,1,804,673,131,0.837065,0.162935,0.837065,98,33,805,674,131,0.837267,0.162733,0.837267,98,33,1, merged,0,0,0
60151,1000327,2,733,580,153,0.791269,0.208731,1.628333,118,35,734,581,153,0.791553,0.208447,1.62882,118,35,1, merged,0,0,0
60158,1000328,1,1102,821,281,0.745009,0.254991,0.745009,252,29,1103,822,281,0.74524,0.25476,0.74524,252,29,-1, merged,0,0,0
60162,1000327,2,735,582,153,0.791837,0.208163,1.537077,118,35,736,583,153,0.79212,0.20788,1.537821,118,35,-1, merged,0,0,0
60162,1000328,1,1103,822,281,0.74524,0.25476,0.74524,252,29,1105,824,281,0.745701,0.254299,0.745701,252,29,-1, merged,0,0,0
60165,1000130,3,805,674,131,0.837267,0.162733,2.375088,98,33,806,675,131,0.837469,0.162531,2.375802,98,33,1, merged,0,0,0
60165,1000327,2,736,583,153,0.79212,0.20788,1.537821,118,35,737,584,153,0.792402,0.207598,1.538333,118,35,1, merged,0,0,0
60165,1000328,1,1105,824,281,0.745701,0.254299,0.745701,252,29,1106,825,281,0.745931,0.254069,0.745931,252,29,1, merged,0,0,0
60173,1000153,2,1405,1262,143,0.898221,0.101779,1.502872,108,35,1406,1263,143,0.898293,0.101707,1.505985,108,35,1, merged,0,0,0
60179,1000130,1,806,675,131,0.837469,0.162531,0.837469,98,33,807,676,131,0.83767,0.16233,0.83767,98,33,1, merged,0,0,0
60182,1000023,2,1850,1613,237,0.871892,0.128108,1.720256,209,28,1851,1614,237,0.871961,0.128039,1.720446,209,28,1, merged,0,0,0
60182,1000054,1,1253,1063,190,0.848364,0.151636,0.848364,173,17,1254,1064,190,0.848485,0.151515,0.848485,173,17,1, merged,0,0,0
60191,1000014,2,3376,2728,648,0.808057,0.191943,1.608999,606,42,3377,2729,648,0.808114,0.191886,1.608114,606,42,-1, abandoned,0,0,0
60191,1000105,1,849,680,169,0.800942,0.199058,0.800942,147,22,850,680,170,0.8,0.2,0.8,148,22,1, abandoned,1,1,0
60193,1000153,2,1407,1264,143,0.898365,0.101635,1.744866,108,35,1408,1265,143,0.898438,0.101562,1.745284,108,35,1, merged,0,0,0
60197,1000023,2,1851,1614,237,0.871961,0.128039,1.732872,209,28,1852,1615,237,0.87203,0.12797,1.733274,209,28,1, merged,0,0,0
60199,1000153,2,1408,1265,143,0.898438,0.101562,1.799201,108,35,1409,1266,143,0.89851,0.10149,1.797557,108,35,1, merged,0,0,0
60200,1000007,2,1926,1554,372,0.806854,0.193146,1.705363,328,44,1928,1555,373,0.806535,0.193465,1.70448,329,44,1, merged,1,1,0
60200,1000153,1,1409,1266,143,0.89851,0.10149,0.89851,108,35,1411,1267,144,0.897945,0.102055,0.897945,109,35,1, merged,1,1,0
60202,1000153,1,1411,1267,144,0.897945,0.102055,0.897945,109,35,1413,1269,144,0.898089,0.101911,0.898089,109,35,-1, merged,0,0,0
60204,1000007,2,1928,1555,373,0.806535,0.193465,1.704624,329,44,1929,1556,373,0.806636,0.193364,1.704162,329,44,-1, abandoned,0,0,0
60204,1000132,3,864,718,146,0.831019,0.168981,2.535643,121,25,865,719,146,0.831214,0.168786,2.535376,121,25,-1, abandoned,0,0,0
60204,1000153,1,1413,1269,144,0.898089,0.101911,0.898089,109,35,1415,1270,145,0.897527,0.102473,0.897527,110,35,1, abandoned,1,1,0
60209,1000121,2,2692,2251,441,0.836181,0.163819,1.755626,407,34,2693,2252,441,0.836242,0.163758,1.75591,407,34,1, merged,0,0,0
60213,1000105,4,851,681,170,0.800235,0.199765,2.353902,148,22,852,682,170,0.800469,0.199531,2.354674,148,22,-1, merged,0,0,0
60219,1000108,2,556,477,79,0.857914,0.142086,1.714267,74,5,557,478,79,0.858169,0.141831,1.714918,74,5,1, merged,0,0,0
60220,1000534,1,700,538,162,0.768571,0.231429,0.768571,145,17,701,539,162,0.768902,0.231098,0.768902,145,17,-1, merged,0,0,0
60232,1000004,2,4737,4163,574,0.878826,0.121174,1.643803,455,119,4738,4164,574,0.878852,0.121148,1.644189,455,119,1, merged,0,0,0
60232,1000121,3,2693,2252,441,0.836242,0.163758,2.480045,407,34,2694,2253,441,0.836303,0.163697,2.480492,407,34,1, merged,0,0,0
60233,1000014,2,3377,2729,648,0.808114,0.191886,1.543963,606,42,3378,2730,648,0.808171,0.191829,1.545671,606,42,1, merged,0,0,0
60247,1000132,3,866,720,146,0.831409,0.168591,2.400266,121,25,867,721,146,0.831603,0.168397,2.394178,121,25,1, merged,0,0,0
60248,1000132,3,867,721,146,0.831603,0.168397,2.527006,121,25,868,722,146,0.831797,0.168203,2.523707,121,25,1, merged,0,0,0
60249,1000329,1,3751,2943,808,0.784591,0.215409,0.784591,688,120,3752,2944,808,0.784648,0.215352,0.784648,688,120,1, merged,0,0,0
60255,1000009,2,2019,1680,339,0.832095,0.167905,1.726832,304,35,2020,1681,339,0.832178,0.167822,1.726957,304,35,1, merged,0,0,0
60255,1000015,1,2527,2261,266,0.894737,0.105263,0.894737,244,22,2528,2262,266,0.894778,0.105222,0.894778,244,22,1, merged,0,0,0
60256,1000009,3,2020,1681,339,0.832178,0.167822,2.59362,304,35,2022,1683,339,0.832344,0.167656,2.584777,304,35,-1, merged,0,0,0
60256,1000014,2,3378,2730,648,0.808171,0.191829,1.761442,606,42,3380,2731,649,0.807988,0.192012,1.752433,607,42,1, merged,1,1,0
60260,1000004,3,4738,4164,574,0.878852,0.121148,1.753852,455,119,4739,4165,574,0.878877,0.121123,1.918877,455,119,1, merged,0,0,0
60264,1000130,2,808,677,131,0.837871,0.162129,1.582274,98,33,809,678,131,0.838072,0.161928,1.582951,98,33,1, merged,0,0,0
60266,1000329,2,3754,2946,808,0.784763,0.215237,1.530116,688,120,3756,2947,809,0.784611,0.215389,1.528626,689,120,1, merged,1,1,0
60270,1000140,1,535,451,84,0.842991,0.157009,0.842991,74,10,537,452,85,0.841713,0.158287,0.841713,75,10,1, merged,1,1,0
60271,1000105,2,852,682,170,0.800469,0.199531,1.607446,148,22,853,683,170,0.800703,0.199297,1.607904,148,22,-1, abandoned,0,0,0
60271,1002169,1,860,694,166,0.806977,0.193023,0.806977,121,45,861,695,166,0.807201,0.192799,0.807201,121,45,-1, abandoned,0,0,0
60273,1000012,2,826,707,119,0.855932,0.144068,1.755172,116,3,827,708,119,0.856106,0.143894,1.753834,116,3,1, merged,0,0,0
60277,1000004,2,4739,4165,574,0.878877,0.121123,1.776549,455,119,4741,4167,574,0.878928,0.121072,1.775967,455,119,-1, merged,0,0,0
60277,1000014,3,3380,2731,649,0.807988,0.192012,2.584537,607,42,3381,2732,649,0.808045,0.191955,2.584012,607,42,1, merged,0,0,0
60277,1000153,1,1417,1272,145,0.897671,0.102329,0.897671,110,35,1418,1272,146,0.897038,0.102962,0.897038,111,35,1, merged,1,1,0
60278,1000153,2,1418,1272,146,0.897038,0.102962,1.743885,111,35,1419,1273,146,0.897111,0.102889,1.744302,111,35,1, merged,0,0,0
60282,1000004,1,4741,4167,574,0.878928,0.121072,0.878928,455,119,4742,4168,574,0.878954,0.121046,0.878954,455,119,-1, merged,0,0,0
60282,1000009,2,2023,1684,339,0.832427,0.167573,1.711356,304,35,2025,1685,340,0.832099,0.167901,1.711053,305,35,1, merged,1,1,0
60284,1000054,2,1256,1066,190,0.848726,0.151274,1.52114,173,17,1257,1067,190,0.848846,0.151154,1.52406,173,17,1, merged,0,0,0
60289,1000012,1,827,708,119,0.856106,0.143894,0.856106,116,3,828,709,119,0.85628,0.14372,0.85628,116,3,1, merged,0,0,0
60303,1000091,2,681,540,141,0.792952,0.207048,1.577411,118,23,682,541,141,0.793255,0.206745,1.577772,118,23,1, merged,0,0,0
60303,1000329,1,3758,2948,810,0.78446,0.21554,0.78446,689,121,3759,2949,810,0.784517,0.215483,0.784517,689,121,1, merged,0,0,0
60304,1000014,1,3381,2732,649,0.808045,0.191955,0.808045,607,42,3383,2733,650,0.807863,0.192137,0.807863,608,42,1, merged,1,1,0
60304,1000120,2,2277,2004,273,0.880105,0.119895,1.68815,240,33,2278,2005,273,0.880158,0.119842,1.688021,240,33,-1, merged,0,0,0
60305,1000012,1,828,709,119,0.85628,0.14372,0.85628,116,3,829,710,119,0.856454,0.143546,0.856454,116,3,1, merged,0,0,0
60306,1000108,2,557,478,79,0.858169,0.141831,1.351319,74,5,558,479,79,0.858423,0.141577,1.358423,74,5,1, merged,0,0,0
60310,1000004,2,4743,4169,574,0.87898,0.12102,1.686842,455,119,4744,4170,574,0.879005,0.120995,1.686686,455,119,1, merged,0,0,0
60310,1000014,1,3383,2733,650,0.807863,0.192137,0.807863,608,42,3385,2734,651,0.807681,0.192319,0.807681,609,42,1, merged,1,1,0
60310,1000120,3,2279,2006,273,0.880211,0.119789,2.567053,240,33,2280,2007,273,0.880263,0.119737,2.566949,240,33,1, merged,0,0,0
60314,1000003,3,1572,1304,268,0.829517,0.170483,2.412552,229,39,1573,1305,268,0.829625,0.170375,2.44919,229,39,1, merged,0,0,0
60318,1000003,1,1573,1305,268,0.829625,0.170375,0.829625,229,39,1574,1305,269,0.829098,0.170902,0.829098,230,39,1, merged,1,1,0
60318,1000004,4,4745,4171,574,0.879031,0.120969,3.396652,455,119,4747,4173,574,0.879082,0.120918,3.396104,455,119,-1, merged,0,0,0
60318,1000014,2,3385,2734,651,0.807681,0.192319,1.637306,609,42,3388,2736,652,0.807556,0.192444,1.636654,610,42,-1, merged,1,0,0
60318,1000120,3,2281,2008,273,0.880316,0.119684,2.517622,240,33,2282,2009,273,0.880368,0.119632,2.517022,240,33,-1, merged,0,0,0
60319,1000014,2,3388,2736,652,0.807556,0.192444,1.622371,610,42,3390,2737,653,0.807375,0.192625,1.621746,611,42,1, merged,1,1,0
60319,1000592,3,896,767,129,0.856027,0.143973,2.478398,82,47,898,768,130,0.855234,0.144766,2.47698,82,48,-1, merged,1,1,0
60321,1000014,1,3390,2737,653,0.807375,0.192625,0.807375,611,42,3391,2738,653,0.807431,0.192569,0.807431,611,42,1, merged,0,0,0
60321,1000130,2,809,678,131,0.838072,0.161928,1.645446,98,33,810,679,131,0.838272,0.161728,1.645703,98,33,1, merged,0,0,0
60322,1000153,2,1420,1274,146,0.897183,0.102817,1.75821,111,35,1421,1275,146,0.897255,0.102745,1.758701,111,35,1, merged,0,0,0
60323,1000014,3,3391,2738,653,0.807431,0.192569,2.507568,611,42,3392,2739,653,0.807488,0.192512,2.504524,611,42,-1, abandoned,0,0,0
60323,1000108,1,558,479,79,0.858423,0.141577,0.858423,74,5,559,479,80,0.856887,0.143113,0.856887,75,5,1, abandoned,1,1,0
60323,1000140,2,537,452,85,0.841713,0.158287,1.700136,75,10,538,452,86,0.840149,0.159851,1.697036,76,10,1, abandoned,1,1,0
60324,1000109,1,730,628,102,0.860274,0.139726,0.860274,96,6,731,629,102,0.860465,0.139535,0.860465,96,6,1, merged,0,0,0
60325,1000109,2,731,629,102,0.860465,0.139535,0.860465,96,6,732,630,102,0.860656,0.139344,1.860656,96,6,1, merged,0,0,0
60328,1000003,1,1574,1305,269,0.829098,0.170902,0.829098,230,39,1576,1307,269,0.829315,0.170685,0.829315,230,39,-1, merged,0,0,0
60328,1000108,2,559,479,80,0.856887,0.143113,1.685985,75,5,560,480,80,0.857143,0.142857,1.686458,75,5,1, merged,0,0,0
60329,1000054,1,1258,1068,190,0.848967,0.151033,0.848967,173,17,1259,1069,190,0.849087,0.150913,0.849087,173,17,1, merged,0,0,0
60329,1000110,2,788,708,80,0.898477,0.101523,1.747444,74,6,789,709,80,0.898606,0.101394,1.747692,74,6,1, merged,0,0,0
60330,1000004,1,4747,4173,574,0.879082,0.120918,0.879082,455,119,4749,4174,575,0.878922,0.121078,0.878922,455,120,-1, merged,1,1,0
60330,1000592,2,898,768,130,0.855234,0.144766,1.734315,82,48,899,769,130,0.855395,0.144605,1.734317,82,48,1, merged,0,0,0
60332,1000130,2,810,679,131,0.838272,0.161728,1.66206,98,33,811,680,131,0.838471,0.161529,1.663032,98,33,1, merged,0,0,0
60337,1000109,2,732,630,102,0.860656,0.139344,1.63657,96,6,734,631,103,0.859673,0.140327,1.634407,97,6,-1, merged,1,0,0
60337,1000130,3,811,680,131,0.838471,0.161529,2.475041,98,33,812,681,131,0.83867,0.16133,2.473077,98,33,-1, merged,0,0,0
60338,1000007,2,1930,1557,373,0.806736,0.193264,1.703991,329,44,1932,1559,373,0.806936,0.193064,1.702301,329,44,-1, abandoned,0,0,0
60338,1000153,1,1421,1275,146,0.897255,0.102745,0.897255,111,35,1424,1275,149,0.895365,0.104635,0.895365,114,35,1, abandoned,1,1,0
60343,1000015,2,2531,2265,266,0.894903,0.105097,1.663805,244,22,2532,2266,266,0.894945,0.105055,1.664175,244,22,1, merged,0,0,0
60343,1000534,1,701,539,162,0.768902,0.231098,0.768902,145,17,702,540,162,0.769231,0.230769,0.769231,145,17,1, merged,0,0,0
60346,1000121,4,2696,2255,441,0.836424,0.163576,3.146431,407,34,2697,2256,441,0.836485,0.163515,3.13936,407,34,-1, merged,0,0,0
60347,1000014,2,3392,2739,653,0.807488,0.192512,1.677053,611,42,3397,2742,655,0.807183,0.192817,1.673036,613,42,-1, merged,1,0,0
60347,1000026,3,730,622,108,0.852055,0.147945,2.529108,105,3,734,624,110,0.850136,0.149864,2.523173,107,3,-1, merged,1,0,0
60347,1000120,4,2284,2011,273,0.880473,0.119527,3.409581,240,33,2286,2011,275,0.879703,0.120297,3.402875,242,33,1, merged,1,1,0
60347,1000140,6,538,452,86,0.840149,0.159851,5.043691,76,10,539,453,86,0.840445,0.159555,5.03484,76,10,1, merged,0,0,0
60349,1000009,2,2026,1686,340,0.832182,0.167818,1.601412,305,35,2027,1687,340,0.832264,0.167736,1.601823,305,35,1, merged,0,0,0
60349,1000534,1,702,540,162,0.769231,0.230769,0.769231,145,17,703,541,162,0.769559,0.230441,0.769559,145,17,-1, merged,0,0,0
60351,1000015,3,2532,2266,266,0.894945,0.105055,2.398076,244,22,2533,2267,266,0.894986,0.105014,2.401185,244,22,1, merged,0,0,0
60351,1000153,1,1425,1276,149,0.895439,0.104561,0.895439,114,35,1426,1277,149,0.895512,0.104488,0.895512,114,35,1, merged,0,0,0
60355,1000004,1,4751,4176,575,0.878973,0.121027,0.878973,455,120,4755,4179,576,0.878864,0.121136,0.878864,456,120,-1, merged,1,0,0
60362,1000329,2,3759,2949,810,0.784517,0.215483,1.526804,689,121,3760,2950,810,0.784574,0.215426,1.526452,689,121,-1, merged,0,0,0
60363,1000329,2,3760,2950,810,0.784574,0.215426,1.526452,689,121,3761,2951,810,0.784632,0.215368,1.526104,689,121,-1, merged,0,0,0
60369,1000004,1,4755,4179,576,0.878864,0.121136,0.878864,456,120,4756,4180,576,0.87889,0.12111,0.87889,456,120,1, merged,0,0,0
60369,1000592,2,902,772,130,0.855876,0.144124,1.73474,82,48,903,773,130,0.856035,0.143965,1.734925,82,48,1, merged,0,0,0
60382,1000014,1,3398,2743,655,0.80724,0.19276,0.80724,613,42,3399,2744,655,0.807296,0.192704,0.807296,613,42,-1, merged,0,0,0
60382,1000105,2,855,685,170,0.80117,0.19883,1.608409,148,22,858,687,171,0.800699,0.199301,1.607996,148,23,-1, merged,1,0,0
60402,1000014,1,3399,2744,655,0.807296,0.192704,0.807296,613,42,3400,2745,655,0.807353,0.192647,0.807353,613,42,1, merged,0,0,0
60402,1000140,2,539,453,86,0.840445,0.159555,1.647742,76,10,540,454,86,0.840741,0.159259,1.648094,76,10,1, merged,0,0,0
60408,1000109,1,734,631,103,0.859673,0.140327,0.859673,97,6,735,632,103,0.859864,0.140136,0.859864,97,6,1, merged,0,0,0
60411,1000109,1,735,632,103,0.859864,0.140136,0.859864,97,6,736,633,103,0.860054,0.139946,0.860054,97,6,1, merged,0,0,0
60416,1000015,2,2534,2268,266,0.895028,0.104972,1.79054,244,22,2535,2269,266,0.895069,0.104931,1.790101,244,22,1, merged,0,0,0
60416,1000153,1,1426,1277,149,0.895512,0.104488,0.895512,114,35,1429,1279,150,0.895031,0.104969,0.895031,115,35,1, merged,1,1,0
60418,1000132,2,868,722,146,0.831797,0.168203,0.831797,121,25,869,723,146,0.831991,0.168009,1.831991,121,25,1, merged,0,0,0
60419,1000132,2,869,723,146,0.831991,0.168009,1.831991,121,25,870,724,146,0.832184,0.167816,1.832184,121,25,1, merged,0,0,0
60420,1000007,1,1932,1559,373,0.806936,0.193064,0.806936,329,44,1935,1562,373,0.807235,0.192765,0.807235,329,44,-1, merged,0,0,0
60420,1000132,3,870,724,146,0.832184,0.167816,2.63912,121,25,872,725,147,0.831422,0.168578,2.238657,122,25,1, merged,1,1,0
60423,1000004,2,4757,4181,576,0.878915,0.121085,1.663547,456,120,4758,4182,576,0.878941,0.121059,1.66363,456,120,1, merged,0,0,0
60423,1000329,1,3761,2951,810,0.784632,0.215368,0.784632,689,121,3762,2952,810,0.784689,0.215311,0.784689,689,121,1, merged,0,0,0
60427,1000014,1,3400,2745,655,0.807353,0.192647,0.807353,613,42,3401,2746,655,0.80741,0.19259,0.80741,613,42,1, merged,0,0,0
60427,1000105,2,860,689,171,0.801163,0.198837,1.608516,148,23,861,690,171,0.801394,0.198606,1.608803,148,23,1, merged,0,0,0
60432,1000120,2,2289,2014,275,0.87986,0.12014,1.606176,242,33,2290,2015,275,0.879913,0.120087,1.611871,242,33,1, merged,0,0,0
60436,1000003,2,1576,1307,269,0.829315,0.170685,1.693956,230,39,1580,1310,270,0.829114,0.170886,1.692502,231,39,1, abandoned,1,1,0
60441,1000120,2,2292,2017,275,0.880017,0.119983,1.736767,242,33,2293,2018,275,0.88007,0.11993,1.737213,242,33,1, merged,0,0,0
60448,1000121,2,2698,2257,441,0.836546,0.163454,1.565787,407,34,2699,2258,441,0.836606,0.163394,1.566822,407,34,1, merged,0,0,0
60452,1000007,2,1935,1562,373,0.807235,0.192765,1.702428,329,44,1936,1562,374,0.806818,0.193182,1.7017,330,44,1, merged,1,1,0
60452,1000014,3,3401,2746,655,0.80741,0.19259,2.509838,613,42,3402,2747,655,0.807466,0.192534,2.509166,613,42,-1, merged,0,0,0
60452,1000015,1,2538,2272,266,0.895193,0.104807,0.895193,244,22,2540,2273,267,0.894882,0.105118,0.894882,245,22,1, merged,1,1,0
60458,1000153,1,1429,1279,150,0.895031,0.104969,0.895031,115,35,1430,1280,150,0.895105,0.104895,0.895105,115,35,1, merged,0,0,0
60459,1000007,1,1936,1562,374,0.806818,0.193182,0.806818,330,44,1938,1564,374,0.807018,0.192982,0.807018,330,44,-1, merged,0,0,0
60459,1000153,2,1430,1280,150,0.895105,0.104895,1.701923,115,35,1431,1281,150,0.895178,0.104822,1.702196,115,35,1, merged,0,0,0
60461,1000004,2,4758,4182,576,0.878941,0.121059,1.686142,456,120,4761,4184,577,0.878807,0.121193,1.686232,457,120,-1, merged,1,0,0
60461,1000121,4,2699,2258,441,0.836606,0.163394,3.337119,407,34,2700,2259,441,0.836667,0.163333,3.339466,407,34,1, merged,0,0,0
60461,1000329,5,3763,2953,810,0.784746,0.215254,4.121865,689,121,3764,2954,810,0.784803,0.215197,4.12427,689,121,1, merged,0,0,0
60461,1002169,1,861,695,166,0.807201,0.192799,0.807201,121,45,862,696,166,0.807425,0.192575,0.807425,121,45,-1, merged,0,0,0
60462,1000054,2,1262,1072,190,0.849445,0.150555,1.605378,173,17,1266,1074,192,0.848341,0.151659,1.599602,175,17,-1, merged,1,0,0
60462,1000166,1,590,446,144,0.755932,0.244068,0.755932,138,6,595,447,148,0.751261,0.248739,0.751261,142,6,1, merged,1,1,0
60470,1000105,2,862,691,171,0.801624,0.198376,1.629327,148,23,863,692,171,0.801854,0.198146,1.630137,148,23,1, merged,0,0,0
60474,1000014,2,3403,2748,655,0.807523,0.192477,1.614947,613,42,3406,2751,655,0.807692,0.192308,1.615563,613,42,-1, merged,0,0,0
60474,1002169,1,862,696,166,0.807425,0.192575,0.807425,121,45,864,698,166,0.80787,0.19213,0.80787,121,45,-1, merged,0,0,0
60482,1000023,2,1860,1623,237,0.872581,0.127419,1.712238,209,28,1861,1624,237,0.872649,0.127351,1.71128,209,28,-1, abandoned,0,0,0
60482,1000130,1,817,686,131,0.839657,0.160343,0.839657,98,33,818,686,132,0.838631,0.161369,0.838631,99,33,1, abandoned,1,1,0
60489,1000012,1,831,712,119,0.856799,0.143201,0.856799,116,3,832,713,119,0.856971,0.143029,0.856971,116,3,1, merged,0,0,0
60491,1000023,5,1861,1624,237,0.872649,0.127351,3.800203,209,28,1863,1626,237,0.872786,0.127214,3.785547,209,28,-1, abandoned,0,0,0
60491,1000140,1,540,454,86,0.840741,0.159259,0.840741,76,10,543,454,89,0.836096,0.163904,0.836096,79,10,1, abandoned,1,1,0
60494,1000009,2,2028,1688,340,0.832347,0.167653,1.499014,305,35,2032,1691,341,0.832185,0.167815,1.520357,305,36,-1, merged,1,0,0
60494,1000026,3,734,624,110,0.850136,0.149864,2.34915,107,3,736,626,110,0.850543,0.149457,2.370901,107,3,-1, merged,0,0,0
60495,1000329,2,3764,2954,810,0.784803,0.215197,1.592674,689,121,3765,2955,810,0.784861,0.215139,1.592953,689,121,-1, abandoned,0,0,0
60495,1002169,1,864,698,166,0.80787,0.19213,0.80787,121,45,865,699,166,0.808092,0.191908,0.808092,121,45,-1, abandoned,0,0,0
60498,1000329,2,3766,2956,810,0.784918,0.215082,1.59301,689,121,3767,2957,810,0.784975,0.215025,1.593289,689,121,-1, abandoned,0,0,0
60498,1002169,1,865,699,166,0.808092,0.191908,0.808092,121,45,866,700,166,0.808314,0.191686,0.808314,121,45,-1, abandoned,0,0,0
60508,1000329,1,3768,2958,810,0.785032,0.214968,0.785032,689,121,3769,2958,811,0.784824,0.215176,0.784824,690,121,1, merged,1,1,0
60511,1000004,2,4762,4185,577,0.878832,0.121168,1.751618,457,120,4763,4185,578,0.878648,0.121352,1.750966,458,120,1, abandoned,1,1,0
60511,1000023,1,1863,1626,237,0.872786,0.127214,0.872786,209,28,1864,1626,238,0.872318,0.127682,0.872318,210,28,1, abandoned,1,1,0
60512,1000140,1,543,454,89,0.836096,0.163904,0.836096,79,10,544,455,89,0.836397,0.163603,0.836397,79,10,1, merged,0,0,0
60520,1000011,1,993,909,84,0.915408,0.084592,0.915408,79,5,994,910,84,0.915493,0.084507,0.915493,79,5,1, merged,0,0,0
60520,1000153,2,1432,1282,150,0.895251,0.104749,1.810659,115,35,1433,1283,150,0.895324,0.104676,1.810817,115,35,1, merged,0,0,0
60523,1000014,1,3407,2752,655,0.807749,0.192251,0.807749,613,42,3408,2753,655,0.807805,0.192195,0.807805,613,42,1, merged,0,0,0
60533,1000009,2,2032,1691,341,0.832185,0.167815,1.712412,305,36,2033,1692,341,0.832268,0.167732,1.712546,305,36,1, merged,0,0,0
60533,1000120,1,2296,2021,275,0.880226,0.119774,0.880226,242,33,2297,2022,275,0.880279,0.119721,0.880279,242,33,1, merged,0,0,0
60541,1000023,2,1864,1626,238,0.872318,0.127682,1.731841,210,28,1865,1627,238,0.872386,0.127614,1.732244,210,28,1, merged,0,0,0
60544,1000004,2,4764,4186,578,0.878673,0.121327,1.794251,458,120,4766,4187,579,0.878514,0.121486,1.794262,459,120,1, merged,1,1,0
60544,1000011,1,995,911,84,0.915578,0.084422,0.915578,79,5,997,913,84,0.915747,0.084253,0.915747,79,5,-1, merged,0,0,0
60544,1000153,3,1433,1283,150,0.895324,0.104676,2.689576,115,35,1434,1284,150,0.895397,0.104603,2.689659,115,35,1, merged,0,0,0
60549,1000014,1,3408,2753,655,0.807805,0.192195,0.807805,613,42,3409,2754,655,0.807862,0.192138,0.807862,613,42,1, merged,0,0,0
60550,1000014,1,3409,2754,655,0.807862,0.192138,0.807862,613,42,3410,2755,655,0.807918,0.192082,0.807918,613,42,1, merged,0,0,0
60551,1000120,1,2298,2023,275,0.880331,0.119669,0.880331,242,33,2299,2024,275,0.880383,0.119617,0.880383,242,33,1, merged,0,0,0
60551,1000153,2,1434,1284,150,0.895397,0.104603,1.775728,115,35,1435,1285,150,0.89547,0.10453,1.775853,115,35,1, merged,0,0,0
60559,1000329,2,3770,2959,811,0.784881,0.215119,0.784881,690,121,3773,2961,812,0.784787,0.215213,0.784787,691,121,1, merged,1,1,0
60560,1000004,2,4766,4187,579,0.878514,0.121486,1.618337,459,120,4770,4191,579,0.878616,0.121384,1.619357,459,120,-1, merged,0,0,0
60561,1000023,1,1865,1627,238,0.872386,0.127614,0.872386,210,28,1866,1628,238,0.872454,0.127546,0.872454,210,28,1, merged,0,0,0
60574,1000014,1,3410,2755,655,0.807918,0.192082,0.807918,613,42,3411,2755,656,0.807681,0.192319,0.807681,614,42,1, abandoned,1,1,0
60574,1000023,2,1866,1628,238,0.872454,0.127546,1.680372,210,28,1867,1629,238,0.872523,0.127477,1.680204,210,28,-1, abandoned,0,0,0
60586,1000004,1,4774,4195,579,0.878718,0.121282,0.878718,459,120,4775,4195,580,0.878534,0.121466,0.878534,459,121,-1, merged,1,1,0
60586,1000329,2,3773,2961,812,0.784787,0.215213,1.663505,691,121,3774,2961,813,0.784579,0.215421,1.663113,691,122,-1, merged,1,1,0
60588,1000534,4,706,544,162,0.770538,0.229462,3.121577,145,17,707,545,162,0.770863,0.229137,3.118195,145,17,1, merged,0,0,0
60589,1000009,2,2033,1692,341,0.832268,0.167732,1.44129,305,36,2034,1693,341,0.83235,0.16765,1.44429,305,36,1, merged,0,0,0
60590,1000015,1,2551,2284,267,0.895335,0.104665,0.895335,245,22,2552,2285,267,0.895376,0.104624,0.895376,245,22,1, merged,0,0,0
60593,1000009,2,2034,1693,341,0.83235,0.16765,1.44429,305,36,2035,1694,341,0.832432,0.167568,1.447247,305,36,1, merged,0,0,0
60594,1000105,2,863,692,171,0.801854,0.198146,1.588397,148,23,864,692,172,0.800926,0.199074,1.585648,148,24,-1, merged,1,1,0
60597,1000105,2,864,692,172,0.800926,0.199074,1.60924,148,24,865,692,173,0.8,0.2,1.607382,148,25,-1, merged,1,1,0
60597,1002169,1,866,700,166,0.808314,0.191686,0.808314,121,45,867,700,167,0.807382,0.192618,0.807382,121,46,-1, merged,1,1,0
60598,1000014,2,3411,2755,656,0.807681,0.192319,1.664824,614,42,3412,2755,657,0.807444,0.192556,1.663059,615,42,1, merged,1,1,0
60598,1000108,1,560,480,80,0.857143,0.142857,0.857143,75,5,561,480,81,0.855615,0.144385,0.855615,76,5,1, merged,1,1,0
60599,1000108,1,561,480,81,0.855615,0.144385,0.855615,76,5,563,481,82,0.854352,0.145648,0.854352,76,6,-1, merged,1,1,0
60603,1000014,2,3412,2755,657,0.807444,0.192556,1.557444,615,42,3413,2756,657,0.807501,0.192499,1.585279,615,42,1, merged,0,0,0
60615,1000023,1,1867,1629,238,0.872523,0.127477,0.872523,210,28,1869,1631,238,0.872659,0.127341,0.872659,210,28,-1, merged,0,0,0
60615,1000329,2,3779,2966,813,0.784864,0.215136,1.657386,691,122,3780,2967,813,0.784921,0.215079,1.65758,691,122,1, merged,0,0,0
60640,1000329,2,3781,2968,813,0.784978,0.215022,1.284978,691,122,3782,2969,813,0.785034,0.214966,1.118368,691,122,1, merged,0,0,0
60641,1000054,2,1266,1074,192,0.848341,0.151659,1.617347,175,17,1267,1075,192,0.848461,0.151539,1.61814,175,17,1, merged,0,0,0
60642,1000328,1,1106,825,281,0.745931,0.254069,0.745931,252,29,1107,825,282,0.745257,0.254743,0.745257,253,29,1, merged,1,1,0
60645,1000153,1,1439,1289,150,0.895761,0.104239,0.895761,115,35,1441,1291,150,0.895906,0.104094,0.895906,115,35,-1, abandoned,0,0,0
60645,1000534,2,708,546,162,0.771186,0.228814,1.666947,145,17,709,547,162,0.771509,0.228491,1.667415,145,17,-1, abandoned,0,0,0
60648,1000023,1,1871,1633,238,0.872795,0.127205,0.872795,210,28,1872,1634,238,0.872863,0.127137,0.872863,210,28,1, merged,0,0,0
60648,1000592,2,903,773,130,0.856035,0.143965,1.728831,82,48,904,774,130,0.856195,0.143805,1.729058,82,48,1, merged,0,0,0
60650,1000023,2,1872,1634,238,0.872863,0.127137,1.70956,210,28,1873,1635,238,0.872931,0.127069,1.709927,210,28,1, merged,0,0,0
60650,1000140,1,545,456,89,0.836697,0.163303,0.836697,79,10,546,457,89,0.836996,0.163004,0.836996,79,10,1, merged,0,0,0
60651,1000014,1,3415,2758,657,0.807613,0.192387,0.807613,615,42,3417,2760,657,0.807726,0.192274,0.807726,615,42,-1, merged,0,0,0
60651,1000108,2,564,482,82,0.85461,0.14539,1.662223,76,6,565,483,82,0.854867,0.145133,1.662593,76,6,1, merged,0,0,0
60652,1000121,2,2707,2266,441,0.837089,0.162911,1.622123,407,34,2708,2266,442,0.83678,0.16322,1.621249,408,34,1, abandoned,1,1,0
60652,1000329,1,3782,2969,813,0.785034,0.214966,0.785034,691,122,3786,2970,816,0.784469,0.215531,0.784469,694,122,-1, abandoned,1,0,0
60656,1000014,1,3417,2760,657,0.807726,0.192274,0.807726,615,42,3418,2760,658,0.80749,0.19251,0.80749,616,42,1, merged,1,1,0
60663,1000011,1,998,914,84,0.915832,0.084168,0.915832,79,5,1000,916,84,0.916,0.084,0.916,79,5,-1, merged,0,0,0
60663,1000120,2,2301,2026,275,0.880487,0.119513,1.796318,242,33,2302,2027,275,0.880539,0.119461,1.796539,242,33,1, merged,0,0,0
60665,1000004,1,4775,4195,580,0.878534,0.121466,0.878534,459,121,4776,4196,580,0.878559,0.121441,0.878559,459,121,-1, merged,0,0,0
60665,1000120,2,2302,2027,275,0.880539,0.119461,1.759073,242,33,2303,2028,275,0.880591,0.119409,1.75915,242,33,1, merged,0,0,0
60668,1000004,2,4776,4196,580,0.878559,0.121441,1.624633,459,121,4778,4198,580,0.87861,0.12139,1.622736,459,121,-1, merged,0,0,0
60672,1000012,1,836,716,120,0.856459,0.143541,0.856459,117,3,837,717,120,0.856631,0.143369,0.856631,117,3,-1, merged,0,0,0
60679,1000007,2,1941,1567,374,0.807316,0.192684,1.639587,330,44,1943,1569,374,0.807514,0.192486,1.639377,330,44,-1, merged,0,0,0
60679,1000009,1,2039,1697,342,0.832271,0.167729,0.832271,306,36,2040,1697,343,0.831863,0.168137,0.831863,307,36,1, merged,1,1,0
60679,1000592,3,907,776,131,0.855568,0.144432,2.495154,82,49,908,776,132,0.854626,0.145374,2.494002,82,50,-1, merged,1,1,0
60682,1000009,2,2040,1697,343,0.831863,0.168137,1.727768,307,36,2041,1698,343,0.831945,0.168055,1.727923,307,36,1, merged,0,0,0
60682,1000153,1,1441,1291,150,0.895906,0.104094,0.895906,115,35,1442,1292,150,0.895978,0.104022,0.895978,115,35,1, merged,0,0,0
60685,1000012,2,837,717,120,0.856631,0.143369,1.709125,117,3,838,718,120,0.856802,0.143198,1.707774,117,3,1, merged,0,0,0
60686,1000007,1,1943,1569,374,0.807514,0.192486,0.807514,330,44,1944,1569,375,0.807099,0.192901,0.807099,331,44,1, merged,1,1,0
60686,1000011,2,1001,917,84,0.916084,0.083916,1.723598,79,5,1003,919,84,0.916251,0.083749,1.72335,79,5,-1, merged,0,0,0
60699,1000132,1,877,729,148,0.831243,0.168757,0.831243,123,25,878,729,149,0.830296,0.169704,0.830296,124,25,1, merged,1,1,0
60700,1000009,2,2041,1698,343,0.831945,0.168055,1.727995,307,36,2042,1698,344,0.831538,0.168462,1.726493,308,36,1, merged,1,1,0
60700,1000153,1,1443,1293,150,0.89605,0.10395,0.89605,115,35,1447,1295,152,0.894955,0.105045,0.894955,117,35,-1, merged,1,0,0
60707,1000327,2,740,586,154,0.791892,0.208108,1.599938,119,35,741,587,154,0.792173,0.207827,1.600439,119,35,1, merged,0,0,0
60707,1002169,1,870,703,167,0.808046,0.191954,0.808046,121,46,871,704,167,0.808266,0.191734,0.808266,121,46,-1, merged,0,0,0
60708,1000004,2,4778,4198,580,0.87861,0.12139,1.662929,459,121,4781,4201,580,0.878686,0.121314,1.662648,459,121,-1, merged,0,0,0
60708,1000329,1,3788,2971,817,0.784319,0.215681,0.784319,695,122,3791,2972,819,0.783962,0.216038,0.783962,697,122,1, merged,1,1,0
60713,1000003,2,1584,1313,271,0.828914,0.171086,1.5432,231,40,1585,1313,272,0.828391,0.171609,1.578391,231,41,-1, merged,1,1,0
60717,1000014,1,3418,2760,658,0.80749,0.19251,0.80749,616,42,3420,2760,660,0.807018,0.192982,0.807018,618,42,1, merged,1,1,0
60717,1000130,3,823,691,132,0.839611,0.160389,2.13428,99,33,824,691,133,0.838592,0.161408,2.12061,100,33,1, merged,1,1,0
60718,1000012,2,838,718,120,0.856802,0.143198,1.707774,117,3,839,719,120,0.856973,0.143027,1.708266,117,3,-1, abandoned,0,0,0
60745,1000004,2,4783,4202,581,0.878528,0.121472,1.736452,460,121,4784,4203,581,0.878554,0.121446,1.736864,460,121,-1, abandoned,0,0,0
60745,1000054,4,1270,1078,192,0.848819,0.151181,3.302085,175,17,1271,1078,193,0.848151,0.151849,3.295542,176,17,1, abandoned,1,1,0
60747,1000153,4,1447,1295,152,0.894955,0.105045,2.574584,117,35,1448,1296,152,0.895028,0.104972,3.572156,117,35,1, merged,0,0,0
60747,1000534,1,709,547,162,0.771509,0.228491,0.771509,145,17,711,548,163,0.770745,0.229255,0.770745,146,17,1, merged,1,1,0
60757,1000023,1,1880,1641,239,0.872872,0.127128,0.872872,210,29,1881,1642,239,0.87294,0.12706,0.87294,210,29,1, merged,0,0,0
60772,1000004,2,4787,4206,581,0.87863,0.12137,1.759324,460,121,4788,4207,581,0.878655,0.121345,1.759071,460,121,-1, abandoned,0,0,0
60772,1000120,1,2305,2030,275,0.880694,0.119306,0.880694,242,33,2308,2032,276,0.880416,0.119584,0.880416,243,33,1, abandoned,1,1,0
60773,1000132,1,880,731,149,0.830682,0.169318,0.830682,124,25,881,731,150,0.829739,0.170261,0.829739,125,25,1, merged,1,1,0
60781,1000015,1,2567,2300,267,0.895988,0.104012,0.895988,245,22,2568,2301,267,0.896028,0.103972,0.896028,245,22,-1, abandoned,0,0,0
60781,1000329,2,3792,2973,819,0.784019,0.215981,1.680007,697,122,3793,2974,819,0.784076,0.215924,1.680104,697,122,-1, abandoned,0,0,0
60782,1000014,1,3420,2760,660,0.807018,0.192982,0.807018,618,42,3422,2762,660,0.80713,0.19287,0.80713,618,42,-1, merged,0,0,0
60784,1000327,3,741,587,154,0.792173,0.207827,2.409597,119,35,742,588,154,0.792453,0.207547,2.415126,119,35,1, merged,0,0,0
60787,1000009,2,2048,1704,344,0.832031,0.167969,1.602777,308,36,2049,1705,344,0.832113,0.167887,1.603181,308,36,-1, abandoned,0,0,0
60787,1000534,1,711,548,163,0.770745,0.229255,0.770745,146,17,712,549,163,0.771067,0.228933,0.771067,146,17,-1, abandoned,0,0,0
60792,1000328,2,1107,825,282,0.745257,0.254743,1.553524,253,29,1108,825,283,0.744585,0.255415,1.552145,253,30,-1, merged,1,1,0
60792,1002169,1,871,704,167,0.808266,0.191734,0.808266,121,46,873,705,168,0.80756,0.19244,0.80756,121,47,-1, merged,1,0,0
60793,1000009,1,2050,1706,344,0.832195,0.167805,0.832195,308,36,2051,1707,344,0.832277,0.167723,0.832277,308,36,1, merged,0,0,0
60804,1000023,1,1884,1645,239,0.873142,0.126858,0.873142,210,29,1885,1646,239,0.87321,0.12679,0.87321,210,29,1, merged,0,0,0
60812,1000004,1,4789,4208,581,0.87868,0.12132,0.87868,460,121,4791,4209,582,0.878522,0.121478,0.878522,461,121,-1, merged,1,0,0
60813,1000153,2,1449,1297,152,0.8951,0.1049,1.814238,117,35,1450,1297,153,0.894483,0.105517,1.811149,118,35,1, abandoned,1,1,0
60818,1000014,3,3422,2762,660,0.80713,0.19287,2.570818,618,42,3423,2763,660,0.807187,0.192813,2.571754,618,42,-1, abandoned,0,0,0
60818,1000023,1,1886,1647,239,0.873277,0.126723,0.873277,210,29,1888,1649,239,0.873411,0.126589,0.873411,210,29,-1, abandoned,0,0,0
60820,1000054,2,1272,1079,193,0.84827,0.15173,1.655831,176,17,1273,1080,193,0.84839,0.15161,1.655247,176,17,1, merged,0,0,0
60820,1002169,1,873,705,168,0.80756,0.19244,0.80756,121,47,875,706,169,0.806857,0.193143,0.806857,121,48,-1, merged,1,0,0
60821,1000014,1,3423,2763,660,0.807187,0.192813,0.807187,618,42,3426,2765,661,0.807064,0.192936,0.807064,619,42,1, merged,1,1,0
60834,1000003,3,1585,1313,272,0.828391,0.171609,2.454581,231,41,1586,1314,272,0.828499,0.171501,2.456388,231,41,1, merged,0,0,0
60834,1000153,1,1450,1297,153,0.894483,0.105517,0.894483,118,35,1451,1298,153,0.894555,0.105445,0.894555,118,35,1, merged,0,0,0
60835,1000003,2,1586,1314,272,0.828499,0.171501,1.723055,231,41,1587,1315,272,0.828607,0.171393,1.723308,231,41,1, merged,0,0,0
60835,1000153,1,1451,1298,153,0.894555,0.105445,0.894555,118,35,1453,1300,153,0.894701,0.105299,0.894701,118,35,-1, merged,0,0,0
60836,1000014,1,3427,2766,661,0.80712,0.19288,0.80712,619,42,3428,2767,661,0.807176,0.192824,0.807176,619,42,1, merged,0,0,0
60841,1000004,1,4791,4209,582,0.878522,0.121478,0.878522,461,121,4793,4211,582,0.878573,0.121427,0.878573,461,121,-1, merged,0,0,0
60845,1000132,4,882,732,150,0.829932,0.170068,3.035148,125,25,883,733,150,0.830125,0.169875,3.116863,125,25,1, merged,0,0,0
60846,1000120,1,2308,2032,276,0.880416,0.119584,0.880416,243,33,2309,2033,276,0.880468,0.119532,0.880468,243,33,-1, merged,0,0,0
60859,1000012,2,839,719,120,0.856973,0.143027,1.711709,117,3,840,720,120,0.857143,0.142857,1.712185,117,3,-1, abandoned,0,0,0
60863,1000023,2,1889,1650,239,0.873478,0.126522,1.873478,210,29,1890,1651,239,0.873545,0.126455,1.873545,210,29,1, merged,0,0,0
60871,1000534,1,712,549,163,0.771067,0.228933,0.771067,146,17,714,550,164,0.770308,0.229692,0.770308,147,17,1, merged,1,1,0
60886,1000014,2,3429,2768,661,0.807232,0.192768,1.430421,619,42,3432,2769,663,0.806818,0.193182,1.428247,621,42,1, merged,1,1,0
60900,1000054,2,1273,1080,193,0.84839,0.15161,1.54839,176,17,1274,1081,193,0.848509,0.151491,1.484872,176,17,1, merged,0,0,0
60914,1000329,4,3794,2975,819,0.784133,0.215867,3.323156,697,122,3795,2975,820,0.783926,0.216074,3.322345,698,122,1, abandoned,1,1,0
60920,1000004,1,4797,4215,582,0.878674,0.121326,0.878674,461,121,4798,4216,582,0.878699,0.121301,0.878699,461,121,1, merged,0,0,0
60920,1000023,4,1893,1654,239,0.873745,0.126255,3.232919,210,29,1894,1655,239,0.873812,0.126188,3.239615,210,29,1, merged,0,0,0
60927,1000007,1,1950,1575,375,0.807692,0.192308,0.807692,331,44,1953,1577,376,0.807476,0.192524,0.807476,332,44,-1, merged,1,0,0
60927,1000009,2,2067,1720,347,0.832124,0.167876,1.639816,310,37,2068,1721,347,0.832205,0.167795,1.639681,310,37,1, merged,0,0,0
60931,1000120,2,2310,2034,276,0.880519,0.119481,1.687377,243,33,2311,2035,276,0.880571,0.119429,1.687649,243,33,1, merged,0,0,0
60931,1002169,1,875,706,169,0.806857,0.193143,0.806857,121,48,876,707,169,0.807078,0.192922,0.807078,121,48,-1, merged,0,0,0
60936,1000014,1,3433,2770,663,0.806874,0.193126,0.806874,621,42,3434,2770,664,0.806639,0.193361,0.806639,622,42,1, abandoned,1,1,0
60941,1000166,3,600,452,148,0.753333,0.246667,2.250468,142,6,601,453,148,0.753744,0.246256,2.253842,142,6,1, merged,0,0,0
60960,1000009,2,2069,1722,347,0.832286,0.167714,1.602594,310,37,2070,1723,347,0.832367,0.167633,1.602997,310,37,1, merged,0,0,0
60960,1000534,1,714,550,164,0.770308,0.229692,0.770308,147,17,715,551,164,0.770629,0.229371,0.770629,147,17,1, merged,0,0,0
60961,1000009,1,2070,1723,347,0.832367,0.167633,0.832367,310,37,2072,1723,349,0.831564,0.168436,0.831564,312,37,1, merged,1,1,0
60961,1000534,2,715,551,164,0.770629,0.229371,1.602997,147,17,719,553,166,0.769124,0.230876,1.600687,148,18,1, merged,1,1,0
60973,1000023,1,1900,1661,239,0.874211,0.125789,0.874211,210,29,1901,1662,239,0.874277,0.125723,0.874277,210,29,1, merged,0,0,0
60976,1000014,1,3435,2771,664,0.806696,0.193304,0.806696,622,42,3436,2772,664,0.806752,0.193248,0.806752,622,42,1, merged,0,0,0
60983,1000005,3,972,848,124,0.872428,0.127572,2.596621,114,10,973,849,124,0.872559,0.127441,2.593707,114,10,1, merged,0,0,0
60987,1000004,1,4798,4216,582,0.878699,0.121301,0.878699,461,121,4799,4217,582,0.878725,0.121275,0.878725,461,121,1, merged,0,0,0
60987,1000015,2,2575,2308,267,0.896311,0.103689,1.77501,245,22,2576,2309,267,0.896351,0.103649,1.775076,245,22,1, merged,0,0,0
60996,1000015,1,2578,2311,267,0.896431,0.103569,0.896431,245,22,2579,2312,267,0.896472,0.103528,0.896472,245,22,1, merged,0,0,0
60996,1000153,2,1460,1307,153,0.895205,0.104795,1.791637,118,35,1461,1308,153,0.895277,0.104723,1.791749,118,35,1, merged,0,0,0
61001,1000015,1,2579,2312,267,0.896472,0.103528,0.896472,245,22,2580,2313,267,0.896512,0.103488,0.896512,245,22,1, merged,0,0,0
61002,1000329,2,3797,2977,820,0.78404,0.21596,1.658086,698,122,3798,2977,821,0.783834,0.216166,1.658358,698,123,-1, merged,1,1,0
61003,1000120,3,2315,2039,276,0.880778,0.119222,2.54581,243,33,2316,2040,276,0.880829,0.119171,2.546884,243,33,1, merged,0,0,0
61003,1002169,1,876,707,169,0.807078,0.192922,0.807078,121,48,877,708,169,0.807298,0.192702,0.807298,121,48,-1, merged,0,0,0
61006,1000014,1,3438,2773,665,0.806574,0.193426,0.806574,623,42,3439,2774,665,0.80663,0.19337,0.80663,623,42,1, merged,0,0,0
61018,1000592,2,908,776,132,0.854626,0.145374,1.72001,82,50,909,777,132,0.854785,0.145215,1.72271,82,50,1, merged,0,0,0
61019,1000130,6,838,705,133,0.841289,0.158711,4.771089,100,33,839,706,133,0.841478,0.158522,4.764085,100,33,1, merged,0,0,0
61019,1000329,2,3798,2977,821,0.783834,0.216166,1.591131,698,123,3800,2979,821,0.783947,0.216053,1.591464,698,123,-1, merged,0,0,0
61019,1002169,1,877,708,169,0.807298,0.192702,0.807298,121,48,878,709,169,0.807517,0.192483,0.807517,121,48,-1, merged,0,0,0
61024,1000329,2,3801,2980,821,0.784004,0.215996,1.591521,698,123,3803,2982,821,0.784118,0.215882,1.592072,698,123,-1, merged,0,0,0
61024,1002169,1,878,709,169,0.807517,0.192483,0.807517,121,48,880,711,169,0.807955,0.192045,0.807955,121,48,-1, merged,0,0,0
61036,1000329,2,3803,2982,821,0.784118,0.215882,1.445135,698,123,3804,2983,821,0.784175,0.215825,1.450841,698,123,1, merged,0,0,0
61048,1000003,2,1592,1320,272,0.829146,0.170854,1.684492,231,41,1593,1321,272,0.829253,0.170747,1.685203,231,41,1, merged,0,0,0
61049,1000014,1,3439,2774,665,0.80663,0.19337,0.80663,623,42,3441,2776,665,0.806742,0.193258,0.806742,623,42,1, merged,0,0,0
61054,1000054,2,1278,1085,193,0.848983,0.151017,1.5645,176,17,1279,1086,193,0.849101,0.150899,1.552491,176,17,1, merged,0,0,0
61055,1000592,1,909,777,132,0.854785,0.145215,0.854785,82,50,910,778,132,0.854945,0.145055,0.854945,82,50,1, merged,0,0,0
61057,1000023,2,1905,1666,239,0.874541,0.125459,1.474541,210,29,1906,1667,239,0.874607,0.125393,1.51097,210,29,1, merged,0,0,0
61059,1000014,1,3445,2780,665,0.806967,0.193033,0.806967,623,42,3446,2781,665,0.807023,0.192977,0.807023,623,42,1, merged,0,0,0
61059,1000023,2,1907,1668,239,0.874672,0.125328,1.681639,210,29,1908,1669,239,0.874738,0.125262,1.681761,210,29,1, merged,0,0,0
61061,1000014,1,3446,2781,665,0.807023,0.192977,0.807023,623,42,3447,2782,665,0.807079,0.192921,0.807079,623,42,1, merged,0,0,0
61061,1000153,2,1462,1309,153,0.895349,0.104651,1.702371,118,35,1463,1310,153,0.89542,0.10458,1.702499,118,35,1, merged,0,0,0
61071,1000023,2,1910,1671,239,0.874869,0.125131,1.578259,210,29,1911,1672,239,0.874935,0.125065,1.580817,210,29,1, merged,0,0,0
61079,1000004,1,4800,4218,582,0.87875,0.12125,0.87875,461,121,4801,4219,582,0.878775,0.121225,0.878775,461,121,-1, merged,0,0,0
61079,1000014,2,3447,2782,665,0.807079,0.192921,1.685829,623,42,3452,2784,668,0.806489,0.193511,1.685264,626,42,-1, merged,1,0,0
61079,1000329,4,3807,2985,822,0.784082,0.215918,3.277865,699,123,3808,2986,822,0.784139,0.215861,3.277575,699,123,1, merged,0,0,0
61079,1002169,3,880,711,169,0.807955,0.192045,2.493783,121,48,881,712,169,0.808173,0.191827,2.493437,121,48,-1, merged,0,0,0
61080,1000199,1,656,564,92,0.859756,0.140244,0.859756,83,9,657,565,92,0.85997,0.14003,0.85997,83,9,1, merged,0,0,0
61084,1000140,2,547,458,89,0.837294,0.162706,1.630277,79,10,549,459,90,0.836066,0.163934,1.628387,80,10,1, merged,1,1,0
61086,1002169,1,881,712,169,0.808173,0.191827,0.808173,121,48,884,715,169,0.808824,0.191176,0.808824,121,48,-1, merged,0,0,0
61093,1000026,2,736,626,110,0.850543,0.149457,1.525757,107,3,737,627,110,0.850746,0.149254,1.528712,107,3,1, merged,0,0,0
61097,1000015,2,2580,2313,267,0.896512,0.103488,1.792003,245,22,2581,2314,267,0.896552,0.103448,1.792186,245,22,1, merged,0,0,0
61097,1000153,1,1464,1311,153,0.895492,0.104508,0.895492,118,35,1466,1313,153,0.895634,0.104366,0.895634,118,35,-1, merged,0,0,0
61102,1000054,2,1280,1087,193,0.849219,0.150781,1.555101,176,17,1281,1088,193,0.849336,0.150664,1.55767,176,17,1, merged,0,0,0
61104,1000153,1,1467,1314,153,0.895706,0.104294,0.895706,118,35,1469,1315,154,0.895167,0.104833,0.895167,119,35,1, merged,1,1,0
61110,1000007,2,1953,1577,376,0.807476,0.192524,1.704027,332,44,1956,1579,377,0.80726,0.19274,1.703504,332,45,-1, merged,1,0,0
61110,1000015,1,2581,2314,267,0.896552,0.103448,0.896552,245,22,2583,2315,268,0.896245,0.103755,0.896245,246,22,1, merged,1,1,0
61112,1000014,1,3453,2785,668,0.806545,0.193455,0.806545,626,42,3455,2787,668,0.806657,0.193343,0.806657,626,42,-1, merged,0,0,0
61113,1000005,1,974,850,124,0.87269,0.12731,0.87269,114,10,975,851,124,0.872821,0.127179,0.872821,114,10,-1, abandoned,0,0,0
61122,1000014,1,3455,2787,668,0.806657,0.193343,0.806657,626,42,3458,2789,669,0.806536,0.193464,0.806536,627,42,-1, merged,1,0,0
61126,1000014,1,3458,2789,669,0.806536,0.193464,0.806536,627,42,3459,2790,669,0.806592,0.193408,0.806592,627,42,1, merged,0,0,0
61126,1000153,2,1471,1317,154,0.895309,0.104691,1.701845,119,35,1472,1318,154,0.89538,0.10462,1.701972,119,35,1, merged,0,0,0
61134,1000014,1,3459,2790,669,0.806592,0.193408,0.806592,627,42,3460,2791,669,0.806647,0.193353,0.806647,627,42,1, merged,0,0,0
61134,1000166,2,602,454,148,0.754153,0.245847,1.560744,142,6,603,455,148,0.754561,0.245439,1.561208,142,6,1, merged,0,0,0
61141,1000054,2,1282,1089,193,0.849454,0.150546,1.557787,176,17,1283,1090,193,0.849571,0.150429,1.560315,176,17,1, merged,0,0,0
61148,1000014,4,3462,2793,669,0.806759,0.193241,3.341223,627,42,3464,2795,669,0.806871,0.193129,3.305565,627,42,1, merged,0,0,0
61148,1000534,1,723,557,166,0.770401,0.229599,0.770401,148,18,726,558,168,0.768595,0.231405,0.768595,150,18,1, merged,1,1,0
61150,1000120,2,2327,2051,276,0.881392,0.118608,1.629464,243,33,2328,2052,276,0.881443,0.118557,1.630161,243,33,1, merged,0,0,0
61151,1000007,3,1956,1579,377,0.80726,0.19274,2.526047,332,45,1957,1579,378,0.806847,0.193153,2.523335,333,45,1, abandoned,1,1,0
61151,1000014,1,3464,2795,669,0.806871,0.193129,0.806871,627,42,3466,2796,670,0.806694,0.193306,0.806694,628,42,1, abandoned,1,1,0
61157,1000009,1,2077,1728,349,0.831969,0.168031,0.831969,312,37,2080,1729,351,0.83125,0.16875,0.83125,314,37,-1, abandoned,1,0,0
61164,1000009,2,2083,1732,351,0.831493,0.168507,1.600406,314,37,2088,1737,351,0.831897,0.168103,1.602074,314,37,-1, merged,0,0,0
61164,1000534,1,727,559,168,0.768913,0.231087,0.768913,150,18,731,563,168,0.770178,0.229822,0.770178,150,18,-1, merged,0,0,0
61179,1000004,2,4802,4220,582,0.8788,0.1212,1.685606,461,121,4803,4221,582,0.878826,0.121174,1.685687,461,121,1, merged,0,0,0
61179,1000014,1,3468,2798,670,0.806805,0.193195,0.806805,628,42,3469,2799,670,0.806861,0.193139,0.806861,628,42,1, merged,0,0,0
61180,1000054,2,1283,1090,193,0.849571,0.150429,1.560315,176,17,1284,1091,193,0.849688,0.150312,1.554607,176,17,1, merged,0,0,0
61183,1000007,3,1957,1579,378,0.806847,0.193153,2.497165,333,45,1958,1580,378,0.806946,0.193054,2.497152,333,45,1, merged,0,0,0
61183,1000120,2,2329,2053,276,0.881494,0.118506,1.690318,243,33,2331,2054,277,0.881167,0.118833,1.690206,244,33,1, merged,1,1,0
61183,1002169,1,884,715,169,0.808824,0.191176,0.808824,121,48,885,716,169,0.80904,0.19096,0.80904,121,48,-1, merged,0,0,0
61184,1000120,2,2331,2054,277,0.881167,0.118833,1.690206,244,33,2332,2055,277,0.881218,0.118782,1.690473,244,33,1, merged,0,0,0
61184,1002169,1,885,716,169,0.80904,0.19096,0.80904,121,48,886,717,169,0.809255,0.190745,0.809255,121,48,-1, merged,0,0,0
61185,1000120,2,2332,2055,277,0.881218,0.118782,1.690473,244,33,2333,2056,277,0.881269,0.118731,1.690739,244,33,1, merged,0,0,0
61185,1002169,1,886,717,169,0.809255,0.190745,0.809255,121,48,887,718,169,0.80947,0.19053,0.80947,121,48,-1, merged,0,0,0
61186,1000120,2,2333,2056,277,0.881269,0.118731,1.690739,244,33,2334,2057,277,0.88132,0.11868,1.691004,244,33,1, merged,0,0,0
61186,1002169,1,887,718,169,0.80947,0.19053,0.80947,121,48,888,719,169,0.809685,0.190315,0.809685,121,48,-1, merged,0,0,0
61187,1000120,4,2334,2057,277,0.88132,0.11868,3.212042,244,33,2335,2058,277,0.88137,0.11863,3.20629,244,33,1, merged,0,0,0
61187,1000329,3,3809,2987,822,0.784195,0.215805,2.330722,699,123,3810,2988,822,0.784252,0.215748,2.32492,699,123,1, merged,0,0,0
61187,1002169,1,888,719,169,0.809685,0.190315,0.809685,121,48,889,720,169,0.809899,0.190101,0.809899,121,48,-1, merged,0,0,0
61196,1000023,1,1913,1674,239,0.875065,0.124935,0.875065,210,29,1914,1675,239,0.875131,0.124869,0.875131,210,29,1, merged,0,0,0
61197,1000004,2,4803,4221,582,0.878826,0.121174,1.735969,461,121,4805,4223,582,0.878876,0.121124,1.628876,461,121,-1, merged,0,0,0
61206,1000121,1,2708,2266,442,0.83678,0.16322,0.83678,408,34,2709,2267,442,0.83684,0.16316,0.83684,408,34,-1, merged,0,0,0
61206,1000329,2,3811,2989,822,0.784309,0.215691,1.621088,699,123,3813,2991,822,0.784422,0.215578,1.621262,699,123,-1, merged,0,0,0
61208,1000121,2,2709,2267,442,0.83684,0.16316,1.33684,408,34,2710,2268,442,0.8369,0.1631,1.503567,408,34,1, merged,0,0,0
61213,1002169,1,889,720,169,0.809899,0.190101,0.809899,121,48,890,720,170,0.808989,0.191011,0.808989,121,49,-1, merged,1,1,0
61214,1000023,1,1914,1675,239,0.875131,0.124869,0.875131,210,29,1915,1676,239,0.875196,0.124804,0.875196,210,29,1, merged,0,0,0
61214,1000120,3,2340,2063,277,0.881624,0.118376,2.534532,244,33,2341,2064,277,0.881674,0.118326,2.542585,244,33,1, merged,0,0,0
61220,1000004,1,4807,4225,582,0.878927,0.121073,0.878927,461,121,4811,4229,582,0.879027,0.120973,0.879027,461,121,-1, merged,0,0,0
61220,1000026,2,737,627,110,0.850746,0.149254,1.729673,107,3,738,628,110,0.850949,0.149051,1.729976,107,3,1, merged,0,0,0
61221,1000014,2,3471,2801,670,0.806972,0.193028,1.545569,628,42,3474,2804,670,0.807139,0.192861,1.544442,628,42,-1, merged,0,0,0
61223,1000009,2,2090,1739,351,0.832057,0.167943,1.727933,314,37,2093,1741,352,0.83182,0.16818,1.727161,314,38,-1, merged,1,0,0
61223,1000153,1,1479,1325,154,0.895876,0.104124,0.895876,119,35,1481,1326,155,0.895341,0.104659,0.895341,120,35,1, merged,1,1,0
61227,1000009,2,2093,1741,352,0.83182,0.16818,1.727161,314,38,2094,1742,352,0.831901,0.168099,1.727312,314,38,-1, abandoned,0,0,0
61227,1000153,1,1481,1326,155,0.895341,0.104659,0.895341,120,35,1482,1327,155,0.895412,0.104588,0.895412,120,35,-1, abandoned,0,0,0
61228,1000014,1,3474,2804,670,0.807139,0.192861,0.807139,628,42,3479,2808,671,0.807128,0.192872,0.807128,629,42,-1, merged,1,0,0
61228,1000120,2,2341,2064,277,0.881674,0.118326,1.688813,244,33,2342,2065,277,0.881725,0.118275,1.688854,244,33,1, merged,0,0,0
61229,1000014,2,3479,2808,671,0.807128,0.192872,1.544431,629,42,3482,2811,671,0.807295,0.192705,1.543309,629,42,-1, merged,0,0,0
61233,1000004,2,4811,4229,582,0.879027,0.120973,1.566527,461,121,4812,4230,582,0.879052,0.120948,1.584935,461,121,1, merged,0,0,0
61239,1000004,1,4812,4230,582,0.879052,0.120948,0.879052,461,121,4815,4232,583,0.87892,0.12108,0.87892,462,121,1, merged,1,1,0
61241,1000004,2,4817,4234,583,0.87897,0.12103,1.684431,462,121,4819,4235,584,0.878813,0.121187,1.679489,463,121,-1, abandoned,1,0,0
61242,1000004,1,4819,4235,584,0.878813,0.121187,0.878813,463,121,4820,4236,584,0.878838,0.121162,0.878838,463,121,1, merged,0,0,0
61242,1000592,2,910,778,132,0.854945,0.145055,1.733758,82,50,911,779,132,0.855104,0.144896,1.733942,82,50,1, merged,0,0,0
61244,1000014,1,3482,2811,671,0.807295,0.192705,0.807295,629,42,3483,2812,671,0.80735,0.19265,0.80735,629,42,1, merged,0,0,0
61244,1000120,2,2342,2065,277,0.881725,0.118275,1.68902,244,33,2344,2066,278,0.881399,0.118601,1.688749,244,34,-1, merged,1,1,0
61247,1000009,2,2094,1742,352,0.831901,0.168099,1.639251,314,38,2096,1744,352,0.832061,0.167939,1.639466,314,38,1, merged,0,0,0
61247,1000014,1,3483,2812,671,0.80735,0.19265,0.80735,629,42,3484,2813,671,0.807405,0.192595,0.807405,629,42,1, merged,0,0,0
61248,1000009,2,2096,1744,352,0.832061,0.167939,1.639466,314,38,2099,1745,354,0.831348,0.168652,1.638577,316,38,1, merged,1,1,0
61248,1000014,1,3484,2813,671,0.807405,0.192595,0.807405,629,42,3486,2814,672,0.807229,0.192771,0.807229,630,42,1, merged,1,1,0
61249,1000009,2,2099,1745,354,0.831348,0.168652,1.638577,316,38,2101,1746,355,0.831033,0.168967,1.638086,317,38,1, merged,1,1,0
61249,1000014,1,3486,2814,672,0.807229,0.192771,0.807229,630,42,3488,2815,673,0.807053,0.192947,0.807053,631,42,1, merged,1,1,0
61251,1000011,2,1012,927,85,0.916008,0.083992,1.699707,80,5,1013,928,85,0.916091,0.083909,1.701138,80,5,1, merged,0,0,0
61254,1000009,2,2103,1748,355,0.831194,0.168806,1.638246,317,38,2104,1749,355,0.831274,0.168726,1.638151,317,38,1, merged,0,0,0
61254,1000014,1,3488,2815,673,0.807053,0.192947,0.807053,631,42,3490,2816,674,0.806877,0.193123,0.806877,632,42,1, merged,1,1,0
61260,1000054,2,1284,1091,193,0.849688,0.150312,1.554607,176,17,1285,1092,193,0.849805,0.150195,1.548992,176,17,1, merged,0,0,0
61266,1000004,2,4820,4236,584,0.878838,0.121162,1.754164,463,121,4824,4240,584,0.878939,0.121061,1.753808,463,121,-1, merged,0,0,0
61266,1000023,1,1917,1678,239,0.875326,0.124674,0.875326,210,29,1918,1678,240,0.87487,0.12513,0.87487,211,29,1, merged,1,1,0
61267,1000009,2,2104,1749,355,0.831274,0.168726,1.431274,317,38,2105,1749,356,0.830879,0.169121,1.402307,318,38,1, merged,1,1,0
61268,1000009,2,2105,1749,356,0.830879,0.169121,1.402307,318,38,2106,1750,356,0.830959,0.169041,1.455959,318,38,1, merged,0,0,0
61273,1000327,3,743,588,155,0.791386,0.208614,2.651449,119,36,744,589,155,0.791667,0.208333,2.651949,119,36,1, merged,0,0,0
61277,1000011,2,1016,930,86,0.915354,0.084646,1.697963,81,5,1017,931,86,0.915438,0.084562,1.696302,81,5,1, merged,0,0,0
61278,1000011,2,1017,931,86,0.915438,0.084562,1.696302,81,5,1018,932,86,0.915521,0.084479,1.697729,81,5,1, merged,0,0,0
61284,1000132,2,884,734,150,0.830317,0.169683,1.614851,125,25,885,735,150,0.830508,0.169492,1.6151,125,25,-1, abandoned,0,0,0
61284,1000329,1,3815,2993,822,0.784535,0.215465,0.784535,699,123,3816,2994,822,0.784591,0.215409,0.784591,699,123,-1, abandoned,0,0,0
61289,1000327,1,744,589,155,0.791667,0.208333,0.791667,119,36,746,591,155,0.792225,0.207775,0.792225,119,36,-1, merged,0,0,0
61302,1000004,1,4827,4242,585,0.878807,0.121193,0.878807,464,121,4828,4243,585,0.878832,0.121168,0.878832,464,121,1, merged,0,0,0
61302,1000329,3,3816,2994,822,0.784591,0.215409,1.663398,699,123,3817,2995,822,0.784648,0.215352,2.163479,699,123,1, merged,0,0,0
61306,1000329,2,3817,2995,822,0.784648,0.215352,1.284648,699,123,3818,2996,822,0.784704,0.215296,1.451371,699,123,1, merged,0,0,0
61309,1000328,2,1108,825,283,0.744585,0.255415,1.526607,253,30,1109,825,284,0.743913,0.256087,1.524182,253,31,-1, merged,1,1,0
61309,1000329,3,3818,2996,822,0.784704,0.215296,2.311311,699,123,3819,2996,823,0.784499,0.215501,2.308681,699,124,-1, merged,1,1,0
61312,1000534,1,734,566,168,0.771117,0.228883,0.771117,150,18,736,568,168,0.771739,0.228261,0.771739,150,18,-1, abandoned,0,0,0
61314,1000004,2,4828,4243,585,0.878832,0.121168,1.687821,464,121,4829,4244,585,0.878857,0.121143,1.688487,464,121,-1, abandoned,0,0,0
61314,1002169,1,890,720,170,0.808989,0.191011,0.808989,121,49,893,723,170,0.80963,0.19037,0.80963,121,49,-1, abandoned,0,0,0
61322,1000014,1,3492,2817,675,0.806701,0.193299,0.806701,633,42,3493,2818,675,0.806756,0.193244,0.806756,633,42,-1, abandoned,0,0,0
61325,1000014,1,3494,2818,676,0.806525,0.193475,0.806525,634,42,3495,2819,676,0.806581,0.193419,0.806581,634,42,1, merged,0,0,0
61326,1000004,2,4829,4244,585,0.878857,0.121143,1.685438,464,121,4830,4245,585,0.878882,0.121118,1.685518,464,121,1, merged,0,0,0
61326,1000014,1,3495,2819,676,0.806581,0.193419,0.806581,634,42,3496,2820,676,0.806636,0.193364,0.806636,634,42,1, merged,0,0,0
61329,1000121,3,2710,2268,442,0.8369,0.1631,2.573742,408,34,2711,2269,442,0.836961,0.163039,2.586961,408,34,1, merged,0,0,0
61330,1000004,1,4830,4245,585,0.878882,0.121118,0.878882,464,121,4834,4248,586,0.878775,0.121225,0.878775,465,121,1, merged,1,1,0
61330,1000592,3,911,779,132,0.855104,0.144896,2.540653,82,50,913,780,133,0.854326,0.145674,2.542312,83,50,1, merged,1,1,0
61331,1000054,1,1286,1093,193,0.849922,0.150078,0.849922,176,17,1289,1095,194,0.849496,0.150504,0.849496,177,17,-1, merged,1,0,0
61333,1000014,1,3496,2820,676,0.806636,0.193364,0.806636,634,42,3497,2821,676,0.806691,0.193309,0.806691,634,42,1, merged,0,0,0
61334,1000592,3,913,780,133,0.854326,0.145674,2.226704,83,50,914,781,133,0.854486,0.145514,2.172549,83,50,1, merged,0,0,0
61336,1000023,2,1926,1686,240,0.875389,0.124611,1.875389,211,29,1927,1687,240,0.875454,0.124546,1.875454,211,29,1, merged,0,0,0
61340,1000023,2,1927,1687,240,0.875454,0.124546,1.735048,211,29,1928,1688,240,0.875519,0.124481,1.735332,211,29,1, merged,0,0,0
61344,1000004,1,4834,4248,586,0.878775,0.121225,0.878775,465,121,4835,4249,586,0.8788,0.1212,0.8788,465,121,1, merged,0,0,0
61349,1000329,2,3819,2996,823,0.784499,0.215501,1.448466,699,124,3820,2996,824,0.784293,0.215707,1.446944,700,124,1, merged,1,1,0
61350,1000004,1,4835,4249,586,0.8788,0.1212,0.8788,465,121,4836,4250,586,0.878825,0.121175,0.878825,465,121,1, merged,0,0,0
61350,1000023,2,1930,1690,240,0.875648,0.124352,1.754448,211,29,1931,1691,240,0.875712,0.124288,1.754538,211,29,1, merged,0,0,0
61372,1000011,1,1020,934,86,0.915686,0.084314,0.915686,81,5,1022,936,86,0.915851,0.084149,0.915851,81,5,-1, merged,0,0,0
61372,1000120,2,2344,2066,278,0.881399,0.118601,1.797086,244,34,2345,2067,278,0.88145,0.11855,1.797301,244,34,-1, merged,0,0,0
61378,1000054,2,1290,1096,194,0.849612,0.150388,1.63247,177,17,1291,1097,194,0.849729,0.150271,1.633205,177,17,1, merged,0,0,0
61382,1000011,2,1022,936,86,0.915851,0.084149,1.797301,81,5,1023,937,86,0.915934,0.084066,1.797434,81,5,1, merged,0,0,0
61382,1000120,1,2345,2067,278,0.88145,0.11855,0.88145,244,34,2346,2068,278,0.8815,0.1185,0.8815,244,34,-1, merged,0,0,0
61383,1000007,2,1958,1580,378,0.806946,0.193054,1.637985,333,45,1963,1584,379,0.806928,0.193072,1.638128,334,45,-1, merged,1,0,0
61383,1000009,1,2107,1751,356,0.831039,0.168961,0.831039,318,38,2109,1753,356,0.8312,0.1688,0.8312,318,38,-1, merged,0,0,0
61384,1000007,2,1963,1584,379,0.806928,0.193072,1.638128,334,45,1964,1585,379,0.807026,0.192974,1.637992,334,45,-1, abandoned,0,0,0
61384,1000009,1,2109,1753,356,0.8312,0.1688,0.8312,318,38,2112,1755,357,0.830966,0.169034,0.830966,319,38,-1, abandoned,1,0,0
61385,1000007,2,1964,1585,379,0.807026,0.192974,1.637992,334,45,1965,1585,380,0.806616,0.193384,1.637742,335,45,1, abandoned,1,1,0
61385,1000009,1,2112,1755,357,0.830966,0.169034,0.830966,319,38,2114,1757,357,0.831126,0.168874,0.831126,319,38,-1, abandoned,0,0,0
61386,1000329,2,3820,2996,824,0.784293,0.215707,1.446944,700,124,3822,2998,824,0.784406,0.215594,1.444406,700,124,-1, merged,0,0,0
61388,1000329,2,3822,2998,824,0.784406,0.215594,1.594037,700,124,3824,2999,825,0.784257,0.215743,1.594101,701,124,1, merged,1,1,0
61388,1002169,1,893,723,170,0.80963,0.19037,0.80963,121,49,894,724,170,0.809843,0.190157,0.809843,121,49,-1, merged,0,0,0
61390,1000120,2,2346,2068,278,0.8815,0.1185,1.665758,244,34,2347,2069,278,0.881551,0.118449,1.665865,244,34,1, merged,0,0,0
61390,1000329,1,3824,2999,825,0.784257,0.215743,0.784257,701,124,3825,3000,825,0.784314,0.215686,0.784314,701,124,1, merged,0,0,0
61392,1000130,2,840,707,133,0.841667,0.158333,1.406884,100,33,842,708,134,0.840855,0.159145,1.400855,101,33,1, merged,1,1,0
61402,1000004,1,4838,4251,587,0.878669,0.121331,0.878669,465,122,4839,4252,587,0.878694,0.121306,0.878694,465,122,1, merged,0,0,0
61402,1000592,2,915,781,134,0.853552,0.146448,1.732221,84,50,916,782,134,0.853712,0.146288,1.732406,84,50,1, merged,0,0,0
61405,1000004,1,4839,4252,587,0.878694,0.121306,0.878694,465,122,4842,4255,587,0.878769,0.121231,0.878769,465,122,-1, merged,0,0,0
61407,1000004,1,4842,4255,587,0.878769,0.121231,0.878769,465,122,4843,4256,587,0.878794,0.121206,0.878794,465,122,1, merged,0,0,0
61407,1000592,2,916,782,134,0.853712,0.146288,1.732481,84,50,917,783,134,0.853871,0.146129,1.732665,84,50,1, merged,0,0,0
61408,1000004,1,4843,4256,587,0.878794,0.121206,0.878794,465,122,4845,4258,587,0.878844,0.121156,0.878844,465,122,-1, merged,0,0,0
61408,1000592,2,917,783,134,0.853871,0.146129,1.732665,84,50,918,784,134,0.854031,0.145969,1.732875,84,50,1, merged,0,0,0
61409,1000091,2,684,542,142,0.792398,0.207602,1.536311,119,23,685,543,142,0.792701,0.207299,1.536845,119,23,-1, abandoned,0,0,0
61409,1000328,1,1109,825,284,0.743913,0.256087,0.743913,253,31,1110,826,284,0.744144,0.255856,0.744144,253,31,-1, abandoned,0,0,0
61428,1000004,1,4845,4258,587,0.878844,0.121156,0.878844,465,122,4846,4259,587,0.878869,0.121131,0.878869,465,122,1, merged,0,0,0
61428,1000592,2,918,784,134,0.854031,0.145969,1.732875,84,50,919,785,134,0.854189,0.145811,1.733059,84,50,1, merged,0,0,0
61439,1000009,2,2114,1757,357,0.831126,0.168874,1.391126,319,38,2116,1758,358,0.830813,0.169187,1.386368,320,38,1, merged,1,1,0
61442,1000004,2,4857,4270,587,0.879144,0.120856,1.738277,465,122,4858,4271,587,0.879168,0.120832,1.738519,465,122,1, merged,0,0,0
61456,1000007,2,1965,1585,380,0.806616,0.193384,1.637509,335,45,1967,1585,382,0.805796,0.194204,1.636848,337,45,1, merged,1,1,0
61456,1000009,1,2117,1759,358,0.830893,0.169107,0.830893,320,38,2119,1761,358,0.831052,0.168948,0.831052,320,38,-1, merged,0,0,0
61467,1000014,1,3500,2823,677,0.806571,0.193429,0.806571,634,43,3501,2824,677,0.806627,0.193373,0.806627,634,43,1, merged,0,0,0
61472,1000014,1,3501,2824,677,0.806627,0.193373,0.806627,634,43,3502,2825,677,0.806682,0.193318,0.806682,634,43,1, merged,0,0,0
61472,1000054,2,1295,1101,194,0.850193,0.149807,1.65682,177,17,1296,1102,194,0.850309,0.149691,1.656991,177,17,1, merged,0,0,0
61475,1000011,1,1024,938,86,0.916016,0.083984,0.916016,81,5,1025,939,86,0.916098,0.083902,0.916098,81,5,1, merged,0,0,0
61475,1000534,2,736,568,168,0.771739,0.228261,1.687755,150,18,737,569,168,0.772049,0.227951,1.688146,150,18,1, merged,0,0,0
61480,1000007,1,1971,1588,383,0.805682,0.194318,0.805682,337,46,1972,1588,384,0.805274,0.194726,0.805274,338,46,1, merged,1,1,0
61480,1000009,2,2122,1764,358,0.831291,0.168709,1.636974,320,38,2123,1765,358,0.831371,0.168629,1.636645,320,38,1, merged,0,0,0
61484,1000007,1,1976,1590,386,0.804656,0.195344,0.804656,340,46,1978,1590,388,0.803842,0.196158,0.803842,342,46,1, merged,1,1,0
61484,1000009,2,2123,1765,358,0.831371,0.168629,1.636027,320,38,2124,1766,358,0.83145,0.16855,1.635292,320,38,1, merged,0,0,0
61486,1000007,1,1979,1591,388,0.803941,0.196059,0.803941,342,46,1984,1596,388,0.804435,0.195565,0.804435,342,46,-1, merged,0,0,0
61486,1000009,2,2124,1766,358,0.83145,0.16855,1.635391,320,38,2126,1768,358,0.831609,0.168391,1.636044,320,38,-1, merged,0,0,0
61489,1000130,2,852,718,134,0.842723,0.157277,1.398279,101,33,853,719,134,0.842907,0.157093,1.414336,101,33,1, merged,0,0,0
61490,1000130,2,853,719,134,0.842907,0.157093,1.414336,101,33,854,720,134,0.843091,0.156909,1.429298,101,33,1, merged,0,0,0
61496,1000105,2,868,694,174,0.799539,0.200461,1.584242,149,25,869,695,174,0.79977,0.20023,1.582256,149,25,-1, abandoned,0,0,0
61504,1000014,1,3503,2826,677,0.806737,0.193263,0.806737,634,43,3504,2827,677,0.806792,0.193208,0.806792,634,43,1, merged,0,0,0
61508,1000023,3,1937,1697,240,0.876097,0.123903,2.591801,211,29,1939,1697,242,0.875193,0.124807,2.581128,213,29,1, merged,1,1,0
61509,1000014,3,3504,2827,677,0.806792,0.193208,2.533148,634,43,3506,2829,677,0.806902,0.193098,2.530833,634,43,-1, merged,0,0,0
61509,1000023,2,1939,1697,242,0.875193,0.124807,1.726356,213,29,1940,1697,243,0.874742,0.125258,1.72393,214,29,1, merged,1,1,0
61515,1000327,4,746,591,155,0.792225,0.207775,3.273045,119,36,747,591,156,0.791165,0.208835,3.19808,120,36,1, merged,1,1,0
61518,1000014,1,3506,2829,677,0.806902,0.193098,0.806902,634,43,3507,2829,678,0.806672,0.193328,0.806672,635,43,1, merged,1,1,0
61518,1000534,2,738,570,168,0.772358,0.227642,1.57926,150,18,740,570,170,0.77027,0.22973,1.576943,152,18,1, merged,1,1,0
61519,1000014,1,3507,2829,678,0.806672,0.193328,0.806672,635,43,3509,2829,680,0.806213,0.193787,0.806213,637,43,1, merged,1,1,0
61519,1000534,2,740,570,170,0.77027,0.22973,1.576943,152,18,742,571,171,0.769542,0.230458,1.575754,153,18,1, merged,1,1,0
61520,1000004,1,4869,4282,587,0.879441,0.120559,0.879441,465,122,4870,4283,587,0.879466,0.120534,0.879466,465,122,-1, merged,0,0,0
61520,1000132,4,887,737,150,0.830891,0.169109,3.267017,125,25,890,739,151,0.830337,0.169663,3.251241,126,25,-1, merged,1,0,0
61521,1000004,1,4870,4283,587,0.879466,0.120534,0.879466,465,122,4872,4284,588,0.87931,0.12069,0.87931,466,122,-1, merged,1,0,0
61521,1000120,2,2348,2070,278,0.881601,0.118399,1.761067,244,34,2349,2071,278,0.881652,0.118348,1.760962,244,34,-1, merged,0,0,0
61521,1000534,3,742,571,171,0.769542,0.230458,2.530609,153,18,743,571,172,0.768506,0.231494,2.529468,154,18,1, merged,1,1,0
61526,1000007,2,1989,1600,389,0.804424,0.195576,1.662831,343,46,1992,1602,390,0.804217,0.195783,1.660099,344,46,-1, merged,1,0,0
61532,1000014,1,3512,2831,681,0.806093,0.193907,0.806093,638,43,3513,2832,681,0.806149,0.193851,0.806149,638,43,1, merged,0,0,0
61532,1000023,2,1941,1698,243,0.874807,0.125193,1.6809,214,29,1942,1699,243,0.874871,0.125129,1.68102,214,29,1, merged,0,0,0
61539,1000014,1,3513,2832,681,0.806149,0.193851,0.806149,638,43,3514,2833,681,0.806204,0.193796,0.806204,638,43,1, merged,0,0,0
61546,1000009,2,2129,1771,358,0.831846,0.168154,1.520018,320,38,2130,1772,358,0.831925,0.168075,1.516135,320,38,1, merged,0,0,0
61553,1000534,3,743,571,172,0.768506,0.231494,2.542238,154,18,744,572,172,0.768817,0.231183,2.543008,154,18,1, merged,0,0,0
61556,1002169,1,894,724,170,0.809843,0.190157,0.809843,121,49,901,731,170,0.811321,0.188679,0.811321,121,49,-1, merged,0,0,0
61566,1000004,1,4873,4285,588,0.879335,0.120665,0.879335,466,122,4875,4286,589,0.879179,0.120821,0.879179,467,122,1, abandoned,1,1,0
61568,1000014,1,3515,2834,681,0.806259,0.193741,0.806259,638,43,3520,2835,685,0.805398,0.194602,0.805398,642,43,1, merged,1,1,0
61581,1000009,2,2132,1774,358,0.832083,0.167917,1.516293,320,38,2133,1775,358,0.832161,0.167839,1.519661,320,38,-1, merged,0,0,0
61583,1000004,2,4875,4286,589,0.879179,0.120821,1.585062,467,122,4876,4287,589,0.879204,0.120796,1.601426,467,122,1, merged,0,0,0
61589,1000130,2,855,721,134,0.843275,0.156725,1.429482,101,33,856,722,134,0.843458,0.156542,1.443458,101,33,1, merged,0,0,0
61598,1000011,2,1027,941,86,0.916261,0.083739,1.603761,81,5,1028,942,86,0.916342,0.083658,1.607064,81,5,1, merged,0,0,0
61604,1000054,1,1298,1104,194,0.850539,0.149461,0.850539,177,17,1299,1105,194,0.850654,0.149346,0.850654,177,17,1, merged,0,0,0
61617,1000121,2,2711,2269,442,0.836961,0.163039,1.336961,408,34,2712,2270,442,0.837021,0.162979,1.347659,408,34,-1, abandoned,0,0,0
61620,1000004,1,4877,4288,589,0.879229,0.120771,0.879229,467,122,4878,4289,589,0.879254,0.120746,0.879254,467,122,1, merged,0,0,0
61625,1000004,1,4878,4289,589,0.879254,0.120746,0.879254,467,122,4879,4289,590,0.879074,0.120926,0.879074,468,122,1, abandoned,1,1,0
61625,1000054,2,1299,1105,194,0.850654,0.149346,1.729908,177,17,1300,1105,195,0.85,0.15,1.729074,178,17,1, abandoned,1,1,0
61632,1000140,1,550,460,90,0.836364,0.163636,0.836364,80,10,553,462,91,0.835443,0.164557,0.835443,81,10,1, merged,1,1,0
61636,1000004,3,4879,4289,590,0.879074,0.120926,2.542325,468,122,4880,4290,590,0.879098,0.120902,2.542677,468,122,1, merged,0,0,0
61636,1000014,1,3521,2836,685,0.805453,0.194547,0.805453,642,43,3523,2838,685,0.805563,0.194437,0.805563,642,43,1, merged,0,0,0
61638,1000054,4,1300,1105,195,0.85,0.15,3.111194,178,17,1301,1106,195,0.850115,0.149885,3.111315,178,17,1, merged,0,0,0
61638,1000166,2,603,455,148,0.754561,0.245439,1.565881,142,6,606,456,150,0.752475,0.247525,1.563525,144,6,1, merged,1,1,0
61638,1002169,1,901,731,170,0.811321,0.188679,0.811321,121,49,905,734,171,0.81105,0.18895,0.81105,121,50,-1, merged,1,0,0
61641,1000009,1,2138,1780,358,0.832554,0.167446,0.832554,320,38,2140,1781,359,0.832243,0.167757,0.832243,320,39,-1, merged,1,0,0
61651,1000199,2,659,567,92,0.860395,0.139605,1.636491,83,9,661,568,93,0.859304,0.140696,1.635739,83,10,-1, merged,1,1,0
61653,1000199,2,661,568,93,0.859304,0.140696,1.635739,83,10,662,569,93,0.859517,0.140483,1.636289,83,10,1, merged,0,0,0
61654,1000199,2,662,569,93,0.859517,0.140483,1.636289,83,10,663,569,94,0.85822,0.14178,1.635329,83,11,-1, merged,1,1,0
61655,1000199,2,663,569,94,0.85822,0.14178,1.635329,83,11,664,570,94,0.858434,0.141566,1.635877,83,11,-1, abandoned,0,0,0
61656,1000199,2,664,570,94,0.858434,0.141566,1.635877,83,11,666,572,94,0.858859,0.141141,1.635135,83,11,-1, merged,0,0,0
61657,1000199,2,666,572,94,0.858859,0.141141,1.635135,83,11,667,573,94,0.85907,0.14093,1.635682,83,11,1, merged,0,0,0
61660,1000004,1,4880,4290,590,0.879098,0.120902,0.879098,468,122,4881,4291,590,0.879123,0.120877,0.879123,468,122,-1, merged,0,0,0
61660,1000328,2,1110,826,284,0.744144,0.255856,1.623243,253,31,1112,828,284,0.744604,0.255396,1.623727,253,31,-1, merged,0,0,0
61660,1000329,4,3830,3004,826,0.784334,0.215666,3.218626,702,124,3831,3005,826,0.78439,0.21561,3.219376,702,124,-1, merged,0,0,0
61660,1002169,3,905,734,171,0.81105,0.18895,2.434292,121,50,906,735,171,0.811258,0.188742,2.434986,121,50,-1, merged,0,0,0
61661,1000121,2,2712,2270,442,0.837021,0.162979,1.65617,408,34,2713,2271,442,0.837081,0.162919,1.658133,408,34,1, merged,0,0,0
61662,1000014,4,3523,2838,685,0.805563,0.194437,3.270197,642,43,3524,2838,686,0.805335,0.194665,3.267076,643,43,1, merged,1,1,0
61662,1000130,2,856,722,134,0.843458,0.156542,1.654716,101,33,858,724,134,0.843823,0.156177,1.655289,101,33,-1, merged,0,0,0
61662,1002169,1,906,735,171,0.811258,0.188742,0.811258,121,50,907,736,171,0.811466,0.188534,0.811466,121,50,-1, merged,0,0,0
61663,1000014,2,3524,2838,686,0.805335,0.194665,1.616801,643,43,3525,2839,686,0.80539,0.19461,1.617478,643,43,1, merged,0,0,0
61663,1002169,1,907,736,171,0.811466,0.188534,0.811466,121,50,910,739,171,0.812088,0.187912,0.812088,121,50,-1, merged,0,0,0
61668,1000004,1,4881,4291,590,0.879123,0.120877,0.879123,468,122,4882,4291,591,0.878943,0.121057,0.878943,469,122,1, abandoned,1,1,0
61669,1000091,2,687,544,143,0.791849,0.208151,1.603937,120,23,688,545,143,0.792151,0.207849,1.604445,120,23,-1, abandoned,0,0,0
61669,1002169,1,910,739,171,0.812088,0.187912,0.812088,121,50,911,740,171,0.812294,0.187706,0.812294,121,50,-1, abandoned,0,0,0
61671,1000091,2,690,547,143,0.792754,0.207246,1.605048,120,23,691,548,143,0.793054,0.206946,1.605554,120,23,-1, abandoned,0,0,0
61671,1002169,1,911,740,171,0.812294,0.187706,0.812294,121,50,912,741,171,0.8125,0.1875,0.8125,121,50,-1, abandoned,0,0,0
61675,1000004,2,4882,4291,591,0.878943,0.121057,1.66339,469,122,4883,4292,591,0.878968,0.121032,1.663527,469,122,-1, merged,0,0,0
61675,1000329,1,3832,3006,826,0.784447,0.215553,0.784447,702,124,3834,3008,826,0.784559,0.215441,0.784559,702,124,-1, merged,0,0,0
61676,1000009,1,2140,1781,359,0.832243,0.167757,0.832243,320,39,2142,1782,360,0.831933,0.168067,0.831933,321,39,1, merged,1,1,0
61676,1000014,2,3525,2839,686,0.80539,0.19461,1.637633,643,43,3527,2840,687,0.805217,0.194783,1.63715,644,43,1, merged,1,1,0
61696,1000011,2,1028,942,86,0.916342,0.083658,1.72178,81,5,1029,943,86,0.916424,0.083576,1.721916,81,5,1, merged,0,0,0
61696,1000014,1,3531,2844,687,0.805438,0.194562,0.805438,644,43,3532,2845,687,0.805493,0.194507,0.805493,644,43,1, merged,0,0,0
61697,1000592,2,919,785,134,0.854189,0.145811,1.670757,84,50,920,785,135,0.853261,0.146739,1.670908,85,50,1, abandoned,1,1,0
61699,1000011,1,1029,943,86,0.916424,0.083576,0.916424,81,5,1031,945,86,0.916586,0.083414,0.916586,81,5,-1, merged,0,0,0
61699,1000015,2,2585,2317,268,0.896325,0.103675,1.812749,246,22,2586,2317,269,0.895978,0.104022,1.812564,247,22,1, merged,1,1,0
61705,1000014,3,3532,2845,687,0.805493,0.194507,2.442543,644,43,3533,2846,687,0.805548,0.194452,2.436733,644,43,-1, abandoned,0,0,0
61705,1000026,2,741,631,110,0.851552,0.148448,1.63705,107,3,742,631,111,0.850404,0.149596,1.631185,108,3,1, abandoned,1,1,0
61706,1000023,1,1945,1702,243,0.875064,0.124936,0.875064,214,29,1947,1704,243,0.875193,0.124807,0.875193,214,29,1, merged,0,0,0
61707,1000014,1,3533,2846,687,0.805548,0.194452,0.805548,644,43,3535,2847,688,0.805375,0.194625,0.805375,645,43,1, merged,1,1,0
61710,1000009,2,2145,1785,360,0.832168,0.167832,1.713797,321,39,2147,1787,360,0.832324,0.167676,1.714004,321,39,1, merged,0,0,0
61710,1000120,1,2357,2078,279,0.881629,0.118371,0.881629,245,34,2358,2079,279,0.881679,0.118321,0.881679,245,34,1, merged,0,0,0
61712,1000004,2,4884,4293,591,0.878993,0.121007,1.774971,469,122,4885,4294,591,0.879017,0.120983,1.775036,469,122,1, merged,0,0,0
61712,1000015,1,2586,2317,269,0.895978,0.104022,0.895978,247,22,2587,2318,269,0.896019,0.103981,0.896019,247,22,1, merged,0,0,0
61713,1000004,2,4885,4294,591,0.879017,0.120983,1.775036,469,122,4886,4295,591,0.879042,0.120958,1.775101,469,122,1, merged,0,0,0
61713,1000015,1,2587,2318,269,0.896019,0.103981,0.896019,247,22,2588,2319,269,0.896059,0.103941,0.896059,247,22,1, merged,0,0,0
61714,1000004,2,4886,4295,591,0.879042,0.120958,1.775101,469,122,4887,4296,591,0.879067,0.120933,1.77482,469,122,1, merged,0,0,0
61714,1000015,1,2588,2319,269,0.896059,0.103941,0.896059,247,22,2590,2320,270,0.895753,0.104247,0.895753,248,22,1, merged,1,1,0
61715,1000004,2,4887,4296,591,0.879067,0.120933,1.77482,469,122,4888,4297,591,0.879092,0.120908,1.774885,469,122,1, merged,0,0,0
61715,1000015,1,2590,2320,270,0.895753,0.104247,0.895753,248,22,2591,2321,270,0.895793,0.104207,0.895793,248,22,1, merged,0,0,0
61716,1000004,2,4888,4297,591,0.879092,0.120908,1.774885,469,122,4889,4298,591,0.879116,0.120884,1.77495,469,122,1, merged,0,0,0
61716,1000015,1,2591,2321,270,0.895793,0.104207,0.895793,248,22,2592,2322,270,0.895833,0.104167,0.895833,248,22,1, merged,0,0,0
61717,1000004,2,4889,4298,591,0.879116,0.120884,1.77495,469,122,4890,4299,591,0.879141,0.120859,1.775015,469,122,1, merged,0,0,0
61717,1000015,1,2592,2322,270,0.895833,0.104167,0.895833,248,22,2593,2323,270,0.895874,0.104126,0.895874,248,22,1, merged,0,0,0
61720,1000091,2,691,548,143,0.793054,0.206946,1.636876,120,23,694,549,145,0.791066,0.208934,1.635614,122,23,1, merged,1,1,0
61720,1000130,1,858,724,134,0.843823,0.156177,0.843823,101,33,862,728,134,0.844548,0.155452,0.844548,101,33,-1, merged,0,0,0
61731,1000023,2,1957,1714,243,0.87583,0.12417,1.733846,214,29,1958,1715,243,0.875894,0.124106,1.734125,214,29,1, merged,0,0,0
61738,1000121,3,2713,2271,442,0.837081,0.162919,1.347719,408,34,2714,2272,442,0.837141,0.162859,1.357974,408,34,-1, abandoned,0,0,0
61743,1000328,3,1112,828,284,0.744604,0.255396,2.34172,253,31,1113,828,285,0.743935,0.256065,2.341312,254,31,1, merged,1,1,0
61743,1000329,2,3835,3009,826,0.784615,0.215385,1.597115,702,124,3836,3010,826,0.784672,0.215328,1.597377,702,124,-1, merged,0,0,0
61743,1002169,1,912,741,171,0.8125,0.1875,0.8125,121,50,913,742,171,0.812705,0.187295,0.812705,121,50,-1, merged,0,0,0
61744,1000004,2,4890,4299,591,0.879141,0.120859,1.462474,469,122,4893,4301,592,0.879011,0.120989,1.417472,470,122,1, merged,1,1,0
61746,1000004,2,4895,4303,592,0.87906,0.12094,1.691766,470,122,4896,4304,592,0.879085,0.120915,1.691995,470,122,-1, abandoned,0,0,0
61746,1000329,3,3836,3010,826,0.784672,0.215328,2.476437,702,124,3837,3011,826,0.784728,0.215272,2.476723,702,124,-1, abandoned,0,0,0
61746,1002169,1,913,742,171,0.812705,0.187295,0.812705,121,50,914,743,171,0.81291,0.18709,0.81291,121,50,-1, abandoned,0,0,0
61752,1000329,2,3837,3011,826,0.784728,0.215272,1.698929,702,124,3839,3011,828,0.784319,0.215681,1.693142,702,126,-1, merged,1,1,0
61754,1000004,1,4897,4305,592,0.87911,0.12089,0.87911,470,122,4898,4306,592,0.879134,0.120866,0.879134,470,122,-1, merged,0,0,0
61754,1000329,2,3842,3014,828,0.784487,0.215513,1.663597,702,126,3844,3015,829,0.784339,0.215661,1.663474,703,126,1, merged,1,1,0
61756,1000329,3,3844,3015,829,0.784339,0.215661,2.403701,703,126,3845,3016,829,0.784395,0.215605,2.407034,703,126,-1, merged,0,0,0
61756,1002169,1,914,743,171,0.81291,0.18709,0.81291,121,50,915,744,171,0.813115,0.186885,0.813115,121,50,-1, merged,0,0,0
61757,1000327,2,747,591,156,0.791165,0.208835,0.791165,120,36,748,592,156,0.791444,0.208556,0.791444,120,36,-1, merged,0,0,0
61761,1000327,2,748,592,156,0.791444,0.208556,1.541444,120,36,749,593,156,0.791722,0.208278,1.5695,120,36,1, merged,0,0,0
61763,1000327,2,749,593,156,0.791722,0.208278,1.576174,120,36,750,594,156,0.792,0.208,1.576507,120,36,1, merged,0,0,0
61763,1000329,1,3846,3017,829,0.784451,0.215549,0.784451,703,126,3847,3018,829,0.784507,0.215493,0.784507,703,126,1, merged,0,0,0
61766,1000132,2,899,746,153,0.829811,0.170189,1.634923,128,25,900,747,153,0.83,0.17,1.635732,128,25,1, merged,0,0,0
61767,1000014,1,3536,2848,688,0.80543,0.19457,0.80543,645,43,3537,2849,688,0.805485,0.194515,0.805485,645,43,1, merged,0,0,0
61768,1000004,1,4898,4306,592,0.879134,0.120866,0.879134,470,122,4899,4306,593,0.878955,0.121045,0.878955,471,122,1, merged,1,1,0
61771,1000329,2,3847,3018,829,0.784507,0.215493,1.52135,703,126,3850,3021,829,0.784675,0.215325,1.52456,703,126,-1, merged,0,0,0
61772,1000329,2,3850,3021,829,0.784675,0.215325,1.52456,703,126,3854,3024,830,0.784639,0.215361,1.516068,704,126,-1, merged,1,0,0
61772,1002169,3,915,744,171,0.813115,0.186885,2.337674,121,50,916,745,171,0.813319,0.186681,2.329387,121,50,-1, merged,0,0,0
61773,1000329,2,3854,3024,830,0.784639,0.215361,1.516068,704,126,3858,3025,833,0.784085,0.215915,1.502317,707,126,-1, merged,1,0,0
61774,1000329,2,3858,3025,833,0.784085,0.215915,1.502317,707,126,3863,3027,836,0.783588,0.216412,1.493265,710,126,-1, merged,1,0,0
61775,1000329,1,3863,3027,836,0.783588,0.216412,0.783588,710,126,3868,3028,840,0.782834,0.217166,0.782834,714,126,1, merged,1,1,0
61776,1000329,1,3868,3028,840,0.782834,0.217166,0.782834,714,126,3873,3029,844,0.782081,0.217919,0.782081,718,126,1, merged,1,1,0
61777,1000329,1,3873,3029,844,0.782081,0.217919,0.782081,718,126,3878,3031,847,0.781588,0.218412,0.781588,721,126,-1, merged,1,0,0
61778,1000329,2,3878,3031,847,0.781588,0.218412,1.465006,721,126,3882,3033,849,0.781298,0.218702,1.462671,723,126,1, merged,1,1,0
61779,1000329,1,3882,3033,849,0.781298,0.218702,0.781298,723,126,3886,3034,852,0.780751,0.219249,0.780751,726,126,1, merged,1,1,0
61782,1000329,2,3886,3034,852,0.780751,0.219249,0.780751,726,126,3888,3036,852,0.780864,0.219136,0.780864,726,126,-1, merged,0,0,0
61783,1000014,1,3537,2849,688,0.805485,0.194515,0.805485,645,43,3540,2851,689,0.805367,0.194633,0.805367,646,43,-1, merged,1,0,0
61783,1000121,2,2714,2272,442,0.837141,0.162859,1.642626,408,34,2715,2273,442,0.837201,0.162799,1.642568,408,34,1, merged,0,0,0
61795,1000054,1,1303,1108,195,0.850345,0.149655,0.850345,178,17,1304,1109,195,0.85046,0.14954,0.85046,178,17,1, merged,0,0,0
61795,1000592,2,920,785,135,0.853261,0.146739,1.703606,85,50,921,786,135,0.85342,0.14658,1.70388,85,50,1, merged,0,0,0
61802,1000109,3,774,670,104,0.865633,0.134367,2.501946,98,6,775,671,104,0.865806,0.134194,2.502663,98,6,1, merged,0,0,0
61802,1000199,2,670,576,94,0.859701,0.140299,1.636313,83,11,671,577,94,0.859911,0.140089,1.636857,83,11,1, merged,0,0,0
61803,1000026,2,742,631,111,0.850404,0.149596,1.710315,108,3,745,634,111,0.851007,0.148993,1.711747,108,3,-1, merged,0,0,0
61803,1000199,1,671,577,94,0.859911,0.140089,0.859911,83,11,675,581,94,0.860741,0.139259,0.860741,83,11,-1, merged,0,0,0
61804,1000329,2,3889,3037,852,0.780921,0.219079,1.638844,726,126,3890,3037,853,0.78072,0.21928,1.634774,727,126,1, abandoned,1,1,0
61805,1000014,1,3540,2851,689,0.805367,0.194633,0.805367,646,43,3541,2852,689,0.805422,0.194578,0.805422,646,43,1, merged,0,0,0
61805,1000105,2,871,697,174,0.80023,0.19977,1.605597,149,25,872,698,174,0.800459,0.199541,1.605881,149,25,1, merged,0,0,0
61807,1000023,1,1966,1723,243,0.876399,0.123601,0.876399,214,29,1968,1725,243,0.876524,0.123476,0.876524,214,29,1, merged,0,0,0
61816,1000004,2,4902,4308,594,0.878825,0.121175,1.729514,472,122,4903,4309,594,0.87885,0.12115,1.729653,472,122,1, merged,0,0,0
61816,1000054,1,1306,1111,195,0.850689,0.149311,0.850689,178,17,1307,1112,195,0.850803,0.149197,0.850803,178,17,1, merged,0,0,0
61816,1000140,3,555,464,91,0.836036,0.163964,2.56555,81,10,556,465,91,0.836331,0.163669,2.565984,81,10,1, merged,0,0,0
61818,1000004,1,4903,4309,594,0.87885,0.12115,0.87885,472,122,4904,4310,594,0.878874,0.121126,0.878874,472,122,1, merged,0,0,0
61822,1000004,1,4904,4310,594,0.878874,0.121126,0.878874,472,122,4906,4312,594,0.878924,0.121076,0.878924,472,122,-1, merged,0,0,0
61822,1000015,2,2593,2323,270,0.895874,0.104126,1.774748,248,22,2594,2324,270,0.895914,0.104086,1.774837,248,22,1, merged,0,0,0
61823,1000004,2,4906,4312,594,0.878924,0.121076,1.684346,472,122,4907,4313,594,0.878948,0.121052,1.684143,472,122,-1, merged,0,0,0
61823,1000014,1,3541,2852,689,0.805422,0.194578,0.805422,646,43,3542,2852,690,0.805195,0.194805,0.805195,647,43,1, merged,1,1,0
61825,1000023,2,1968,1725,243,0.876524,0.123476,1.74609,214,29,1969,1726,243,0.876587,0.123413,1.739835,214,29,1, merged,0,0,0
61826,1000109,1,776,672,104,0.865979,0.134021,0.865979,98,6,777,673,104,0.866152,0.133848,0.866152,98,6,1, merged,0,0,0
61830,1000007,2,1996,1605,391,0.804108,0.195892,1.636588,344,47,1997,1606,391,0.804206,0.195794,1.636764,344,47,1, merged,0,0,0
61830,1000009,1,2149,1789,360,0.83248,0.16752,0.83248,321,39,2150,1790,360,0.832558,0.167442,0.832558,321,39,1, merged,0,0,0
61834,1000007,2,2000,1608,392,0.804,0.196,1.636558,344,48,2001,1608,393,0.803598,0.196402,1.636234,344,49,-1, merged,1,1,0
61834,1000009,1,2150,1790,360,0.832558,0.167442,0.832558,321,39,2151,1791,360,0.832636,0.167364,0.832636,321,39,1, merged,0,0,0
61834,1000015,3,2594,2324,270,0.895914,0.104086,2.532472,248,22,2595,2325,270,0.895954,0.104046,2.532188,248,22,1, merged,0,0,0
61840,1000054,2,1307,1112,195,0.850803,0.149197,1.548478,178,17,1308,1113,195,0.850917,0.149083,1.550917,178,17,1, merged,0,0,0
61848,1000120,2,2362,2083,279,0.88188,0.11812,1.58188,245,34,2364,2084,280,0.881557,0.118443,1.571698,246,34,1, merged,1,1,0
61859,1000004,3,4909,4315,594,0.878998,0.121002,2.473149,472,122,4910,4316,594,0.879022,0.120978,2.473693,472,122,-1, abandoned,0,0,0
61859,1000329,2,3892,3039,853,0.780832,0.219168,1.594151,727,126,3894,3041,853,0.780945,0.219055,1.594671,727,126,-1, abandoned,0,0,0
61859,1002169,1,916,745,171,0.813319,0.186681,0.813319,121,50,918,747,171,0.813725,0.186275,0.813725,121,50,-1, abandoned,0,0,0
61862,1000004,2,4910,4316,594,0.879022,0.120978,1.57133,472,122,4911,4317,594,0.879047,0.120953,1.574699,472,122,1, merged,0,0,0
61865,1000054,2,1308,1113,195,0.850917,0.149083,1.550917,178,17,1309,1114,195,0.851031,0.148969,1.553321,178,17,1, merged,0,0,0
61869,1000023,2,1970,1727,243,0.87665,0.12335,1.57894,214,29,1971,1728,243,0.876712,0.123288,1.581258,214,29,1, merged,0,0,0
61869,1000054,3,1309,1114,195,0.851031,0.148969,2.429971,178,17,1310,1115,195,0.851145,0.148855,2.432403,178,17,1, merged,0,0,0
61871,1000014,1,3542,2852,690,0.805195,0.194805,0.805195,647,43,3543,2853,690,0.80525,0.19475,0.80525,647,43,1, merged,0,0,0
61871,1000054,2,1310,1115,195,0.851145,0.148855,1.65634,178,17,1311,1116,195,0.851259,0.148741,1.656508,178,17,1, merged,0,0,0
61872,1000014,1,3543,2853,690,0.80525,0.19475,0.80525,647,43,3544,2854,690,0.805305,0.194695,0.805305,647,43,1, merged,0,0,0
61872,1000054,2,1311,1116,195,0.851259,0.148741,1.656508,178,17,1312,1117,195,0.851372,0.148628,1.656677,178,17,1, merged,0,0,0
61874,1000014,2,3544,2854,690,0.805305,0.194695,1.656677,647,43,3545,2854,691,0.805078,0.194922,1.655801,648,43,1, merged,1,1,0
61874,1000026,3,745,634,111,0.851007,0.148993,2.507683,108,3,746,635,111,0.851206,0.148794,2.507008,108,3,1, merged,0,0,0
61874,1000054,1,1312,1117,195,0.851372,0.148628,0.851372,178,17,1313,1117,196,0.850724,0.149276,0.850724,179,17,1, merged,1,1,0
61875,1000014,2,3545,2854,691,0.805078,0.194922,1.655801,648,43,3546,2854,692,0.804851,0.195149,1.655041,649,43,1, merged,1,1,0
61875,1000054,1,1313,1117,196,0.850724,0.149276,0.850724,179,17,1315,1118,197,0.85019,0.14981,0.85019,180,17,1, merged,1,1,0
61876,1000105,3,874,700,174,0.800915,0.199085,2.379633,149,25,875,701,174,0.801143,0.198857,2.380692,149,25,1, merged,0,0,0
61876,1000132,2,900,747,153,0.83,0.17,1.578718,128,25,901,748,153,0.830189,0.169811,1.579549,128,25,1, merged,0,0,0
61880,1000003,3,1593,1321,272,0.829253,0.170747,2.558308,231,41,1594,1322,272,0.82936,0.17064,2.558955,231,41,-1, abandoned,0,0,0
61880,1000109,1,777,673,104,0.866152,0.133848,0.866152,98,6,778,674,104,0.866324,0.133676,0.866324,98,6,-1, abandoned,0,0,0
61883,1000011,3,1032,946,86,0.916667,0.083333,2.577822,81,5,1033,947,86,0.916747,0.083253,2.578378,81,5,1, merged,0,0,0
61883,1000014,1,3546,2854,692,0.804851,0.195149,0.804851,649,43,3547,2855,692,0.804906,0.195094,0.804906,649,43,1, merged,0,0,0
61905,1000004,2,4912,4318,594,0.879072,0.120928,1.733126,472,122,4913,4319,594,0.879096,0.120904,1.733935,472,122,1, merged,0,0,0
61907,1000005,1,981,857,124,0.873598,0.126402,0.873598,114,10,982,858,124,0.873727,0.126273,0.873727,114,10,1, merged,0,0,0
61907,1000121,2,2716,2274,442,0.837261,0.162739,1.710859,408,34,2717,2275,442,0.837321,0.162679,1.711048,408,34,1, merged,0,0,0
61927,1000121,1,2729,2280,449,0.835471,0.164529,0.835471,415,34,2730,2281,449,0.835531,0.164469,0.835531,415,34,-1, abandoned,0,0,0
61928,1000199,2,675,581,94,0.860741,0.139259,1.638353,83,11,678,584,94,0.861357,0.138643,1.638143,83,11,-1, merged,0,0,0
61929,1000140,2,557,466,91,0.836625,0.163375,1.642974,81,10,558,467,91,0.836918,0.163082,1.64388,81,10,1, merged,0,0,0
61932,1000329,2,3897,3044,853,0.781114,0.218886,0.781114,727,126,3898,3045,853,0.78117,0.21883,1.78117,727,126,1, merged,0,0,0
61933,1000329,2,3898,3045,853,0.78117,0.21883,1.78117,727,126,3899,3046,853,0.781226,0.218774,1.781226,727,126,1, merged,0,0,0
61934,1000329,2,3899,3046,853,0.781226,0.218774,1.781226,727,126,3900,3047,853,0.781282,0.218718,1.781282,727,126,1, merged,0,0,0
61935,1000329,2,3900,3047,853,0.781282,0.218718,1.781282,727,126,3901,3048,853,0.781338,0.218662,1.781338,727,126,1, merged,0,0,0
61936,1000329,2,3901,3048,853,0.781338,0.218662,1.781338,727,126,3902,3049,853,0.781394,0.218606,1.781394,727,126,1, merged,0,0,0
61943,1000004,2,4914,4320,594,0.879121,0.120879,1.692846,472,122,4918,4324,594,0.879219,0.120781,1.693954,472,122,-1, merged,0,0,0
61943,1000329,4,3902,3049,853,0.781394,0.218606,3.210352,727,126,3907,3053,854,0.781418,0.218582,3.21194,728,126,-1, merged,1,0,0
61943,1002169,1,918,747,171,0.813725,0.186275,0.813725,121,50,923,752,171,0.814735,0.185265,0.814735,121,50,-1, merged,0,0,0
61961,1000009,2,2153,1793,360,0.832791,0.167209,1.601919,321,39,2154,1793,361,0.832405,0.167595,1.601842,322,39,1, abandoned,1,1,0
61961,1000534,1,745,573,172,0.769128,0.230872,0.769128,154,18,746,574,172,0.769437,0.230563,0.769437,154,18,-1, abandoned,0,0,0
61965,1000023,2,1973,1730,243,0.876837,0.123163,1.658167,214,29,1974,1731,243,0.8769,0.1231,1.658086,214,29,1, merged,0,0,0
61965,1000329,1,3910,3055,855,0.78133,0.21867,0.78133,729,126,3912,3056,856,0.781186,0.218814,0.781186,730,126,1, merged,1,1,0
61967,1000004,1,4919,4325,594,0.879244,0.120756,0.879244,472,122,4920,4326,594,0.879268,0.120732,0.879268,472,122,1, merged,0,0,0
61967,1000329,2,3913,3057,856,0.781242,0.218758,1.660486,730,126,3914,3058,856,0.781298,0.218702,1.660566,730,126,1, merged,0,0,0
61970,1000054,2,1316,1119,197,0.850304,0.149696,1.554849,180,17,1317,1119,198,0.849658,0.150342,1.548906,181,17,1, abandoned,1,1,0
61971,1000014,1,3548,2856,692,0.804961,0.195039,0.804961,649,43,3549,2857,692,0.805015,0.194985,0.805015,649,43,1, merged,0,0,0
61971,1000108,2,570,488,82,0.85614,0.14386,1.661101,76,6,571,489,82,0.856392,0.143608,1.661408,76,6,1, merged,0,0,0
61973,1000014,2,3549,2857,692,0.805015,0.194985,1.517515,649,43,3551,2858,693,0.804844,0.195156,1.514387,650,43,1, merged,1,1,0
61974,1000109,2,778,674,104,0.866324,0.133676,1.727681,98,6,779,675,104,0.866496,0.133504,1.728057,98,6,1, merged,0,0,0
61974,1000199,1,678,584,94,0.861357,0.138643,0.861357,83,11,679,585,94,0.861561,0.138439,0.861561,83,11,1, merged,0,0,0
61976,1000054,2,1317,1119,198,0.849658,0.150342,1.657834,181,17,1318,1119,199,0.849014,0.150986,1.654656,182,17,1, abandoned,1,1,0
61978,1000009,2,2154,1793,361,0.832405,0.167595,1.64722,322,39,2155,1794,361,0.832483,0.167517,1.650664,322,39,1, merged,0,0,0
61989,1000004,4,4921,4327,594,0.879293,0.120707,3.265069,472,122,4922,4328,594,0.879317,0.120683,3.266123,472,122,-1, merged,0,0,0
61989,1000329,2,3914,3058,856,0.781298,0.218702,1.571041,730,126,3917,3060,857,0.78121,0.21879,1.57167,731,126,-1, merged,1,0,0
61989,1002169,3,923,752,171,0.814735,0.185265,2.385776,121,50,925,754,171,0.815135,0.184865,2.386805,121,50,-1, merged,0,0,0
61996,1000199,2,679,585,94,0.861561,0.138439,1.638347,83,11,680,586,94,0.861765,0.138235,1.639213,83,11,1, merged,0,0,0
61997,1000004,2,4922,4328,594,0.879317,0.120683,1.694452,472,122,4923,4329,594,0.879342,0.120658,1.694677,472,122,-1, abandoned,0,0,0
61997,1002169,1,925,754,171,0.815135,0.184865,0.815135,121,50,926,755,171,0.815335,0.184665,0.815335,121,50,-1, abandoned,0,0,0
61998,1000130,1,865,731,134,0.845087,0.154913,0.845087,101,33,866,731,135,0.844111,0.155889,0.844111,102,33,1, abandoned,1,1,0
61998,1000592,3,921,786,135,0.85342,0.14658,2.532469,85,50,922,786,136,0.852495,0.147505,2.531192,86,50,1, abandoned,1,1,0
62012,1000166,2,606,456,150,0.752475,0.247525,1.451723,144,6,609,459,150,0.753695,0.246305,1.447724,144,6,-1, merged,0,0,0
62014,1000105,2,879,704,175,0.80091,0.19909,1.252523,149,26,882,707,175,0.801587,0.198413,1.254712,149,26,-1, abandoned,0,0,0
62014,1000328,3,1114,829,285,0.744165,0.255835,1.996688,254,31,1116,831,285,0.744624,0.255376,1.999336,254,31,-1, abandoned,0,0,0
62014,1002169,4,926,755,171,0.815335,0.184665,2.812023,121,50,927,756,171,0.815534,0.184466,2.81487,121,50,-1, abandoned,0,0,0
62023,1000015,2,2599,2329,270,0.896114,0.103886,1.696114,248,22,2600,2330,270,0.896154,0.103846,1.705678,248,22,1, merged,0,0,0
62037,1000054,2,1319,1120,199,0.849128,0.150872,1.632461,182,17,1320,1121,199,0.849242,0.150758,1.633176,182,17,1, merged,0,0,0
62038,1000054,2,1320,1121,199,0.849242,0.150758,1.633176,182,17,1321,1122,199,0.849357,0.150643,1.633887,182,17,1, merged,0,0,0
62039,1000023,4,1976,1732,244,0.876518,0.123482,3.191077,215,29,1977,1733,244,0.876581,0.123419,3.191595,215,29,1, merged,0,0,0
62039,1000054,1,1321,1122,199,0.849357,0.150643,0.849357,182,17,1322,1122,200,0.848714,0.151286,0.848714,183,17,1, merged,1,1,0
62045,1000004,2,4925,4331,594,0.879391,0.120609,1.775545,472,122,4926,4332,594,0.879415,0.120585,1.775609,472,122,1, merged,0,0,0
62045,1000015,1,2600,2330,270,0.896154,0.103846,0.896154,248,22,2601,2331,270,0.896194,0.103806,0.896194,248,22,1, merged,0,0,0
62046,1000004,2,4926,4332,594,0.879415,0.120585,1.775609,472,122,4927,4333,594,0.87944,0.12056,1.775673,472,122,1, merged,0,0,0
62046,1000015,1,2601,2331,270,0.896194,0.103806,0.896194,248,22,2602,2332,270,0.896234,0.103766,0.896234,248,22,1, merged,0,0,0
62047,1000004,2,4927,4333,594,0.87944,0.12056,1.775673,472,122,4928,4334,594,0.879464,0.120536,1.775738,472,122,1, merged,0,0,0
62047,1000015,1,2602,2332,270,0.896234,0.103766,0.896234,248,22,2603,2333,270,0.896274,0.103726,0.896274,248,22,1, merged,0,0,0
62048,1000004,2,4928,4334,594,0.879464,0.120536,1.775738,472,122,4929,4335,594,0.879489,0.120511,1.775802,472,122,1, merged,0,0,0
62048,1000015,1,2603,2333,270,0.896274,0.103726,0.896274,248,22,2604,2334,270,0.896313,0.103687,0.896313,248,22,1, merged,0,0,0
62049,1000004,2,4929,4335,594,0.879489,0.120511,1.775802,472,122,4930,4336,594,0.879513,0.120487,1.775866,472,122,1, merged,0,0,0
62049,1000015,1,2604,2334,270,0.896313,0.103687,0.896313,248,22,2605,2335,270,0.896353,0.103647,0.896353,248,22,1, merged,0,0,0
62050,1000004,2,4930,4336,594,0.879513,0.120487,1.775866,472,122,4931,4337,594,0.879538,0.120462,1.775931,472,122,1, merged,0,0,0
62050,1000015,1,2605,2335,270,0.896353,0.103647,0.896353,248,22,2606,2336,270,0.896393,0.103607,0.896393,248,22,1, merged,0,0,0
62051,1000004,2,4931,4337,594,0.879538,0.120462,1.775931,472,122,4932,4338,594,0.879562,0.120438,1.775995,472,122,1, merged,0,0,0
62051,1000015,1,2606,2336,270,0.896393,0.103607,0.896393,248,22,2607,2337,270,0.896433,0.103567,0.896433,248,22,1, merged,0,0,0
62059,1000108,5,571,489,82,0.856392,0.143608,2.890197,76,6,572,490,82,0.856643,0.143357,2.893105,76,6,-1, merged,0,0,0
62059,1000130,4,866,731,135,0.844111,0.155889,2.033804,102,33,870,735,135,0.844828,0.155172,2.036461,102,33,-1, merged,0,0,0
62068,1000004,1,4932,4338,594,0.879562,0.120438,0.879562,472,122,4933,4339,594,0.879586,0.120414,0.879586,472,122,1, merged,0,0,0
62068,1000007,2,2002,1609,393,0.803696,0.196304,1.683258,344,49,2003,1610,393,0.803794,0.196206,1.683381,344,49,1, merged,0,0,0
62073,1000108,2,572,490,82,0.856643,0.143357,1.688072,76,6,573,491,82,0.856894,0.143106,1.686439,76,6,1, merged,0,0,0
62074,1000329,1,3918,3061,857,0.781266,0.218734,0.781266,731,126,3921,3063,858,0.781178,0.218822,0.781178,732,126,-1, merged,1,0,0
62075,1000329,1,3921,3063,858,0.781178,0.218822,0.781178,732,126,3924,3064,860,0.780836,0.219164,0.780836,734,126,1, merged,1,1,0
62081,1000004,1,4933,4339,594,0.879586,0.120414,0.879586,472,122,4935,4341,594,0.879635,0.120365,0.879635,472,122,-1, merged,0,0,0
62081,1000007,2,2003,1610,393,0.803794,0.196206,1.683381,344,49,2004,1611,393,0.803892,0.196108,1.683527,344,49,1, merged,0,0,0
62084,1000105,2,884,709,175,0.802036,0.197964,1.564923,149,26,885,710,175,0.80226,0.19774,1.567566,149,26,1, merged,0,0,0
62085,1000009,1,2158,1797,361,0.832715,0.167285,0.832715,322,39,2163,1800,363,0.832178,0.167822,0.832178,324,39,-1, merged,1,0,0
62086,1000140,2,559,468,91,0.837209,0.162791,1.618045,81,10,560,469,91,0.8375,0.1625,1.618249,81,10,1, merged,0,0,0
62086,1000329,1,3924,3064,860,0.780836,0.219164,0.780836,734,126,3927,3066,861,0.780749,0.219251,0.780749,735,126,-1, merged,1,0,0
62089,1000120,2,2370,2088,282,0.881013,0.118987,1.736628,246,36,2371,2089,282,0.881063,0.118937,1.737446,246,36,1, merged,0,0,0
62090,1000140,2,560,469,91,0.8375,0.1625,1.693883,81,10,561,470,91,0.83779,0.16221,1.694933,81,10,1, merged,0,0,0
62092,1000140,2,561,470,91,0.83779,0.16221,1.694933,81,10,562,471,91,0.838078,0.161922,1.695973,81,10,1, merged,0,0,0
62095,1000108,1,573,491,82,0.856894,0.143106,0.856894,76,6,574,492,82,0.857143,0.142857,0.857143,76,6,1, merged,0,0,0
62097,1000108,3,574,492,82,0.857143,0.142857,2.315038,76,6,575,493,82,0.857391,0.142609,2.383433,76,6,1, merged,0,0,0
62110,1000023,1,1979,1734,245,0.8762,0.1238,0.8762,216,29,1981,1735,246,0.87582,0.12418,0.87582,217,29,1, merged,1,1,0
62131,1000166,2,619,467,152,0.754443,0.245557,1.613747,146,6,620,468,152,0.754839,0.245161,1.614355,146,6,1, merged,0,0,0
62134,1000054,1,1324,1123,201,0.848187,0.151813,0.848187,184,17,1325,1124,201,0.848302,0.151698,0.848302,184,17,1, merged,0,0,0
62134,1000166,3,622,470,152,0.755627,0.244373,2.387012,146,6,623,471,152,0.756019,0.243981,2.388105,146,6,1, merged,0,0,0
62135,1000166,1,623,471,152,0.756019,0.243981,0.756019,146,6,625,472,153,0.7552,0.2448,0.7552,147,6,1, merged,1,1,0
62140,1000054,2,1325,1124,201,0.848302,0.151698,1.639473,184,17,1326,1125,201,0.848416,0.151584,1.639942,184,17,1, merged,0,0,0
62141,1000140,2,566,474,92,0.837456,0.162544,1.537456,82,10,567,475,92,0.837743,0.162257,1.565015,82,10,1, merged,0,0,0
62149,1000121,2,2731,2282,449,0.835591,0.164409,1.739324,415,34,2733,2283,450,0.835346,0.164654,1.735541,415,35,-1, merged,1,0,0
62152,1000004,6,4938,4344,594,0.879708,0.120292,4.967357,472,122,4940,4345,595,0.879555,0.120445,4.89775,473,122,1, merged,1,1,0
62152,1000120,3,2371,2089,282,0.881063,0.118937,2.436019,246,36,2373,2089,284,0.88032,0.11968,2.372339,248,36,1, merged,1,1,0
62156,1000054,2,1326,1125,201,0.848416,0.151584,1.66395,184,17,1328,1127,201,0.848645,0.151355,1.663499,184,17,-1, merged,0,0,0
62156,1002169,1,927,756,171,0.815534,0.184466,0.815534,121,50,929,757,172,0.814855,0.185145,0.814855,121,51,-1, merged,1,0,0
62158,1000015,3,2614,2344,270,0.89671,0.10329,2.496803,248,22,2616,2346,270,0.896789,0.103211,2.493094,248,22,-1, merged,0,0,0
62159,1000015,2,2616,2346,270,0.896789,0.103211,1.677491,248,22,2617,2347,270,0.896828,0.103172,1.678805,248,22,1, merged,0,0,0
62160,1000004,2,4940,4345,595,0.879555,0.120445,1.776383,473,122,4941,4346,595,0.879579,0.120421,1.776447,473,122,1, merged,0,0,0
62160,1000015,1,2617,2347,270,0.896828,0.103172,0.896828,248,22,2618,2348,270,0.896868,0.103132,0.896868,248,22,1, merged,0,0,0
62162,1000004,2,4941,4346,595,0.879579,0.120421,1.776486,473,122,4942,4347,595,0.879603,0.120397,1.77655,473,122,1, merged,0,0,0
62162,1000015,1,2619,2349,270,0.896907,0.103093,0.896907,248,22,2620,2350,270,0.896947,0.103053,0.896947,248,22,1, merged,0,0,0
62163,1000004,2,4942,4347,595,0.879603,0.120397,1.77655,473,122,4943,4348,595,0.879628,0.120372,1.776614,473,122,1, merged,0,0,0
62163,1000015,1,2620,2350,270,0.896947,0.103053,0.896947,248,22,2621,2351,270,0.896986,0.103014,0.896986,248,22,1, merged,0,0,0
62164,1000004,2,4943,4348,595,0.879628,0.120372,1.776614,473,122,4944,4349,595,0.879652,0.120348,1.776677,473,122,1, merged,0,0,0
62164,1000015,1,2621,2351,270,0.896986,0.103014,0.896986,248,22,2622,2352,270,0.897025,0.102975,0.897025,248,22,1, merged,0,0,0
62167,1000054,2,1328,1127,201,0.848645,0.151355,1.655498,184,17,1329,1128,201,0.848758,0.151242,1.653106,184,17,1, merged,0,0,0
62167,1000140,3,568,476,92,0.838028,0.161972,2.493526,82,10,569,477,92,0.838313,0.161687,2.491419,82,10,1, merged,0,0,0
62173,1000004,2,4944,4349,595,0.879652,0.120348,1.776717,473,122,4945,4350,595,0.879676,0.120324,1.776438,473,122,1, merged,0,0,0
62173,1000015,1,2623,2353,270,0.897064,0.102936,0.897064,248,22,2625,2354,271,0.896762,0.103238,0.896762,249,22,1, merged,1,1,0
62176,1000105,1,885,710,175,0.80226,0.19774,0.80226,149,26,887,711,176,0.801578,0.198422,0.801578,150,26,1, merged,1,1,0
62176,1000132,2,905,752,153,0.830939,0.169061,1.633199,128,25,906,753,153,0.831126,0.168874,1.632704,128,25,1, merged,0,0,0
62182,1000009,2,2167,1804,363,0.832487,0.167513,1.529457,324,39,2169,1806,363,0.832642,0.167358,1.522642,324,39,-1, merged,0,0,0
62183,1000004,1,4945,4350,595,0.879676,0.120324,0.879676,473,122,4947,4352,595,0.879725,0.120275,0.879725,473,122,-1, merged,0,0,0
62183,1000130,2,870,735,135,0.844828,0.155172,1.724504,102,33,871,736,135,0.845006,0.154994,1.724731,102,33,1, merged,0,0,0
62189,1000004,2,4947,4352,595,0.879725,0.120275,1.732666,473,122,4948,4353,595,0.879749,0.120251,1.736892,473,122,1, merged,0,0,0
62192,1000108,1,575,493,82,0.857391,0.142609,0.857391,76,6,577,494,83,0.856153,0.143847,0.856153,77,6,1, merged,1,1,0
62197,1000054,3,1329,1128,201,0.848758,0.151242,2.329421,184,17,1330,1129,201,0.848872,0.151128,2.332924,184,17,1, merged,0,0,0
62199,1000009,2,2169,1806,363,0.832642,0.167358,1.483805,324,39,2171,1808,363,0.832796,0.167204,1.491887,324,39,1, merged,0,0,0
62201,1000108,2,577,494,83,0.856153,0.143847,1.695032,77,6,578,495,83,0.856401,0.143599,1.692353,77,6,1, merged,0,0,0
62201,1000140,1,571,479,92,0.838879,0.161121,0.838879,82,10,573,479,94,0.835951,0.164049,0.835951,82,12,-1, merged,1,1,0
62203,1000132,1,907,754,153,0.831312,0.168688,0.831312,128,25,908,755,153,0.831498,0.168502,0.831498,128,25,1, merged,0,0,0
62207,1000130,5,871,736,135,0.845006,0.154994,2.780907,102,33,873,737,136,0.844215,0.155785,2.774018,103,33,1, merged,1,1,0
62207,1000328,4,1116,831,285,0.744624,0.255376,1.935901,254,31,1119,833,286,0.744415,0.255585,1.929803,255,31,-1, merged,1,0,0
62210,1000054,2,1331,1130,201,0.848986,0.151014,1.532319,184,17,1332,1131,201,0.849099,0.150901,1.53505,184,17,1, merged,0,0,0
62216,1000023,2,1988,1742,246,0.876258,0.123742,1.735774,217,29,1989,1743,246,0.87632,0.12368,1.736048,217,29,1, merged,0,0,0
62226,1000004,1,4948,4353,595,0.879749,0.120251,0.879749,473,122,4949,4353,596,0.879572,0.120428,0.879572,474,122,1, abandoned,1,1,0
62226,1000130,2,873,737,136,0.844215,0.155785,1.723965,103,33,874,737,137,0.843249,0.156751,1.722821,104,33,1, abandoned,1,1,0
62231,1000130,1,874,737,137,0.843249,0.156751,0.843249,104,33,875,738,137,0.843429,0.156571,0.843429,104,33,1, merged,0,0,0
62231,1000166,2,630,477,153,0.757143,0.242857,1.600392,147,6,631,478,153,0.757528,0.242472,1.600956,147,6,1, merged,0,0,0
62242,1000108,1,578,495,83,0.856401,0.143599,0.856401,77,6,579,496,83,0.856649,0.143351,0.856649,77,6,1, merged,0,0,0
62243,1000108,1,579,496,83,0.856649,0.143351,0.856649,77,6,581,496,85,0.853701,0.146299,0.853701,79,6,1, merged,1,1,0
62243,1000140,3,573,479,94,0.835951,0.164049,2.498754,82,12,574,480,94,0.836237,0.163763,2.494219,82,12,1, merged,0,0,0
62244,1000004,2,4950,4354,596,0.879596,0.120404,1.738263,474,122,4951,4355,596,0.87962,0.12038,1.739037,474,122,1, merged,0,0,0
62247,1000108,1,581,496,85,0.853701,0.146299,0.853701,79,6,582,497,85,0.853952,0.146048,0.853952,79,6,1, merged,0,0,0
62247,1000329,2,3931,3069,862,0.780717,0.219283,1.634418,736,126,3932,3070,862,0.780773,0.219227,1.634725,736,126,1, merged,0,0,0
62249,1000003,2,1594,1322,272,0.82936,0.17064,1.703547,231,41,1595,1323,272,0.829467,0.170533,1.703926,231,41,1, merged,0,0,0
62251,1000023,2,1999,1752,247,0.876438,0.123562,1.72779,218,29,2000,1753,247,0.8765,0.1235,1.728185,218,29,1, merged,0,0,0
62265,1000004,2,4951,4355,596,0.87962,0.12038,1.734072,474,122,4953,4356,597,0.879467,0.120533,1.734663,475,122,1, abandoned,1,1,0
62265,1000108,1,584,499,85,0.854452,0.145548,0.854452,79,6,587,502,85,0.855196,0.144804,0.855196,79,6,-1, abandoned,0,0,0
62266,1000023,2,2000,1753,247,0.8765,0.1235,1.739771,218,29,2001,1754,247,0.876562,0.123438,1.740198,218,29,1, merged,0,0,0
62269,1000003,2,1596,1324,272,0.829574,0.170426,1.646045,231,41,1597,1325,272,0.829681,0.170319,1.644669,231,41,-1, merged,0,0,0
62269,1000026,3,747,636,111,0.851406,0.148594,2.49745,108,3,748,637,111,0.851604,0.148396,2.496273,108,3,1, merged,0,0,0
62274,1000004,2,4953,4356,597,0.879467,0.120533,1.776229,475,122,4954,4357,597,0.879491,0.120509,1.776293,475,122,1, merged,0,0,0
62274,1000015,1,2625,2354,271,0.896762,0.103238,0.896762,249,22,2626,2355,271,0.896801,0.103199,0.896801,249,22,1, merged,0,0,0
62280,1000328,2,1119,833,286,0.744415,0.255585,1.560063,255,31,1122,835,287,0.744207,0.255793,1.560053,256,31,-1, merged,1,0,0
62280,1002169,1,933,761,172,0.815648,0.184352,0.815648,121,51,934,762,172,0.815846,0.184154,0.815846,121,51,-1, merged,0,0,0
62303,1000329,1,3933,3071,862,0.780829,0.219171,0.780829,736,126,3934,3072,862,0.780885,0.219115,0.780885,736,126,1, merged,0,0,0
62304,1000004,1,4954,4357,597,0.879491,0.120509,0.879491,475,122,4958,4359,599,0.879185,0.120815,0.879185,477,122,1, abandoned,1,1,0
62309,1000329,2,3934,3072,862,0.780885,0.219115,1.63257,736,126,3935,3073,862,0.78094,0.21906,1.632958,736,126,1, merged,0,0,0
62311,1000054,2,1335,1133,202,0.848689,0.151311,1.686328,185,17,1336,1134,202,0.848802,0.151198,1.687038,185,17,1, merged,0,0,0
62318,1000003,3,1597,1325,272,0.829681,0.170319,2.349082,231,41,1598,1326,272,0.829787,0.170213,2.342182,231,41,1, merged,0,0,0
62318,1000329,2,3935,3073,862,0.78094,0.21906,1.519402,736,126,3937,3075,862,0.781052,0.218948,1.512395,736,126,-1, merged,0,0,0
62345,1000592,2,923,787,136,0.852654,0.147346,1.670301,86,50,924,788,136,0.852814,0.147186,1.672581,86,50,1, merged,0,0,0
62353,1000108,1,594,508,86,0.855219,0.144781,0.855219,80,6,600,513,87,0.855,0.145,0.855,81,6,-1, merged,1,0,0
62355,1000110,2,798,718,80,0.899749,0.100251,1.759908,74,6,799,719,80,0.899875,0.100125,1.75777,74,6,1, merged,0,0,0
62356,1000140,2,576,482,94,0.836806,0.163194,1.664583,82,12,577,483,94,0.837088,0.162912,1.665343,82,12,1, merged,0,0,0
62368,1000005,2,987,861,126,0.87234,0.12766,1.707982,116,10,988,862,126,0.87247,0.12753,1.708171,116,10,1, merged,0,0,0
62368,1000121,1,2744,2293,451,0.835641,0.164359,0.835641,416,35,2745,2294,451,0.835701,0.164299,0.835701,416,35,1, merged,0,0,0
62370,1000003,2,1598,1326,272,0.829787,0.170213,1.67859,231,41,1600,1327,273,0.829375,0.170625,1.677022,232,41,-1, merged,1,0,0
62370,1000054,1,1336,1134,202,0.848802,0.151198,0.848802,185,17,1339,1135,204,0.847647,0.152353,0.847647,187,17,1, merged,1,1,0
62372,1000105,2,887,711,176,0.801578,0.198422,1.582432,150,26,888,712,176,0.801802,0.198198,1.582711,150,26,1, merged,0,0,0
62372,1000329,1,3938,3075,863,0.780853,0.219147,0.780853,737,126,3939,3076,863,0.780909,0.219091,0.780909,737,126,1, merged,0,0,0
62387,1000009,2,2179,1816,363,0.83341,0.16659,1.602641,324,39,2180,1817,363,0.833486,0.166514,1.603023,324,39,1, merged,0,0,0
62387,1000534,1,754,580,174,0.769231,0.230769,0.769231,156,18,755,581,174,0.769536,0.230464,0.769536,156,18,-1, merged,0,0,0
62391,1000327,1,750,594,156,0.792,0.208,0.792,120,36,751,595,156,0.792277,0.207723,0.792277,120,36,1, merged,0,0,0
62392,1000015,1,2632,2361,271,0.897036,0.102964,0.897036,249,22,2633,2362,271,0.897076,0.102924,0.897076,249,22,1, merged,0,0,0
62401,1000004,1,4960,4360,600,0.879032,0.120968,0.879032,478,122,4961,4361,600,0.879057,0.120943,0.879057,478,122,1, merged,0,0,0
62401,1000328,2,1123,836,287,0.744435,0.255565,1.623467,256,31,1124,837,287,0.744662,0.255338,1.623719,256,31,1, merged,0,0,0
62406,1000329,2,3939,3076,863,0.780909,0.219091,1.596755,737,126,3940,3077,863,0.780964,0.219036,1.597007,737,126,1, merged,0,0,0
62406,1002169,1,934,762,172,0.815846,0.184154,0.815846,121,51,935,763,172,0.816043,0.183957,0.816043,121,51,-1, merged,0,0,0
62408,1000004,3,4964,4363,601,0.878928,0.121072,1.759249,479,122,4966,4365,601,0.878977,0.121023,1.759398,479,122,-1, merged,0,0,0
62408,1000120,1,2373,2089,284,0.88032,0.11968,0.88032,248,36,2375,2091,284,0.880421,0.119579,0.880421,248,36,-1, merged,0,0,0
62411,1000015,2,2633,2362,271,0.897076,0.102924,1.54152,249,22,2635,2363,272,0.896774,0.103226,1.535072,250,22,1, merged,1,1,0
62415,1000130,2,878,741,137,0.843964,0.156036,1.389418,104,33,879,742,137,0.844141,0.155859,1.427474,104,33,1, merged,0,0,0
62418,1000140,2,578,484,94,0.83737,0.16263,1.529678,82,12,579,485,94,0.837651,0.162349,1.551937,82,12,1, merged,0,0,0
62423,1000026,3,748,637,111,0.851604,0.148396,2.655187,108,3,749,637,112,0.850467,0.149533,2.654341,109,3,1, merged,1,1,0
62423,1000153,2,1485,1330,155,0.895623,0.104377,1.803583,120,35,1489,1333,156,0.895232,0.104768,1.803874,121,35,-1, merged,1,0,0
62431,1000054,2,1340,1136,204,0.847761,0.152239,1.663804,187,17,1341,1137,204,0.847875,0.152125,1.663243,187,17,1, merged,0,0,0
62431,1002169,1,935,763,172,0.816043,0.183957,0.816043,121,51,937,764,173,0.815368,0.184632,0.815368,121,52,-1, merged,1,0,0
62432,1000004,1,4966,4365,601,0.878977,0.121023,0.878977,479,122,4970,4367,603,0.878672,0.121328,0.878672,481,122,-1, merged,1,0,0
62432,1000009,2,2181,1818,363,0.833563,0.166437,1.71254,324,39,2183,1819,364,0.833257,0.166743,1.711929,325,39,1, merged,1,1,0
62434,1000004,2,4970,4367,603,0.878672,0.121328,1.755419,481,122,4971,4368,603,0.878696,0.121304,1.755504,481,122,1, merged,0,0,0
62434,1000023,1,2004,1757,247,0.876747,0.123253,0.876747,218,29,2005,1758,247,0.876808,0.123192,0.876808,218,29,1, merged,0,0,0
62439,1000054,1,1341,1137,204,0.847875,0.152125,0.847875,187,17,1342,1138,204,0.847988,0.152012,0.847988,187,17,1, merged,0,0,0
62444,1000004,2,4971,4368,603,0.878696,0.121304,1.775471,481,122,4972,4369,603,0.878721,0.121279,1.775534,481,122,1, merged,0,0,0
62444,1000015,1,2635,2363,272,0.896774,0.103226,0.896774,250,22,2636,2364,272,0.896813,0.103187,0.896813,250,22,1, merged,0,0,0
62447,1000003,2,1600,1327,273,0.829375,0.170625,1.679842,232,41,1601,1327,274,0.828857,0.171143,1.67819,233,41,1, merged,1,1,0
62447,1000015,3,2636,2364,272,0.896813,0.103187,2.576656,250,22,2637,2365,272,0.896852,0.103148,2.575043,250,22,-1, merged,0,0,0
62447,1000026,1,749,637,112,0.850467,0.149533,0.850467,109,3,750,637,113,0.849333,0.150667,0.849333,110,3,1, merged,1,1,0
62447,1000109,5,779,675,104,0.866496,0.133504,4.304916,98,6,780,675,105,0.865385,0.134615,4.302597,99,6,1, merged,1,1,0
62447,1000199,4,680,586,94,0.861765,0.138235,3.43842,83,11,682,588,94,0.86217,0.13783,3.437213,83,11,-1, merged,0,0,0
62449,1000004,2,4972,4369,603,0.878721,0.121279,1.775573,481,122,4973,4370,603,0.878745,0.121255,1.775637,481,122,1, merged,0,0,0
62449,1000015,1,2637,2365,272,0.896852,0.103148,0.896852,250,22,2638,2366,272,0.896892,0.103108,0.896892,250,22,1, merged,0,0,0
62457,1000003,3,1601,1327,274,0.828857,0.171143,2.469134,233,41,1602,1328,274,0.828964,0.171036,2.470097,233,41,1, merged,0,0,0
62457,1000199,2,682,588,94,0.86217,0.13783,1.640277,83,11,683,589,94,0.862372,0.137628,1.641133,83,11,-1, merged,0,0,0
62458,1000003,2,1602,1328,274,0.828964,0.171036,1.691336,233,41,1604,1330,274,0.829177,0.170823,1.69175,233,41,1, merged,0,0,0
62458,1000199,1,683,589,94,0.862372,0.137628,0.862372,83,11,684,590,94,0.862573,0.137427,0.862573,83,11,-1, merged,0,0,0
62459,1000121,1,2746,2295,451,0.835761,0.164239,0.835761,416,35,2748,2297,451,0.835881,0.164119,0.835881,416,35,-1, merged,0,0,0
62462,1000592,1,925,789,136,0.852973,0.147027,0.852973,86,50,926,790,136,0.853132,0.146868,0.853132,86,50,1, merged,0,0,0
62468,1000140,1,580,486,94,0.837931,0.162069,0.837931,82,12,581,486,95,0.836489,0.163511,0.836489,83,12,1, merged,1,1,0
62468,1000592,3,926,790,136,0.853132,0.146868,2.362424,86,50,928,791,137,0.852371,0.147629,2.357084,87,50,1, merged,1,1,0
62472,1000009,1,2185,1821,364,0.83341,0.16659,0.83341,325,39,2187,1823,364,0.833562,0.166438,0.833562,325,39,-1, merged,0,0,0
62476,1000012,2,892,765,127,0.857623,0.142377,1.718181,123,4,893,766,127,0.857783,0.142217,1.717467,123,4,1, merged,0,0,0
62482,1000130,2,879,742,137,0.844141,0.155859,1.576679,104,33,880,742,138,0.843182,0.156818,1.574474,105,33,1, merged,1,1,0
62483,1000004,1,4973,4370,603,0.878745,0.121255,0.878745,481,122,4974,4371,603,0.87877,0.12123,0.87877,481,122,1, merged,0,0,0
62483,1000329,2,3940,3077,863,0.780964,0.219036,1.65971,737,126,3941,3078,863,0.78102,0.21898,1.65979,737,126,1, merged,0,0,0
62484,1000328,1,1124,837,287,0.744662,0.255338,0.744662,256,31,1125,838,287,0.744889,0.255111,0.744889,256,31,1, merged,0,0,0
62484,1000329,2,3941,3078,863,0.78102,0.21898,1.525682,737,126,3942,3079,863,0.781076,0.218924,1.525964,737,126,1, merged,0,0,0
62490,1002169,3,937,764,173,0.815368,0.184632,2.14219,121,52,938,765,173,0.815565,0.184435,2.097717,121,52,-1, merged,0,0,0
62495,1000004,3,4974,4371,603,0.87877,0.12123,2.537516,481,122,4978,4374,604,0.878666,0.121334,2.538773,482,122,-1, merged,1,0,0
62495,1000130,2,880,742,138,0.843182,0.156818,1.658747,105,33,882,743,139,0.842404,0.157596,1.660106,106,33,-1, merged,1,0,0
62495,1002169,1,938,765,173,0.815565,0.184435,0.815565,121,52,949,776,173,0.817703,0.182297,0.817703,121,52,-1, merged,0,0,0
62496,1000004,3,4978,4374,604,0.878666,0.121334,2.427661,482,122,4979,4375,604,0.878691,0.121309,2.42898,482,122,1, merged,0,0,0
62496,1002169,1,949,776,173,0.817703,0.182297,0.817703,121,52,951,778,173,0.818086,0.181914,0.818086,121,52,-1, merged,0,0,0
62510,1000026,2,750,637,113,0.849333,0.150667,1.563619,110,3,751,637,114,0.848202,0.151798,1.514869,111,3,1, merged,1,1,0
62510,1000054,3,1342,1138,204,0.847988,0.152012,2.411607,187,17,1343,1139,204,0.848101,0.151899,2.36297,187,17,1, merged,0,0,0
62512,1000108,2,602,515,87,0.855482,0.144518,1.68599,81,6,603,516,87,0.855721,0.144279,1.686945,81,6,1, merged,0,0,0
62518,1000054,1,1343,1139,204,0.848101,0.151899,0.848101,187,17,1344,1139,205,0.84747,0.15253,0.84747,188,17,1, merged,1,1,0
62518,1000166,2,633,479,154,0.756714,0.243286,1.604815,147,7,635,481,154,0.75748,0.24252,1.604951,147,7,-1, merged,0,0,0
62526,1000329,2,3945,3082,863,0.781242,0.218758,1.599328,737,126,3948,3084,864,0.781155,0.218845,1.599432,738,126,-1, merged,1,0,0
62526,1002169,1,951,778,173,0.818086,0.181914,0.818086,121,52,952,779,173,0.818277,0.181723,0.818277,121,52,-1, merged,0,0,0
62528,1000009,3,2189,1825,364,0.833714,0.166286,2.241548,325,39,2190,1826,364,0.83379,0.16621,2.248142,325,39,1, merged,0,0,0
62528,1000534,1,755,581,174,0.769536,0.230464,0.769536,156,18,756,581,175,0.768519,0.231481,0.768519,157,18,1, merged,1,1,0
62538,1000003,1,1605,1331,274,0.829283,0.170717,0.829283,233,41,1607,1333,274,0.829496,0.170504,0.829496,233,41,-1, merged,0,0,0
62540,1000005,1,1002,876,126,0.874251,0.125749,0.874251,116,10,1004,877,127,0.873506,0.126494,0.873506,117,10,1, merged,1,1,0
62540,1000121,2,2750,2298,452,0.835636,0.164364,1.709888,417,35,2751,2299,452,0.835696,0.164304,1.709202,417,35,1, merged,0,0,0
62545,1000009,1,2190,1826,364,0.83379,0.16621,0.83379,325,39,2192,1827,365,0.833485,0.166515,0.833485,326,39,1, merged,1,1,0
62545,1000534,2,756,581,175,0.768519,0.231481,1.602308,157,18,757,582,175,0.768824,0.231176,1.60231,157,18,1, merged,0,0,0
62551,1000534,3,757,582,175,0.768824,0.231176,2.617346,157,18,758,582,176,0.76781,0.23219,2.614615,157,19,-1, merged,1,1,0
62552,1000009,1,2192,1827,365,0.833485,0.166515,0.833485,326,39,2193,1828,365,0.833561,0.166439,0.833561,326,39,1, merged,0,0,0
62552,1000534,2,758,582,176,0.76781,0.23219,1.601295,157,19,759,583,176,0.768116,0.231884,1.601677,157,19,1, merged,0,0,0
62560,1000009,2,2194,1829,365,0.833637,0.166363,1.652445,326,39,2196,1830,366,0.833333,0.166667,1.650267,327,39,1, merged,1,1,0
62565,1000003,1,1607,1333,274,0.829496,0.170504,0.829496,233,41,1608,1333,275,0.82898,0.17102,0.82898,234,41,1, merged,1,1,0
62565,1000199,3,684,590,94,0.862573,0.137427,2.471156,83,11,685,591,94,0.862774,0.137226,2.471166,83,11,1, merged,0,0,0
62566,1000015,2,2642,2370,272,0.897048,0.102952,1.729468,250,22,2643,2371,272,0.897087,0.102913,1.729691,250,22,1, merged,0,0,0
62566,1000132,1,913,760,153,0.832421,0.167579,0.832421,128,25,914,761,153,0.832604,0.167396,0.832604,128,25,1, merged,0,0,0
62578,1000166,1,636,482,154,0.757862,0.242138,0.757862,147,7,638,483,155,0.757053,0.242947,0.757053,148,7,1, merged,1,1,0
62591,1000015,2,2644,2372,272,0.897126,0.102874,1.777898,250,22,2645,2373,272,0.897164,0.102836,1.777987,250,22,1, merged,0,0,0
62591,1000120,1,2382,2098,284,0.880772,0.119228,0.880772,248,36,2383,2099,284,0.880822,0.119178,0.880822,248,36,1, merged,0,0,0
62594,1000120,2,2383,2099,284,0.880822,0.119178,1.661978,248,36,2384,2100,284,0.880872,0.119128,1.662083,248,36,1, merged,0,0,0
62594,1000329,1,3948,3084,864,0.781155,0.218845,0.781155,738,126,3949,3085,864,0.78121,0.21879,0.78121,738,126,1, merged,0,0,0
62598,1000329,1,3949,3085,864,0.78121,0.21879,0.78121,738,126,3950,3086,864,0.781266,0.218734,0.781266,738,126,1, merged,0,0,0
62599,1000105,2,888,712,176,0.801802,0.198198,1.570223,150,26,889,713,176,0.802025,0.197975,1.570794,150,26,1, merged,0,0,0
62609,1000005,1,1006,879,127,0.873757,0.126243,0.873757,117,10,1007,880,127,0.873883,0.126117,0.873883,117,10,1, merged,0,0,0
62609,1000023,2,2010,1763,247,0.877114,0.122886,1.750872,218,29,2011,1764,247,0.877176,0.122824,1.751058,218,29,1, merged,0,0,0
62615,1000054,3,1346,1141,205,0.847697,0.152303,2.423027,188,17,1347,1142,205,0.84781,0.15219,2.422662,188,17,1, merged,0,0,0
62615,1000166,2,638,483,155,0.757053,0.242947,1.575331,148,7,639,484,155,0.757433,0.242567,1.574852,148,7,1, merged,0,0,0
62615,1002169,1,952,779,173,0.818277,0.181723,0.818277,121,52,953,779,174,0.817419,0.182581,0.817419,121,53,-1, merged,1,1,0
62616,1000120,2,2388,2104,284,0.881072,0.118928,1.739658,248,36,2389,2105,284,0.881122,0.118878,1.740418,248,36,1, merged,0,0,0
62627,1000120,2,2389,2105,284,0.881122,0.118878,1.766472,248,36,2391,2107,284,0.881221,0.118779,1.762471,248,36,-1, merged,0,0,0
62630,1000009,1,2204,1838,366,0.833938,0.166062,0.833938,327,39,2205,1839,366,0.834014,0.165986,0.834014,327,39,1, merged,0,0,0
62630,1000121,2,2757,2305,452,0.836054,0.163946,1.669992,417,35,2758,2306,452,0.836113,0.163887,1.670127,417,35,1, merged,0,0,0
62633,1000004,1,4981,4377,604,0.878739,0.121261,0.878739,482,122,4982,4378,604,0.878764,0.121236,0.878764,482,122,1, merged,0,0,0
62633,1000007,2,2008,1615,393,0.804283,0.195717,1.683022,344,49,2009,1616,393,0.80438,0.19562,1.683144,344,49,1, merged,0,0,0
62634,1000004,2,4982,4378,604,0.878764,0.121236,1.683144,482,122,4983,4379,604,0.878788,0.121212,1.683265,482,122,1, merged,0,0,0
62634,1000007,1,2009,1616,393,0.80438,0.19562,0.80438,344,49,2010,1617,393,0.804478,0.195522,0.804478,344,49,1, merged,0,0,0
62636,1000130,2,882,743,139,0.842404,0.157596,1.694422,106,33,883,744,139,0.842582,0.157418,1.694931,106,33,1, merged,0,0,0
62637,1000105,1,889,713,176,0.802025,0.197975,0.802025,150,26,892,713,179,0.799327,0.200673,0.799327,150,29,-1, merged,1,1,0
62637,1000140,2,582,487,95,0.83677,0.16323,1.638795,83,12,583,488,95,0.83705,0.16295,1.636377,83,12,1, merged,0,0,0
62643,1000120,1,2392,2108,284,0.881271,0.118729,0.881271,248,36,2395,2109,286,0.880585,0.119415,0.880585,250,36,1, merged,1,1,0
62644,1000054,1,1347,1142,205,0.84781,0.15219,0.84781,188,17,1350,1144,206,0.847407,0.152593,0.847407,189,17,1, merged,1,1,0
62644,1000166,2,639,484,155,0.757433,0.242567,1.605243,148,7,640,485,155,0.757812,0.242188,1.60522,148,7,1, merged,0,0,0
62645,1000003,2,1608,1333,275,0.82898,0.17102,1.608716,234,41,1609,1333,276,0.828465,0.171535,1.607057,235,41,1, merged,1,1,0
62645,1000023,3,2012,1765,247,0.877237,0.122763,2.485952,218,29,2013,1766,247,0.877298,0.122702,2.484355,218,29,1, merged,0,0,0
62651,1000026,2,751,637,114,0.848202,0.151798,1.606015,111,3,752,638,114,0.848404,0.151596,1.606595,111,3,1, merged,0,0,0
62651,1000166,1,640,485,155,0.757812,0.242188,0.757812,148,7,641,486,155,0.75819,0.24181,0.75819,148,7,1, merged,0,0,0
62672,1000109,3,780,675,105,0.865385,0.134615,2.506751,99,6,781,676,105,0.865557,0.134443,2.507447,99,6,1, merged,0,0,0
62672,1000199,2,685,591,94,0.862774,0.137226,1.641366,83,11,686,592,94,0.862974,0.137026,1.64189,83,11,1, merged,0,0,0
62678,1000120,2,2395,2109,286,0.880585,0.119415,1.625473,250,36,2396,2110,286,0.880634,0.119366,1.62575,250,36,1, merged,0,0,0
62678,1000328,1,1125,838,287,0.744889,0.255111,0.744889,256,31,1126,839,287,0.745115,0.254885,0.745115,256,31,1, merged,0,0,0
62678,1000329,3,3951,3087,864,0.781321,0.218679,2.406795,738,126,3952,3088,864,0.781377,0.218623,2.407126,738,126,1, merged,0,0,0
62684,1000009,1,2205,1839,366,0.834014,0.165986,0.834014,327,39,2206,1839,367,0.833636,0.166364,0.833636,328,39,1, merged,1,1,0
62691,1000005,2,1010,883,127,0.874257,0.125743,1.710489,117,10,1011,884,127,0.874382,0.125618,1.710673,117,10,1, merged,0,0,0
62691,1000121,1,2760,2308,452,0.836232,0.163768,0.836232,417,35,2761,2309,452,0.836291,0.163709,0.836291,417,35,1, merged,0,0,0
62697,1000004,4,4985,4381,604,0.878837,0.121163,3.284838,482,122,4987,4383,604,0.878885,0.121115,3.285744,482,122,-1, merged,0,0,0
62697,1000007,2,2012,1618,394,0.804175,0.195825,1.572291,345,49,2013,1619,394,0.804272,0.195728,1.572998,345,49,-1, merged,0,0,0
62697,1000009,3,2207,1840,367,0.833711,0.166289,2.406002,328,39,2209,1842,367,0.833861,0.166139,2.406859,328,39,-1, merged,0,0,0
62697,1000014,5,3555,2862,693,0.805063,0.194937,4.089902,650,43,3556,2863,693,0.805118,0.194882,4.090862,650,43,1, merged,0,0,0
62697,1000534,1,759,583,176,0.768116,0.231884,0.768116,157,19,761,585,176,0.768725,0.231275,0.768725,157,19,-1, merged,0,0,0
62700,1000014,2,3556,2863,693,0.805118,0.194882,1.591325,650,43,3558,2864,694,0.804947,0.195053,1.588452,651,43,1, merged,1,1,0
62701,1000014,2,3558,2864,694,0.804947,0.195053,1.588452,651,43,3560,2866,694,0.805056,0.194944,1.585878,651,43,-1, merged,0,0,0
62713,1000166,2,643,488,155,0.758942,0.241058,1.618671,148,7,644,489,155,0.759317,0.240683,1.619257,148,7,1, merged,0,0,0
62723,1000004,1,4989,4385,604,0.878934,0.121066,0.878934,482,122,4992,4388,604,0.879006,0.120994,0.879006,482,122,-1, merged,0,0,0
62723,1000120,2,2398,2111,287,0.880317,0.119683,1.759251,251,36,2402,2114,288,0.8801,0.1199,1.759106,252,36,-1, merged,1,0,0
62725,1000004,1,4992,4388,604,0.879006,0.120994,0.879006,482,122,4994,4390,604,0.879055,0.120945,0.879055,482,122,-1, merged,0,0,0
62725,1000329,2,3952,3088,864,0.781377,0.218623,1.660383,738,126,3953,3089,864,0.781432,0.218568,1.660487,738,126,1, merged,0,0,0
62726,1000329,2,3953,3089,864,0.781432,0.218568,1.641372,738,126,3954,3090,864,0.781487,0.218513,1.641847,738,126,1, merged,0,0,0
62730,1000108,2,605,518,87,0.856198,0.143802,1.673617,81,6,606,518,88,0.854785,0.145215,1.672396,82,6,1, merged,1,1,0
62730,1002169,1,953,779,174,0.817419,0.182581,0.817419,121,53,954,780,174,0.81761,0.18239,0.81761,121,53,-1, merged,0,0,0
62732,1000121,1,2764,2312,452,0.836469,0.163531,0.836469,417,35,2765,2313,452,0.836528,0.163472,0.836528,417,35,1, merged,0,0,0
62733,1000121,1,2765,2313,452,0.836528,0.163472,0.836528,417,35,2766,2313,453,0.836226,0.163774,0.836226,418,35,1, merged,1,1,0
62733,1000132,2,915,762,153,0.832787,0.167213,1.669315,128,25,917,764,153,0.833152,0.166848,1.669377,128,25,-1, merged,0,0,0
62736,1000004,1,4994,4390,604,0.879055,0.120945,0.879055,482,122,4995,4391,604,0.879079,0.120921,0.879079,482,122,-1, merged,0,0,0
62736,1000120,3,2402,2114,288,0.8801,0.1199,2.425821,252,36,2403,2115,288,0.88015,0.11985,2.427198,252,36,1, merged,0,0,0
62737,1000121,2,2766,2313,453,0.836226,0.163774,1.617713,418,35,2767,2314,453,0.836285,0.163715,1.617827,418,35,1, merged,0,0,0
62737,1000329,1,3954,3090,864,0.781487,0.218513,0.781487,738,126,3955,3091,864,0.781542,0.218458,0.781542,738,126,1, merged,0,0,0
62740,1000108,1,606,518,88,0.854785,0.145215,0.854785,82,6,607,519,88,0.855025,0.144975,0.855025,82,6,-1, merged,0,0,0
62742,1000004,2,4995,4391,604,0.879079,0.120921,1.759229,482,122,4998,4394,604,0.879152,0.120848,1.758935,482,122,-1, merged,0,0,0
62742,1000120,1,2403,2115,288,0.88015,0.11985,0.88015,252,36,2404,2115,289,0.879784,0.120216,0.879784,253,36,1, merged,1,1,0
62744,1000004,2,4998,4394,604,0.879152,0.120848,1.712303,482,122,5000,4396,604,0.8792,0.1208,1.711809,482,122,-1, merged,0,0,0
62744,1000132,1,917,764,153,0.833152,0.166848,0.833152,128,25,920,766,154,0.832609,0.167391,0.832609,129,25,1, merged,1,1,0
62745,1000004,2,5000,4396,604,0.8792,0.1208,1.711809,482,122,5002,4398,604,0.879248,0.120752,1.712401,482,122,-1, merged,0,0,0
62745,1000132,1,920,766,154,0.832609,0.167391,0.832609,129,25,923,769,154,0.833153,0.166847,0.833153,129,25,-1, merged,0,0,0
62746,1000004,2,5002,4398,604,0.879248,0.120752,1.712401,482,122,5004,4399,605,0.879097,0.120903,1.71063,483,122,-1, merged,1,0,0
62746,1000132,1,923,769,154,0.833153,0.166847,0.833153,129,25,926,770,156,0.831533,0.168467,0.831533,131,25,1, merged,1,1,0
62749,1000009,1,2210,1843,367,0.833937,0.166063,0.833937,328,39,2211,1844,367,0.834012,0.165988,0.834012,328,39,1, merged,0,0,0
62749,1000534,2,761,585,176,0.768725,0.231275,1.602662,157,19,763,585,178,0.76671,0.23329,1.600722,157,21,-1, merged,1,1,0
62750,1000009,1,2211,1844,367,0.834012,0.165988,0.834012,328,39,2212,1845,367,0.834087,0.165913,0.834087,328,39,1, merged,0,0,0
62750,1000534,2,763,585,178,0.76671,0.23329,1.600722,157,21,765,585,180,0.764706,0.235294,1.598793,157,23,-1, merged,1,1,0
62759,1000054,1,1353,1146,207,0.847007,0.152993,0.847007,190,17,1355,1146,209,0.845756,0.154244,0.845756,192,17,1, merged,1,1,0
62759,1000110,4,802,722,80,0.900249,0.099751,3.373792,74,6,803,722,81,0.899128,0.100872,3.368941,75,6,1, merged,1,1,0
62759,1000140,2,584,489,95,0.837329,0.162671,1.684335,83,12,586,490,96,0.836177,0.163823,1.681934,84,12,1, merged,1,1,0
62760,1000110,4,803,722,81,0.899128,0.100872,3.22778,75,6,804,722,82,0.89801,0.10199,3.219149,76,6,1, merged,1,1,0
62760,1000140,3,586,490,96,0.836177,0.163823,2.328652,84,12,589,492,97,0.835314,0.164686,2.321139,85,12,1, merged,1,1,0
62761,1000130,2,887,746,141,0.841037,0.158963,1.693386,108,33,888,747,141,0.841216,0.158784,1.693895,108,33,1, merged,0,0,0
62763,1000009,2,2212,1845,367,0.834087,0.165913,1.731329,328,39,2213,1846,367,0.834162,0.165838,1.731443,328,39,1, merged,0,0,0
62763,1000015,1,2647,2375,272,0.897242,0.102758,0.897242,250,22,2648,2376,272,0.897281,0.102719,0.897281,250,22,1, merged,0,0,0
62764,1000023,2,2023,1776,247,0.877904,0.122096,1.771944,218,29,2025,1777,248,0.877531,0.122469,1.772956,219,29,1, merged,1,1,0
62767,1000007,2,2015,1621,394,0.804467,0.195533,1.638628,345,49,2017,1622,395,0.804165,0.195835,1.638476,346,49,1, merged,1,1,0
62767,1000009,1,2213,1846,367,0.834162,0.165838,0.834162,328,39,2215,1848,367,0.834312,0.165688,0.834312,328,39,-1, merged,0,0,0
62767,1000015,3,2648,2376,272,0.897281,0.102719,2.535909,250,22,2649,2377,272,0.89732,0.10268,2.535796,250,22,1, merged,0,0,0
62772,1000023,1,2025,1777,248,0.877531,0.122469,0.877531,219,29,2026,1777,249,0.877098,0.122902,0.877098,220,29,1, merged,1,1,0
62772,1000130,2,888,747,141,0.841216,0.158784,1.718747,108,33,890,748,142,0.840449,0.159551,1.717547,109,33,1, merged,1,1,0
62782,1000108,2,607,519,88,0.855025,0.144975,1.787609,82,6,608,520,88,0.855263,0.144737,1.777485,82,6,1, merged,0,0,0
62787,1000023,2,2031,1782,249,0.8774,0.1226,1.723157,220,29,2032,1782,250,0.876969,0.123031,1.722215,221,29,1, merged,1,1,0
62787,1000054,1,1355,1146,209,0.845756,0.154244,0.845756,192,17,1357,1147,210,0.845247,0.154753,0.845247,193,17,1, merged,1,1,0
62791,1000004,1,5005,4400,605,0.879121,0.120879,0.879121,483,122,5006,4401,605,0.879145,0.120855,0.879145,483,122,1, merged,0,0,0
62799,1000007,1,2017,1622,395,0.804165,0.195835,0.804165,346,49,2018,1623,395,0.804262,0.195738,0.804262,346,49,1, merged,0,0,0
62799,1000015,2,2649,2377,272,0.89732,0.10268,1.701484,250,22,2650,2378,272,0.897358,0.102642,1.70162,250,22,1, merged,0,0,0
62801,1000009,1,2221,1853,368,0.834309,0.165691,0.834309,329,39,2222,1854,368,0.834383,0.165617,0.834383,329,39,1, merged,0,0,0
62804,1000004,1,5007,4402,605,0.879169,0.120831,0.879169,483,122,5008,4403,605,0.879193,0.120807,0.879193,483,122,1, merged,0,0,0
62804,1000007,2,2019,1624,395,0.804359,0.195641,1.683528,346,49,2020,1625,395,0.804455,0.195545,1.683649,346,49,1, merged,0,0,0
62820,1000009,2,2224,1856,368,0.834532,0.165468,1.524532,329,39,2225,1857,368,0.834607,0.165393,1.527676,329,39,-1, abandoned,0,0,0
62821,1000009,1,2225,1857,368,0.834607,0.165393,0.834607,329,39,2226,1858,368,0.834681,0.165319,0.834681,329,39,1, merged,0,0,0
62825,1000026,2,753,639,114,0.848606,0.151394,1.627522,111,3,754,640,114,0.848806,0.151194,1.62933,111,3,1, merged,0,0,0
62825,1000109,3,782,677,105,0.865729,0.134271,2.493251,99,6,783,678,105,0.8659,0.1341,2.49523,99,6,1, merged,0,0,0
62826,1000007,2,2020,1625,395,0.804455,0.195545,1.546197,346,49,2022,1626,396,0.804154,0.195846,1.54225,347,49,1, merged,1,1,0
62830,1000009,2,2226,1858,368,0.834681,0.165319,1.834681,329,39,2227,1859,368,0.834755,0.165245,1.834755,329,39,1, merged,0,0,0
62836,1000015,2,2652,2380,272,0.897436,0.102564,1.567203,250,22,2653,2381,272,0.897475,0.102525,1.568771,250,22,1, merged,0,0,0
62840,1000108,2,608,520,88,0.855263,0.144737,1.661233,82,6,609,521,88,0.855501,0.144499,1.662048,82,6,1, merged,0,0,0
62844,1000007,2,2022,1626,396,0.804154,0.195846,1.683988,347,49,2023,1627,396,0.804251,0.195749,1.684135,347,49,1, merged,0,0,0
62844,1000120,1,2405,2116,289,0.879834,0.120166,0.879834,253,36,2406,2117,289,0.879884,0.120116,0.879884,253,36,1, merged,0,0,0
62850,1000121,2,2772,2317,455,0.835859,0.164141,1.653469,419,36,2773,2318,455,0.835918,0.164082,1.653719,419,36,1, merged,0,0,0
62850,1002169,1,954,780,174,0.81761,0.18239,0.81761,121,53,955,781,174,0.817801,0.182199,0.817801,121,53,-1, merged,0,0,0
62852,1000121,3,2773,2318,455,0.835918,0.164082,2.167578,419,36,2774,2319,455,0.835977,0.164023,2.17882,419,36,1, merged,0,0,0
62872,1000121,2,2774,2319,455,0.835977,0.164023,1.75703,419,36,2775,2320,455,0.836036,0.163964,1.761036,419,36,1, merged,0,0,0
62875,1000004,3,5012,4407,605,0.87929,0.12071,2.545897,483,122,5015,4410,605,0.879362,0.120638,2.544562,483,122,-1, merged,0,0,0
62875,1000026,2,754,640,114,0.848806,0.151194,1.666607,111,3,755,640,115,0.847682,0.152318,1.6652,112,3,1, merged,1,1,0
62875,1002169,1,955,781,174,0.817801,0.182199,0.817801,121,53,959,784,175,0.817518,0.182482,0.817518,121,54,-1, merged,1,0,0
62877,1000023,1,2050,1800,250,0.878049,0.121951,0.878049,221,29,2051,1801,250,0.878108,0.121892,0.878108,221,29,1, merged,0,0,0
62885,1000023,2,2051,1801,250,0.878108,0.121892,1.729219,221,29,2052,1802,250,0.878168,0.121832,1.729609,221,29,1, merged,0,0,0
62893,1000534,3,766,586,180,0.765013,0.234987,2.492136,157,23,768,588,180,0.765625,0.234375,2.487123,157,23,-1, merged,0,0,0
62895,1000109,2,783,678,105,0.8659,0.1341,1.646424,99,6,784,679,105,0.866071,0.133929,1.6461,99,6,1, merged,0,0,0
62896,1000130,2,896,754,142,0.841518,0.158482,1.659036,109,33,897,754,143,0.84058,0.15942,1.657246,109,34,-1, merged,1,1,0
62896,1002169,1,959,784,175,0.817518,0.182482,0.817518,121,54,960,784,176,0.816667,0.183333,0.816667,121,55,-1, merged,1,1,0
62897,1000004,1,5017,4412,605,0.87941,0.12059,0.87941,483,122,5018,4413,605,0.879434,0.120566,0.879434,483,122,1, merged,0,0,0
62897,1000329,2,3955,3091,864,0.781542,0.218458,1.660952,738,126,3956,3092,864,0.781598,0.218402,1.661032,738,126,1, merged,0,0,0
62904,1000121,2,2780,2325,455,0.836331,0.163669,1.73863,419,36,2781,2326,455,0.83639,0.16361,1.738875,419,36,1, merged,0,0,0
62917,1000054,1,1358,1148,210,0.845361,0.154639,0.845361,193,17,1359,1149,210,0.845475,0.154525,0.845475,193,17,1, merged,0,0,0
62918,1000130,1,897,754,143,0.84058,0.15942,0.84058,109,34,898,755,143,0.840757,0.159243,0.840757,109,34,1, merged,0,0,0
62923,1000004,1,5018,4413,605,0.879434,0.120566,0.879434,483,122,5019,4414,605,0.879458,0.120542,0.879458,483,122,1, merged,0,0,0
62923,1000015,2,2654,2382,272,0.897513,0.102487,1.776947,250,22,2655,2383,272,0.897552,0.102448,1.77701,250,22,1, merged,0,0,0
62926,1000004,1,5019,4414,605,0.879458,0.120542,0.879458,483,122,5020,4415,605,0.879482,0.120518,0.879482,483,122,1, merged,0,0,0
62926,1000015,2,2655,2383,272,0.897552,0.102448,1.77701,250,22,2656,2384,272,0.89759,0.10241,1.777072,250,22,1, merged,0,0,0
62932,1000108,1,610,522,88,0.855738,0.144262,0.855738,82,6,611,522,89,0.854337,0.145663,0.854337,83,6,1, merged,1,1,0
62932,1000140,2,591,494,97,0.835871,0.164129,1.691609,85,12,592,495,97,0.836149,0.163851,1.690486,85,12,1, merged,0,0,0
62933,1000009,1,2228,1860,368,0.834829,0.165171,0.834829,329,39,2229,1861,368,0.834904,0.165096,0.834904,329,39,1, merged,0,0,0
62937,1000108,4,611,522,89,0.854337,0.145663,2.170824,83,6,613,523,90,0.853181,0.146819,2.146746,84,6,1, abandoned,1,1,0
62944,1000534,1,768,588,180,0.765625,0.234375,0.765625,157,23,776,594,182,0.765464,0.234536,0.765464,159,23,-1, merged,1,0,0
62953,1000015,1,2658,2385,273,0.897291,0.102709,0.897291,250,23,2659,2386,273,0.89733,0.10267,0.89733,250,23,1, merged,0,0,0
62955,1000004,1,5023,4418,605,0.879554,0.120446,0.879554,483,122,5025,4419,606,0.879403,0.120597,0.879403,484,122,1, merged,1,1,0
62956,1000534,1,776,594,182,0.765464,0.234536,0.765464,159,23,780,595,185,0.762821,0.237179,0.762821,162,23,1, merged,1,1,0
62957,1000023,2,2052,1802,250,0.878168,0.121832,1.758251,221,29,2053,1803,250,0.878227,0.121773,1.757945,221,29,1, merged,0,0,0
62957,1000120,1,2410,2121,289,0.880083,0.119917,0.880083,253,36,2411,2121,290,0.879718,0.120282,0.879718,254,36,1, merged,1,1,0
62958,1000023,2,2053,1803,250,0.878227,0.121773,1.757945,221,29,2055,1804,251,0.877859,0.122141,1.757262,222,29,1, merged,1,1,0
62958,1000120,1,2411,2121,290,0.879718,0.120282,0.879718,254,36,2413,2122,291,0.879403,0.120597,0.879403,255,36,-1, merged,1,0,0
62971,1000140,2,592,495,97,0.836149,0.163851,1.640882,85,12,593,496,97,0.836425,0.163575,1.641735,85,12,-1, merged,0,0,0
62974,1000004,2,5025,4419,606,0.879403,0.120597,1.745474,484,122,5026,4420,606,0.879427,0.120573,1.744395,484,122,1, merged,0,0,0
62974,1000109,1,784,679,105,0.866071,0.133929,0.866071,99,6,785,679,106,0.864968,0.135032,0.864968,100,6,1, merged,1,1,0
62984,1000110,2,805,723,82,0.898137,0.101863,1.658873,76,6,806,724,82,0.898263,0.101737,1.656673,76,6,-1, abandoned,0,0,0
62984,1000166,1,652,496,156,0.760736,0.239264,0.760736,149,7,654,496,158,0.75841,0.24159,0.75841,151,7,1, abandoned,1,1,0
62988,1000026,1,755,640,115,0.847682,0.152318,0.847682,112,3,757,642,115,0.848085,0.151915,0.848085,112,3,-1, merged,0,0,0
62989,1000015,2,2659,2386,273,0.89733,0.10267,1.745414,250,23,2660,2386,274,0.896992,0.103008,1.745477,251,23,1, merged,1,1,0
62989,1000026,1,757,642,115,0.848085,0.151915,0.848085,112,3,759,644,115,0.848485,0.151515,0.848485,112,3,-1, merged,0,0,0
62993,1000011,1,1042,955,87,0.916507,0.083493,0.916507,82,5,1043,956,87,0.916587,0.083413,0.916587,82,5,1, merged,0,0,0
62994,1000009,2,2233,1865,368,0.835199,0.164801,1.751786,329,39,2234,1866,368,0.835273,0.164727,1.752019,329,39,1, merged,0,0,0
62994,1000011,1,1043,956,87,0.916587,0.083413,0.916587,82,5,1045,958,87,0.916746,0.083254,0.916746,82,5,1, merged,0,0,0
62995,1000011,2,1045,958,87,0.916746,0.083254,1.916746,82,5,1046,959,87,0.916826,0.083174,1.916826,82,5,1, merged,0,0,0
63008,1000003,3,1609,1333,276,0.828465,0.171535,2.471785,235,41,1610,1334,276,0.828571,0.171429,2.472408,235,41,1, merged,0,0,0
63008,1000199,1,686,592,94,0.862974,0.137026,0.862974,83,11,687,593,94,0.863173,0.136827,0.863173,83,11,-1, merged,0,0,0
63013,1000140,2,597,500,97,0.837521,0.162479,1.65833,85,12,598,501,97,0.837793,0.162207,1.659632,85,12,1, merged,0,0,0
63021,1000009,2,2235,1867,368,0.835347,0.164653,1.462107,329,39,2236,1868,368,0.83542,0.16458,1.464791,329,39,1, merged,0,0,0
63026,1000014,2,3562,2868,694,0.805166,0.194834,0.805166,651,43,3564,2868,696,0.804714,0.195286,0.804714,653,43,1, abandoned,1,1,0
63034,1000026,4,759,644,115,0.848485,0.151515,2.644209,112,3,760,644,116,0.847368,0.152632,3.639074,113,3,1, abandoned,1,1,0
63034,1000153,3,1492,1335,157,0.894772,0.105228,1.795724,121,36,1493,1335,158,0.894173,0.105827,2.791706,122,36,1, abandoned,1,1,0
63056,1000054,2,1360,1150,210,0.845588,0.154412,1.683381,193,17,1361,1151,210,0.845702,0.154298,1.683765,193,17,1, merged,0,0,0
63056,1000140,1,598,501,97,0.837793,0.162207,0.837793,85,12,599,502,97,0.838063,0.161937,0.838063,85,12,1, merged,0,0,0
63061,1000007,1,2023,1627,396,0.804251,0.195749,0.804251,347,49,2024,1628,396,0.804348,0.195652,0.804348,347,49,1, merged,0,0,0
63061,1000015,2,2661,2387,274,0.897031,0.102969,1.701282,251,23,2662,2388,274,0.89707,0.10293,1.701418,251,23,1, merged,0,0,0
63076,1000003,2,1610,1334,276,0.828571,0.171429,1.501382,235,41,1611,1335,276,0.828678,0.171322,1.50299,235,41,1, merged,0,0,0
63076,1000015,4,2662,2388,274,0.89707,0.10293,3.263221,251,23,2663,2389,274,0.897109,0.102891,3.265347,251,23,1, merged,0,0,0
63083,1000140,1,599,502,97,0.838063,0.161937,0.838063,85,12,600,503,97,0.838333,0.161667,0.838333,85,12,1, merged,0,0,0
63084,1000140,1,600,503,97,0.838333,0.161667,0.838333,85,12,601,504,97,0.838602,0.161398,0.838602,85,12,1, merged,0,0,0
63088,1000005,2,1019,892,127,0.875368,0.124632,1.753097,117,10,1020,893,127,0.87549,0.12451,1.753279,117,10,1, merged,0,0,0
63088,1000023,1,2061,1809,252,0.877729,0.122271,0.877729,223,29,2062,1810,252,0.877789,0.122211,0.877789,223,29,1, merged,0,0,0
63091,1000007,2,2024,1628,396,0.804348,0.195652,1.701456,347,49,2025,1629,396,0.804444,0.195556,1.701592,347,49,1, merged,0,0,0
63091,1000015,1,2663,2389,274,0.897109,0.102891,0.897109,251,23,2664,2390,274,0.897147,0.102853,0.897147,251,23,1, merged,0,0,0
63094,1000005,2,1021,894,127,0.875612,0.124388,1.713228,117,10,1022,895,127,0.875734,0.124266,1.713408,117,10,1, merged,0,0,0
63094,1000121,1,2802,2347,455,0.837616,0.162384,0.837616,419,36,2803,2348,455,0.837674,0.162326,0.837674,419,36,-1, merged,0,0,0
63096,1000004,2,5029,4422,607,0.8793,0.1207,1.776447,485,122,5030,4423,607,0.879324,0.120676,1.77651,485,122,1, merged,0,0,0
63096,1000015,1,2664,2390,274,0.897147,0.102853,0.897147,251,23,2665,2391,274,0.897186,0.102814,0.897186,251,23,1, merged,0,0,0
63101,1000132,1,933,777,156,0.832797,0.167203,0.832797,131,25,936,780,156,0.833333,0.166667,0.833333,131,25,-1, merged,0,0,0
63108,1000121,2,2803,2348,455,0.837674,0.162326,1.613727,419,36,2804,2349,455,0.837732,0.162268,1.61428,419,36,1, merged,0,0,0
63115,1000003,2,1611,1335,276,0.828678,0.171322,1.693926,235,41,1612,1336,276,0.828784,0.171216,1.694509,235,41,1, merged,0,0,0
63116,1000015,1,2666,2392,274,0.897224,0.102776,0.897224,251,23,2667,2393,274,0.897263,0.102737,0.897263,251,23,1, merged,0,0,0
63123,1000023,1,2066,1814,252,0.878025,0.121975,0.878025,223,29,2067,1815,252,0.878084,0.121916,0.878084,223,29,1, merged,0,0,0
63144,1000023,1,2070,1818,252,0.878261,0.121739,0.878261,223,29,2071,1818,253,0.877837,0.122163,0.877837,224,29,1, abandoned,1,1,0
63145,1000023,2,2071,1818,253,0.877837,0.122163,1.699676,224,29,2072,1819,253,0.877896,0.122104,1.700753,224,29,1, merged,0,0,0
63146,1000003,1,1612,1336,276,0.828784,0.171216,0.828784,235,41,1613,1337,276,0.82889,0.17111,0.82889,235,41,1, merged,0,0,0
63147,1000003,1,1613,1337,276,0.82889,0.17111,0.82889,235,41,1615,1339,276,0.829102,0.170898,0.829102,235,41,1, merged,0,0,0
63150,1000003,2,1615,1339,276,0.829102,0.170898,1.676471,235,41,1616,1340,276,0.829208,0.170792,1.675866,235,41,1, merged,0,0,0
63150,1000007,3,2026,1630,396,0.804541,0.195459,2.481012,347,49,2027,1631,396,0.804637,0.195363,2.480503,347,49,1, merged,0,0,0
63150,1000026,1,760,644,116,0.847368,0.152632,0.847368,113,3,763,646,117,0.846658,0.153342,0.846658,114,3,1, merged,1,1,0
63151,1000130,2,899,756,143,0.840934,0.159066,1.586727,109,34,900,757,143,0.841111,0.158889,1.586469,109,34,-1, merged,0,0,0
63151,1000328,1,1129,842,287,0.745793,0.254207,0.745793,256,31,1131,843,288,0.745358,0.254642,0.745358,257,31,1, merged,1,1,0
63155,1000023,1,2072,1819,253,0.877896,0.122104,0.877896,224,29,2073,1820,253,0.877955,0.122045,0.877955,224,29,1, merged,0,0,0
63156,1000140,2,601,504,97,0.838602,0.161398,1.671049,85,12,602,505,97,0.83887,0.16113,1.669558,85,12,1, merged,0,0,0
63160,1000109,1,785,679,106,0.864968,0.135032,0.864968,100,6,786,680,106,0.86514,0.13486,0.86514,100,6,1, merged,0,0,0
63160,1000199,2,687,593,94,0.863173,0.136827,1.728141,83,11,688,594,94,0.863372,0.136628,1.728512,83,11,1, merged,0,0,0
63164,1000023,1,2073,1820,253,0.877955,0.122045,0.877955,224,29,2074,1821,253,0.878014,0.121986,0.878014,224,29,1, merged,0,0,0
63165,1000004,1,5030,4423,607,0.879324,0.120676,0.879324,485,122,5031,4424,607,0.879348,0.120652,0.879348,485,122,1, merged,0,0,0
63179,1000004,1,5032,4425,607,0.879372,0.120628,0.879372,485,122,5033,4426,607,0.879396,0.120604,0.879396,485,122,1, merged,0,0,0
63180,1000004,1,5033,4426,607,0.879396,0.120604,0.879396,485,122,5034,4427,607,0.87942,0.12058,0.87942,485,122,1, merged,0,0,0
63184,1000009,2,2237,1869,368,0.835494,0.164506,1.732795,329,39,2239,1870,369,0.835194,0.164806,1.732534,329,40,-1, merged,1,1,0
63184,1000015,1,2668,2394,274,0.897301,0.102699,0.897301,251,23,2669,2395,274,0.89734,0.10266,0.89734,251,23,-1, merged,0,0,0
63187,1000007,1,2030,1634,396,0.804926,0.195074,0.804926,347,49,2031,1635,396,0.805022,0.194978,0.805022,347,49,1, merged,0,0,0
63187,1000009,2,2239,1870,369,0.835194,0.164806,1.64012,329,40,2240,1871,369,0.835268,0.164732,1.64029,329,40,1, merged,0,0,0
63188,1000105,4,894,714,180,0.798658,0.201342,2.86425,151,29,895,715,180,0.798883,0.201117,2.851944,151,29,1, merged,0,0,0
63188,1000329,2,3960,3095,865,0.781566,0.218434,1.288059,739,126,3961,3095,866,0.781368,0.218632,1.275039,740,126,1, merged,1,1,0
63194,1000130,2,900,757,143,0.841111,0.158889,1.755174,109,34,901,757,144,0.840178,0.159822,1.74787,110,34,1, merged,1,1,0
63208,1000004,2,5035,4428,607,0.879444,0.120556,1.776822,485,122,5036,4429,607,0.879468,0.120532,1.776885,485,122,1, merged,0,0,0
63208,1000015,1,2670,2396,274,0.897378,0.102622,0.897378,251,23,2671,2397,274,0.897417,0.102583,0.897417,251,23,1, merged,0,0,0
63212,1000004,2,5036,4429,607,0.879468,0.120532,1.776885,485,122,5037,4430,607,0.879492,0.120508,1.776947,485,122,1, merged,0,0,0
63212,1000015,1,2671,2397,274,0.897417,0.102583,0.897417,251,23,2672,2398,274,0.897455,0.102545,0.897455,251,23,1, merged,0,0,0
63224,1000004,3,5037,4430,607,0.879492,0.120508,2.594557,485,122,5038,4431,607,0.879516,0.120484,2.594758,485,122,1, merged,0,0,0
63224,1000005,1,1030,903,127,0.876699,0.123301,0.876699,117,10,1031,904,127,0.876819,0.123181,0.876819,117,10,1, merged,0,0,0
63224,1000121,2,2815,2360,455,0.838366,0.161634,1.715065,419,36,2816,2361,455,0.838423,0.161577,1.715242,419,36,1, merged,0,0,0
63233,1000005,2,1031,904,127,0.876819,0.123181,1.715002,117,10,1034,907,127,0.877176,0.122824,1.714468,117,10,-1, merged,0,0,0
63233,1000121,1,2818,2362,456,0.838183,0.161817,0.838183,420,36,2821,2362,459,0.837292,0.162708,0.837292,423,36,1, merged,1,1,0
63235,1000004,2,5038,4431,607,0.879516,0.120484,1.759019,485,122,5039,4432,607,0.87954,0.12046,1.759093,485,122,1, merged,0,0,0
63235,1000120,1,2415,2124,291,0.879503,0.120497,0.879503,255,36,2416,2125,291,0.879553,0.120447,0.879553,255,36,1, merged,0,0,0
63240,1000003,1,1617,1341,276,0.829314,0.170686,0.829314,235,41,1618,1341,277,0.828801,0.171199,0.828801,236,41,1, merged,1,1,0
63243,1000130,1,902,758,144,0.840355,0.159645,0.840355,110,34,903,759,144,0.840532,0.159468,0.840532,110,34,1, merged,0,0,0
63244,1000054,1,1361,1151,210,0.845702,0.154298,0.845702,193,17,1362,1152,210,0.845815,0.154185,0.845815,193,17,1, merged,0,0,0
63244,1000121,2,2823,2364,459,0.837407,0.162593,1.683109,423,36,2824,2365,459,0.837465,0.162535,1.68328,423,36,1, merged,0,0,0
63246,1000004,1,5041,4434,607,0.879587,0.120413,0.879587,485,122,5043,4435,608,0.879437,0.120563,0.879437,486,122,-1, merged,1,0,0
63246,1000130,2,903,759,144,0.840532,0.159468,1.720119,110,34,905,760,145,0.839779,0.160221,1.719216,111,34,1, merged,1,1,0
63246,1000329,3,3962,3096,866,0.781424,0.218576,2.501542,740,126,3965,3098,867,0.781337,0.218663,2.500553,741,126,-1, merged,1,0,0
63246,1002169,4,960,784,176,0.816667,0.183333,3.318209,121,55,961,785,176,0.816857,0.183143,3.31741,121,55,-1, merged,0,0,0
63254,1000005,1,1037,910,127,0.877531,0.122469,0.877531,117,10,1039,911,128,0.876805,0.123195,0.876805,118,10,1, merged,1,1,0
63261,1000023,1,2081,1828,253,0.878424,0.121576,0.878424,224,29,2082,1829,253,0.878482,0.121518,0.878482,224,29,1, merged,0,0,0
63262,1000329,2,3965,3098,867,0.781337,0.218663,1.533862,741,126,3966,3099,867,0.781392,0.218608,1.53454,741,126,1, merged,0,0,0
63265,1000054,1,1362,1152,210,0.845815,0.154185,0.845815,193,17,1363,1152,211,0.845194,0.154806,0.845194,194,17,1, merged,1,1,0
63265,1000329,2,3966,3099,867,0.781392,0.218608,1.627207,741,126,3968,3101,867,0.781502,0.218498,1.626696,741,126,-1, merged,0,0,0
63275,1000004,2,5044,4436,608,0.879461,0.120539,1.776916,486,122,5045,4437,608,0.879485,0.120515,1.776978,486,122,1, merged,0,0,0
63275,1000015,1,2672,2398,274,0.897455,0.102545,0.897455,251,23,2673,2399,274,0.897493,0.102507,0.897493,251,23,1, merged,0,0,0
63276,1000004,1,5045,4437,608,0.879485,0.120515,0.879485,486,122,5046,4438,608,0.879509,0.120491,0.879509,486,122,1, merged,0,0,0
63276,1000011,2,1046,959,87,0.916826,0.083174,1.796311,82,5,1047,960,87,0.916905,0.083095,1.796414,82,5,1, merged,0,0,0
63278,1000043,1,711,588,123,0.827004,0.172996,0.827004,107,16,712,589,123,0.827247,0.172753,0.827247,107,16,1, merged,0,0,0
63285,1000004,2,5046,4438,608,0.879509,0.120491,1.684531,486,122,5047,4439,608,0.879532,0.120468,1.684651,486,122,1, merged,0,0,0
63285,1000007,1,2031,1635,396,0.805022,0.194978,0.805022,347,49,2032,1636,396,0.805118,0.194882,0.805118,347,49,1, merged,0,0,0
63293,1000130,2,905,760,145,0.839779,0.160221,1.646797,111,34,906,761,145,0.839956,0.160044,1.647536,111,34,-1, abandoned,0,0,0
63294,1000004,3,5047,4439,608,0.879532,0.120468,2.540922,486,122,5049,4441,608,0.87958,0.12042,2.531871,486,122,-1, merged,0,0,0
63294,1000132,1,943,784,159,0.831389,0.168611,0.831389,134,25,944,784,160,0.830508,0.169492,0.830508,135,25,1, merged,1,1,0
63307,1000130,2,906,761,145,0.839956,0.160044,1.744065,111,34,907,762,145,0.840132,0.159868,1.745538,111,34,1, merged,0,0,0
63312,1000004,1,5049,4441,608,0.87958,0.12042,0.87958,486,122,5050,4441,609,0.879406,0.120594,0.879406,486,123,-1, merged,1,1,0
63313,1000054,1,1364,1153,211,0.845308,0.154692,0.845308,194,17,1366,1155,211,0.845534,0.154466,0.845534,194,17,1, merged,0,0,0
63313,1000166,2,655,497,158,0.758779,0.241221,1.604087,151,7,656,498,158,0.759146,0.240854,1.604681,151,7,1, merged,0,0,0
63320,1000004,1,5050,4441,609,0.879406,0.120594,0.879406,486,123,5052,4443,609,0.879454,0.120546,0.879454,486,123,-1, merged,0,0,0
63320,1000015,3,2674,2400,274,0.897532,0.102468,2.685388,251,23,2675,2401,274,0.89757,0.10243,2.686115,251,23,1, merged,0,0,0
63322,1000007,1,2033,1637,396,0.805214,0.194786,0.805214,347,49,2034,1638,396,0.80531,0.19469,0.80531,347,49,1, merged,0,0,0
63322,1000009,2,2244,1875,369,0.835561,0.164439,1.640775,329,40,2245,1876,369,0.835635,0.164365,1.640944,329,40,1, merged,0,0,0
63324,1000007,1,2036,1640,396,0.805501,0.194499,0.805501,347,49,2037,1641,396,0.805596,0.194404,0.805596,347,49,1, merged,0,0,0
63324,1000534,2,780,595,185,0.762821,0.237179,1.568321,162,23,781,596,185,0.763124,0.236876,1.568721,162,23,1, merged,0,0,0
63328,1000007,2,2038,1642,396,0.805692,0.194308,1.703262,347,49,2039,1642,397,0.805297,0.194703,1.702235,348,49,1, merged,1,1,0
63328,1000015,1,2675,2401,274,0.89757,0.10243,0.89757,251,23,2678,2402,276,0.896938,0.103062,0.896938,253,23,1, merged,1,1,0
63329,1000004,1,5052,4443,609,0.879454,0.120546,0.879454,486,123,5053,4444,609,0.879478,0.120522,0.879478,486,123,1, merged,0,0,0
63329,1000592,2,930,793,137,0.852688,0.147312,1.732142,87,50,931,794,137,0.852846,0.147154,1.732324,87,50,1, merged,0,0,0
63330,1000199,3,690,596,94,0.863768,0.136232,2.508068,83,11,693,598,95,0.862915,0.137085,2.483895,84,11,-1, merged,1,0,0
63332,1000014,2,3566,2870,696,0.804823,0.195177,1.621681,653,43,3569,2873,696,0.804987,0.195013,1.621377,653,43,-1, merged,0,0,0
63332,1000054,4,1366,1155,211,0.845534,0.154466,3.304556,194,17,1367,1156,211,0.845647,0.154353,3.304127,194,17,1, merged,0,0,0
63332,1000121,3,2828,2368,460,0.837341,0.162659,2.459022,424,36,2830,2369,461,0.837102,0.162898,2.45848,425,36,1, merged,1,1,0
63332,1002169,1,961,785,176,0.816857,0.183143,0.816857,121,55,964,787,177,0.81639,0.18361,0.81639,121,56,-1, merged,1,0,0
63337,1000004,2,5053,4444,609,0.879478,0.120522,1.562017,486,123,5054,4445,609,0.879501,0.120499,1.556424,486,123,1, merged,0,0,0
63345,1000014,1,3569,2873,696,0.804987,0.195013,0.804987,653,43,3570,2873,697,0.804762,0.195238,0.804762,654,43,1, merged,1,1,0
63345,1000130,2,907,762,145,0.840132,0.159868,1.64512,111,34,909,763,146,0.839384,0.160616,1.644146,112,34,1, merged,1,1,0
63347,1000009,1,2245,1876,369,0.835635,0.164365,0.835635,329,40,2247,1878,369,0.835781,0.164219,0.835781,329,40,-1, merged,0,0,0
63348,1000004,2,5054,4445,609,0.879501,0.120499,1.718885,486,123,5058,4449,609,0.879597,0.120403,1.718058,486,123,-1, merged,0,0,0
63348,1000130,1,909,763,146,0.839384,0.160616,0.839384,112,34,910,763,147,0.838462,0.161538,0.838462,113,34,1, merged,1,1,0
63349,1000132,3,944,784,160,0.830508,0.169492,2.419989,135,25,945,785,160,0.830688,0.169312,2.428394,135,25,1, merged,0,0,0
63352,1000023,2,2084,1831,253,0.878599,0.121401,1.659849,224,29,2085,1832,253,0.878657,0.121343,1.666536,224,29,1, merged,0,0,0
63355,1000329,2,3968,3101,867,0.781502,0.218498,1.559524,741,126,3969,3102,867,0.781557,0.218443,1.560066,741,126,-1, abandoned,0,0,0
63360,1000130,2,910,763,147,0.838462,0.161538,1.359295,113,34,911,764,147,0.838639,0.161361,1.369251,113,34,1, merged,0,0,0
63361,1000023,1,2085,1832,253,0.878657,0.121343,0.878657,224,29,2086,1832,254,0.878236,0.121764,0.878236,225,29,1, abandoned,1,1,0
63362,1000121,4,2830,2369,461,0.837102,0.162898,3.184724,425,36,2831,2370,461,0.83716,0.16284,3.186496,425,36,1, merged,0,0,0
63362,1000328,3,1135,847,288,0.746256,0.253744,2.347621,257,31,1136,848,288,0.746479,0.253521,2.349336,257,31,1, merged,0,0,0
63363,1000023,3,2086,1832,254,0.878236,0.121764,2.409764,225,29,2088,1833,255,0.877874,0.122126,2.411757,226,29,1, merged,1,1,0
63366,1000023,1,2088,1833,255,0.877874,0.122126,0.877874,226,29,2089,1834,255,0.877932,0.122068,0.877932,226,29,1, merged,0,0,0
63366,1000592,2,931,794,137,0.852846,0.147154,1.73072,87,50,932,795,137,0.853004,0.146996,1.730936,87,50,1, merged,0,0,0
63372,1000121,1,2831,2370,461,0.83716,0.16284,0.83716,425,36,2833,2371,462,0.836922,0.163078,0.836922,426,36,1, merged,1,1,0
63375,1000003,2,1618,1341,277,0.828801,0.171199,1.609781,236,41,1619,1342,277,0.828907,0.171093,1.610202,236,41,1, merged,0,0,0
63376,1000109,2,786,680,106,0.86514,0.13486,1.646435,100,6,787,681,106,0.865311,0.134689,1.646921,100,6,1, merged,0,0,0
63383,1000004,3,5061,4452,609,0.879668,0.120332,2.621625,486,123,5062,4453,609,0.879692,0.120308,2.611687,486,123,1, merged,0,0,0
63383,1000023,1,2091,1834,257,0.877092,0.122908,0.877092,228,29,2093,1835,258,0.876732,0.123268,0.876732,229,29,1, merged,1,1,0
63387,1000140,1,605,506,99,0.836364,0.163636,0.836364,87,12,606,506,100,0.834983,0.165017,0.834983,88,12,1, abandoned,1,1,0
63388,1000140,2,606,506,100,0.834983,0.165017,1.661755,88,12,607,506,101,0.833608,0.166392,1.660833,89,12,1, abandoned,1,1,0
63389,1000054,2,1367,1156,211,0.845647,0.154353,1.730496,194,17,1368,1157,211,0.84576,0.15424,1.726,194,17,1, merged,0,0,0
63399,1000003,1,1619,1342,277,0.828907,0.171093,0.828907,236,41,1622,1343,279,0.82799,0.17201,0.82799,238,41,1, merged,1,1,0
63399,1000015,4,2679,2403,276,0.896976,0.103024,3.335968,253,23,2680,2404,276,0.897015,0.102985,3.335593,253,23,1, merged,0,0,0
63399,1000026,3,763,646,117,0.846658,0.153342,2.438992,114,3,764,647,117,0.846859,0.153141,2.438578,114,3,-1, merged,0,0,0
63399,1000534,2,782,597,185,0.763427,0.236573,1.592334,162,23,783,598,185,0.763729,0.236271,1.591719,162,23,-1, merged,0,0,0
63400,1000054,2,1369,1158,211,0.845873,0.154127,1.679481,194,17,1370,1159,211,0.845985,0.154015,1.679867,194,17,1, merged,0,0,0
63400,1000140,1,607,506,101,0.833608,0.166392,0.833608,89,12,608,507,101,0.833882,0.166118,0.833882,89,12,1, merged,0,0,0
63411,1000329,4,3969,3102,867,0.781557,0.218443,3.075442,741,126,3970,3103,867,0.781612,0.218388,3.078042,741,126,1, merged,0,0,0
63414,1000004,1,5062,4453,609,0.879692,0.120308,0.879692,486,123,5066,4454,612,0.879195,0.120805,0.879195,489,123,1, merged,1,1,0
63414,1000130,2,911,764,147,0.838639,0.161361,1.718331,113,34,913,764,149,0.836802,0.163198,1.715996,115,34,1, merged,1,1,0
63416,1000009,2,2248,1879,369,0.835854,0.164146,1.672656,329,40,2251,1881,370,0.835629,0.164371,1.671515,330,40,-1, merged,1,0,0
63416,1000130,1,913,764,149,0.836802,0.163198,0.836802,115,34,914,764,150,0.835886,0.164114,0.835886,116,34,1, merged,1,1,0
63417,1000003,2,1623,1344,279,0.828096,0.171904,1.683834,238,41,1624,1345,279,0.828202,0.171798,1.684097,238,41,1, merged,0,0,0
63417,1000012,1,915,783,132,0.855738,0.144262,0.855738,128,4,916,784,132,0.855895,0.144105,0.855895,128,4,1, merged,0,0,0
63420,1000011,1,1048,961,87,0.916985,0.083015,0.916985,82,5,1050,962,88,0.91619,0.08381,0.91619,83,5,-1, abandoned,1,0,0
63423,1000009,2,2251,1881,370,0.835629,0.164371,1.481462,330,40,2252,1882,370,0.835702,0.164298,1.488763,330,40,1, merged,0,0,0
63425,1000054,2,1370,1159,211,0.845985,0.154015,1.593354,194,17,1371,1160,211,0.846098,0.153902,1.593909,194,17,1, merged,0,0,0
63425,1000328,1,1140,852,288,0.747368,0.252632,0.747368,257,31,1142,854,288,0.747811,0.252189,0.747811,257,31,-1, merged,0,0,0
63431,1000199,2,694,599,95,0.863112,0.136888,1.644722,84,11,696,601,95,0.863506,0.136494,1.644934,84,11,-1, merged,0,0,0
63434,1000004,1,5066,4454,612,0.879195,0.120805,0.879195,489,123,5067,4455,612,0.879218,0.120782,0.879218,489,123,-1, merged,0,0,0
63434,1000329,2,3970,3103,867,0.781612,0.218388,1.660807,741,126,3971,3104,867,0.781667,0.218333,1.660886,741,126,1, merged,0,0,0
63443,1000007,1,2040,1643,397,0.805392,0.194608,0.805392,348,49,2041,1643,398,0.804998,0.195002,0.804998,349,49,1, merged,1,1,0
63443,1000009,2,2254,1884,370,0.835847,0.164153,1.64124,330,40,2255,1885,370,0.83592,0.16408,1.640918,330,40,1, merged,0,0,0
63448,1000014,1,3579,2880,699,0.804694,0.195306,0.804694,656,43,3582,2883,699,0.804858,0.195142,0.804858,656,43,-1, abandoned,0,0,0
63454,1000109,2,787,681,106,0.865311,0.134689,1.728817,100,6,788,682,106,0.865482,0.134518,1.727749,100,6,1, merged,0,0,0
63454,1000199,1,696,601,95,0.863506,0.136494,0.863506,84,11,697,601,96,0.862267,0.137733,0.862267,85,11,1, merged,1,1,0
63455,1000014,3,3582,2883,699,0.804858,0.195142,2.103628,656,43,3583,2884,699,0.804912,0.195088,2.111644,656,43,1, merged,0,0,0
63458,1000007,1,2042,1644,398,0.805093,0.194907,0.805093,349,49,2043,1644,399,0.804699,0.195301,0.804699,350,49,1, merged,1,1,0
63458,1000009,3,2255,1885,370,0.83592,0.16408,2.537732,330,40,2256,1886,370,0.835993,0.164007,2.537077,330,40,1, merged,0,0,0
63458,1000015,2,2682,2405,277,0.896719,0.103281,1.701812,254,23,2683,2405,278,0.896385,0.103615,1.701084,255,23,1, merged,1,1,0
63469,1000003,3,1624,1345,279,0.828202,0.171798,2.557127,238,41,1625,1346,279,0.828308,0.171692,2.557597,238,41,1, merged,0,0,0
63469,1000109,1,788,682,106,0.865482,0.134518,0.865482,100,6,789,683,106,0.865653,0.134347,0.865653,100,6,1, merged,0,0,0
63469,1000199,2,703,607,96,0.863442,0.136558,1.728925,85,11,704,608,96,0.863636,0.136364,1.729289,85,11,1, merged,0,0,0
63470,1000534,1,783,598,185,0.763729,0.236271,0.763729,162,23,784,598,186,0.762755,0.237245,0.762755,163,23,1, merged,1,1,0
63471,1000009,1,2256,1886,370,0.835993,0.164007,0.835993,330,40,2257,1886,371,0.835623,0.164377,0.835623,331,40,1, merged,1,1,0
63471,1000011,3,1050,962,88,0.91619,0.08381,2.405245,83,5,1051,963,88,0.91627,0.08373,2.379344,83,5,-1, merged,0,0,0
63471,1000120,4,2425,2134,291,0.88,0.12,3.285245,255,36,2426,2135,291,0.880049,0.119951,3.259393,255,36,1, merged,0,0,0
63472,1000132,1,946,786,160,0.830867,0.169133,0.830867,135,25,948,787,161,0.830169,0.169831,0.830169,136,25,1, abandoned,1,1,0
63478,1000132,1,948,787,161,0.830169,0.169831,0.830169,136,25,950,788,162,0.829474,0.170526,0.829474,137,25,1, abandoned,1,1,0
63482,1000110,1,811,729,82,0.89889,0.10111,0.89889,76,6,812,730,82,0.899015,0.100985,0.899015,76,6,1, merged,0,0,0
63482,1000140,2,610,509,101,0.834426,0.165574,1.733316,89,12,611,510,101,0.834697,0.165303,1.733712,89,12,1, merged,0,0,0
63485,1000012,2,917,785,132,0.856052,0.143948,1.535298,128,4,918,786,132,0.856209,0.143791,1.528936,128,4,1, merged,0,0,0
63486,1000166,2,656,498,158,0.759146,0.240854,1.618443,151,7,657,499,158,0.759513,0.240487,1.619513,151,7,1, merged,0,0,0
63498,1000329,2,3972,3105,867,0.781722,0.218278,1.598112,741,126,3973,3106,867,0.781777,0.218223,1.598357,741,126,-1, abandoned,0,0,0
63498,1002169,1,964,787,177,0.81639,0.18361,0.81639,121,56,965,788,177,0.81658,0.18342,0.81658,121,56,-1, abandoned,0,0,0
63504,1000007,2,2044,1644,400,0.804305,0.195695,1.639928,350,50,2045,1644,401,0.803912,0.196088,1.639164,350,51,-1, merged,1,1,0
63504,1000009,1,2257,1886,371,0.835623,0.164377,0.835623,331,40,2258,1886,372,0.835252,0.164748,0.835252,331,41,-1, merged,1,1,0
63505,1000329,2,3973,3106,867,0.781777,0.218223,1.562705,741,126,3974,3107,867,0.781832,0.218168,1.563323,741,126,1, merged,0,0,0
63506,1000121,2,2835,2373,462,0.837037,0.162963,1.562037,426,36,2836,2374,462,0.837094,0.162906,1.56549,426,36,1, merged,0,0,0
63511,1000199,2,704,608,96,0.863636,0.136364,1.645065,85,11,705,609,96,0.86383,0.13617,1.64557,85,11,1, merged,0,0,0
63523,1000003,2,1625,1346,279,0.828308,0.171692,1.705216,238,41,1626,1347,279,0.828413,0.171587,1.70538,238,41,1, merged,0,0,0
63523,1000023,1,2096,1838,258,0.876908,0.123092,0.876908,229,29,2097,1839,258,0.876967,0.123033,0.876967,229,29,1, merged,0,0,0
63530,1000005,1,1052,923,129,0.877376,0.122624,0.877376,119,10,1054,925,129,0.877609,0.122391,0.877609,119,10,-1, merged,0,0,0
63539,1000015,1,2683,2405,278,0.896385,0.103615,0.896385,255,23,2684,2406,278,0.896423,0.103577,0.896423,255,23,1, merged,0,0,0
63541,1000014,3,3583,2884,699,0.804912,0.195088,2.352412,656,43,3585,2885,700,0.804742,0.195258,2.307522,657,43,1, merged,1,1,0
63544,1000023,2,2098,1840,258,0.877026,0.122974,1.72959,229,29,2099,1840,259,0.876608,0.123392,1.728262,230,29,1, abandoned,1,1,0
63544,1000592,1,936,798,138,0.852564,0.147436,0.852564,88,50,937,798,139,0.851654,0.148346,0.851654,89,50,1, abandoned,1,1,0
63545,1000004,3,5077,4463,614,0.879062,0.120938,2.531529,491,123,5079,4465,614,0.87911,0.12089,2.532701,491,123,-1, merged,0,0,0
63545,1000121,4,2837,2375,462,0.837152,0.162848,3.368681,426,36,2844,2381,463,0.837201,0.162799,3.369903,427,36,-1, merged,1,0,0
63545,1000130,2,914,764,150,0.835886,0.164114,1.652467,116,34,915,765,150,0.836066,0.163934,1.653591,116,34,-1, merged,0,0,0
63545,1000329,5,3974,3107,867,0.781832,0.218168,4.150513,741,126,3978,3110,868,0.7818,0.2182,4.151702,742,126,-1, merged,1,0,0
63545,1002169,1,965,788,177,0.81658,0.18342,0.81658,121,56,970,793,177,0.817526,0.182474,0.817526,121,56,-1, merged,0,0,0
63551,1000132,2,952,789,163,0.828782,0.171218,1.736474,138,25,953,790,163,0.828961,0.171039,1.730476,138,25,1, merged,0,0,0
63554,1000023,2,2099,1840,259,0.876608,0.123392,1.726281,230,29,2100,1841,259,0.876667,0.123333,1.721494,230,29,-1, merged,0,0,0
63557,1000014,2,3586,2886,700,0.804796,0.195204,1.612819,657,43,3588,2887,701,0.804627,0.195373,1.610894,658,43,1, merged,1,1,0
63563,1002169,1,970,793,177,0.817526,0.182474,0.817526,121,56,972,795,177,0.817901,0.182099,0.817901,121,56,-1, abandoned,0,0,0
63564,1000004,1,5079,4465,614,0.87911,0.12089,0.87911,491,123,5080,4466,614,0.879134,0.120866,0.879134,491,123,-1, merged,0,0,0
63565,1000054,2,1372,1160,212,0.845481,0.154519,1.663382,195,17,1373,1161,212,0.845594,0.154406,1.663682,195,17,1, merged,0,0,0
63565,1002169,1,972,795,177,0.817901,0.182099,0.817901,121,56,973,796,177,0.818088,0.181912,0.818088,121,56,-1, merged,0,0,0
63567,1000007,2,2045,1644,401,0.803912,0.196088,1.650771,350,51,2047,1646,401,0.804104,0.195896,1.651162,350,51,-1, merged,0,0,0
63567,1000026,1,764,647,117,0.846859,0.153141,0.846859,114,3,765,648,117,0.847059,0.152941,0.847059,114,3,-1, merged,0,0,0
63567,1000153,3,1494,1336,158,0.894244,0.105756,2.545014,122,36,1497,1339,158,0.894456,0.105544,2.545618,122,36,-1, merged,0,0,0
63571,1000023,1,2100,1841,259,0.876667,0.123333,0.876667,230,29,2101,1842,259,0.876725,0.123275,0.876725,230,29,1, merged,0,0,0
63573,1000054,2,1373,1161,212,0.845594,0.154406,1.605049,195,17,1374,1162,212,0.845706,0.154294,1.605525,195,17,1, merged,0,0,0
63573,1000166,1,661,502,159,0.759455,0.240545,0.759455,152,7,662,503,159,0.759819,0.240181,0.759819,152,7,1, merged,0,0,0
63578,1000121,2,2844,2381,463,0.837201,0.162799,1.619056,427,36,2845,2382,463,0.837258,0.162742,1.619168,427,36,1, merged,0,0,0
63578,1000329,1,3979,3111,868,0.781855,0.218145,0.781855,742,126,3980,3112,868,0.78191,0.21809,0.78191,742,126,1, merged,0,0,0
63580,1000004,3,5080,4466,614,0.879134,0.120866,2.408854,491,123,5082,4467,615,0.878985,0.121015,2.40824,491,124,-1, merged,1,0,0
63580,1000328,1,1142,854,288,0.747811,0.252189,0.747811,257,31,1144,855,289,0.747378,0.252622,0.747378,257,32,-1, merged,1,0,0
63580,1000329,2,3980,3112,868,0.78191,0.21809,1.52972,742,126,3984,3115,869,0.781878,0.218122,1.529255,743,126,1, merged,1,1,0
63585,1000009,1,2258,1886,372,0.835252,0.164748,0.835252,331,41,2262,1890,372,0.835544,0.164456,0.835544,331,41,-1, merged,0,0,0
63586,1000108,1,618,528,90,0.854369,0.145631,0.854369,84,6,619,528,91,0.852989,0.147011,0.852989,85,6,1, merged,1,1,0
63586,1000140,2,612,511,101,0.834967,0.165033,1.689336,89,12,614,513,101,0.835505,0.164495,1.688494,89,12,-1, merged,0,0,0
63588,1000009,2,2262,1890,372,0.835544,0.164456,1.462995,331,41,2263,1891,372,0.835616,0.164384,1.458258,331,41,1, merged,0,0,0
63591,1000005,3,1056,926,130,0.876894,0.123106,2.367998,120,10,1057,927,130,0.87701,0.12299,2.359896,120,10,1, merged,0,0,0
63591,1000121,2,2845,2382,463,0.837258,0.162742,1.491105,427,36,2846,2383,463,0.837316,0.162684,1.482885,427,36,1, merged,0,0,0
63593,1000091,2,695,550,145,0.791367,0.208633,1.538745,122,23,696,551,145,0.791667,0.208333,1.539265,122,23,1, merged,0,0,0
63593,1000328,1,1144,855,289,0.747378,0.252622,0.747378,257,32,1145,856,289,0.747598,0.252402,0.747598,257,32,1, merged,0,0,0
63595,1000327,1,753,597,156,0.792829,0.207171,0.792829,120,36,754,598,156,0.793103,0.206897,0.793103,120,36,1, merged,0,0,0
63603,1000005,2,1057,927,130,0.87701,0.12299,1.638915,120,10,1058,928,130,0.877127,0.122873,1.649854,120,10,1, merged,0,0,0
63607,1000023,1,2101,1842,259,0.876725,0.123275,0.876725,230,29,2103,1843,260,0.876367,0.123633,0.876367,230,30,1, merged,1,0,0
63611,1000003,1,1626,1347,279,0.828413,0.171587,0.828413,238,41,1627,1347,280,0.827904,0.172096,0.827904,239,41,1, merged,1,1,0
63611,1000015,2,2686,2408,278,0.8965,0.1035,1.724914,255,23,2687,2408,279,0.896167,0.103833,1.724071,256,23,1, merged,1,1,0
63616,1000109,2,790,684,106,0.865823,0.134177,1.647874,100,6,791,685,106,0.865992,0.134008,1.648354,100,6,1, merged,0,0,0
63619,1000014,1,3591,2890,701,0.80479,0.19521,0.80479,658,43,3592,2891,701,0.804844,0.195156,0.804844,658,43,1, merged,0,0,0
63620,1000004,3,5082,4467,615,0.878985,0.121015,2.3624,491,124,5084,4468,616,0.878836,0.121164,2.349898,492,124,-1, merged,1,0,0
63620,1000014,2,3592,2891,701,0.804844,0.195156,1.483416,658,43,3594,2891,703,0.804396,0.195604,1.471063,660,43,1, merged,1,1,0
63620,1002169,5,973,796,177,0.818088,0.181912,3.919619,121,56,974,797,177,0.818275,0.181725,3.911031,121,56,-1, merged,0,0,0
63621,1000140,2,614,513,101,0.835505,0.164495,1.66273,89,12,615,514,101,0.835772,0.164228,1.663449,89,12,1, merged,0,0,0
63625,1000327,2,754,598,156,0.793103,0.206897,1.570881,120,36,755,599,156,0.793377,0.206623,1.575986,120,36,1, merged,0,0,0
63630,1000004,2,5085,4469,616,0.878859,0.121141,1.775065,492,124,5086,4470,616,0.878883,0.121117,1.775127,492,124,1, merged,0,0,0
63630,1000015,1,2688,2409,279,0.896205,0.103795,0.896205,256,23,2689,2410,279,0.896244,0.103756,0.896244,256,23,1, merged,0,0,0
63631,1000004,2,5086,4470,616,0.878883,0.121117,1.775127,492,124,5087,4471,616,0.878907,0.121093,1.77519,492,124,1, merged,0,0,0
63631,1000015,1,2689,2410,279,0.896244,0.103756,0.896244,256,23,2690,2411,279,0.896283,0.103717,0.896283,256,23,1, merged,0,0,0
63632,1000004,2,5087,4471,616,0.878907,0.121093,1.77519,492,124,5088,4472,616,0.878931,0.121069,1.775252,492,124,1, merged,0,0,0
63632,1000015,1,2690,2411,279,0.896283,0.103717,0.896283,256,23,2691,2412,279,0.896321,0.103679,0.896321,256,23,1, merged,0,0,0
63633,1000004,2,5088,4472,616,0.878931,0.121069,1.775252,492,124,5089,4473,616,0.878955,0.121045,1.775314,492,124,1, merged,0,0,0
63633,1000015,1,2691,2412,279,0.896321,0.103679,0.896321,256,23,2692,2413,279,0.89636,0.10364,0.89636,256,23,1, merged,0,0,0
63646,1000005,1,1059,929,130,0.877243,0.122757,0.877243,120,10,1061,931,130,0.877474,0.122526,0.877474,120,10,-1, merged,0,0,0
63646,1000043,2,715,592,123,0.827972,0.172028,1.705215,107,16,717,593,124,0.827057,0.172943,1.704531,107,17,-1, merged,1,0,0
63647,1000009,2,2264,1892,372,0.835689,0.164311,1.835689,331,41,2265,1893,372,0.835762,0.164238,1.835762,331,41,1, merged,0,0,0
63654,1000140,1,615,514,101,0.835772,0.164228,0.835772,89,12,616,515,101,0.836039,0.163961,0.836039,89,12,1, merged,0,0,0
63655,1000140,2,616,515,101,0.836039,0.163961,1.665055,89,12,617,516,101,0.836305,0.163695,1.661946,89,12,1, merged,0,0,0
63658,1000003,3,1627,1347,280,0.827904,0.172096,2.298967,239,41,1629,1348,281,0.827502,0.172498,2.304366,239,42,-1, merged,1,1,0
63658,1000014,2,3594,2891,703,0.804396,0.195604,1.471063,660,43,3595,2892,703,0.804451,0.195549,1.476864,660,43,1, merged,0,0,0
63673,1000140,2,617,516,101,0.836305,0.163695,1.661946,89,12,618,517,101,0.83657,0.16343,1.658453,89,12,1, merged,0,0,0
63674,1000004,2,5089,4473,616,0.878955,0.121045,1.759332,492,124,5090,4474,616,0.878978,0.121022,1.759404,492,124,1, merged,0,0,0
63674,1000120,1,2441,2149,292,0.880377,0.119623,0.880377,255,37,2442,2150,292,0.880426,0.119574,0.880426,255,37,1, merged,0,0,0
63676,1000004,2,5090,4474,616,0.878978,0.121022,1.775415,492,124,5091,4475,616,0.879002,0.120998,1.775477,492,124,1, merged,0,0,0
63676,1000015,1,2694,2415,279,0.896437,0.103563,0.896437,256,23,2695,2416,279,0.896475,0.103525,0.896475,256,23,1, merged,0,0,0
63688,1000007,2,2056,1655,401,0.804961,0.195039,1.482234,350,51,2057,1656,401,0.805056,0.194944,1.483789,350,51,1, merged,0,0,0
63694,1000012,2,919,787,132,0.856366,0.143634,1.765457,128,4,920,788,132,0.856522,0.143478,1.761714,128,4,1, merged,0,0,0
63697,1000199,2,707,611,96,0.864215,0.135785,1.645775,85,11,708,611,97,0.862994,0.137006,1.645173,85,12,-1, merged,1,1,0
63698,1000199,2,708,611,97,0.862994,0.137006,1.645173,85,12,709,611,98,0.861777,0.138223,1.64457,85,13,-1, merged,1,1,0
63701,1000014,1,3595,2892,703,0.804451,0.195549,0.804451,660,43,3596,2893,703,0.804505,0.195495,0.804505,660,43,1, merged,0,0,0
63707,1000004,2,5091,4475,616,0.879002,0.120998,1.72482,492,124,5092,4476,616,0.879026,0.120974,1.724229,492,124,-1, abandoned,0,0,0
63707,1000054,1,1375,1163,212,0.845818,0.154182,0.845818,195,17,1376,1163,213,0.845203,0.154797,0.845203,196,17,1, abandoned,1,1,0
63709,1000007,1,2058,1657,401,0.805151,0.194849,0.805151,350,51,2064,1661,403,0.804748,0.195252,0.804748,352,51,-1, merged,1,0,0
63709,1000026,3,765,648,117,0.847059,0.152941,2.414965,114,3,766,648,118,0.845953,0.154047,2.414361,115,3,1, merged,1,1,0
63709,1000534,2,784,598,186,0.762755,0.237245,1.567906,163,23,787,601,186,0.763659,0.236341,1.568408,163,23,-1, merged,0,0,0
63710,1000014,1,3596,2893,703,0.804505,0.195495,0.804505,660,43,3597,2894,703,0.804559,0.195441,0.804559,660,43,1, merged,0,0,0
63716,1000014,1,3597,2894,703,0.804559,0.195441,0.804559,660,43,3600,2896,704,0.804444,0.195556,0.804444,661,43,1, merged,1,1,0
63716,1000105,3,896,716,180,0.799107,0.200893,2.48458,151,29,897,717,180,0.799331,0.200669,2.484738,151,29,1, merged,0,0,0
63716,1000120,2,2452,2160,292,0.880914,0.119086,1.685473,255,37,2453,2161,292,0.880962,0.119038,1.685407,255,37,1, merged,0,0,0
63717,1000009,2,2265,1893,372,0.835762,0.164238,1.470244,331,41,2266,1894,372,0.835834,0.164166,1.47282,331,41,1, merged,0,0,0
63719,1000026,2,766,648,118,0.845953,0.154047,1.445953,115,3,767,648,119,0.84485,0.15515,1.423797,116,3,1, merged,1,1,0
63720,1000005,1,1062,932,130,0.877589,0.122411,0.877589,120,10,1063,933,130,0.877705,0.122295,0.877705,120,10,1, merged,0,0,0
63721,1000005,1,1063,933,130,0.877705,0.122295,0.877705,120,10,1065,935,130,0.877934,0.122066,0.877934,120,10,-1, merged,0,0,0
63724,1000005,2,1069,939,130,0.878391,0.121609,1.591506,120,10,1070,940,130,0.878505,0.121495,1.59279,120,10,1, merged,0,0,0
63744,1000105,2,898,718,180,0.799555,0.200445,1.584908,151,29,899,719,180,0.799778,0.200222,1.584239,151,29,1, merged,0,0,0
63747,1000003,3,1629,1348,281,0.827502,0.172498,2.411422,239,42,1632,1350,282,0.827206,0.172794,2.407792,240,42,-1, merged,1,0,0
63747,1000014,2,3600,2896,704,0.804444,0.195556,1.58392,661,43,3601,2897,704,0.804499,0.195501,1.580586,661,43,-1, merged,0,0,0
63751,1000004,1,5092,4476,616,0.879026,0.120974,0.879026,492,124,5093,4477,616,0.87905,0.12095,0.87905,492,124,1, merged,0,0,0
63751,1000014,2,3603,2899,704,0.804607,0.195393,1.683633,661,43,3604,2900,704,0.804661,0.195339,1.683711,661,43,1, merged,0,0,0
63753,1000329,3,3984,3115,869,0.781878,0.218122,2.376612,743,126,3986,3117,869,0.781987,0.218013,2.378062,743,126,-1, merged,0,0,0
63753,1002169,1,976,799,177,0.818648,0.181352,0.818648,121,56,978,801,177,0.819018,0.180982,0.819018,121,56,-1, merged,0,0,0
63758,1000009,2,2266,1894,372,0.835834,0.164166,1.716796,331,41,2267,1895,372,0.835906,0.164094,1.716917,331,41,1, merged,0,0,0
63758,1000120,1,2453,2161,292,0.880962,0.119038,0.880962,255,37,2454,2162,292,0.881011,0.118989,0.881011,255,37,1, merged,0,0,0
63759,1002169,2,978,801,177,0.819018,0.180982,1.396796,121,56,979,802,177,0.819203,0.180797,1.40616,121,56,-1, abandoned,0,0,0
63762,1000009,1,2267,1895,372,0.835906,0.164094,0.835906,331,41,2268,1896,372,0.835979,0.164021,0.835979,331,41,1, merged,0,0,0
63764,1000009,1,2268,1896,372,0.835979,0.164021,0.835979,331,41,2269,1896,373,0.83561,0.16439,0.83561,332,41,1, abandoned,1,1,0
63767,1000023,2,2103,1843,260,0.876367,0.123633,1.744584,230,30,2104,1844,260,0.876426,0.123574,1.74275,230,30,1, merged,0,0,0
63768,1000004,1,5093,4477,616,0.87905,0.12095,0.87905,492,124,5095,4479,616,0.879097,0.120903,0.879097,492,124,-1, merged,0,0,0
63768,1000121,2,2846,2383,463,0.837316,0.162684,1.716365,427,36,2847,2384,463,0.837373,0.162627,1.71647,427,36,1, merged,0,0,0
63769,1000004,1,5095,4479,616,0.879097,0.120903,0.879097,492,124,5097,4481,616,0.879145,0.120855,0.879145,492,124,-1, merged,0,0,0
63769,1000121,2,2847,2384,463,0.837373,0.162627,1.71647,427,36,2848,2385,463,0.83743,0.16257,1.716574,427,36,1, merged,0,0,0
63772,1000121,1,2850,2387,463,0.837544,0.162456,0.837544,427,36,2854,2390,464,0.837421,0.162579,0.837421,428,36,-1, merged,1,0,0
63773,1000026,3,767,648,119,0.84485,0.15515,2.311807,116,3,768,648,120,0.84375,0.15625,2.30279,117,3,1, merged,1,1,0
63773,1000054,6,1376,1163,213,0.845203,0.154797,4.611864,196,17,1377,1164,213,0.845316,0.154684,4.599086,196,17,1, merged,0,0,0
63773,1000166,5,662,503,159,0.759819,0.240181,3.766661,152,7,663,503,160,0.758673,0.241327,3.75377,153,7,1, merged,1,1,0
63785,1000003,2,1632,1350,282,0.827206,0.172794,1.5596,240,42,1634,1350,284,0.826193,0.173807,1.538522,242,42,1, abandoned,1,1,0
63788,1000004,2,5097,4481,616,0.879145,0.120855,1.77562,492,124,5098,4482,616,0.879168,0.120832,1.775682,492,124,1, merged,0,0,0
63788,1000015,1,2695,2416,279,0.896475,0.103525,0.896475,256,23,2696,2417,279,0.896513,0.103487,0.896513,256,23,1, merged,0,0,0
63791,1000014,1,3605,2901,704,0.804716,0.195284,0.804716,661,43,3608,2903,705,0.804601,0.195399,0.804601,662,43,1, merged,1,1,0
63794,1000026,1,768,648,120,0.84375,0.15625,0.84375,117,3,770,648,122,0.841558,0.158442,0.841558,119,3,1, merged,1,1,0
63794,1000166,6,663,503,160,0.758673,0.241327,4.200378,153,7,664,504,160,0.759036,0.240964,4.121299,153,7,1, merged,0,0,0
63797,1000014,1,3609,2904,705,0.804655,0.195345,0.804655,662,43,3612,2905,707,0.804264,0.195736,0.804264,664,43,1, merged,1,1,0
63801,1000004,1,5098,4482,616,0.879168,0.120832,0.879168,492,124,5099,4483,616,0.879192,0.120808,0.879192,492,124,1, merged,0,0,0
63801,1000121,3,2855,2391,464,0.837478,0.162522,2.498492,428,36,2856,2392,464,0.837535,0.162465,2.498627,428,36,1, merged,0,0,0
63801,1000329,2,3988,3118,870,0.781846,0.218154,1.661014,744,126,3989,3119,870,0.7819,0.2181,1.661092,744,126,1, merged,0,0,0
63802,1000004,1,5099,4483,616,0.879192,0.120808,0.879192,492,124,5100,4484,616,0.879216,0.120784,0.879216,492,124,1, merged,0,0,0
63802,1000121,2,2856,2392,464,0.837535,0.162465,1.716727,428,36,2857,2393,464,0.837592,0.162408,1.716808,428,36,1, merged,0,0,0
63805,1000011,1,1055,967,88,0.916588,0.083412,0.916588,83,5,1057,968,89,0.915799,0.084201,0.915799,83,6,-1, merged,1,0,0
63805,1000120,3,2457,2165,292,0.881156,0.118844,2.653465,255,37,2458,2166,292,0.881204,0.118796,2.653439,255,37,1, merged,0,0,0
63811,1000009,1,2269,1896,373,0.83561,0.16439,0.83561,332,41,2270,1896,374,0.835242,0.164758,0.835242,333,41,1, merged,1,1,0
63819,1000004,2,5100,4484,616,0.879216,0.120784,1.716808,492,124,5101,4485,616,0.879239,0.120761,1.716888,492,124,1, merged,0,0,0
63819,1000121,1,2857,2393,464,0.837592,0.162408,0.837592,428,36,2858,2394,464,0.837649,0.162351,0.837649,428,36,1, merged,0,0,0
63822,1000004,2,5101,4485,616,0.879239,0.120761,1.67289,492,124,5102,4485,617,0.879067,0.120933,1.673262,492,125,-1, merged,1,1,0
63822,1000327,1,756,600,156,0.793651,0.206349,0.793651,120,36,758,602,156,0.794195,0.205805,0.794195,120,36,1, merged,0,0,0
63844,1000004,2,5102,4485,617,0.879067,0.120933,1.720625,492,125,5103,4486,617,0.879091,0.120909,1.720855,492,125,1, merged,0,0,0
63844,1000026,1,770,648,122,0.841558,0.158442,0.841558,119,3,771,649,122,0.841764,0.158236,0.841764,119,3,1, merged,0,0,0
63844,1000054,5,1377,1164,213,0.845316,0.154684,4.159649,196,17,1378,1165,213,0.845428,0.154572,4.162221,196,17,1, merged,0,0,0
63844,1000110,3,814,732,82,0.899263,0.100737,2.619888,76,6,815,733,82,0.899387,0.100613,2.620241,76,6,1, merged,0,0,0
63846,1000014,2,3614,2907,707,0.804372,0.195628,1.670696,664,43,3615,2908,707,0.804426,0.195574,1.671093,664,43,1, merged,0,0,0
63849,1000014,1,3615,2908,707,0.804426,0.195574,0.804426,664,43,3617,2909,708,0.804258,0.195742,0.804258,665,43,1, merged,1,1,0
63849,1000140,2,620,519,101,0.837097,0.162903,1.641523,89,12,622,520,102,0.836013,0.163987,1.640271,90,12,1, merged,1,1,0
63862,1000007,2,2065,1662,403,0.804843,0.195157,1.663903,352,51,2066,1662,404,0.804453,0.195547,1.663985,352,52,-1, merged,1,1,0
63863,1000140,2,623,521,102,0.836276,0.163724,1.595312,90,12,625,522,103,0.8352,0.1648,1.593095,91,12,1, abandoned,1,1,0
63863,1000166,1,664,504,160,0.759036,0.240964,0.759036,153,7,665,504,161,0.757895,0.242105,0.757895,154,7,1, abandoned,1,1,0
63871,1000130,1,933,783,150,0.839228,0.160772,0.839228,116,34,934,783,151,0.83833,0.16167,0.83833,117,34,1, abandoned,1,1,0
63871,1000592,2,941,802,139,0.852285,0.147715,1.691513,89,50,942,803,139,0.852442,0.147558,1.690771,89,50,-1, abandoned,0,0,0
63873,1000004,2,5103,4486,617,0.879091,0.120909,1.775642,492,125,5104,4487,617,0.879114,0.120886,1.775704,492,125,1, merged,0,0,0
63873,1000015,1,2697,2418,279,0.896552,0.103448,0.896552,256,23,2698,2419,279,0.89659,0.10341,0.89659,256,23,1, merged,0,0,0
63874,1000329,3,3989,3119,870,0.7819,0.2181,2.411035,744,126,3990,3120,870,0.781955,0.218045,2.412462,744,126,-1, merged,0,0,0
63878,1000007,2,2066,1662,404,0.804453,0.195547,1.39066,352,52,2067,1663,404,0.804548,0.195452,1.397768,352,52,1, merged,0,0,0
63880,1000015,2,2699,2420,279,0.896628,0.103372,1.738392,256,23,2700,2421,279,0.896667,0.103333,1.738636,256,23,1, merged,0,0,0
63880,1000026,1,771,649,122,0.841764,0.158236,0.841764,119,3,772,650,122,0.841969,0.158031,0.841969,119,3,1, merged,0,0,0
63884,1000110,2,815,733,82,0.899387,0.100613,1.470815,76,6,816,734,82,0.89951,0.10049,1.49951,76,6,1, merged,0,0,0
63886,1000014,1,3618,2910,708,0.804312,0.195688,0.804312,665,43,3619,2911,708,0.804366,0.195634,0.804366,665,43,1, merged,0,0,0
63891,1000005,1,1075,944,131,0.87814,0.12186,0.87814,121,10,1076,945,131,0.878253,0.121747,0.878253,121,10,1, merged,0,0,0
63891,1000121,3,2859,2395,464,0.837705,0.162295,2.543431,428,36,2860,2396,464,0.837762,0.162238,2.549348,428,36,1, merged,0,0,0
63891,1000130,4,936,785,151,0.838675,0.161325,3.382106,117,34,937,786,151,0.838847,0.161153,3.388196,117,34,1, merged,0,0,0
63899,1000132,3,953,790,163,0.828961,0.171039,2.471187,138,25,954,791,163,0.82914,0.17086,2.473579,138,25,1, merged,0,0,0
63901,1000329,4,3990,3120,870,0.781955,0.218045,3.12434,744,126,3991,3121,870,0.78201,0.21799,3.117867,744,126,1, merged,0,0,0
63903,1000005,2,1076,945,131,0.878253,0.121747,1.717272,121,10,1077,946,131,0.878366,0.121634,1.716491,121,10,1, merged,0,0,0
63903,1000130,1,938,787,151,0.839019,0.160981,0.839019,117,34,939,787,152,0.838126,0.161874,0.838126,117,35,-1, merged,1,1,0
63916,1000009,2,2274,1900,374,0.835532,0.164468,1.428752,333,41,2275,1901,374,0.835604,0.164396,1.442162,333,41,1, merged,0,0,0
63917,1000121,2,2860,2396,464,0.837762,0.162238,1.619772,428,36,2861,2397,464,0.837819,0.162181,1.619742,428,36,1, merged,0,0,0
63917,1000329,1,3991,3121,870,0.78201,0.21799,0.78201,744,126,3994,3123,871,0.781923,0.218077,0.781923,744,127,-1, merged,1,0,0
63923,1000005,1,1077,946,131,0.878366,0.121634,0.878366,121,10,1078,946,132,0.877551,0.122449,0.877551,122,10,1, abandoned,1,1,0
63923,1000023,2,2104,1844,260,0.876426,0.123574,1.754792,230,30,2106,1846,260,0.876543,0.123457,1.754094,230,30,-1, abandoned,0,0,0
63926,1000009,1,2275,1901,374,0.835604,0.164396,0.835604,333,41,2277,1903,374,0.835749,0.164251,0.835749,333,41,-1, merged,0,0,0
63926,1000014,2,3619,2911,708,0.804366,0.195634,1.63997,665,43,3620,2912,708,0.80442,0.19558,1.640169,665,43,1, merged,0,0,0
63927,1000105,2,900,719,181,0.798889,0.201111,1.702593,151,30,901,720,181,0.799112,0.200888,1.703524,151,30,1, merged,0,0,0
63939,1000328,2,1145,856,289,0.747598,0.252402,1.487369,257,32,1147,858,289,0.748038,0.251962,1.488234,257,32,-1, merged,0,0,0
63940,1000054,1,1380,1167,213,0.845652,0.154348,0.845652,196,17,1382,1168,214,0.845152,0.154848,0.845152,197,17,1, merged,1,1,0
63946,1000003,4,1634,1350,284,0.826193,0.173807,2.472176,242,42,1635,1350,285,0.825688,0.174312,2.471264,243,42,1, merged,1,1,0
63946,1000199,2,710,612,98,0.861972,0.138028,1.645983,85,13,712,614,98,0.86236,0.13764,1.645576,85,13,-1, merged,0,0,0
63956,1000005,1,1084,950,134,0.876384,0.123616,0.876384,124,10,1085,950,135,0.875576,0.124424,0.875576,125,10,1, merged,1,1,0
63956,1000121,2,2861,2397,464,0.837819,0.162181,1.714203,428,36,2862,2398,464,0.837876,0.162124,1.713452,428,36,1, merged,0,0,0
63966,1000014,1,3625,2917,708,0.80469,0.19531,0.80469,665,43,3626,2918,708,0.804744,0.195256,0.804744,665,43,1, merged,0,0,0
63968,1000009,1,2278,1904,374,0.835821,0.164179,0.835821,333,41,2280,1905,375,0.835526,0.164474,0.835526,334,41,1, merged,1,1,0
63968,1000132,2,956,793,163,0.829498,0.170502,1.665319,138,25,957,794,163,0.829676,0.170324,1.665202,138,25,1, merged,0,0,0
63979,1000004,2,5106,4489,617,0.879162,0.120838,1.755705,492,125,5108,4491,617,0.879209,0.120791,1.755336,492,125,-1, merged,0,0,0
63979,1000023,1,2106,1846,260,0.876543,0.123457,0.876543,230,30,2107,1846,261,0.876127,0.123873,0.876127,231,30,1, merged,1,1,0
63985,1000007,2,2071,1667,404,0.804925,0.195075,1.634601,352,52,2072,1668,404,0.805019,0.194981,1.634873,352,52,1, merged,0,0,0
63985,1000132,1,957,794,163,0.829676,0.170324,0.829676,138,25,958,795,163,0.829854,0.170146,0.829854,138,25,-1, merged,0,0,0
63987,1000014,3,3626,2918,708,0.804744,0.195256,2.328644,665,43,3627,2919,708,0.804797,0.195203,2.329399,665,43,1, merged,0,0,0
63987,1000328,2,1147,858,289,0.748038,0.251962,1.5239,257,32,1148,859,289,0.748258,0.251742,1.524602,257,32,1, merged,0,0,0
63988,1000014,3,3627,2919,708,0.804797,0.195203,2.329399,665,43,3628,2920,708,0.804851,0.195149,2.330152,665,43,1, merged,0,0,0
63988,1000328,2,1148,859,289,0.748258,0.251742,1.524602,257,32,1149,860,289,0.748477,0.251523,1.525301,257,32,1, merged,0,0,0
63989,1000328,2,1149,860,289,0.748477,0.251523,1.525301,257,32,1151,861,290,0.748045,0.251955,1.525823,258,32,1, merged,1,1,0
63990,1000328,2,1151,861,290,0.748045,0.251955,1.525823,258,32,1154,863,291,0.747834,0.252166,1.526085,259,32,1, merged,1,1,0
63991,1000004,4,5108,4491,617,0.879209,0.120791,3.318211,492,125,5109,4492,617,0.879233,0.120767,3.31818,492,125,-1, merged,0,0,0
63991,1000121,2,2862,2398,464,0.837876,0.162124,1.657079,428,36,2867,2402,465,0.83781,0.16219,1.656915,429,36,1, merged,1,1,0
63991,1000329,3,3994,3123,871,0.781923,0.218077,2.439002,744,127,3996,3125,871,0.782032,0.217968,2.438947,744,127,-1, merged,0,0,0
63991,1002169,1,979,802,177,0.819203,0.180797,0.819203,121,56,984,806,178,0.819106,0.180894,0.819106,121,57,-1, merged,1,0,0
63992,1000007,1,2072,1668,404,0.805019,0.194981,0.805019,352,52,2073,1669,404,0.805113,0.194887,0.805113,352,52,1, merged,0,0,0
63992,1000015,2,2701,2422,279,0.896705,0.103295,1.701724,256,23,2702,2423,279,0.896743,0.103257,1.701857,256,23,1, merged,0,0,0
64001,1000592,2,942,803,139,0.852442,0.147558,1.671547,89,50,944,805,139,0.852754,0.147246,1.672044,89,50,-1, merged,0,0,0
64001,1002169,1,984,806,178,0.819106,0.180894,0.819106,121,57,985,807,178,0.819289,0.180711,0.819289,121,57,-1, merged,0,0,0
64005,1000009,2,2285,1909,376,0.835449,0.164551,1.599408,335,41,2286,1909,377,0.835083,0.164917,1.598074,335,42,-1, merged,1,1,0
64005,1000534,1,788,602,186,0.763959,0.236041,0.763959,163,23,789,602,187,0.762991,0.237009,0.762991,163,24,-1, merged,1,1,0
64007,1000592,2,944,805,139,0.852754,0.147246,1.672979,89,50,945,806,139,0.85291,0.14709,1.67059,89,50,1, merged,0,0,0
64009,1000130,2,951,796,155,0.837014,0.162986,0.837014,120,35,952,797,155,0.837185,0.162815,0.837185,120,35,-1, abandoned,0,0,0
64015,1000023,1,2108,1847,261,0.876186,0.123814,0.876186,231,30,2110,1848,262,0.875829,0.124171,0.875829,232,30,1, merged,1,1,0
64016,1000329,1,3996,3125,871,0.782032,0.217968,0.782032,744,127,3999,3125,874,0.781445,0.218555,0.781445,746,128,1, merged,1,1,0
64022,1000054,3,1382,1168,214,0.845152,0.154848,2.442693,197,17,1383,1169,214,0.845264,0.154736,2.442446,197,17,1, merged,0,0,0
64022,1000166,4,665,504,161,0.757895,0.242105,3.200588,154,7,666,505,161,0.758258,0.241742,3.200704,154,7,1, merged,0,0,0
64022,1002169,1,985,807,178,0.819289,0.180711,0.819289,121,57,986,807,179,0.818458,0.181542,0.818458,121,58,-1, merged,1,1,0
64023,1000054,1,1383,1169,214,0.845264,0.154736,0.845264,197,17,1384,1170,214,0.845376,0.154624,0.845376,197,17,1, merged,0,0,0
64024,1000132,1,958,795,163,0.829854,0.170146,0.829854,138,25,959,796,163,0.830031,0.169969,0.830031,138,25,1, merged,0,0,0
64027,1000009,2,2288,1911,377,0.835227,0.164773,1.474683,335,42,2289,1912,377,0.835299,0.164701,1.477191,335,42,1, merged,0,0,0
64042,1000009,2,2291,1914,377,0.835443,0.164557,1.677412,335,42,2292,1915,377,0.835515,0.164485,1.677688,335,42,1, merged,0,0,0
64042,1000026,1,772,650,122,0.841969,0.158031,0.841969,119,3,773,651,122,0.842173,0.157827,0.842173,119,3,1, merged,0,0,0
64053,1000109,2,795,689,106,0.866667,0.133333,1.734014,100,6,796,690,106,0.866834,0.133166,1.731974,100,6,-1, abandoned,0,0,0
64055,1000014,2,3630,2922,708,0.804959,0.195041,1.623417,665,43,3632,2923,709,0.804791,0.195209,1.6238,666,43,1, merged,1,1,0
64055,1000121,4,2868,2403,465,0.837866,0.162134,3.287503,429,36,2869,2404,465,0.837923,0.162077,3.285965,429,36,1, merged,0,0,0
64055,1002169,1,986,807,179,0.818458,0.181542,0.818458,121,58,989,810,179,0.819009,0.180991,0.819009,121,58,-1, merged,0,0,0
64057,1000014,2,3632,2923,709,0.804791,0.195209,1.43637,666,43,3633,2924,709,0.804844,0.195156,1.454844,666,43,1, merged,0,0,0
64058,1000014,2,3633,2924,709,0.804844,0.195156,1.454844,666,43,3634,2925,709,0.804898,0.195102,1.471565,666,43,1, merged,0,0,0
64059,1000109,2,796,690,106,0.866834,0.133166,1.731974,100,6,797,691,106,0.867001,0.132999,1.727761,100,6,-1, merged,0,0,0
64062,1000009,2,2293,1916,377,0.835587,0.164413,1.634921,335,42,2294,1917,377,0.835658,0.164342,1.634553,335,42,-1, merged,0,0,0
64062,1000105,1,902,721,181,0.799335,0.200665,0.799335,151,30,905,723,182,0.798895,0.201105,0.798895,152,30,1, merged,1,1,0
64062,1000329,3,4002,3128,874,0.781609,0.218391,2.416531,746,128,4003,3128,875,0.781414,0.218586,2.415967,747,128,1, merged,1,1,0
64065,1000012,2,923,791,132,0.856988,0.143012,1.720539,128,4,924,792,132,0.857143,0.142857,1.720949,128,4,1, merged,0,0,0
64068,1000014,2,3634,2925,709,0.804898,0.195102,1.471565,666,43,3635,2926,709,0.804952,0.195048,1.429952,666,43,1, merged,0,0,0
64069,1000014,1,3635,2926,709,0.804952,0.195048,0.804952,666,43,3636,2927,709,0.805006,0.194994,0.805006,666,43,1, merged,0,0,0
64069,1000026,2,773,651,122,0.842173,0.157827,1.647125,119,3,774,652,122,0.842377,0.157623,1.647383,119,3,1, merged,0,0,0
64073,1000009,3,2296,1918,378,0.835366,0.164634,2.537191,336,42,2297,1919,378,0.835438,0.164562,2.536763,336,42,1, merged,0,0,0
64073,1000014,2,3636,2927,709,0.805006,0.194994,1.701825,666,43,3638,2928,710,0.804838,0.195162,1.701326,667,43,1, merged,1,1,0
64073,1000015,1,2704,2425,279,0.89682,0.10318,0.89682,256,23,2705,2425,280,0.896488,0.103512,0.896488,257,23,1, merged,1,1,0
64079,1000003,1,1635,1350,285,0.825688,0.174312,0.825688,243,42,1636,1350,286,0.825183,0.174817,0.825183,244,42,1, merged,1,1,0
64079,1000109,3,797,691,106,0.867001,0.132999,2.475906,100,6,798,692,106,0.867168,0.132832,2.476173,100,6,1, merged,0,0,0
64080,1000003,1,1636,1350,286,0.825183,0.174817,0.825183,244,42,1639,1352,287,0.824893,0.175107,0.824893,245,42,1, merged,1,1,0
64080,1000109,3,798,692,106,0.867168,0.132832,2.476173,100,6,799,693,106,0.867334,0.132666,2.47635,100,6,1, merged,0,0,0
64081,1000329,2,4003,3128,875,0.781414,0.218586,1.600423,747,128,4004,3129,875,0.781469,0.218531,1.60066,747,128,1, merged,0,0,0
64081,1002169,1,989,810,179,0.819009,0.180991,0.819009,121,58,990,811,179,0.819192,0.180808,0.819192,121,58,-1, merged,0,0,0
64090,1000329,2,4004,3129,875,0.781469,0.218531,1.634534,747,128,4006,3131,875,0.781578,0.218422,1.633742,747,128,-1, merged,0,0,0
64090,1000592,1,946,807,139,0.853066,0.146934,0.853066,89,50,947,807,140,0.852165,0.147835,0.852165,90,50,1, merged,1,1,0
64091,1000007,1,2074,1670,404,0.805207,0.194793,0.805207,352,52,2076,1671,405,0.804913,0.195087,0.804913,353,52,1, merged,1,1,0
64095,1000109,2,799,693,106,0.867334,0.132666,1.651457,100,6,800,694,106,0.8675,0.1325,1.651923,100,6,1, merged,0,0,0
64096,1000199,2,712,614,98,0.86236,0.13764,1.646782,85,13,713,615,98,0.862553,0.137447,1.647275,85,13,1, merged,0,0,0
64103,1000014,2,3638,2928,710,0.804838,0.195162,1.588622,667,43,3642,2929,713,0.804228,0.195772,1.589594,670,43,1, merged,1,1,0
64103,1000026,4,774,652,122,0.842377,0.157623,3.279147,119,3,775,652,123,0.84129,0.15871,3.277465,120,3,1, merged,1,1,0
64106,1000004,1,5109,4492,617,0.879233,0.120767,0.879233,492,125,5110,4493,617,0.879256,0.120744,0.879256,492,125,1, merged,0,0,0
64106,1000120,2,2461,2169,292,0.881349,0.118651,1.760582,255,37,2462,2170,292,0.881397,0.118603,1.760654,255,37,1, merged,0,0,0
64107,1000009,2,2303,1923,380,0.834998,0.165002,1.698804,336,44,2304,1924,380,0.835069,0.164931,1.697267,336,44,1, merged,0,0,0
64111,1000009,2,2308,1928,380,0.835355,0.164645,1.835355,336,44,2309,1929,380,0.835427,0.164573,1.835427,336,44,-1, abandoned,0,0,0
64112,1000130,2,952,797,155,0.837185,0.162815,1.689298,120,35,953,798,155,0.837356,0.162644,1.684578,120,35,-1, merged,0,0,0
64122,1000014,2,3642,2929,713,0.804228,0.195772,1.429228,670,43,3643,2930,713,0.804282,0.195718,1.444282,670,43,1, merged,0,0,0
64126,1000007,3,2076,1671,405,0.804913,0.195087,2.466079,353,52,2077,1672,405,0.805007,0.194993,2.462453,353,52,1, merged,0,0,0
64126,1000026,2,775,652,123,0.84129,0.15871,1.661166,120,3,776,653,123,0.841495,0.158505,1.657446,120,3,1, merged,0,0,0
64133,1000004,2,5110,4493,617,0.879256,0.120744,1.775744,492,125,5111,4494,617,0.87928,0.12072,1.775806,492,125,1, merged,0,0,0
64133,1000015,1,2705,2425,280,0.896488,0.103512,0.896488,257,23,2706,2426,280,0.896526,0.103474,0.896526,257,23,1, merged,0,0,0
64143,1000130,2,953,798,155,0.837356,0.162644,0.837356,120,35,954,798,156,0.836478,0.163522,1.336478,120,36,-1, merged,1,1,0
64150,1000014,1,3644,2931,713,0.804336,0.195664,0.804336,670,43,3645,2932,713,0.80439,0.19561,0.80439,670,43,1, merged,0,0,0
64153,1000004,3,5111,4494,617,0.87928,0.12072,2.421943,492,125,5112,4495,617,0.879304,0.120696,2.42041,492,125,-1, merged,0,0,0
64153,1000091,1,703,558,145,0.793741,0.206259,0.793741,122,23,704,558,146,0.792614,0.207386,0.792614,123,23,1, merged,1,1,0
64153,1000328,2,1159,868,291,0.748921,0.251079,1.542663,259,32,1161,869,292,0.748493,0.251507,1.541106,260,32,1, merged,1,1,0
64154,1000132,2,959,796,163,0.830031,0.169969,1.578524,138,25,960,797,163,0.830208,0.169792,1.579134,138,25,1, merged,0,0,0
64154,1000328,1,1161,869,292,0.748493,0.251507,0.748493,260,32,1163,871,292,0.748925,0.251075,0.748925,260,32,1, merged,0,0,0
64155,1000023,1,2114,1852,262,0.876064,0.123936,0.876064,232,30,2116,1853,263,0.875709,0.124291,0.875709,233,30,1, merged,1,1,0
64172,1000009,2,2317,1936,381,0.835563,0.164437,1.732089,337,44,2319,1937,382,0.835274,0.164726,1.731838,338,44,1, merged,1,1,0
64172,1000015,1,2706,2426,280,0.896526,0.103474,0.896526,257,23,2707,2427,280,0.896564,0.103436,0.896564,257,23,-1, merged,0,0,0
64183,1000009,1,2320,1938,382,0.835345,0.164655,0.835345,338,44,2321,1939,382,0.835416,0.164584,0.835416,338,44,-1, merged,0,0,0
64183,1000026,3,776,653,123,0.841495,0.158505,2.283397,120,3,777,654,123,0.841699,0.158301,2.280289,120,3,1, merged,0,0,0
64183,1000534,4,790,603,187,0.763291,0.236709,3.046688,163,24,791,604,187,0.76359,0.23641,3.04388,163,24,1, merged,0,0,0
64197,1000014,2,3651,2938,713,0.804711,0.195289,1.804711,670,43,3652,2939,713,0.804765,0.195235,1.804765,670,43,1, merged,0,0,0
64202,1000015,2,2711,2430,281,0.896348,0.103652,1.896348,258,23,2712,2431,281,0.896386,0.103614,1.896386,258,23,1, merged,0,0,0
64203,1000011,2,1063,974,89,0.916275,0.083725,1.792325,83,6,1064,975,89,0.916353,0.083647,1.792664,83,6,1, merged,0,0,0
64222,1000004,3,5112,4495,617,0.879304,0.120696,2.397126,492,125,5115,4498,617,0.879374,0.120626,2.392347,492,125,-1, merged,0,0,0
64222,1002169,1,990,811,179,0.819192,0.180808,0.819192,121,58,995,815,180,0.819095,0.180905,0.819095,121,59,-1, merged,1,0,0
64226,1000005,2,1100,965,135,0.877273,0.122727,1.713548,125,10,1101,966,135,0.877384,0.122616,1.713716,125,10,1, merged,0,0,0
64226,1000121,1,2889,2416,473,0.836276,0.163724,0.836276,437,36,2890,2417,473,0.836332,0.163668,0.836332,437,36,1, merged,0,0,0
64230,1000009,2,2324,1942,382,0.835628,0.164372,1.692771,338,44,2325,1943,382,0.835699,0.164301,1.692996,338,44,1, merged,0,0,0
64230,1000012,1,924,792,132,0.857143,0.142857,0.857143,128,4,925,793,132,0.857297,0.142703,0.857297,128,4,1, merged,0,0,0
64232,1000005,1,1101,966,135,0.877384,0.122616,0.877384,125,10,1102,967,135,0.877495,0.122505,0.877495,125,10,1, merged,0,0,0
64232,1000121,2,2890,2417,473,0.836332,0.163668,1.713716,437,36,2891,2418,473,0.836389,0.163611,1.713884,437,36,1, merged,0,0,0
64239,1000014,2,3654,2941,713,0.804871,0.195129,1.444871,670,43,3655,2942,713,0.804925,0.195075,1.458771,670,43,1, merged,0,0,0
64242,1000004,2,5115,4498,617,0.879374,0.120626,1.379374,492,125,5116,4499,617,0.879398,0.120602,1.379398,492,125,1, merged,0,0,0
64242,1000592,3,947,807,140,0.852165,0.147835,2.231539,90,50,948,808,140,0.852321,0.147679,2.231719,90,50,1, merged,0,0,0
64244,1000009,1,2330,1948,382,0.836052,0.163948,0.836052,338,44,2332,1949,383,0.835763,0.164237,0.835763,339,44,1, merged,1,1,0
64244,1000534,2,791,604,187,0.76359,0.23641,1.599642,163,24,792,605,187,0.763889,0.236111,1.599652,163,24,1, merged,0,0,0
64248,1000004,1,5116,4499,617,0.879398,0.120602,0.879398,492,125,5117,4499,618,0.879226,0.120774,0.879226,493,125,1, merged,1,1,0
64250,1000132,1,961,797,164,0.829344,0.170656,0.829344,139,25,963,798,165,0.82866,0.17134,0.82866,140,25,1, merged,1,1,0
64264,1000329,2,4007,3132,875,0.781632,0.218368,1.600728,747,128,4009,3134,875,0.781741,0.218259,1.601018,747,128,-1, merged,0,0,0
64264,1002169,1,995,815,180,0.819095,0.180905,0.819095,121,59,996,816,180,0.819277,0.180723,0.819277,121,59,-1, merged,0,0,0
64269,1000005,1,1102,967,135,0.877495,0.122505,0.877495,125,10,1103,968,135,0.877607,0.122393,0.877607,125,10,1, merged,0,0,0
64269,1000121,2,2891,2418,473,0.836389,0.163611,1.713884,437,36,2892,2419,473,0.836445,0.163555,1.714052,437,36,1, merged,0,0,0
64270,1000005,1,1103,968,135,0.877607,0.122393,0.877607,125,10,1104,969,135,0.877717,0.122283,0.877717,125,10,1, merged,0,0,0
64270,1000121,2,2892,2419,473,0.836445,0.163555,1.714052,437,36,2893,2420,473,0.836502,0.163498,1.714219,437,36,1, merged,0,0,0
64271,1000005,1,1104,969,135,0.877717,0.122283,0.877717,125,10,1105,970,135,0.877828,0.122172,0.877828,125,10,1, merged,0,0,0
64271,1000121,2,2893,2420,473,0.836502,0.163498,1.714219,437,36,2894,2421,473,0.836558,0.163442,1.714386,437,36,1, merged,0,0,0
64272,1000003,3,1639,1352,287,0.824893,0.175107,2.411581,245,42,1640,1353,287,0.825,0.175,2.411795,245,42,1, merged,0,0,0
64272,1000014,2,3656,2943,713,0.804978,0.195022,1.586688,670,43,3657,2944,713,0.805031,0.194969,1.586795,670,43,1, merged,0,0,0
64272,1000329,1,4013,3137,876,0.781709,0.218291,0.781709,748,128,4014,3138,876,0.781764,0.218236,0.781764,748,128,1, merged,0,0,0
64280,1000004,3,5118,4500,618,0.87925,0.12075,2.456293,493,125,5119,4500,619,0.879078,0.120922,2.457072,493,126,-1, merged,1,1,0
64280,1000121,2,2894,2421,473,0.836558,0.163442,1.577043,437,36,2895,2422,473,0.836615,0.163385,1.577994,437,36,1, merged,0,0,0
64292,1000132,1,963,798,165,0.82866,0.17134,0.82866,140,25,966,801,165,0.829193,0.170807,0.829193,140,25,-1, merged,0,0,0
64294,1000132,1,967,802,165,0.829369,0.170631,0.829369,140,25,969,804,165,0.829721,0.170279,0.829721,140,25,-1, abandoned,0,0,0
64294,1000328,3,1165,873,292,0.749356,0.250644,2.398003,260,32,1166,874,292,0.749571,0.250429,2.398751,260,32,-1, abandoned,0,0,0
64294,1002169,2,996,816,180,0.819277,0.180723,1.648646,121,59,997,817,180,0.819458,0.180542,1.64918,121,59,-1, abandoned,0,0,0
64299,1000005,2,1108,973,135,0.878159,0.121841,1.619538,125,10,1109,974,135,0.878269,0.121731,1.616364,125,10,1, merged,0,0,0
64301,1000003,3,1640,1353,287,0.825,0.175,2.528263,245,42,1641,1354,287,0.825107,0.174893,2.528606,245,42,1, merged,0,0,0
64301,1000009,2,2332,1949,383,0.835763,0.164237,1.703263,339,44,2333,1950,383,0.835834,0.164166,1.703499,339,44,1, merged,0,0,0
64301,1000109,1,800,694,106,0.8675,0.1325,0.8675,100,6,801,695,106,0.867665,0.132335,0.867665,100,6,1, merged,0,0,0
64315,1000014,2,3664,2950,714,0.805131,0.194869,1.477545,671,43,3665,2951,714,0.805184,0.194816,1.48315,671,43,1, merged,0,0,0
64317,1000130,1,958,802,156,0.837161,0.162839,0.837161,120,36,959,802,157,0.836288,0.163712,0.836288,121,36,1, merged,1,1,0
64321,1000023,1,2117,1854,263,0.875768,0.124232,0.875768,233,30,2119,1855,264,0.875413,0.124587,0.875413,234,30,1, merged,1,1,0
64325,1000014,1,3665,2951,714,0.805184,0.194816,0.805184,671,43,3666,2952,714,0.805237,0.194763,0.805237,671,43,-1, abandoned,0,0,0
64325,1000105,2,906,724,182,0.799117,0.200883,1.604301,152,30,907,724,183,0.798236,0.201764,1.603473,153,30,1, abandoned,1,1,0
64328,1000108,1,624,530,94,0.849359,0.150641,0.849359,88,6,625,531,94,0.8496,0.1504,0.8496,88,6,1, merged,0,0,0
64328,1000121,2,2899,2426,473,0.83684,0.16316,1.686199,437,36,2900,2427,473,0.836897,0.163103,1.686497,437,36,1, merged,0,0,0
64334,1000023,1,2119,1855,264,0.875413,0.124587,0.875413,234,30,2120,1856,264,0.875472,0.124528,0.875472,234,30,1, merged,0,0,0
64337,1000005,2,1110,975,135,0.878378,0.121622,1.75385,125,10,1111,976,135,0.878488,0.121512,1.754018,125,10,1, merged,0,0,0
64337,1000023,1,2120,1856,264,0.875472,0.124528,0.875472,234,30,2121,1857,264,0.87553,0.12447,0.87553,234,30,1, merged,0,0,0
64338,1000023,2,2121,1857,264,0.87553,0.12447,1.719213,234,30,2122,1857,265,0.875118,0.124882,1.716998,235,30,1, abandoned,1,1,0
64342,1000121,3,2900,2427,473,0.836897,0.163103,2.477353,437,36,2902,2428,474,0.836664,0.163336,2.472812,438,36,1, merged,1,1,0
64342,1000329,1,4015,3139,876,0.781818,0.218182,0.781818,748,128,4018,3142,876,0.781981,0.218019,0.781981,748,128,-1, merged,0,0,0
64343,1000108,1,625,531,94,0.8496,0.1504,0.8496,88,6,626,531,95,0.848243,0.151757,0.848243,89,6,1, abandoned,1,1,0
64344,1000108,1,626,531,95,0.848243,0.151757,0.848243,89,6,628,532,96,0.847134,0.152866,0.847134,90,6,1, merged,1,1,0
64372,1000120,2,2467,2175,292,0.881638,0.118362,1.666141,255,37,2468,2176,292,0.881686,0.118314,1.66671,255,37,1, merged,0,0,0
64378,1000091,4,707,561,146,0.793494,0.206506,3.244531,123,23,708,562,146,0.793785,0.206215,3.245623,123,23,-1, abandoned,0,0,0
64378,1000592,3,950,810,140,0.852632,0.147368,2.451037,90,50,951,811,140,0.852787,0.147213,2.451838,90,50,-1, abandoned,0,0,0
64378,1002169,1,997,817,180,0.819458,0.180542,0.819458,121,59,998,818,180,0.819639,0.180361,0.819639,121,59,-1, abandoned,0,0,0
64382,1000004,2,5123,4503,620,0.878977,0.121023,1.775478,494,126,5124,4504,620,0.879001,0.120999,1.77554,494,126,1, merged,0,0,0
64382,1000015,1,2715,2434,281,0.896501,0.103499,0.896501,258,23,2716,2435,281,0.896539,0.103461,0.896539,258,23,1, merged,0,0,0
64383,1000004,2,5124,4504,620,0.879001,0.120999,1.77554,494,126,5125,4505,620,0.879024,0.120976,1.775601,494,126,1, merged,0,0,0
64383,1000015,1,2716,2435,281,0.896539,0.103461,0.896539,258,23,2717,2436,281,0.896577,0.103423,0.896577,258,23,1, merged,0,0,0
64384,1000004,2,5125,4505,620,0.879024,0.120976,1.775601,494,126,5126,4506,620,0.879048,0.120952,1.775663,494,126,1, merged,0,0,0
64384,1000015,1,2717,2436,281,0.896577,0.103423,0.896577,258,23,2718,2437,281,0.896615,0.103385,0.896615,258,23,1, merged,0,0,0
64386,1000015,2,2718,2437,281,0.896615,0.103385,1.771733,258,23,2719,2438,281,0.896653,0.103347,1.77183,258,23,1, merged,0,0,0
64386,1000023,1,2122,1857,265,0.875118,0.124882,0.875118,235,30,2123,1858,265,0.875177,0.124823,0.875177,235,30,1, merged,0,0,0
64393,1000043,1,718,593,125,0.825905,0.174095,0.825905,107,18,719,593,126,0.824757,0.175243,0.824757,108,18,1, merged,1,1,0
64394,1000005,3,1114,978,136,0.877917,0.122083,2.425615,126,10,1116,980,136,0.878136,0.121864,2.424414,126,10,-1, merged,0,0,0
64394,1000014,2,3669,2955,714,0.805397,0.194603,1.547698,671,43,3670,2955,715,0.805177,0.194823,1.546277,672,43,1, merged,1,1,0
64397,1000329,2,4019,3143,876,0.782035,0.217965,1.782035,748,128,4020,3144,876,0.78209,0.21791,1.78209,748,128,-1, abandoned,0,0,0
64404,1000105,2,907,724,183,0.798236,0.201764,1.536491,153,30,909,725,184,0.79758,0.20242,1.533366,154,30,1, merged,1,1,0
64406,1000166,1,666,505,161,0.758258,0.241742,0.758258,154,7,667,506,161,0.758621,0.241379,0.758621,154,7,1, merged,0,0,0
64408,1000592,1,951,811,140,0.852787,0.147213,0.852787,90,50,953,812,141,0.852046,0.147954,0.852046,91,50,1, merged,1,1,0
64410,1000592,1,953,812,141,0.852046,0.147954,0.852046,91,50,955,813,142,0.851309,0.148691,0.851309,92,50,1, merged,1,1,0
64417,1000120,1,2468,2176,292,0.881686,0.118314,0.881686,255,37,2472,2180,292,0.881877,0.118123,0.881877,255,37,-1, merged,0,0,0
64419,1000105,2,914,727,187,0.795405,0.204595,1.355405,157,30,915,728,187,0.795628,0.204372,1.364256,157,30,1, merged,0,0,0
64431,1000004,1,5126,4506,620,0.879048,0.120952,0.879048,494,126,5127,4507,620,0.879072,0.120928,0.879072,494,126,-1, merged,0,0,0
64434,1000009,1,2339,1955,384,0.835827,0.164173,0.835827,340,44,2340,1956,384,0.835897,0.164103,0.835897,340,44,1, merged,0,0,0
64434,1000015,2,2720,2439,281,0.896691,0.103309,1.732518,258,23,2721,2440,281,0.896729,0.103271,1.732627,258,23,1, merged,0,0,0
64440,1000023,1,2123,1858,265,0.875177,0.124823,0.875177,235,30,2124,1859,265,0.875235,0.124765,0.875235,235,30,1, merged,0,0,0
64441,1000004,2,5127,4507,620,0.879072,0.120928,1.379072,494,126,5128,4508,620,0.879095,0.120905,1.345762,494,126,-1, abandoned,0,0,0
64443,1000004,1,5128,4508,620,0.879095,0.120905,0.879095,494,126,5129,4509,620,0.879119,0.120881,0.879119,494,126,-1, abandoned,0,0,0
64445,1000014,4,3670,2955,715,0.805177,0.194823,3.103338,672,43,3671,2956,715,0.80523,0.19477,3.101952,672,43,1, merged,0,0,0
64446,1000121,2,2906,2431,475,0.836545,0.163455,1.571485,439,36,2908,2433,475,0.836657,0.163343,1.569216,439,36,-1, merged,0,0,0
64450,1000004,2,5129,4509,620,0.879119,0.120881,1.684349,494,126,5130,4510,620,0.879142,0.120858,1.684206,494,126,1, merged,0,0,0
64450,1000014,1,3671,2956,715,0.80523,0.19477,0.80523,672,43,3673,2957,716,0.805064,0.194936,0.805064,673,43,1, merged,1,1,0
64453,1000121,3,2908,2433,475,0.836657,0.163343,2.368537,439,36,2909,2434,475,0.836714,0.163286,2.374641,439,36,1, merged,0,0,0
64454,1000121,3,2909,2434,475,0.836714,0.163286,2.374641,439,36,2910,2435,475,0.83677,0.16323,2.371872,439,36,1, merged,0,0,0
64456,1000004,1,5130,4510,620,0.879142,0.120858,0.879142,494,126,5131,4511,620,0.879166,0.120834,0.879166,494,126,-1, merged,0,0,0
64456,1000120,2,2473,2181,292,0.881925,0.118075,1.761067,255,37,2476,2184,292,0.882068,0.117932,1.761234,255,37,-1, merged,0,0,0
64457,1000004,1,5131,4511,620,0.879166,0.120834,0.879166,494,126,5132,4512,620,0.879189,0.120811,0.879189,494,126,-1, merged,0,0,0
64457,1000014,4,3673,2957,716,0.805064,0.194936,3.222242,673,43,3675,2959,716,0.80517,0.19483,3.21348,673,43,-1, merged,0,0,0
64458,1000121,2,2910,2435,475,0.83677,0.16323,1.584433,439,36,2911,2436,475,0.836826,0.163174,1.577567,439,36,1, merged,0,0,0
64459,1000014,2,3675,2959,716,0.80517,0.19483,1.545911,673,43,3677,2960,717,0.805004,0.194996,1.550459,674,43,1, merged,1,1,0
64460,1000014,2,3677,2960,717,0.805004,0.194996,1.550459,674,43,3679,2961,718,0.804838,0.195162,1.552664,675,43,1, merged,1,1,0
64463,1000014,1,3679,2961,718,0.804838,0.195162,0.804838,675,43,3680,2962,718,0.804891,0.195109,0.804891,675,43,1, merged,0,0,0
64464,1000014,2,3680,2962,718,0.804891,0.195109,1.548481,675,43,3682,2963,719,0.804726,0.195274,1.542014,676,43,1, merged,1,1,0
64465,1000023,1,2124,1859,265,0.875235,0.124765,0.875235,235,30,2125,1860,265,0.875294,0.124706,0.875294,235,30,1, merged,0,0,0
64467,1000023,2,2125,1860,265,0.875294,0.124706,1.708627,235,30,2126,1861,265,0.875353,0.124647,1.732496,235,30,1, merged,0,0,0
64474,1000004,1,5132,4512,620,0.879189,0.120811,0.879189,494,126,5133,4513,620,0.879213,0.120787,0.879213,494,126,1, merged,0,0,0
64474,1000120,2,2476,2184,292,0.882068,0.117932,1.761257,255,37,2477,2185,292,0.882115,0.117885,1.761328,255,37,1, merged,0,0,0
64475,1000004,1,5133,4513,620,0.879213,0.120787,0.879213,494,126,5134,4514,620,0.879236,0.120764,0.879236,494,126,1, merged,0,0,0
64475,1000120,2,2477,2185,292,0.882115,0.117885,1.761328,255,37,2478,2186,292,0.882163,0.117837,1.761399,255,37,1, merged,0,0,0
64476,1000004,2,5134,4514,620,0.879236,0.120764,1.698876,494,126,5136,4516,620,0.879283,0.120717,1.699103,494,126,-1, merged,0,0,0
64476,1000120,3,2478,2186,292,0.882163,0.117837,2.581039,255,37,2479,2187,292,0.882211,0.117789,2.581314,255,37,1, merged,0,0,0
64476,1002169,1,998,818,180,0.819639,0.180361,0.819639,121,59,999,819,180,0.81982,0.18018,0.81982,121,59,-1, merged,0,0,0
64477,1000004,2,5136,4516,620,0.879283,0.120717,1.699103,494,126,5137,4517,620,0.879307,0.120693,1.698307,494,126,1, merged,0,0,0
64477,1000120,3,2479,2187,292,0.882211,0.117789,2.581314,255,37,2480,2188,292,0.882258,0.117742,2.580565,255,37,1, merged,0,0,0
64477,1002169,1,999,819,180,0.81982,0.18018,0.81982,121,59,1000,819,181,0.819,0.181,0.819,121,60,-1, merged,1,1,0
64478,1000004,2,5137,4517,620,0.879307,0.120693,1.698307,494,126,5138,4518,620,0.87933,0.12067,1.697512,494,126,1, merged,0,0,0
64478,1000120,3,2480,2188,292,0.882258,0.117742,2.580565,255,37,2481,2189,292,0.882306,0.117694,2.579818,255,37,1, merged,0,0,0
64478,1002169,1,1000,819,181,0.819,0.181,0.819,121,60,1001,819,182,0.818182,0.181818,0.818182,121,61,-1, merged,1,1,0
64479,1000004,2,5138,4518,620,0.87933,0.12067,1.697512,494,126,5139,4519,620,0.879354,0.120646,1.696719,494,126,1, merged,0,0,0
64479,1000120,3,2481,2189,292,0.882306,0.117694,2.579818,255,37,2482,2190,292,0.882353,0.117647,2.579072,255,37,1, merged,0,0,0
64479,1002169,1,1001,819,182,0.818182,0.181818,0.818182,121,61,1002,819,183,0.817365,0.182635,0.817365,121,62,-1, merged,1,1,0
64480,1000004,1,5139,4519,620,0.879354,0.120646,0.879354,494,126,5141,4520,621,0.879206,0.120794,0.879206,495,126,-1, merged,1,0,0
64480,1000120,2,2482,2190,292,0.882353,0.117647,1.761707,255,37,2483,2191,292,0.8824,0.1176,1.761607,255,37,1, merged,0,0,0
64481,1000004,1,5141,4520,621,0.879206,0.120794,0.879206,495,126,5143,4521,622,0.879059,0.120941,0.879059,496,126,-1, merged,1,0,0
64481,1000120,2,2483,2191,292,0.8824,0.1176,1.761607,255,37,2485,2192,293,0.882093,0.117907,1.761151,256,37,1, merged,1,1,0
64482,1000004,1,5143,4521,622,0.879059,0.120941,0.879059,496,126,5145,4522,623,0.878912,0.121088,0.878912,496,127,1, merged,1,0,0
64482,1000120,2,2485,2192,293,0.882093,0.117907,1.761151,256,37,2486,2193,293,0.88214,0.11786,1.761052,256,37,1, merged,0,0,0
64483,1000004,1,5145,4522,623,0.878912,0.121088,0.878912,496,127,5146,4523,623,0.878935,0.121065,0.878935,496,127,1, merged,0,0,0
64483,1000120,2,2486,2193,293,0.88214,0.11786,1.761052,256,37,2487,2194,293,0.882187,0.117813,1.761122,256,37,1, merged,0,0,0
64484,1000004,1,5146,4523,623,0.878935,0.121065,0.878935,496,127,5147,4524,623,0.878959,0.121041,0.878959,496,127,-1, merged,0,0,0
64484,1000121,4,2911,2436,475,0.836826,0.163174,3.234506,439,36,2913,2438,475,0.836938,0.163062,3.220649,439,36,-1, merged,0,0,0
64485,1000014,3,3687,2966,721,0.804448,0.195552,2.226264,678,43,3688,2967,721,0.804501,0.195499,2.216855,678,43,1, merged,0,0,0
64485,1000120,4,2487,2194,293,0.882187,0.117813,3.108451,256,37,2488,2195,293,0.882235,0.117765,3.09909,256,37,1, merged,0,0,0
64487,1000023,1,2126,1861,265,0.875353,0.124647,0.875353,235,30,2127,1862,265,0.875411,0.124589,0.875411,235,30,1, merged,0,0,0
64488,1000329,1,4025,3149,876,0.78236,0.21764,0.78236,748,128,4027,3151,876,0.782468,0.217532,0.782468,748,128,-1, merged,0,0,0
64489,1000329,1,4027,3151,876,0.782468,0.217532,0.782468,748,128,4029,3153,876,0.782576,0.217424,0.782576,748,128,-1, abandoned,0,0,0
64492,1000011,1,1066,977,89,0.91651,0.08349,0.91651,83,6,1067,977,90,0.915651,0.084349,0.915651,84,6,1, merged,1,1,0
64492,1000014,2,3688,2967,721,0.804501,0.195499,1.721011,678,43,3691,2968,723,0.804118,0.195882,1.719769,680,43,1, merged,1,1,0
64492,1000015,4,2725,2444,281,0.896881,0.103119,3.513544,258,23,2726,2445,281,0.896919,0.103081,3.512521,258,23,1, merged,0,0,0
64503,1000012,2,931,796,135,0.854995,0.145005,1.659113,130,5,932,797,135,0.85515,0.14485,1.659321,130,5,1, merged,0,0,0
64503,1000014,1,3691,2968,723,0.804118,0.195882,0.804118,680,43,3692,2969,723,0.804171,0.195829,0.804171,680,43,1, merged,0,0,0
64510,1000043,2,721,594,127,0.823856,0.176144,1.669037,109,18,722,595,127,0.8241,0.1759,1.669526,109,18,1, merged,0,0,0
64510,1000108,1,633,535,98,0.845182,0.154818,0.845182,92,6,634,536,98,0.845426,0.154574,0.845426,92,6,1, merged,0,0,0
64513,1000054,1,1384,1170,214,0.845376,0.154624,0.845376,197,17,1386,1171,215,0.844877,0.155123,0.844877,198,17,1, merged,1,1,0
64514,1000005,2,1116,980,136,0.878136,0.121864,1.715074,126,10,1117,981,136,0.878245,0.121755,1.715239,126,10,1, merged,0,0,0
64514,1000121,1,2913,2438,475,0.836938,0.163062,0.836938,439,36,2914,2439,475,0.836994,0.163006,0.836994,439,36,-1, merged,0,0,0
64535,1000534,1,794,607,187,0.764484,0.235516,0.764484,163,24,795,608,187,0.76478,0.23522,0.76478,163,24,1, merged,0,0,0
64543,1000005,2,1118,982,136,0.878354,0.121646,1.67214,126,10,1119,982,137,0.877569,0.122431,1.670235,127,10,1, abandoned,1,1,0
64543,1000043,4,724,597,127,0.824586,0.175414,3.342394,109,18,725,597,128,0.823448,0.176552,3.338023,110,18,1, abandoned,1,1,0
64543,1000091,1,708,562,146,0.793785,0.206215,0.793785,123,23,709,562,147,0.792666,0.207334,0.792666,124,23,1, abandoned,1,1,0
64543,1000108,3,635,537,98,0.845669,0.154331,2.517809,92,6,636,537,99,0.84434,0.15566,2.514575,93,6,1, abandoned,1,1,0
64552,1000014,2,3692,2969,723,0.804171,0.195829,1.568951,680,43,3694,2970,724,0.804006,0.195994,1.567826,681,43,1, merged,1,1,0
64552,1000534,1,795,608,187,0.76478,0.23522,0.76478,163,24,796,608,188,0.763819,0.236181,0.763819,164,24,1, merged,1,1,0
64554,1000015,2,2727,2446,281,0.896956,0.103044,1.660775,258,23,2728,2446,282,0.896628,0.103372,1.661628,259,23,1, merged,1,1,0
64554,1000534,1,796,608,188,0.763819,0.236181,0.763819,164,24,800,612,188,0.765,0.235,0.765,164,24,-1, merged,0,0,0
64556,1000014,2,3694,2970,724,0.804006,0.195994,1.641056,681,43,3695,2971,724,0.80406,0.19594,1.641165,681,43,1, merged,0,0,0
64556,1000121,1,2915,2440,475,0.83705,0.16295,0.83705,439,36,2916,2441,475,0.837106,0.162894,0.837106,439,36,1, merged,0,0,0
64558,1000014,2,3695,2971,724,0.80406,0.19594,1.641221,681,43,3696,2972,724,0.804113,0.195887,1.64133,681,43,1, merged,0,0,0
64558,1000121,1,2917,2442,475,0.837161,0.162839,0.837161,439,36,2918,2443,475,0.837217,0.162783,0.837217,439,36,1, merged,0,0,0
64563,1000005,1,1119,982,137,0.877569,0.122431,0.877569,127,10,1120,983,137,0.877679,0.122321,0.877679,127,10,1, merged,0,0,0
64563,1000121,2,2922,2447,475,0.83744,0.16256,1.715009,439,36,2923,2448,475,0.837496,0.162504,1.715174,439,36,1, merged,0,0,0
64563,1000328,3,1170,877,293,0.749573,0.250427,2.464582,261,32,1171,878,293,0.749787,0.250213,2.464961,261,32,1, merged,0,0,0
64566,1000005,1,1120,983,137,0.877679,0.122321,0.877679,127,10,1121,984,137,0.877788,0.122212,0.877788,127,10,1, merged,0,0,0
64566,1000014,4,3696,2972,724,0.804113,0.195887,3.269184,681,43,3697,2973,724,0.804166,0.195834,3.269616,681,43,1, merged,0,0,0
64566,1000121,2,2925,2450,475,0.837607,0.162393,1.715285,439,36,2926,2451,475,0.837662,0.162338,1.71545,439,36,1, merged,0,0,0
64566,1000328,3,1171,878,293,0.749787,0.250213,2.465072,261,32,1172,879,293,0.75,0.25,2.46545,261,32,1, merged,0,0,0
64569,1000014,1,3697,2973,724,0.804166,0.195834,0.804166,681,43,3698,2974,724,0.804218,0.195782,0.804218,681,43,1, merged,0,0,0
64569,1000328,3,1172,879,293,0.75,0.25,2.335542,261,32,1173,880,293,0.750213,0.249787,2.33625,261,32,1, merged,0,0,0
64570,1000328,2,1173,880,293,0.750213,0.249787,1.532031,261,32,1174,881,293,0.750426,0.249574,1.532684,261,32,1, merged,0,0,0
64575,1000140,2,633,527,106,0.832543,0.167457,1.619114,94,12,634,528,106,0.832808,0.167192,1.619889,94,12,1, merged,0,0,0
64576,1000023,1,2128,1863,265,0.87547,0.12453,0.87547,235,30,2131,1865,266,0.875176,0.124824,0.875176,236,30,1, merged,1,1,0
64578,1000105,1,915,728,187,0.795628,0.204372,0.795628,157,30,916,729,187,0.795852,0.204148,0.795852,157,30,1, merged,0,0,0
64578,1000132,2,969,804,165,0.829721,0.170279,1.62535,140,25,970,805,165,0.829897,0.170103,1.625748,140,25,1, merged,0,0,0
64581,1000327,3,759,603,156,0.794466,0.205534,2.077043,120,36,760,604,156,0.794737,0.205263,2.097421,120,36,1, merged,0,0,0
64581,1000329,2,4029,3153,876,0.782576,0.217424,1.282576,748,128,4031,3155,876,0.782684,0.217316,1.302684,748,128,-1, merged,0,0,0
64588,1000005,1,1121,984,137,0.877788,0.122212,0.877788,127,10,1122,985,137,0.877897,0.122103,0.877897,127,10,1, merged,0,0,0
64588,1000014,3,3703,2979,724,0.804483,0.195517,2.396556,681,43,3704,2980,724,0.804536,0.195464,2.397879,681,43,1, merged,0,0,0
64597,1000023,1,2132,1866,266,0.875235,0.124765,0.875235,236,30,2133,1867,266,0.875293,0.124707,0.875293,236,30,1, merged,0,0,0
64599,1000003,2,1648,1361,287,0.82585,0.17415,1.643215,245,42,1650,1362,288,0.825455,0.174545,1.643002,246,42,1, merged,1,1,0
64599,1000004,3,5149,4526,623,0.879006,0.120994,2.52222,496,127,5150,4527,623,0.879029,0.120971,2.522031,496,127,-1, merged,0,0,0
64599,1000120,4,2488,2195,293,0.882235,0.117765,3.404455,256,37,2489,2196,293,0.882282,0.117718,3.404313,256,37,1, merged,0,0,0
64599,1002169,1,1002,819,183,0.817365,0.182635,0.817365,121,62,1003,820,183,0.817547,0.182453,0.817547,121,62,-1, merged,0,0,0
64604,1000091,1,709,562,147,0.792666,0.207334,0.792666,124,23,710,563,147,0.792958,0.207042,0.792958,124,23,-1, merged,0,0,0
64605,1000014,2,3704,2980,724,0.804536,0.195464,1.522093,681,43,3706,2981,725,0.804371,0.195629,1.516493,682,43,1, merged,1,1,0
64606,1000120,2,2489,2196,293,0.882282,0.117718,1.594403,256,37,2490,2196,294,0.881928,0.118072,1.590883,257,37,1, abandoned,1,1,0
64607,1000014,3,3706,2981,725,0.804371,0.195629,2.395254,682,43,3707,2982,725,0.804424,0.195576,2.397558,682,43,1, merged,0,0,0
64607,1000120,1,2490,2196,294,0.881928,0.118072,0.881928,257,37,2492,2198,294,0.882022,0.117978,0.882022,257,37,-1, merged,0,0,0
64622,1000011,2,1069,979,90,0.915809,0.084191,1.770355,84,6,1070,980,90,0.915888,0.084112,1.768601,84,6,1, merged,0,0,0
64629,1000592,2,956,814,142,0.851464,0.148536,1.704557,92,50,957,815,142,0.85162,0.14838,1.702519,92,50,-1, abandoned,0,0,0
64630,1000592,2,957,815,142,0.85162,0.14838,1.713524,92,50,958,816,142,0.851775,0.148225,1.714334,92,50,1, merged,0,0,0
64639,1000140,1,634,528,106,0.832808,0.167192,0.832808,94,12,635,529,106,0.833071,0.166929,0.833071,94,12,1, merged,0,0,0
64642,1000015,2,2728,2446,282,0.896628,0.103372,1.769355,259,23,2729,2447,282,0.896665,0.103335,1.771665,259,23,1, merged,0,0,0
64642,1000329,3,4033,3157,876,0.782792,0.217208,2.552147,748,128,4034,3158,876,0.782846,0.217154,2.554511,748,128,1, merged,0,0,0
64646,1000014,2,3709,2984,725,0.80453,0.19547,1.458376,682,43,3710,2985,725,0.804582,0.195418,1.471249,682,43,1, merged,0,0,0
64653,1000005,2,1122,985,137,0.877897,0.122103,1.664978,127,10,1123,986,137,0.878005,0.121995,1.665595,127,10,1, merged,0,0,0
64654,1000120,2,2492,2198,294,0.882022,0.117978,1.744582,257,37,2493,2199,294,0.88207,0.11793,1.745277,257,37,-1, abandoned,0,0,0
64656,1000014,2,3710,2985,725,0.804582,0.195418,1.471249,682,43,3711,2986,725,0.804635,0.195365,1.483206,682,43,1, merged,0,0,0
64661,1000011,2,1070,980,90,0.915888,0.084112,1.767929,84,6,1071,981,90,0.915966,0.084034,1.768384,84,6,1, merged,0,0,0
64668,1000015,1,2731,2449,282,0.896741,0.103259,0.896741,259,23,2733,2450,283,0.896451,0.103549,0.896451,260,23,1, merged,1,1,0
64668,1000329,2,4035,3159,876,0.7829,0.2171,1.679641,748,128,4036,3159,877,0.782706,0.217294,1.679156,748,129,-1, merged,1,1,0
64673,1000108,1,636,537,99,0.84434,0.15566,0.84434,93,6,637,538,99,0.844584,0.155416,0.844584,93,6,-1, merged,0,0,0
64673,1000110,2,818,736,82,0.899756,0.100244,1.744095,76,6,819,737,82,0.899878,0.100122,1.744462,76,6,1, merged,0,0,0
64674,1000014,4,3713,2988,725,0.80474,0.19526,3.136895,682,43,3714,2989,725,0.804793,0.195207,3.14873,682,43,1, merged,0,0,0
64675,1000132,2,973,808,165,0.830421,0.169579,1.644375,140,25,974,809,165,0.830595,0.169405,1.645624,140,25,1, merged,0,0,0
64680,1000004,2,5150,4527,623,0.879029,0.120971,1.661735,496,127,5151,4528,623,0.879053,0.120947,1.661866,496,127,-1, merged,0,0,0
64680,1000329,1,4036,3159,877,0.782706,0.217294,0.782706,748,129,4038,3161,877,0.782813,0.217187,0.782813,748,129,-1, merged,0,0,0
64681,1000014,2,3714,2989,725,0.804793,0.195207,1.494448,682,43,3715,2990,725,0.804845,0.195155,1.504845,682,43,1, merged,0,0,0
64685,1000004,1,5151,4528,623,0.879053,0.120947,0.879053,496,127,5154,4530,624,0.878929,0.121071,0.878929,497,127,-1, merged,1,0,0
64685,1000592,2,963,821,142,0.852544,0.147456,1.731597,92,50,964,822,142,0.852697,0.147303,1.731626,92,50,1, merged,0,0,0
64687,1000014,2,3716,2991,725,0.804898,0.195102,1.504898,682,43,3718,2992,726,0.804734,0.195266,1.492234,683,43,1, merged,1,1,0
64687,1000140,3,635,529,106,0.833071,0.166929,2.337969,94,12,636,530,106,0.833333,0.166667,2.325567,94,12,-1, merged,0,0,0
64689,1000329,2,4040,3162,878,0.782673,0.217327,1.570769,748,130,4042,3164,878,0.782781,0.217219,1.571379,748,130,1, merged,0,0,0
64695,1000014,2,3718,2992,726,0.804734,0.195266,1.492234,683,43,3720,2993,727,0.80457,0.19543,1.48104,684,43,1, merged,1,1,0
64697,1000121,2,2926,2451,475,0.837662,0.162338,1.491983,439,36,2928,2453,475,0.837773,0.162227,1.484115,439,36,-1, merged,0,0,0
64701,1000328,2,1174,881,293,0.750426,0.249574,0.750426,261,32,1175,882,293,0.750638,0.249362,1.750638,261,32,1, merged,0,0,0
64704,1000105,2,918,731,187,0.796296,0.203704,1.446899,157,30,919,732,187,0.796518,0.203482,1.45128,157,30,1, merged,0,0,0
64707,1000091,1,712,564,148,0.792135,0.207865,0.792135,125,23,713,565,148,0.792426,0.207574,0.792426,125,23,1, merged,0,0,0
64707,1000592,2,964,822,142,0.852697,0.147303,1.644832,92,50,965,823,142,0.85285,0.14715,1.645276,92,50,1, merged,0,0,0
64725,1000004,2,5155,4531,624,0.878952,0.121048,1.724053,497,127,5156,4532,624,0.878976,0.121024,1.724188,497,127,1, merged,0,0,0
64725,1000005,3,1124,987,137,0.878114,0.121886,2.602167,127,10,1125,988,137,0.878222,0.121778,2.602411,127,10,1, merged,0,0,0
64725,1000054,1,1388,1173,215,0.845101,0.154899,0.845101,198,17,1389,1174,215,0.845212,0.154788,0.845212,198,17,1, merged,0,0,0
64726,1000091,3,713,565,148,0.792426,0.207574,2.361458,125,23,714,566,148,0.792717,0.207283,2.362798,125,23,1, merged,0,0,0
64726,1000328,1,1179,886,293,0.751484,0.248516,0.751484,261,32,1182,888,294,0.751269,0.248731,0.751269,261,33,-1, merged,1,0,0
64726,1002169,2,1003,820,183,0.817547,0.182453,1.569032,121,62,1010,827,183,0.818812,0.181188,1.570081,121,62,-1, merged,0,0,0
64727,1000004,1,5156,4532,624,0.878976,0.121024,0.878976,497,127,5157,4533,624,0.878999,0.121001,0.878999,497,127,-1, abandoned,0,0,0
64727,1000005,2,1125,988,137,0.878222,0.121778,1.757198,127,10,1126,988,138,0.877442,0.122558,1.756442,128,10,1, abandoned,1,1,0
64727,1000328,3,1182,888,294,0.751269,0.248731,2.508467,261,33,1183,888,295,0.750634,0.249366,2.507076,262,33,1, abandoned,1,1,0
64741,1000005,1,1127,989,138,0.877551,0.122449,0.877551,128,10,1128,989,139,0.876773,0.123227,0.876773,129,10,1, merged,1,1,0
64741,1000014,2,3720,2993,727,0.80457,0.19543,1.682121,684,43,3723,2994,729,0.80419,0.19581,1.680963,686,43,1, merged,1,1,0
64742,1000004,1,5157,4533,624,0.878999,0.121001,0.878999,497,127,5158,4534,624,0.879023,0.120977,0.879023,497,127,-1, merged,0,0,0
64742,1000007,4,2097,1691,406,0.80639,0.19361,3.362739,354,52,2099,1692,407,0.806098,0.193902,3.360517,355,52,1, merged,1,1,0
64742,1000132,2,975,810,165,0.830769,0.169231,1.709769,140,25,977,811,166,0.830092,0.169908,1.709115,141,25,1, merged,1,1,0
64744,1000007,3,2102,1693,409,0.805423,0.194577,2.465756,357,52,2103,1694,409,0.805516,0.194484,2.465358,357,52,1, merged,0,0,0
64747,1000328,2,1183,888,295,0.750634,0.249366,1.573294,262,33,1185,890,295,0.751055,0.248945,1.574584,262,33,-1, merged,0,0,0
64762,1000004,4,5158,4534,624,0.879023,0.120977,3.127124,497,127,5159,4535,624,0.879046,0.120954,3.108423,497,127,-1, abandoned,0,0,0
64762,1000329,2,4042,3164,878,0.782781,0.217219,1.395684,748,130,4043,3165,878,0.782835,0.217165,1.376585,748,130,-1, abandoned,0,0,0
64767,1000014,5,3726,2996,730,0.804079,0.195921,3.170382,687,43,3727,2997,730,0.804132,0.195868,4.167258,687,43,1, merged,0,0,0
64767,1002169,1,1010,827,183,0.818812,0.181188,0.818812,121,62,1011,828,183,0.818991,0.181009,0.818991,121,62,-1, merged,0,0,0
64787,1000592,1,967,825,142,0.853154,0.146846,0.853154,92,50,968,826,142,0.853306,0.146694,0.853306,92,50,1, merged,0,0,0
64788,1000105,1,921,734,187,0.79696,0.20304,0.79696,157,30,923,734,189,0.795233,0.204767,0.795233,157,32,-1, merged,1,1,0
64788,1000140,2,636,530,106,0.833333,0.166667,1.630293,94,12,637,531,106,0.833595,0.166405,1.628828,94,12,1, merged,0,0,0
64799,1000108,2,637,538,99,0.844584,0.155416,1.744462,93,6,638,539,99,0.844828,0.155172,1.744828,93,6,1, merged,0,0,0
64799,1000110,1,819,737,82,0.899878,0.100122,0.899878,76,6,820,738,82,0.9,0.1,0.9,76,6,1, merged,0,0,0
64803,1000043,2,725,597,128,0.823448,0.176552,1.657043,110,18,726,598,128,0.823691,0.176309,1.657547,110,18,1, merged,0,0,0
64803,1000121,3,2936,2458,478,0.837193,0.162807,2.494237,442,36,2937,2459,478,0.837249,0.162751,2.494796,442,36,1, merged,0,0,0
64803,1000140,1,637,531,106,0.833595,0.166405,0.833595,94,12,638,532,106,0.833856,0.166144,0.833856,94,12,1, merged,0,0,0
64805,1000011,2,1072,982,90,0.916045,0.083955,0.916045,84,6,1073,983,90,0.916123,0.083877,1.916123,84,6,1, merged,0,0,0
64807,1000004,2,5159,4535,624,0.879046,0.120954,1.680416,497,127,5162,4538,624,0.879117,0.120883,1.676414,497,127,-1, merged,0,0,0
64811,1000023,1,2136,1869,267,0.875,0.125,0.875,237,30,2137,1870,267,0.875058,0.124942,0.875058,237,30,1, merged,0,0,0
64823,1000121,3,2937,2459,478,0.837249,0.162751,2.325059,442,36,2938,2460,478,0.837304,0.162696,2.324733,442,36,1, merged,0,0,0
64824,1000014,2,3729,2998,731,0.803969,0.196031,1.517204,688,43,3730,2999,731,0.804021,0.195979,1.51935,688,43,1, merged,0,0,0
64825,1000014,4,3730,2999,731,0.804021,0.195979,2.999426,688,43,3731,3000,731,0.804074,0.195926,2.986876,688,43,1, merged,0,0,0
64855,1000023,2,2151,1880,271,0.874012,0.125988,1.740583,241,30,2152,1881,271,0.874071,0.125929,1.740833,241,30,1, merged,0,0,0
64859,1000009,2,2351,1967,384,0.836665,0.163335,1.656978,340,44,2352,1968,384,0.836735,0.163265,1.659812,340,44,1, merged,0,0,0
64860,1000026,1,777,654,123,0.841699,0.158301,0.841699,120,3,778,655,123,0.841902,0.158098,0.841902,120,3,1, merged,0,0,0
64860,1000140,2,638,532,106,0.833856,0.166144,1.675555,94,12,639,533,106,0.834116,0.165884,1.676018,94,12,1, merged,0,0,0
64861,1000003,2,1651,1363,288,0.82556,0.17444,1.631353,246,42,1652,1363,289,0.825061,0.174939,1.630471,247,42,1, abandoned,1,1,0
64861,1000004,3,5162,4538,624,0.879117,0.120883,2.51047,497,127,5163,4539,624,0.87914,0.12086,2.509611,497,127,-1, abandoned,0,0,0
64861,1000007,1,2106,1697,409,0.805793,0.194207,0.805793,357,52,2107,1697,410,0.805411,0.194589,0.805411,358,52,1, abandoned,1,1,0
64863,1000054,3,1393,1177,216,0.844939,0.155061,2.300945,199,17,1394,1178,216,0.84505,0.15495,2.303453,199,17,1, merged,0,0,0
64863,1000166,2,671,510,161,0.76006,0.23994,1.456006,154,7,672,511,161,0.760417,0.239583,1.458403,154,7,1, merged,0,0,0
64864,1000132,2,979,813,166,0.830439,0.169561,1.72972,141,25,980,814,166,0.830612,0.169388,1.730612,141,25,1, merged,0,0,0
64867,1000014,1,3734,3002,732,0.803964,0.196036,0.803964,688,44,3735,3003,732,0.804016,0.195984,0.804016,688,44,1, merged,0,0,0
64870,1000015,1,2741,2457,284,0.896388,0.103612,0.896388,261,23,2742,2458,284,0.896426,0.103574,0.896426,261,23,1, merged,0,0,0
64870,1000026,2,778,655,123,0.841902,0.158098,1.73829,120,3,779,656,123,0.842105,0.157895,1.738531,120,3,1, merged,0,0,0
64880,1000009,3,2354,1969,385,0.836449,0.163551,2.725337,341,44,2355,1970,385,0.836518,0.163482,2.665089,341,44,1, merged,0,0,0
64884,1002169,1,1011,828,183,0.818991,0.181009,0.818991,121,62,1014,831,183,0.819527,0.180473,0.819527,121,62,-1, abandoned,0,0,0
64889,1000005,1,1132,993,139,0.877208,0.122792,0.877208,129,10,1134,993,141,0.875661,0.124339,0.875661,131,10,1, merged,1,1,0
64889,1000108,2,638,539,99,0.844828,0.155172,1.722036,93,6,639,540,99,0.84507,0.15493,1.720732,93,6,1, merged,0,0,0
64894,1000329,3,4052,3173,879,0.78307,0.21693,2.385618,749,130,4053,3174,879,0.783124,0.216876,2.385696,749,130,1, merged,0,0,0
64895,1000121,1,2941,2463,478,0.83747,0.16253,0.83747,442,36,2942,2464,478,0.837525,0.162475,0.837525,442,36,1, merged,0,0,0
64895,1000329,2,4053,3174,879,0.783124,0.216876,1.620594,749,130,4054,3175,879,0.783177,0.216823,1.620703,749,130,1, merged,0,0,0
64896,1000121,2,2942,2464,478,0.837525,0.162475,1.657052,442,36,2945,2466,479,0.837351,0.162649,1.657056,443,36,1, merged,1,1,0
64896,1000329,3,4054,3175,879,0.783177,0.216823,2.440229,749,130,4055,3176,879,0.783231,0.216769,2.440286,749,130,-1, merged,0,0,0
64896,1002169,1,1014,831,183,0.819527,0.180473,0.819527,121,62,1015,832,183,0.819704,0.180296,0.819704,121,62,-1, merged,0,0,0
64897,1000121,1,2945,2466,479,0.837351,0.162649,0.837351,443,36,2947,2467,480,0.837122,0.162878,0.837122,444,36,1, merged,1,1,0
64897,1000329,2,4055,3176,879,0.783231,0.216769,1.620582,749,130,4057,3177,880,0.783091,0.216909,1.620213,750,130,1, merged,1,1,0
64898,1000121,1,2947,2467,480,0.837122,0.162878,0.837122,444,36,2949,2468,481,0.836894,0.163106,0.836894,445,36,1, merged,1,1,0
64898,1000329,2,4057,3177,880,0.783091,0.216909,1.620213,750,130,4059,3179,880,0.783198,0.216802,1.620092,750,130,-1, merged,0,0,0
64899,1000121,1,2949,2468,481,0.836894,0.163106,0.836894,445,36,2951,2470,481,0.837004,0.162996,0.837004,445,36,-1, merged,0,0,0
64899,1000329,2,4059,3179,880,0.783198,0.216802,1.620092,750,130,4060,3180,880,0.783251,0.216749,1.620256,750,130,1, merged,0,0,0
64900,1000121,2,2951,2470,481,0.837004,0.162996,1.620256,445,36,2954,2472,482,0.836831,0.163169,1.61989,446,36,1, merged,1,1,0
64900,1000329,1,4060,3180,880,0.783251,0.216749,0.783251,750,130,4061,3180,881,0.783058,0.216942,0.783058,751,130,1, merged,1,1,0
64901,1000121,2,2954,2472,482,0.836831,0.163169,1.61989,446,36,2956,2473,483,0.836604,0.163396,1.619276,447,36,1, merged,1,1,0
64901,1000329,1,4061,3180,881,0.783058,0.216942,0.783058,751,130,4063,3180,883,0.782673,0.217327,0.782673,753,130,1, merged,1,1,0
64902,1000121,2,2956,2473,483,0.836604,0.163396,1.619276,447,36,2958,2474,484,0.836376,0.163624,1.618664,448,36,1, merged,1,1,0
64902,1000329,1,4063,3180,883,0.782673,0.217327,0.782673,753,130,4065,3180,885,0.782288,0.217712,0.782288,755,130,1, merged,1,1,0
64903,1000121,2,2958,2474,484,0.836376,0.163624,1.618664,448,36,2960,2475,485,0.836149,0.163851,1.618244,449,36,1, merged,1,1,0
64903,1000329,1,4065,3180,885,0.782288,0.217712,0.782288,755,130,4066,3180,886,0.782095,0.217905,0.782095,756,130,1, merged,1,1,0
64904,1000004,3,5163,4539,624,0.87914,0.12086,2.48094,497,127,5164,4539,625,0.87897,0.12103,2.480755,497,128,-1, merged,1,1,0
64904,1000329,2,4066,3180,886,0.782095,0.217905,1.6018,756,130,4067,3180,887,0.781903,0.218097,1.601785,756,131,-1, merged,1,1,0
64904,1002169,1,1015,832,183,0.819704,0.180296,0.819704,121,62,1016,833,183,0.819882,0.180118,0.819882,121,62,-1, merged,0,0,0
64912,1000014,1,3737,3005,732,0.804121,0.195879,0.804121,688,44,3738,3006,732,0.804173,0.195827,0.804173,688,44,1, merged,0,0,0
64912,1000110,2,820,738,82,0.9,0.1,1.704121,76,6,821,739,82,0.900122,0.099878,1.704295,76,6,1, merged,0,0,0
64914,1000005,2,1135,994,141,0.875771,0.124229,1.712085,131,10,1136,995,141,0.87588,0.12412,1.71225,131,10,1, merged,0,0,0
64914,1000121,1,2963,2478,485,0.836315,0.163685,0.836315,449,36,2964,2479,485,0.83637,0.16363,0.83637,449,36,1, merged,0,0,0
64917,1000054,2,1394,1178,216,0.84505,0.15495,1.665109,199,17,1395,1179,216,0.845161,0.154839,1.664769,199,17,1, merged,0,0,0
64917,1000329,3,4067,3180,887,0.781903,0.218097,2.447012,756,131,4068,3181,887,0.781957,0.218043,2.446726,756,131,1, merged,0,0,0
64917,1002169,1,1017,834,183,0.820059,0.179941,0.820059,121,62,1020,836,184,0.819608,0.180392,0.819608,121,63,-1, merged,1,0,0
64918,1000054,3,1395,1179,216,0.845161,0.154839,2.416447,199,17,1396,1180,216,0.845272,0.154728,2.416141,199,17,1, merged,0,0,0
64918,1000328,2,1192,896,296,0.751678,0.248322,1.571286,263,33,1193,897,296,0.751886,0.248114,1.570868,263,33,1, merged,0,0,0
64918,1000329,4,4068,3181,887,0.781957,0.218043,3.198404,756,131,4069,3182,887,0.78201,0.21799,3.198151,756,131,1, merged,0,0,0
64918,1002169,1,1020,836,184,0.819608,0.180392,0.819608,121,63,1022,837,185,0.818982,0.181018,0.818982,121,64,-1, merged,1,0,0
64919,1000054,2,1396,1180,216,0.845272,0.154728,1.597158,199,17,1397,1181,216,0.845383,0.154617,1.597477,199,17,1, merged,0,0,0
64919,1000328,1,1193,897,296,0.751886,0.248114,0.751886,263,33,1194,898,296,0.752094,0.247906,0.752094,263,33,1, merged,0,0,0
64919,1000329,3,4069,3182,887,0.78201,0.21799,2.379169,756,131,4070,3183,887,0.782064,0.217936,2.379541,756,131,1, merged,0,0,0
64920,1000054,2,1397,1181,216,0.845383,0.154617,1.597477,199,17,1398,1182,216,0.845494,0.154506,1.597795,199,17,1, merged,0,0,0
64920,1000328,1,1194,898,296,0.752094,0.247906,0.752094,263,33,1195,899,296,0.752301,0.247699,0.752301,263,33,-1, merged,0,0,0
64920,1000329,3,4070,3183,887,0.782064,0.217936,2.379541,756,131,4071,3184,887,0.782117,0.217883,2.379912,756,131,1, merged,0,0,0
64921,1000328,1,1195,899,296,0.752301,0.247699,0.752301,263,33,1197,900,297,0.75188,0.24812,0.75188,264,33,1, merged,1,1,0
64921,1002169,2,1022,837,185,0.818982,0.181018,1.571284,121,64,1024,839,185,0.819336,0.180664,1.571216,121,64,-1, merged,0,0,0
64922,1000121,2,2964,2479,485,0.83637,0.16363,1.532572,449,36,2965,2480,485,0.836425,0.163575,1.523925,449,36,1, merged,0,0,0
64925,1000329,2,4071,3184,887,0.782117,0.217883,1.580775,756,131,4072,3185,887,0.782171,0.217829,1.582171,756,131,1, merged,0,0,0
64926,1000329,2,4072,3185,887,0.782171,0.217829,1.448838,756,131,4074,3187,887,0.782278,0.217722,1.282278,756,131,-1, merged,0,0,0
64935,1000014,1,3739,3007,732,0.804226,0.195774,0.804226,688,44,3741,3009,732,0.80433,0.19567,0.80433,688,44,-1, merged,0,0,0
64935,1000121,2,2965,2480,485,0.836425,0.163575,1.640651,449,36,2966,2481,485,0.83648,0.16352,1.640811,449,36,1, merged,0,0,0
64939,1000014,1,3741,3009,732,0.80433,0.19567,0.80433,688,44,3743,3010,733,0.804168,0.195832,0.804168,689,44,1, merged,1,1,0
64939,1000121,2,2967,2482,485,0.836535,0.163465,1.640866,449,36,2969,2484,485,0.836645,0.163355,1.640813,449,36,-1, merged,0,0,0
64945,1000592,2,969,827,142,0.853457,0.146543,1.596222,92,50,972,830,142,0.853909,0.146091,1.597088,92,50,-1, merged,0,0,0
64947,1000005,2,1138,996,142,0.87522,0.12478,1.627099,132,10,1139,997,142,0.875329,0.124671,1.627416,132,10,1, merged,0,0,0
64947,1000328,1,1197,900,297,0.75188,0.24812,0.75188,264,33,1198,901,297,0.752087,0.247913,0.752087,264,33,1, merged,0,0,0
64948,1000328,2,1198,901,297,0.752087,0.247913,1.575616,264,33,1199,902,297,0.752294,0.247706,1.571806,264,33,1, merged,0,0,0
64953,1000005,2,1139,997,142,0.875329,0.124671,1.711975,132,10,1140,998,142,0.875439,0.124561,1.711857,132,10,1, merged,0,0,0
64953,1000121,1,2969,2484,485,0.836645,0.163355,0.836645,449,36,2971,2485,486,0.836419,0.163581,0.836419,450,36,1, merged,1,1,0
64954,1000327,2,763,607,156,0.795544,0.204456,1.589662,120,36,764,608,156,0.795812,0.204188,1.573589,120,36,1, merged,0,0,0
64958,1000132,1,980,814,166,0.830612,0.169388,0.830612,141,25,981,815,166,0.830785,0.169215,0.830785,141,25,1, merged,0,0,0
64964,1000105,3,924,735,189,0.795455,0.204545,2.155285,157,32,926,737,189,0.795896,0.204104,2.126337,157,32,-1, merged,0,0,0
64965,1000014,1,3745,3012,733,0.804272,0.195728,0.804272,689,44,3747,3014,733,0.804377,0.195623,0.804377,689,44,1, merged,0,0,0
64965,1000132,3,981,815,166,0.830785,0.169215,2.372599,141,25,982,816,166,0.830957,0.169043,2.373745,141,25,1, merged,0,0,0
64968,1000140,2,639,533,106,0.834116,0.165884,1.62135,94,12,641,535,106,0.834633,0.165367,1.622562,94,12,1, merged,0,0,0
64969,1000110,1,821,739,82,0.900122,0.099878,0.900122,76,6,822,739,83,0.899027,0.100973,0.899027,77,6,1, merged,1,1,0
64975,1000328,1,1199,902,297,0.752294,0.247706,0.752294,264,33,1200,903,297,0.7525,0.2475,0.7525,264,33,1, merged,0,0,0
64975,1000592,2,972,830,142,0.853909,0.146091,1.606203,92,50,973,831,142,0.85406,0.14594,1.60656,92,50,1, merged,0,0,0
64986,1000014,1,3747,3014,733,0.804377,0.195623,0.804377,689,44,3749,3015,734,0.804214,0.195786,0.804214,690,44,1, merged,1,1,0
64986,1000026,3,779,656,123,0.842105,0.157895,2.465994,120,3,780,656,124,0.841026,0.158974,2.461221,121,3,1, merged,1,1,0
64988,1000015,1,2745,2461,284,0.896539,0.103461,0.896539,261,23,2746,2462,284,0.896577,0.103423,0.896577,261,23,-1, merged,0,0,0
64988,1000534,2,800,612,188,0.765,0.235,1.661539,164,24,801,613,188,0.765293,0.234707,1.66187,164,24,-1, merged,0,0,0
64994,1000108,1,639,540,99,0.84507,0.15493,0.84507,93,6,640,541,99,0.845313,0.154688,0.845313,93,6,-1, merged,0,0,0
64994,1000110,2,822,739,83,0.899027,0.100973,1.744097,77,6,823,740,83,0.899149,0.100851,1.744462,77,6,1, merged,0,0,0
64997,1000009,1,2355,1970,385,0.836518,0.163482,0.836518,341,44,2358,1973,385,0.836726,0.163274,0.836726,341,44,-1, abandoned,0,0,0
65010,1000105,2,926,737,189,0.795896,0.204104,1.615232,157,32,928,738,190,0.795259,0.204741,1.614771,158,32,1, merged,1,1,0
65010,1002169,1,1024,839,185,0.819336,0.180664,0.819336,121,64,1025,840,185,0.819512,0.180488,0.819512,121,64,-1, merged,0,0,0
65014,1000009,3,2358,1973,385,0.836726,0.163274,2.574329,341,44,2359,1974,385,0.836795,0.163205,2.572994,341,44,1, merged,0,0,0
65014,1000015,2,2746,2462,284,0.896577,0.103423,1.737602,261,23,2747,2462,285,0.89625,0.10375,1.736199,262,23,1, merged,1,1,0
65014,1000026,1,780,656,124,0.841026,0.158974,0.841026,121,3,781,656,125,0.839949,0.160051,0.839949,122,3,1, merged,1,1,0
65015,1000014,1,3749,3015,734,0.804214,0.195786,0.804214,690,44,3750,3016,734,0.804267,0.195733,0.804267,690,44,1, merged,0,0,0
65015,1000328,2,1200,903,297,0.7525,0.2475,1.556714,264,33,1202,904,298,0.75208,0.24792,1.556347,264,34,-1, merged,1,1,0
65026,1000004,3,5165,4540,625,0.878993,0.121007,2.565777,497,128,5166,4541,625,0.879017,0.120983,2.565281,497,128,-1, abandoned,0,0,0
65026,1000014,2,3750,3016,734,0.804267,0.195733,1.686784,690,44,3751,3016,735,0.804052,0.195948,1.686265,691,44,1, abandoned,1,1,0
65026,1000120,1,2511,2216,295,0.882517,0.117483,0.882517,257,38,2513,2217,296,0.882212,0.117788,0.882212,258,38,-1, abandoned,1,0,0
65028,1000534,3,801,613,188,0.765293,0.234707,2.319087,164,24,802,614,188,0.765586,0.234414,2.315495,164,24,1, merged,0,0,0
65030,1000327,1,764,608,156,0.795812,0.204188,0.795812,120,36,765,608,157,0.794771,0.205229,0.794771,121,36,1, abandoned,1,1,0
65030,1000328,2,1202,904,298,0.75208,0.24792,1.547891,264,34,1203,904,299,0.751455,0.248545,1.546226,265,34,1, abandoned,1,1,0
65042,1000091,2,715,567,148,0.793007,0.206993,1.544462,125,23,716,567,149,0.791899,0.208101,1.542314,126,23,1, merged,1,1,0
65042,1000328,1,1203,904,299,0.751455,0.248545,0.751455,265,34,1206,905,301,0.750415,0.249585,0.750415,267,34,1, merged,1,1,0
65043,1000005,2,1167,1016,151,0.870608,0.129392,1.711034,141,10,1168,1017,151,0.870719,0.129281,1.709702,141,10,1, merged,0,0,0
65051,1000026,1,781,656,125,0.839949,0.160051,0.839949,122,3,782,657,125,0.840153,0.159847,0.840153,122,3,1, merged,0,0,0
65057,1000023,2,2157,1886,271,0.874363,0.125637,1.874363,241,30,2158,1887,271,0.874421,0.125579,1.76331,241,30,-1, abandoned,0,0,0
65057,1000120,3,2513,2217,296,0.882212,0.117788,2.756575,258,38,2514,2218,296,0.882259,0.117741,2.645569,258,38,-1, abandoned,0,0,0
65059,1000023,1,2158,1887,271,0.874421,0.125579,0.874421,241,30,2159,1888,271,0.874479,0.125521,0.874479,241,30,1, merged,0,0,0
65063,1000011,1,1079,989,90,0.916589,0.083411,0.916589,84,6,1080,990,90,0.916667,0.083333,0.916667,84,6,1, merged,0,0,0
65063,1000015,2,2747,2462,285,0.89625,0.10375,1.81284,262,23,2748,2463,285,0.896288,0.103712,1.812955,262,23,1, merged,0,0,0
65072,1000140,1,641,535,106,0.834633,0.165367,0.834633,94,12,643,537,106,0.835148,0.164852,0.835148,94,12,-1, merged,0,0,0
65073,1000015,1,2748,2463,285,0.896288,0.103712,0.896288,262,23,2750,2463,287,0.895636,0.104364,0.895636,262,25,-1, merged,1,1,0
65080,1000015,2,2750,2463,287,0.895636,0.104364,1.774982,262,25,2751,2464,287,0.895674,0.104326,1.775266,262,25,1, merged,0,0,0
65091,1000023,1,2161,1889,272,0.874132,0.125868,0.874132,242,30,2167,1893,274,0.873558,0.126442,0.873558,244,30,-1, merged,1,0,0
65097,1000121,2,2978,2492,486,0.836803,0.163197,1.617928,450,36,2979,2493,486,0.836858,0.163142,1.617735,450,36,1, merged,0,0,0
65101,1000026,1,782,657,125,0.840153,0.159847,0.840153,122,3,783,658,125,0.840358,0.159642,0.840358,122,3,1, merged,0,0,0
65108,1000043,1,726,598,128,0.823691,0.176309,0.823691,110,18,728,600,128,0.824176,0.175824,0.824176,110,18,-1, abandoned,0,0,0
65115,1000009,2,2360,1975,385,0.836864,0.163136,1.732577,341,44,2361,1975,386,0.83651,0.16349,1.732336,342,44,1, merged,1,1,0
65115,1000015,1,2752,2465,287,0.895712,0.104288,0.895712,262,25,2755,2468,287,0.895826,0.104174,0.895826,262,25,-1, merged,0,0,0
65121,1000121,2,2981,2495,486,0.836967,0.163033,1.592693,450,36,2982,2496,486,0.837022,0.162978,1.594598,450,36,1, merged,0,0,0
65131,1000009,2,2362,1976,386,0.836579,0.163421,1.774079,342,44,2365,1979,386,0.836786,0.163214,1.741548,342,44,-1, merged,0,0,0
65133,1000007,1,2112,1700,412,0.804924,0.195076,0.804924,359,53,2113,1701,412,0.805017,0.194983,0.805017,359,53,1, merged,0,0,0
65134,1000132,1,982,816,166,0.830957,0.169043,0.830957,141,25,983,816,167,0.830112,0.169888,0.830112,142,25,1, merged,1,1,0
65139,1000015,2,2755,2468,287,0.895826,0.104174,1.70535,262,25,2756,2469,287,0.895864,0.104136,1.645864,262,25,1, merged,0,0,0
65140,1000328,1,1207,906,301,0.750621,0.249379,0.750621,267,34,1208,906,302,0.75,0.25,0.75,268,34,1, merged,1,1,0
65140,1000592,2,975,832,143,0.853333,0.146667,1.603955,93,50,976,833,143,0.853484,0.146516,1.603484,93,50,1, merged,0,0,0
65142,1000009,1,2365,1979,386,0.836786,0.163214,0.836786,342,44,2367,1980,387,0.836502,0.163498,0.836502,343,44,1, merged,1,1,0
65146,1000329,1,4076,3189,887,0.782385,0.217615,0.782385,756,131,4077,3190,887,0.782438,0.217562,0.782438,756,131,-1, merged,0,0,0
65147,1000003,1,1657,1366,291,0.824381,0.175619,0.824381,249,42,1658,1367,291,0.824487,0.175513,0.824487,249,42,-1, abandoned,0,0,0
65152,1000329,2,4077,3190,887,0.782438,0.217562,1.622864,756,131,4078,3191,887,0.782491,0.217509,1.624041,756,131,1, merged,0,0,0
65160,1000121,2,2982,2496,486,0.837022,0.162978,1.590791,450,36,2983,2497,486,0.837077,0.162923,1.591463,450,36,1, merged,0,0,0
65161,1000121,2,2983,2497,486,0.837077,0.162923,1.591463,450,36,2984,2497,487,0.836796,0.163204,1.589296,451,36,1, abandoned,1,1,0
65164,1000026,1,783,658,125,0.840358,0.159642,0.840358,122,3,784,659,125,0.840561,0.159439,0.840561,122,3,1, merged,0,0,0
65175,1000009,3,2367,1980,387,0.836502,0.163498,2.542924,343,44,2368,1980,388,0.836149,0.163851,2.211906,343,45,-1, merged,1,1,0
65177,1000091,2,716,567,149,0.791899,0.208101,1.630882,126,23,717,568,149,0.79219,0.20781,1.631513,126,23,1, merged,0,0,0
65181,1000023,2,2175,1898,277,0.872644,0.127356,1.668343,247,30,2176,1899,277,0.872702,0.127298,1.667767,247,30,-1, abandoned,0,0,0
65181,1000105,1,930,740,190,0.795699,0.204301,0.795699,158,32,932,741,191,0.795064,0.204936,0.795064,159,32,-1, abandoned,1,0,0
65184,1000014,2,3754,3019,735,0.804209,0.195791,1.498653,691,44,3755,3020,735,0.804261,0.195739,1.506964,691,44,1, merged,0,0,0
65188,1000003,3,1658,1367,291,0.824487,0.175513,2.4876,249,42,1659,1368,291,0.824593,0.175407,2.488183,249,42,1, merged,0,0,0
65188,1000534,2,806,618,188,0.766749,0.233251,1.663113,164,24,807,619,188,0.767038,0.232962,1.66359,164,24,1, merged,0,0,0
65194,1000534,1,807,619,188,0.767038,0.232962,0.767038,164,24,808,620,188,0.767327,0.232673,0.767327,164,24,-1, merged,0,0,0
65198,1000091,1,717,568,149,0.79219,0.20781,0.79219,126,23,718,568,150,0.791086,0.208914,0.791086,126,24,-1, merged,1,1,0
65198,1000329,2,4080,3193,887,0.782598,0.217402,1.574788,756,131,4081,3193,888,0.782406,0.217594,1.573493,756,132,-1, merged,1,1,0
65208,1000026,3,784,659,125,0.840561,0.159439,2.298964,122,3,785,660,125,0.840764,0.159236,2.301537,122,3,1, merged,0,0,0
65208,1000166,1,672,511,161,0.760417,0.239583,0.760417,154,7,673,512,161,0.760773,0.239227,0.760773,154,7,1, merged,0,0,0
65218,1000023,2,2178,1900,278,0.87236,0.12764,1.581098,248,30,2179,1901,278,0.872419,0.127581,1.583957,248,30,1, merged,0,0,0
65224,1000023,1,2179,1901,278,0.872419,0.127581,0.872419,248,30,2180,1902,278,0.872477,0.127523,0.872477,248,30,1, merged,0,0,0
65229,1000105,1,932,741,191,0.795064,0.204936,0.795064,159,32,933,741,192,0.794212,0.205788,0.794212,160,32,1, merged,1,1,0
65239,1000009,3,2373,1985,388,0.836494,0.163506,2.587779,343,45,2374,1986,388,0.836563,0.163437,2.584842,343,45,1, merged,0,0,0
65239,1000015,1,2758,2471,287,0.895939,0.104061,0.895939,262,25,2759,2471,288,0.895614,0.104386,0.895614,263,25,1, merged,1,1,0
65249,1000014,2,3755,3020,735,0.804261,0.195739,1.506964,691,44,3756,3021,735,0.804313,0.195687,1.514839,691,44,1, merged,0,0,0
65253,1000003,1,1659,1368,291,0.824593,0.175407,0.824593,249,42,1663,1371,292,0.824414,0.175586,0.824414,250,42,-1, abandoned,1,0,0
65253,1000329,3,4081,3193,888,0.782406,0.217594,2.426688,756,132,4082,3194,888,0.78246,0.21754,2.427436,756,132,-1, abandoned,0,0,0
65253,1002169,2,1026,841,185,0.819688,0.180312,1.644281,121,64,1031,846,185,0.820563,0.179437,1.644976,121,64,-1, abandoned,0,0,0
65260,1000009,3,2374,1986,388,0.836563,0.163437,2.247034,343,45,2375,1987,388,0.836632,0.163368,2.243379,343,45,1, merged,0,0,0
65260,1000534,2,809,621,188,0.767614,0.232386,1.410471,164,24,811,621,190,0.765721,0.234279,1.406747,164,26,-1, merged,1,1,0
65262,1000329,1,4082,3194,888,0.78246,0.21754,0.78246,756,132,4083,3195,888,0.782513,0.217487,0.782513,756,132,-1, merged,0,0,0
65263,1000091,1,718,568,150,0.791086,0.208914,0.791086,126,24,720,568,152,0.788889,0.211111,0.788889,126,26,-1, merged,1,1,0
65263,1000328,2,1209,907,302,0.750207,0.249793,1.541293,268,34,1210,908,302,0.750413,0.249587,1.539302,268,34,1, merged,0,0,0
65269,1000328,2,1213,910,303,0.750206,0.249794,1.570769,269,34,1214,911,303,0.750412,0.249588,1.571148,269,34,1, merged,0,0,0
65269,1002169,1,1031,846,185,0.820563,0.179437,0.820563,121,64,1032,847,185,0.820736,0.179264,0.820736,121,64,-1, merged,0,0,0
65270,1000328,2,1214,911,303,0.750412,0.249588,1.533021,269,34,1215,912,303,0.750617,0.249383,1.532113,269,34,1, merged,0,0,0
65271,1000328,2,1215,912,303,0.750617,0.249383,1.532113,269,34,1216,913,303,0.750822,0.249178,1.531215,269,34,1, merged,0,0,0
65272,1000005,3,1183,1032,151,0.872358,0.127642,2.313695,141,10,1184,1033,151,0.872466,0.127534,2.317823,141,10,-1, abandoned,0,0,0
65272,1000329,2,4083,3195,888,0.782513,0.217487,1.441336,756,132,4084,3196,888,0.782566,0.217434,1.445357,756,132,-1, abandoned,0,0,0
65295,1000014,4,3756,3021,735,0.804313,0.195687,3.000234,691,44,3757,3022,735,0.804365,0.195635,2.999951,691,44,1, merged,0,0,0
65295,1000054,5,1404,1188,216,0.846154,0.153846,3.846388,199,17,1406,1189,217,0.845661,0.154339,3.845613,199,18,-1, merged,1,1,0
65301,1000105,1,937,745,192,0.795091,0.204909,0.795091,160,32,938,746,192,0.795309,0.204691,0.795309,160,32,1, merged,0,0,0
65301,1000121,2,2993,2506,487,0.837287,0.162713,1.632378,451,36,2994,2507,487,0.837341,0.162659,1.632651,451,36,1, merged,0,0,0
65306,1000108,1,641,542,99,0.845554,0.154446,0.845554,93,6,642,543,99,0.845794,0.154206,0.845794,93,6,-1, merged,0,0,0
65306,1000140,2,645,539,106,0.835659,0.164341,1.681213,94,12,646,540,106,0.835913,0.164087,1.681708,94,12,1, merged,0,0,0
65309,1000043,2,728,600,128,0.824176,0.175824,1.674809,110,18,729,601,128,0.824417,0.175583,1.675427,110,18,1, merged,0,0,0
65309,1000108,4,642,543,99,0.845794,0.154206,3.358053,93,6,643,544,99,0.846034,0.153966,3.358965,93,6,1, merged,0,0,0
65309,1000121,3,2996,2509,487,0.83745,0.16255,2.512259,451,36,2997,2510,487,0.837504,0.162496,2.512931,451,36,1, merged,0,0,0
65313,1000109,2,801,695,106,0.867665,0.132335,1.726134,100,6,803,696,107,0.86675,0.13325,1.723231,101,6,1, merged,1,1,0
65320,1000023,1,2184,1906,278,0.872711,0.127289,0.872711,248,30,2185,1906,279,0.872311,0.127689,0.872311,248,31,-1, merged,1,1,0
65323,1000023,2,2185,1906,279,0.872311,0.127689,1.072311,248,31,2187,1907,280,0.871971,0.128029,1.014828,249,31,1, merged,1,1,0
65345,1000105,2,940,747,193,0.794681,0.205319,1.50701,161,32,942,749,193,0.795117,0.204883,1.504576,161,32,-1, merged,0,0,0
65350,1000009,3,2375,1987,388,0.836632,0.163368,2.545901,343,45,2376,1988,388,0.8367,0.1633,2.54671,343,45,1, merged,0,0,0
65350,1000534,1,811,621,190,0.765721,0.234279,0.765721,164,26,812,622,190,0.76601,0.23399,0.76601,164,26,1, merged,0,0,0
65352,1000005,1,1190,1039,151,0.873109,0.126891,0.873109,141,10,1191,1040,151,0.873216,0.126784,0.873216,141,10,1, merged,0,0,0
65352,1000121,2,2998,2511,487,0.837558,0.162442,1.710668,451,36,2999,2512,487,0.837613,0.162387,1.710828,451,36,1, merged,0,0,0
65359,1000120,4,2516,2220,296,0.882353,0.117647,3.285715,258,38,2517,2221,296,0.8824,0.1176,3.293434,258,38,1, merged,0,0,0
65364,1000009,2,2376,1988,388,0.8367,0.1633,1.6767,343,45,2379,1990,389,0.836486,0.163514,1.642938,344,45,-1, merged,1,0,0
65366,1000009,2,2379,1990,389,0.836486,0.163514,1.732251,344,45,2380,1991,389,0.836555,0.163445,1.732358,344,45,1, merged,0,0,0
65366,1000015,1,2763,2475,288,0.895765,0.104235,0.895765,263,25,2764,2476,288,0.895803,0.104197,0.895803,263,25,1, merged,0,0,0
65370,1000121,1,2999,2512,487,0.837613,0.162387,0.837613,451,36,3000,2513,487,0.837667,0.162333,0.837667,451,36,1, merged,0,0,0
65375,1000328,2,1219,916,303,0.751436,0.248564,1.489846,269,34,1220,917,303,0.751639,0.248361,1.490913,269,34,1, merged,0,0,0
65376,1000328,2,1220,917,303,0.751639,0.248361,1.490913,269,34,1221,918,303,0.751843,0.248157,1.491974,269,34,1, merged,0,0,0
65377,1000105,2,944,751,193,0.795551,0.204449,1.535682,161,32,945,752,193,0.795767,0.204233,1.536751,161,32,1, merged,0,0,0
65378,1000105,1,945,752,193,0.795767,0.204233,0.795767,161,32,946,753,193,0.795983,0.204017,0.795983,161,32,1, merged,0,0,0
65381,1000009,2,2380,1991,389,0.836555,0.163445,1.732433,344,45,2381,1992,389,0.836623,0.163377,1.732216,344,45,-1, abandoned,0,0,0
65381,1000015,1,2766,2478,288,0.895879,0.104121,0.895879,263,25,2768,2479,289,0.895592,0.104408,0.895592,264,25,1, abandoned,1,1,0
65383,1000109,1,808,700,108,0.866337,0.133663,0.866337,101,7,809,701,108,0.866502,0.133498,0.866502,101,7,1, merged,0,0,0
65385,1000109,2,809,701,108,0.866502,0.133498,1.651921,101,7,811,702,109,0.865598,0.134402,1.651312,101,8,-1, merged,1,1,0
65387,1000329,1,4084,3196,888,0.782566,0.217434,0.782566,756,132,4085,3197,888,0.782619,0.217381,0.782619,756,132,1, merged,0,0,0
65396,1000329,2,4085,3197,888,0.782619,0.217381,1.523603,756,132,4086,3198,888,0.782673,0.217327,1.524503,756,132,1, merged,0,0,0
65407,1000166,1,674,513,161,0.761128,0.238872,0.761128,154,7,675,514,161,0.761481,0.238519,0.761481,154,7,1, merged,0,0,0
65408,1000166,1,675,514,161,0.761481,0.238519,0.761481,154,7,676,515,161,0.761834,0.238166,0.761834,154,7,1, merged,0,0,0
65410,1000120,2,2517,2221,296,0.8824,0.1176,1.720066,258,38,2518,2221,297,0.882049,0.117951,1.719437,258,39,-1, merged,1,1,0
65410,1000121,1,3000,2513,487,0.837667,0.162333,0.837667,451,36,3001,2513,488,0.837388,0.162612,0.837388,451,37,-1, merged,1,1,0
65417,1000105,2,950,756,194,0.795789,0.204211,1.640963,162,32,951,757,194,0.796004,0.203996,1.640207,162,32,1, merged,0,0,0
65418,1000005,1,1195,1043,152,0.872803,0.127197,0.872803,142,10,1196,1044,152,0.87291,0.12709,0.87291,142,10,1, merged,0,0,0
65420,1000009,3,2381,1992,389,0.836623,0.163377,2.369091,344,45,2382,1993,389,0.836692,0.163308,2.37295,344,45,1, merged,0,0,0
65432,1000121,2,3005,2516,489,0.837271,0.162729,1.734383,452,37,3006,2516,490,0.836993,0.163007,1.73429,453,37,1, abandoned,1,1,0
65436,1000054,2,1408,1191,217,0.845881,0.154119,1.551763,199,18,1409,1192,217,0.84599,0.15401,1.553782,199,18,1, merged,0,0,0
65439,1000130,2,960,803,157,0.836458,0.163542,1.701164,121,36,961,804,157,0.836629,0.163371,1.702126,121,36,1, merged,0,0,0
65445,1000109,1,811,702,109,0.865598,0.134402,0.865598,101,8,812,702,110,0.864532,0.135468,0.864532,102,8,1, merged,1,1,0
65445,1000199,3,717,618,99,0.861925,0.138075,2.513237,85,14,718,619,99,0.862117,0.137883,2.512657,85,14,1, merged,0,0,0
65454,1000007,2,2117,1705,412,0.805385,0.194615,1.701015,359,53,2118,1706,412,0.805477,0.194523,1.701145,359,53,1, merged,0,0,0
65454,1000015,1,2769,2480,289,0.89563,0.10437,0.89563,264,25,2770,2481,289,0.895668,0.104332,0.895668,264,25,1, merged,0,0,0
65455,1000007,1,2118,1706,412,0.805477,0.194523,0.805477,359,53,2120,1707,413,0.805189,0.194811,0.805189,360,53,1, merged,1,1,0
65455,1000009,3,2382,1993,389,0.836692,0.163308,2.537837,344,45,2383,1994,389,0.83676,0.16324,2.537294,344,45,1, merged,0,0,0
65455,1000015,2,2770,2481,289,0.895668,0.104332,1.701145,264,25,2771,2481,290,0.895345,0.104655,1.700533,265,25,1, merged,1,1,0
65471,1000007,2,2120,1707,413,0.805189,0.194811,1.700571,360,53,2122,1707,415,0.80443,0.19557,1.69985,360,55,-1, merged,1,1,0
65471,1000015,1,2772,2482,290,0.895382,0.104618,0.895382,265,25,2773,2483,290,0.89542,0.10458,0.89542,265,25,1, merged,0,0,0
65476,1000023,2,2194,1914,280,0.872379,0.127621,1.653201,249,31,2195,1915,280,0.872437,0.127563,1.653687,249,31,1, merged,0,0,0
65484,1000108,2,645,546,99,0.846512,0.153488,1.682931,93,6,646,547,99,0.846749,0.153251,1.682134,93,6,-1, abandoned,0,0,0
65484,1000140,1,648,542,106,0.83642,0.16358,0.83642,94,12,650,543,107,0.835385,0.164615,0.835385,95,12,1, abandoned,1,1,0
65493,1000327,2,765,608,157,0.794771,0.205229,1.576021,121,36,766,609,157,0.795039,0.204961,1.575195,121,36,1, merged,0,0,0
65495,1000329,3,4090,3202,888,0.782885,0.217115,2.262712,756,132,4092,3202,890,0.782502,0.217498,2.247857,758,132,1, abandoned,1,1,0
65495,1002169,2,1032,847,185,0.820736,0.179264,1.479827,121,64,1033,848,185,0.82091,0.17909,1.465354,121,64,-1, abandoned,0,0,0
65497,1000003,1,1664,1372,292,0.824519,0.175481,0.824519,250,42,1666,1374,292,0.82473,0.17527,0.82473,250,42,-1, merged,0,0,0
65497,1000120,2,2518,2221,297,0.882049,0.117951,1.706568,258,39,2519,2222,297,0.882096,0.117904,1.706826,258,39,1, merged,0,0,0
65498,1000329,1,4095,3205,890,0.782662,0.217338,0.782662,758,132,4096,3205,891,0.782471,0.217529,0.782471,759,132,1, abandoned,1,1,0
65500,1000329,2,4096,3205,891,0.782471,0.217529,1.563053,759,132,4097,3206,891,0.782524,0.217476,1.561594,759,132,1, merged,0,0,0
65501,1000121,2,3011,2519,492,0.836599,0.163401,1.619123,455,37,3012,2519,493,0.836321,0.163679,1.618654,455,38,-1, merged,1,1,0
65501,1000329,1,4097,3206,891,0.782524,0.217476,0.782524,759,132,4098,3206,892,0.782333,0.217667,0.782333,759,133,-1, merged,1,1,0
65506,1000328,1,1222,919,303,0.752046,0.247954,0.752046,269,34,1223,919,304,0.751431,0.248569,0.751431,270,34,1, abandoned,1,1,0
65506,1000329,2,4098,3206,892,0.782333,0.217667,1.534379,759,133,4099,3207,892,0.782386,0.217614,1.533817,759,133,-1, abandoned,0,0,0
65523,1000328,2,1223,919,304,0.751431,0.248569,1.534218,270,34,1224,919,305,0.750817,0.249183,1.534048,271,34,1, abandoned,1,1,0
65529,1000023,2,2197,1917,280,0.872553,0.127447,1.62337,249,31,2198,1918,280,0.872611,0.127389,1.623632,249,31,1, merged,0,0,0
65529,1000328,1,1224,919,305,0.750817,0.249183,0.750817,271,34,1225,920,305,0.75102,0.24898,0.75102,271,34,1, merged,0,0,0
65530,1000014,4,3758,3023,735,0.804417,0.195583,3.348879,691,44,3759,3023,736,0.804203,0.195797,3.362817,692,44,1, merged,1,1,0
65530,1000120,3,2519,2222,297,0.882096,0.117904,2.544462,258,39,2520,2223,297,0.882143,0.117857,2.558613,258,39,-1, merged,0,0,0
65531,1000166,2,676,515,161,0.761834,0.238166,1.582744,154,7,677,516,161,0.762186,0.237814,1.582302,154,7,1, merged,0,0,0
65531,1002169,1,1033,848,185,0.82091,0.17909,0.82091,121,64,1034,848,186,0.820116,0.179884,0.820116,121,65,-1, merged,1,1,0
65532,1000328,1,1225,920,305,0.75102,0.24898,0.75102,271,34,1226,921,305,0.751223,0.248777,0.751223,271,34,1, merged,0,0,0
65533,1000054,2,1410,1193,217,0.846099,0.153901,1.553891,199,18,1411,1194,217,0.846208,0.153792,1.555886,199,18,1, merged,0,0,0
65537,1000130,2,962,805,157,0.836798,0.163202,0.836798,121,36,964,805,159,0.835062,0.164938,0.835062,123,36,1, abandoned,1,1,0
65540,1000003,1,1666,1374,292,0.82473,0.17527,0.82473,250,42,1669,1375,294,0.823847,0.176153,0.823847,252,42,1, merged,1,1,0
65540,1000120,3,2520,2223,297,0.882143,0.117857,2.483231,258,39,2521,2224,297,0.88219,0.11781,2.480639,258,39,1, merged,0,0,0
65547,1000005,2,1205,1053,152,0.873859,0.126141,1.710289,142,10,1207,1054,153,0.873239,0.126761,1.709224,143,10,1, merged,1,1,0
65547,1000121,1,3014,2521,493,0.83643,0.16357,0.83643,455,38,3018,2523,495,0.835984,0.164016,0.835984,457,38,-1, merged,1,0,0
65550,1000091,1,720,568,152,0.788889,0.211111,0.788889,126,26,722,569,153,0.788089,0.211911,0.788089,127,26,1, merged,1,1,0
65550,1000130,3,964,805,159,0.835062,0.164938,2.528143,123,36,966,807,159,0.835404,0.164596,2.522302,123,36,-1, merged,0,0,0
65555,1000120,2,2521,2224,297,0.88219,0.11781,1.596475,258,39,2522,2225,297,0.882236,0.117764,1.599217,258,39,1, merged,0,0,0
65560,1000015,2,2776,2486,290,0.895533,0.104467,1.786158,265,25,2778,2488,290,0.895608,0.104392,1.774396,265,25,1, merged,0,0,0
65562,1000140,1,650,543,107,0.835385,0.164615,0.835385,95,12,651,543,108,0.834101,0.165899,0.834101,96,12,1, merged,1,1,0
65568,1000091,2,722,569,153,0.788089,0.211911,1.608205,127,26,723,570,153,0.788382,0.211618,1.60788,127,26,1, merged,0,0,0
65568,1002169,1,1034,848,186,0.820116,0.179884,0.820116,121,65,1036,849,187,0.819498,0.180502,0.819498,121,66,-1, merged,1,0,0
65573,1000121,2,3020,2524,496,0.835762,0.164238,1.547171,458,38,3021,2525,496,0.835816,0.164184,1.549149,458,38,1, merged,0,0,0
65574,1000109,2,812,702,110,0.864532,0.135468,1.65054,102,8,813,703,110,0.864699,0.135301,1.651,102,8,1, merged,0,0,0
65582,1000121,3,3025,2527,498,0.835372,0.164628,1.311562,460,38,3026,2528,498,0.835426,0.164574,1.567779,460,38,1, merged,0,0,0
65583,1000109,2,813,703,110,0.864699,0.135301,1.651,102,8,814,704,110,0.864865,0.135135,1.651459,102,8,1, merged,0,0,0
65584,1000011,1,1083,993,90,0.916898,0.083102,0.916898,84,6,1085,995,90,0.917051,0.082949,0.917051,84,6,-1, merged,0,0,0
65584,1000015,4,2778,2488,290,0.895608,0.104392,3.478588,265,25,2779,2489,290,0.895646,0.104354,3.485368,265,25,1, merged,0,0,0
65594,1000105,2,953,759,194,0.796432,0.203568,1.588432,162,32,954,760,194,0.796646,0.203354,1.589199,162,32,1, merged,0,0,0
65602,1000012,1,967,829,138,0.857291,0.142709,0.857291,131,7,969,831,138,0.857585,0.142415,0.857585,131,7,1, merged,0,0,0
65602,1000120,2,2522,2225,297,0.882236,0.117764,1.739527,258,39,2523,2226,297,0.882283,0.117717,1.739868,258,39,1, merged,0,0,0
65604,1000328,2,1226,921,305,0.751223,0.248777,1.60009,271,34,1227,922,305,0.751426,0.248574,1.600672,271,34,1, merged,0,0,0
65626,1000121,2,3028,2529,499,0.835205,0.164795,1.335205,461,38,3029,2530,499,0.835259,0.164741,1.235259,461,38,1, merged,0,0,0
65633,1000109,2,814,704,110,0.864865,0.135135,1.651459,102,8,815,705,110,0.865031,0.134969,1.65055,102,8,-1, merged,0,0,0
65633,1000199,3,718,619,99,0.862117,0.137883,2.513576,85,14,719,620,99,0.862309,0.137691,2.512859,85,14,-1, merged,0,0,0
65637,1000005,1,1214,1058,156,0.871499,0.128501,0.871499,146,10,1215,1059,156,0.871605,0.128395,0.871605,146,10,1, merged,0,0,0
65637,1000023,2,2199,1919,280,0.872669,0.127331,1.744169,249,31,2200,1920,280,0.872727,0.127273,1.744332,249,31,1, merged,0,0,0
65644,1000120,1,2524,2227,297,0.88233,0.11767,0.88233,258,39,2525,2228,297,0.882376,0.117624,0.882376,258,39,-1, merged,0,0,0
65655,1000091,3,724,571,153,0.788674,0.211326,2.360406,127,26,725,572,153,0.788966,0.211034,2.359999,127,26,1, merged,0,0,0
65655,1000328,2,1231,926,305,0.752234,0.247766,1.571732,271,34,1233,926,307,0.751014,0.248986,1.571033,273,34,1, merged,1,1,0
65655,1002169,1,1036,849,187,0.819498,0.180502,0.819498,121,66,1039,852,187,0.820019,0.179981,0.820019,121,66,-1, merged,0,0,0
65656,1000121,2,3032,2533,499,0.835422,0.164578,1.517431,461,38,3035,2535,500,0.835255,0.164745,1.518589,462,38,-1, merged,1,0,0
65656,1000329,3,4109,3216,893,0.782672,0.217328,2.300103,759,134,4111,3218,893,0.782778,0.217222,2.301367,759,134,-1, merged,0,0,0
65657,1000121,1,3035,2535,500,0.835255,0.164745,0.835255,462,38,3037,2536,501,0.835035,0.164965,0.835035,463,38,1, merged,1,1,0
65657,1000329,2,4111,3218,893,0.782778,0.217222,1.618033,759,134,4113,3220,893,0.782884,0.217116,1.617918,759,134,-1, merged,0,0,0
65658,1000121,1,3037,2536,501,0.835035,0.164965,0.835035,463,38,3040,2538,502,0.834868,0.165132,0.834868,464,38,-1, merged,1,0,0
65658,1000329,2,4113,3220,893,0.782884,0.217116,1.617918,759,134,4115,3222,893,0.782989,0.217011,1.617857,759,134,-1, merged,0,0,0
65659,1000121,1,3040,2538,502,0.834868,0.165132,0.834868,464,38,3042,2538,504,0.83432,0.16568,0.83432,466,38,1, merged,1,1,0
65659,1000329,2,4115,3222,893,0.782989,0.217011,1.617857,759,134,4118,3224,894,0.782904,0.217096,1.617224,760,134,-1, merged,1,0,0
65660,1000121,1,3042,2538,504,0.83432,0.16568,0.83432,466,38,3044,2538,506,0.833771,0.166229,0.833771,468,38,1, merged,1,1,0
65660,1000329,2,4118,3224,894,0.782904,0.217096,1.617224,760,134,4121,3226,895,0.78282,0.21718,1.616591,761,134,-1, merged,1,0,0
65661,1000121,1,3044,2538,506,0.833771,0.166229,0.833771,468,38,3046,2538,508,0.833224,0.166776,0.833224,470,38,1, merged,1,1,0
65661,1000329,2,4121,3226,895,0.78282,0.21718,1.616591,761,134,4124,3227,897,0.782493,0.217507,1.615717,763,134,1, merged,1,1,0
65662,1000121,1,3046,2538,508,0.833224,0.166776,0.833224,470,38,3048,2538,510,0.832677,0.167323,0.832677,472,38,1, merged,1,1,0
65662,1000329,2,4124,3227,897,0.782493,0.217507,1.615717,763,134,4127,3228,899,0.782166,0.217834,1.614843,765,134,1, merged,1,1,0
65663,1000003,1,1669,1375,294,0.823847,0.176153,0.823847,252,42,1670,1376,294,0.823952,0.176048,0.823952,252,42,1, merged,0,0,0
65666,1000105,1,954,760,194,0.796646,0.203354,0.796646,162,32,955,760,195,0.795812,0.204188,0.795812,163,32,1, merged,1,1,0
65669,1000054,2,1417,1200,217,0.84686,0.15314,1.556537,199,18,1418,1201,217,0.846968,0.153032,1.552096,199,18,1, merged,0,0,0
65672,1000121,1,3048,2538,510,0.832677,0.167323,0.832677,472,38,3049,2539,510,0.832732,0.167268,0.832732,472,38,1, merged,0,0,0
65674,1000054,4,1418,1201,217,0.846968,0.153032,2.988411,199,18,1419,1202,217,0.847075,0.152925,2.992691,199,18,1, merged,0,0,0
65680,1000054,2,1419,1202,217,0.847075,0.152925,1.715131,199,18,1420,1203,217,0.847183,0.152817,1.715422,199,18,1, merged,0,0,0
65682,1000110,2,826,743,83,0.899516,0.100484,1.733872,77,6,827,743,84,0.898428,0.101572,1.733038,77,7,-1, merged,1,1,0
65682,1000140,1,652,544,108,0.834356,0.165644,0.834356,96,12,653,545,108,0.834609,0.165391,0.834609,96,12,1, merged,0,0,0
65687,1000110,1,827,743,84,0.898428,0.101572,0.898428,77,7,830,745,85,0.89759,0.10241,0.89759,78,7,1, merged,1,1,0
65687,1000140,2,653,545,108,0.834609,0.165391,1.733038,96,12,654,546,108,0.834862,0.165138,1.732453,96,12,1, merged,0,0,0
65696,1000005,1,1217,1060,157,0.870994,0.129006,0.870994,147,10,1218,1060,158,0.870279,0.129721,0.870279,148,10,1, merged,1,1,0
65698,1000132,3,986,819,167,0.830629,0.169371,2.515573,142,25,989,820,169,0.82912,0.17088,2.507891,144,25,1, merged,1,1,0
65698,1000329,2,4127,3228,899,0.782166,0.217834,1.684944,765,134,4128,3229,899,0.782219,0.217781,1.678771,765,134,-1, merged,0,0,0
65701,1000130,1,968,808,160,0.834711,0.165289,0.834711,124,36,969,808,161,0.833849,0.166151,0.833849,124,37,-1, merged,1,1,0
65703,1000328,2,1233,926,307,0.751014,0.248986,1.571033,273,34,1234,927,307,0.751216,0.248784,1.571408,273,34,1, merged,0,0,0
65703,1002169,1,1039,852,187,0.820019,0.179981,0.820019,121,66,1040,853,187,0.820192,0.179808,0.820192,121,66,-1, merged,0,0,0
65704,1000105,1,955,760,195,0.795812,0.204188,0.795812,163,32,957,761,196,0.795193,0.204807,0.795193,164,32,1, merged,1,1,0
65709,1000130,4,969,808,161,0.833849,0.166151,3.222089,124,37,970,809,161,0.834021,0.165979,3.231245,124,37,1, merged,0,0,0
65710,1000054,1,1422,1205,217,0.847398,0.152602,0.847398,199,18,1425,1206,219,0.846316,0.153684,0.846316,201,18,1, merged,1,1,0
65721,1000023,1,2209,1928,281,0.872793,0.127207,0.872793,250,31,2211,1930,281,0.872908,0.127092,0.872908,250,31,-1, merged,0,0,0
65727,1000005,2,1218,1060,158,0.870279,0.129721,1.703285,148,10,1219,1061,158,0.870386,0.129614,1.703446,148,10,1, merged,0,0,0
65727,1000121,1,3054,2544,510,0.833006,0.166994,0.833006,472,38,3055,2545,510,0.833061,0.166939,0.833061,472,38,1, merged,0,0,0
65728,1000054,3,1425,1206,219,0.846316,0.153684,2.329172,201,18,1426,1207,219,0.846424,0.153576,2.331227,201,18,1, merged,0,0,0
65728,1000329,1,4128,3229,899,0.782219,0.217781,0.782219,765,134,4129,3230,899,0.782272,0.217728,0.782272,765,134,1, merged,0,0,0
65737,1000015,1,2780,2490,290,0.895683,0.104317,0.895683,265,25,2781,2491,290,0.895721,0.104279,0.895721,265,25,-1, merged,0,0,0
65746,1000023,1,2211,1930,281,0.872908,0.127092,0.872908,250,31,2212,1931,281,0.872966,0.127034,0.872966,250,31,-1, merged,0,0,0
65757,1000120,1,2526,2229,297,0.882423,0.117577,0.882423,258,39,2527,2229,298,0.882074,0.117926,0.882074,259,39,1, abandoned,1,1,0
65772,1000023,3,2220,1937,283,0.872523,0.127477,2.652742,252,31,2221,1938,283,0.87258,0.12742,2.584986,252,31,-1, abandoned,0,0,0
65786,1000023,2,2223,1939,284,0.872245,0.127755,1.728454,253,31,2224,1940,284,0.872302,0.127698,1.726966,253,31,-1, merged,0,0,0
65788,1000105,1,957,761,196,0.795193,0.204807,0.795193,164,32,958,761,197,0.794363,0.205637,0.794363,165,32,1, abandoned,1,1,0
65796,1000005,2,1233,1070,163,0.867802,0.132198,1.700863,153,10,1236,1072,164,0.867314,0.132686,1.700102,154,10,1, merged,1,1,0
65796,1000121,1,3055,2545,510,0.833061,0.166939,0.833061,472,38,3056,2545,511,0.832788,0.167212,0.832788,473,38,1, merged,1,1,0
65799,1000023,1,2224,1940,284,0.872302,0.127698,0.872302,253,31,2225,1940,285,0.87191,0.12809,0.87191,254,31,1, merged,1,1,0
65803,1000023,1,2225,1940,285,0.87191,0.12809,0.87191,254,31,2227,1940,287,0.871127,0.128873,0.871127,256,31,1, merged,1,1,0
65803,1000109,3,817,707,110,0.865361,0.134639,2.523956,102,8,819,708,111,0.864469,0.135531,2.521213,103,8,1, merged,1,1,0
65805,1000023,1,2227,1940,287,0.871127,0.128873,0.871127,256,31,2228,1941,287,0.871185,0.128815,0.871185,256,31,1, merged,0,0,0
65807,1000012,2,979,840,139,0.858018,0.141982,1.723473,132,7,980,841,139,0.858163,0.141837,1.723862,132,7,1, merged,0,0,0
65809,1000091,1,725,572,153,0.788966,0.211034,0.788966,127,26,726,573,153,0.789256,0.210744,0.789256,127,26,-1, merged,0,0,0
65809,1000130,2,977,813,164,0.832139,0.167861,1.621105,127,37,978,813,165,0.831288,0.168712,1.620545,128,37,1, merged,1,1,0
65813,1000130,2,978,813,165,0.831288,0.168712,1.69834,128,37,979,813,166,0.830439,0.169561,1.693296,129,37,1, merged,1,1,0
65814,1000003,1,1670,1376,294,0.823952,0.176048,0.823952,252,42,1671,1376,295,0.823459,0.176541,0.823459,253,42,1, abandoned,1,1,0
65814,1000153,2,1504,1344,160,0.893617,0.106383,1.717569,122,38,1505,1345,160,0.893688,0.106312,1.717147,122,38,-1, abandoned,0,0,0
65816,1000120,2,2530,2231,299,0.881818,0.118182,1.745026,260,39,2531,2231,300,0.88147,0.11853,1.740625,261,39,1, merged,1,1,0
65817,1000023,2,2228,1941,287,0.871185,0.128815,1.738832,256,31,2229,1942,287,0.871243,0.128757,1.740808,256,31,1, merged,0,0,0
65825,1000023,1,2230,1943,287,0.8713,0.1287,0.8713,256,31,2232,1943,289,0.87052,0.12948,0.87052,256,33,-1, merged,1,1,0
65827,1000014,2,3762,3025,737,0.804094,0.195906,1.677333,693,44,3764,3027,737,0.804198,0.195802,1.68091,693,44,-1, merged,0,0,0
65841,1000109,2,819,708,111,0.864469,0.135531,1.71948,103,8,820,709,111,0.864634,0.135366,1.718137,103,8,1, merged,0,0,0
65853,1000120,2,2531,2231,300,0.88147,0.11853,1.72935,261,39,2532,2232,300,0.881517,0.118483,1.727288,261,39,1, merged,0,0,0
65858,1000110,1,831,746,85,0.897714,0.102286,0.897714,78,7,832,746,86,0.896635,0.103365,0.896635,79,7,1, merged,1,1,0
65858,1000140,2,657,549,108,0.835616,0.164384,1.73333,96,12,658,550,108,0.835866,0.164134,1.732501,96,12,1, merged,0,0,0
65868,1000329,2,4129,3230,899,0.782272,0.217728,1.559623,765,134,4130,3231,899,0.782324,0.217676,1.560527,765,134,-1, abandoned,0,0,0
65869,1000328,3,1238,930,308,0.751212,0.248788,2.319395,274,34,1239,931,308,0.751412,0.248588,2.32051,274,34,1, merged,0,0,0
65869,1000329,2,4130,3231,899,0.782324,0.217676,1.568183,765,134,4131,3232,899,0.782377,0.217623,1.569097,765,134,1, merged,0,0,0
65870,1000105,4,959,762,197,0.794578,0.205422,3.182894,165,32,960,763,197,0.794792,0.205208,3.183509,165,32,1, merged,0,0,0
65870,1000328,2,1239,931,308,0.751412,0.248588,1.53379,274,34,1240,932,308,0.751613,0.248387,1.534043,274,34,1, merged,0,0,0
65870,1000329,1,4131,3232,899,0.782377,0.217623,0.782377,765,134,4132,3233,899,0.78243,0.21757,0.78243,765,134,1, merged,0,0,0
65870,1000592,3,983,840,143,0.854527,0.145473,2.388317,93,50,984,841,143,0.854675,0.145325,2.388718,93,50,1, merged,0,0,0
65874,1000153,2,1505,1345,160,0.893688,0.106312,1.505628,122,38,1506,1346,160,0.893758,0.106242,1.487961,122,38,-1, abandoned,0,0,0
65875,1000043,1,732,604,128,0.825137,0.174863,0.825137,110,18,733,605,128,0.825375,0.174625,0.825375,110,18,-1, abandoned,0,0,0
65875,1000108,2,652,551,101,0.845092,0.154908,1.670229,95,6,653,552,101,0.845329,0.154671,1.670704,95,6,-1, abandoned,0,0,0
65889,1000023,1,2241,1951,290,0.870593,0.129407,0.870593,257,33,2242,1952,290,0.870651,0.129349,0.870651,257,33,1, merged,0,0,0
65893,1000054,1,1429,1210,219,0.846746,0.153254,0.846746,201,18,1432,1210,222,0.844972,0.155028,0.844972,204,18,1, abandoned,1,1,0
65904,1000105,2,962,765,197,0.795218,0.204782,1.588412,165,32,963,765,198,0.794393,0.205607,1.585515,166,32,1, abandoned,1,1,0
65905,1000023,2,2243,1953,290,0.870709,0.129291,1.656326,257,33,2245,1954,291,0.870379,0.129621,1.655223,258,33,1, merged,1,1,0
65905,1000109,3,821,710,111,0.864799,0.135201,2.521125,103,8,822,711,111,0.864964,0.135036,2.520187,103,8,1, merged,0,0,0
65909,1000120,3,2539,2239,300,0.881843,0.118157,2.348688,261,39,2540,2240,300,0.88189,0.11811,2.342775,261,39,1, merged,0,0,0
65909,1000328,2,1240,932,308,0.751613,0.248387,1.466845,274,34,1242,933,309,0.751208,0.248792,1.460885,275,34,1, merged,1,1,0
65915,1000108,2,654,553,101,0.845566,0.154434,1.636688,95,6,655,554,101,0.845802,0.154198,1.634864,95,6,1, merged,0,0,0
65919,1000110,2,832,746,86,0.896635,0.103365,1.73275,79,7,833,747,86,0.896759,0.103241,1.730596,79,7,-1, abandoned,0,0,0
65919,1000140,1,659,551,108,0.836115,0.163885,0.836115,96,12,662,552,110,0.833837,0.166163,0.833837,98,12,1, abandoned,1,1,0
65929,1000054,2,1433,1211,222,0.84508,0.15492,1.53883,204,18,1434,1212,222,0.845188,0.154812,1.54084,204,18,1, merged,0,0,0
65930,1000054,2,1434,1212,222,0.845188,0.154812,1.607725,204,18,1435,1212,223,0.844599,0.155401,1.607486,204,19,-1, merged,1,1,0
65930,1000166,1,678,517,161,0.762537,0.237463,0.762537,154,7,679,518,161,0.762887,0.237113,0.762887,154,7,1, merged,0,0,0
65933,1000132,1,994,824,170,0.828974,0.171026,0.828974,145,25,995,825,170,0.829146,0.170854,0.829146,145,25,1, merged,0,0,0
65935,1000108,2,655,554,101,0.845802,0.154198,1.679638,95,6,656,555,101,0.846037,0.153963,1.680124,95,6,1, merged,0,0,0
65935,1000140,1,662,552,110,0.833837,0.166163,0.833837,98,12,663,553,110,0.834087,0.165913,0.834087,98,12,1, merged,0,0,0
65937,1000003,2,1671,1376,295,0.823459,0.176541,1.719255,253,42,1672,1377,295,0.823565,0.176435,1.719398,253,42,-1, abandoned,0,0,0
65937,1000015,1,2783,2493,290,0.895796,0.104204,0.895796,265,25,2784,2494,290,0.895833,0.104167,0.895833,265,25,-1, abandoned,0,0,0
65944,1000014,3,3766,3029,737,0.804302,0.195698,2.538974,693,44,3767,3030,737,0.804354,0.195646,2.53339,693,44,1, merged,0,0,0
65944,1000023,4,2245,1954,291,0.870379,0.129621,3.409353,258,33,2246,1955,291,0.870436,0.129564,3.403826,258,33,1, merged,0,0,0
65944,1000140,1,663,553,110,0.834087,0.165913,0.834087,98,12,665,554,111,0.833083,0.166917,0.833083,99,12,1, merged,1,1,0
65954,1000023,1,2246,1955,291,0.870436,0.129564,0.870436,258,33,2247,1956,291,0.870494,0.129506,0.870494,258,33,1, merged,0,0,0
65954,1000054,2,1435,1212,223,0.844599,0.155401,1.715036,204,19,1436,1213,223,0.844708,0.155292,1.715202,204,19,1, merged,0,0,0
65961,1000005,1,1255,1083,172,0.862948,0.137052,0.862948,162,10,1256,1084,172,0.863057,0.136943,0.863057,162,10,1, merged,0,0,0
65961,1000121,2,3066,2555,511,0.833333,0.166667,1.696282,473,38,3067,2556,511,0.833388,0.166612,1.696445,473,38,1, merged,0,0,0
65962,1000132,1,995,825,170,0.829146,0.170854,0.829146,145,25,997,826,171,0.828485,0.171515,0.828485,145,26,-1, merged,1,1,0
65964,1000023,1,2247,1956,291,0.870494,0.129506,0.870494,258,33,2248,1956,292,0.870107,0.129893,0.870107,259,33,1, merged,1,1,0
65971,1000153,1,1506,1346,160,0.893758,0.106242,0.893758,122,38,1507,1347,160,0.893829,0.106171,0.893829,122,38,1, merged,0,0,0
65974,1000328,1,1242,933,309,0.751208,0.248792,0.751208,275,34,1243,933,310,0.750603,0.249397,0.750603,276,34,1, merged,1,1,0
65974,1000592,3,984,841,143,0.854675,0.145325,2.384085,93,50,985,842,143,0.854822,0.145178,2.382569,93,50,1, merged,0,0,0
65989,1000007,2,2126,1710,416,0.804327,0.195673,1.632813,361,55,2127,1711,416,0.804419,0.195581,1.633077,361,55,1, merged,0,0,0
65989,1000132,1,997,826,171,0.828485,0.171515,0.828485,145,26,998,827,171,0.828657,0.171343,0.828657,145,26,1, merged,0,0,0
65995,1000003,1,1672,1377,295,0.823565,0.176435,0.823565,253,42,1673,1378,295,0.82367,0.17633,0.82367,253,42,-1, merged,0,0,0
65995,1000012,3,984,844,140,0.857724,0.142276,2.548909,133,7,985,845,140,0.857868,0.142132,2.549395,133,7,1, merged,0,0,0
66001,1000009,3,2387,1998,389,0.837034,0.162966,2.321882,344,45,2388,1999,389,0.837102,0.162898,2.410632,344,45,1, merged,0,0,0
66002,1000140,2,666,555,111,0.833333,0.166667,1.507246,99,12,667,556,111,0.833583,0.166417,1.514434,99,12,1, merged,0,0,0
66003,1000011,3,1086,996,90,0.917127,0.082873,2.715989,84,6,1087,997,90,0.917203,0.082797,2.716354,84,6,1, merged,0,0,0
66003,1000015,1,2786,2496,290,0.895908,0.104092,0.895908,265,25,2787,2496,291,0.895587,0.104413,0.895587,266,25,1, merged,1,1,0
66007,1000004,1,5167,4542,625,0.87904,0.12096,0.87904,497,128,5168,4542,626,0.87887,0.12113,0.87887,498,128,1, abandoned,1,1,0
66007,1000329,2,4132,3233,899,0.78243,0.21757,1.66147,765,134,4133,3233,900,0.782241,0.217759,1.66111,766,134,1, abandoned,1,1,0
66012,1000054,2,1436,1213,223,0.844708,0.155292,1.631428,204,19,1437,1213,224,0.84412,0.15588,1.631268,205,19,1, abandoned,1,1,0
66012,1000592,4,985,842,143,0.854822,0.145178,3.181902,93,50,986,843,143,0.85497,0.14503,3.177596,93,50,-1, abandoned,0,0,0
66017,1000534,1,814,624,190,0.766585,0.233415,0.766585,164,26,816,625,191,0.765931,0.234069,0.765931,165,26,1, merged,1,1,0
66018,1000014,1,3767,3030,737,0.804354,0.195646,0.804354,693,44,3769,3031,738,0.804192,0.195808,0.804192,694,44,1, merged,1,1,0
66018,1000121,2,3073,2562,511,0.833713,0.166287,1.638067,473,38,3074,2562,512,0.833442,0.166558,1.637634,474,38,1, merged,1,1,0
66028,1000014,3,3769,3031,738,0.804192,0.195808,2.589897,694,44,3771,3032,739,0.804031,0.195969,2.598064,695,44,1, merged,1,1,0
66028,1000120,2,2545,2242,303,0.880943,0.119057,1.785705,264,39,2546,2243,303,0.88099,0.11901,1.794033,264,39,-1, merged,0,0,0
66034,1000014,2,3771,3032,739,0.804031,0.195969,1.717074,695,44,3773,3033,740,0.80387,0.19613,1.72387,696,44,1, merged,1,1,0
66049,1000130,2,982,816,166,0.830957,0.169043,1.665038,129,37,983,817,166,0.831129,0.168871,1.665458,129,37,1, merged,0,0,0
66049,1000140,1,669,558,111,0.834081,0.165919,0.834081,99,12,670,559,111,0.834328,0.165672,0.834328,99,12,1, merged,0,0,0
66068,1000009,1,2389,2000,389,0.83717,0.16283,0.83717,344,45,2390,2001,389,0.837238,0.162762,0.837238,344,45,1, merged,0,0,0
66085,1000023,2,2253,1961,292,0.870395,0.129605,1.738634,259,33,2254,1962,292,0.870453,0.129547,1.738039,259,33,1, merged,0,0,0
66103,1000328,2,1246,936,310,0.751204,0.248796,1.528347,276,34,1247,937,310,0.751403,0.248597,1.52897,276,34,1, merged,0,0,0
66106,1000007,2,2127,1711,416,0.804419,0.195581,1.570351,361,55,2129,1713,416,0.804603,0.195397,1.570171,361,55,-1, merged,0,0,0
66106,1000153,4,1507,1347,160,0.893829,0.106171,3.105689,122,38,1509,1349,160,0.89397,0.10603,3.10164,122,38,-1, merged,0,0,0
66106,1000534,1,816,625,191,0.765931,0.234069,0.765931,165,26,819,627,192,0.765568,0.234432,0.765568,166,26,-1, merged,1,0,0
66110,1000328,2,1247,937,310,0.751403,0.248597,1.533802,276,34,1248,937,311,0.750801,0.249199,1.533252,277,34,1, abandoned,1,1,0
66110,1000329,1,4136,3236,900,0.782398,0.217602,0.782398,766,134,4137,3237,900,0.782451,0.217549,0.782451,766,134,-1, abandoned,0,0,0
66118,1000328,1,1248,937,311,0.750801,0.249199,0.750801,277,34,1249,938,311,0.751001,0.248999,0.751001,277,34,1, merged,0,0,0
66118,1000329,2,4138,3238,900,0.782504,0.217496,1.533305,766,134,4139,3238,901,0.782315,0.217685,1.533315,766,135,-1, merged,1,1,0
66122,1000009,2,2400,2010,390,0.8375,0.1625,1.60449,345,45,2403,2010,393,0.836454,0.163546,1.603727,348,45,1, merged,1,1,0
66122,1000014,3,3775,3035,740,0.803974,0.196026,2.408464,696,44,3776,3035,741,0.803761,0.196239,2.407488,697,44,1, merged,1,1,0
66122,1000534,1,824,632,192,0.76699,0.23301,0.76699,166,26,825,633,192,0.767273,0.232727,0.767273,166,26,-1, merged,0,0,0
66125,1000091,1,728,574,154,0.788462,0.211538,0.788462,128,26,729,575,154,0.788752,0.211248,0.788752,128,26,1, merged,0,0,0
66125,1000130,2,986,819,167,0.830629,0.169371,1.61909,130,37,987,820,167,0.8308,0.1692,1.619552,130,37,1, merged,0,0,0
66127,1000105,1,968,769,199,0.794421,0.205579,0.794421,166,33,969,769,200,0.793602,0.206398,0.793602,167,33,1, abandoned,1,1,0
66128,1000121,2,3092,2570,522,0.831177,0.168823,1.702972,484,38,3093,2570,523,0.830909,0.169091,1.691668,485,38,1, abandoned,1,1,0
66152,1000023,2,2270,1977,293,0.870925,0.129075,1.554258,260,33,2271,1978,293,0.870982,0.129018,1.555629,260,33,1, merged,0,0,0
66153,1000023,1,2271,1978,293,0.870982,0.129018,0.870982,260,33,2272,1979,293,0.871039,0.128961,0.871039,260,33,1, merged,0,0,0
66154,1000023,1,2272,1979,293,0.871039,0.128961,0.871039,260,33,2273,1980,293,0.871095,0.128905,0.871095,260,33,-1, merged,0,0,0
66160,1000026,1,787,662,125,0.841169,0.158831,0.841169,122,3,788,663,125,0.841371,0.158629,0.841371,122,3,1, merged,0,0,0
66160,1000120,2,2546,2243,303,0.88099,0.11901,1.722159,264,39,2547,2244,303,0.881037,0.118963,1.722407,264,39,1, merged,0,0,0
66167,1000329,2,4139,3238,901,0.782315,0.217685,1.471756,766,135,4140,3239,901,0.782367,0.217633,1.467552,766,135,-1, abandoned,0,0,0
66182,1000043,1,733,605,128,0.825375,0.174625,0.825375,110,18,734,605,129,0.824251,0.175749,0.824251,111,18,1, merged,1,1,0
66182,1000108,2,657,556,101,0.846271,0.153729,1.671646,95,6,659,557,102,0.84522,0.15478,1.669471,96,6,1, merged,1,1,0
66183,1000121,5,3093,2570,523,0.830909,0.169091,4.014235,485,38,3094,2570,524,0.83064,0.16936,4.007191,486,38,1, merged,1,1,0
66183,1000130,3,987,820,167,0.8308,0.1692,2.40576,130,37,988,820,168,0.82996,0.17004,2.397723,131,37,1, merged,1,1,0
66183,1000140,1,671,560,111,0.834575,0.165425,0.834575,99,12,673,560,113,0.832095,0.167905,0.832095,101,12,1, merged,1,1,0
66185,1000014,1,3777,3035,742,0.803548,0.196452,0.803548,698,44,3779,3037,742,0.803652,0.196348,0.803652,698,44,-1, merged,0,0,0
66185,1000108,2,659,557,102,0.84522,0.15478,1.648768,96,6,660,558,102,0.845455,0.154545,1.649106,96,6,1, merged,0,0,0
66187,1000130,2,988,820,168,0.82996,0.17004,1.602111,131,37,989,821,168,0.830131,0.169869,1.599848,131,37,1, merged,0,0,0
66191,1000023,2,2277,1983,294,0.870883,0.129117,1.55553,261,33,2278,1983,295,0.8705,0.1295,1.552319,262,33,1, abandoned,1,1,0
66193,1000011,2,1089,999,90,0.917355,0.082645,1.822314,84,6,1090,1000,90,0.917431,0.082569,1.822781,84,6,1, merged,0,0,0
66193,1000026,3,788,663,125,0.841371,0.158629,2.663685,122,3,789,664,125,0.841572,0.158428,2.664353,122,3,1, merged,0,0,0
66197,1000004,2,5168,4542,626,0.87887,0.12113,1.760046,498,128,5169,4543,626,0.878893,0.121107,1.759724,498,128,-1, abandoned,0,0,0
66197,1000120,1,2550,2247,303,0.881176,0.118824,0.881176,264,39,2551,2247,304,0.880831,0.119169,0.880831,265,39,1, abandoned,1,1,0
66221,1000004,2,5169,4543,626,0.878893,0.121107,1.668537,498,128,5174,4547,627,0.878817,0.121183,1.668206,499,128,-1, merged,1,0,0
66224,1000015,1,2789,2498,291,0.895662,0.104338,0.895662,266,25,2790,2499,291,0.895699,0.104301,0.895699,266,25,-1, abandoned,0,0,0
66230,1000329,2,4141,3240,901,0.78242,0.21758,1.504159,766,135,4142,3241,901,0.782472,0.217528,1.50661,766,135,1, merged,0,0,0
66245,1000105,1,972,771,201,0.79321,0.20679,0.79321,168,33,973,772,201,0.793422,0.206578,0.793422,168,33,1, merged,0,0,0
66251,1000012,2,992,852,140,0.858871,0.141129,1.75457,133,7,993,853,140,0.859013,0.140987,1.754749,133,7,1, merged,0,0,0
66251,1000015,1,2790,2499,291,0.895699,0.104301,0.895699,266,25,2791,2500,291,0.895736,0.104264,0.895736,266,25,1, merged,0,0,0
66259,1000014,2,3780,3038,742,0.803704,0.196296,1.582949,698,44,3781,3039,742,0.803756,0.196244,1.583417,698,44,1, merged,0,0,0
66262,1000014,3,3781,3039,742,0.803756,0.196244,2.239848,698,44,3782,3040,742,0.803808,0.196192,2.233991,698,44,-1, abandoned,0,0,0
66262,1000105,2,974,773,201,0.793634,0.206366,1.436093,168,33,975,773,202,0.792821,0.207179,1.430183,169,33,1, abandoned,1,1,0
66273,1000328,1,1252,941,311,0.751597,0.248403,0.751597,277,34,1253,942,311,0.751796,0.248204,0.751796,277,34,1, merged,0,0,0
66273,1000329,2,4144,3242,902,0.782336,0.217664,1.533933,767,135,4145,3243,902,0.782388,0.217612,1.534184,767,135,1, merged,0,0,0
66282,1000023,2,2280,1985,295,0.870614,0.129386,1.727163,262,33,2281,1986,295,0.870671,0.129329,1.727517,262,33,1, merged,0,0,0
66287,1000003,1,1674,1379,295,0.823775,0.176225,0.823775,253,42,1675,1379,296,0.823284,0.176716,0.823284,254,42,1, merged,1,1,0
66287,1000121,4,3109,2585,524,0.831457,0.168543,3.120601,486,38,3110,2586,524,0.831511,0.168489,3.125235,486,38,1, merged,0,0,0
66295,1000166,2,680,519,161,0.763235,0.236765,1.631004,154,7,681,520,161,0.763583,0.236417,1.631533,154,7,1, merged,0,0,0
66306,1000054,2,1446,1220,226,0.843707,0.156293,1.526634,206,20,1447,1221,226,0.843815,0.156185,1.529299,206,20,1, merged,0,0,0
66308,1000026,1,789,664,125,0.841572,0.158428,0.841572,122,3,790,665,125,0.841772,0.158228,0.841772,122,3,1, merged,0,0,0
66308,1000327,3,767,610,157,0.795306,0.204694,2.328236,121,36,768,611,157,0.795573,0.204427,2.330597,121,36,1, merged,0,0,0
66308,1000329,4,4145,3243,902,0.782388,0.217612,3.110624,767,135,4147,3244,903,0.782252,0.217748,3.112849,767,136,-1, merged,1,1,0
66309,1000023,1,2282,1987,295,0.870727,0.129273,0.870727,262,33,2283,1988,295,0.870784,0.129216,0.870784,262,33,1, merged,0,0,0
66319,1000023,2,2284,1989,295,0.870841,0.129159,1.701315,262,33,2285,1990,295,0.870897,0.129103,1.700534,262,33,-1, abandoned,0,0,0
66319,1000130,1,991,823,168,0.830474,0.169526,0.830474,131,37,992,823,169,0.829637,0.170363,0.829637,132,37,1, abandoned,1,1,0
66326,1000023,1,2287,1992,295,0.87101,0.12899,0.87101,262,33,2288,1993,295,0.871066,0.128934,0.871066,262,33,1, merged,0,0,0
66329,1000166,1,682,521,161,0.76393,0.23607,0.76393,154,7,683,521,162,0.762811,0.237189,0.762811,155,7,1, abandoned,1,1,0
66330,1000110,2,835,749,86,0.897006,0.102994,1.659817,79,7,836,749,87,0.895933,0.104067,1.656517,80,7,1, merged,1,1,0
66330,1000140,3,674,561,113,0.832344,0.167656,2.492161,101,12,675,562,113,0.832593,0.167407,2.48911,101,12,1, merged,0,0,0
66330,1000166,1,683,521,162,0.762811,0.237189,0.762811,155,7,685,521,164,0.760584,0.239416,0.760584,157,7,1, merged,1,1,0
66331,1000109,1,823,712,111,0.865128,0.134872,0.865128,103,8,824,713,111,0.865291,0.134709,0.865291,103,8,1, merged,0,0,0
66333,1000091,1,729,575,154,0.788752,0.211248,0.788752,128,26,730,576,154,0.789041,0.210959,0.789041,128,26,-1, merged,0,0,0
66333,1000130,2,993,824,169,0.829809,0.170191,1.61856,132,37,995,825,170,0.829146,0.170854,1.618187,133,37,1, merged,1,1,0
66342,1000121,3,3111,2587,524,0.831565,0.168435,2.281523,486,38,3112,2588,524,0.83162,0.16838,2.276642,486,38,1, merged,0,0,0
66342,1000166,2,686,522,164,0.760933,0.239067,1.449957,157,7,688,523,165,0.760174,0.239826,1.445023,158,7,1, merged,1,1,0
66343,1000023,2,2291,1996,295,0.871235,0.128765,1.687025,262,33,2292,1997,295,0.871291,0.128709,1.689473,262,33,1, merged,0,0,0
66346,1000043,1,734,605,129,0.824251,0.175749,0.824251,111,18,736,606,130,0.82337,0.17663,0.82337,112,18,1, merged,1,1,0
66346,1000054,2,1447,1221,226,0.843815,0.156185,1.668065,206,20,1449,1221,228,0.84265,0.15735,1.66602,208,20,1, merged,1,1,0
66350,1000009,2,2406,2013,393,0.836658,0.163342,1.604494,348,45,2408,2014,394,0.836379,0.163621,1.603568,349,45,1, merged,1,1,0
66350,1000534,1,827,635,192,0.767836,0.232164,0.767836,166,26,829,636,193,0.767189,0.232811,0.767189,167,26,1, merged,1,1,0
66355,1000023,2,2292,1997,295,0.871291,0.128709,1.631466,262,33,2293,1998,295,0.871348,0.128652,1.63187,262,33,1, merged,0,0,0
66355,1000054,3,1449,1221,228,0.84265,0.15735,2.474116,208,20,1450,1222,228,0.842759,0.157241,2.474629,208,20,1, merged,0,0,0
66355,1000166,1,688,523,165,0.760174,0.239826,0.760174,158,7,689,524,165,0.760522,0.239478,0.760522,158,7,1, merged,0,0,0
66357,1000043,1,736,606,130,0.82337,0.17663,0.82337,112,18,737,607,130,0.823609,0.176391,0.823609,112,18,1, merged,0,0,0
66357,1000108,3,663,561,102,0.846154,0.153846,2.502116,96,6,664,562,102,0.846386,0.153614,2.502835,96,6,1, merged,0,0,0
66357,1000140,2,675,562,113,0.832593,0.167407,1.655962,101,12,676,563,113,0.83284,0.16716,1.656449,101,12,1, merged,0,0,0
66362,1000329,2,4147,3244,903,0.782252,0.217748,1.645889,767,136,4148,3245,903,0.782305,0.217695,1.647473,767,136,1, merged,0,0,0
66365,1000199,2,722,623,99,0.862881,0.137119,1.650456,85,14,723,624,99,0.863071,0.136929,1.651071,85,14,1, merged,0,0,0
66368,1000009,2,2408,2014,394,0.836379,0.163621,1.731748,349,45,2411,2017,394,0.836582,0.163418,1.730418,349,45,-1, merged,0,0,0
66371,1000009,1,2411,2017,394,0.836582,0.163418,0.836582,349,45,2412,2018,394,0.83665,0.16335,0.83665,349,45,-1, abandoned,0,0,0
66371,1000026,2,790,665,125,0.841772,0.158228,1.678354,122,3,791,665,126,0.840708,0.159292,1.677358,123,3,1, abandoned,1,1,0
66371,1000153,3,1513,1353,160,0.89425,0.10575,2.572604,122,38,1514,1354,160,0.89432,0.10568,2.571678,122,38,-1, abandoned,0,0,0
66375,1000005,2,1275,1098,177,0.861176,0.138824,1.653822,167,10,1277,1099,178,0.860611,0.139389,1.652448,168,10,-1, merged,1,0,0
66375,1000054,4,1450,1222,228,0.842759,0.157241,3.256349,208,20,1451,1223,228,0.842867,0.157133,3.25543,208,20,1, merged,0,0,0
66375,1000105,1,979,776,203,0.792646,0.207354,0.792646,170,33,980,776,204,0.791837,0.208163,0.791837,171,33,1, merged,1,1,0
66375,1000166,3,691,525,166,0.759768,0.240232,2.41359,159,7,692,526,166,0.760116,0.239884,2.412563,159,7,1, merged,0,0,0
66376,1000007,1,2132,1716,416,0.804878,0.195122,0.804878,361,55,2134,1718,416,0.805061,0.194939,0.805061,361,55,-1, merged,0,0,0
66376,1000009,3,2412,2018,394,0.83665,0.16335,2.408718,349,45,2414,2018,396,0.835957,0.164043,2.408768,351,45,1, merged,1,1,0
66376,1000534,2,829,636,193,0.767189,0.232811,1.572067,167,26,831,638,193,0.76775,0.23225,1.572811,167,26,-1, merged,0,0,0
66378,1000014,3,3786,3042,744,0.803487,0.196513,2.532588,700,44,3787,3043,744,0.803538,0.196462,2.531137,700,44,-1, merged,0,0,0
66378,1000121,2,3112,2588,524,0.83162,0.16838,1.729102,486,38,3114,2590,524,0.831728,0.168272,1.727598,486,38,-1, merged,0,0,0
66390,1000132,1,1008,836,172,0.829365,0.170635,0.829365,146,26,1009,836,173,0.828543,0.171457,0.828543,147,26,1, merged,1,1,0
66403,1000043,1,740,610,130,0.824324,0.175676,0.824324,112,18,741,611,130,0.824561,0.175439,0.824561,112,18,1, merged,0,0,0
66403,1000108,3,665,563,102,0.846617,0.153383,2.440172,96,6,666,564,102,0.846847,0.153153,2.457123,96,6,1, merged,0,0,0
66405,1000023,2,2300,2005,295,0.871739,0.128261,1.73969,262,33,2301,2006,295,0.871795,0.128205,1.739927,262,33,1, merged,0,0,0
66412,1000534,1,831,638,193,0.76775,0.23225,0.76775,167,26,832,639,193,0.768029,0.231971,0.768029,167,26,1, merged,0,0,0
66413,1000534,1,832,639,193,0.768029,0.231971,0.768029,167,26,833,640,193,0.768307,0.231693,0.768307,167,26,1, merged,0,0,0
66414,1000328,2,1254,942,312,0.751196,0.248804,1.533501,278,34,1256,942,314,0.75,0.25,1.532116,278,36,-1, merged,1,1,0
66414,1000329,1,4148,3245,903,0.782305,0.217695,0.782305,767,136,4149,3245,904,0.782116,0.217884,0.782116,767,137,-1, merged,1,1,0
66416,1000327,2,768,611,157,0.795573,0.204427,1.577689,121,36,769,612,157,0.795839,0.204161,1.578007,121,36,1, merged,0,0,0
66416,1000329,1,4149,3245,904,0.782116,0.217884,0.782116,767,137,4150,3246,904,0.782169,0.217831,0.782169,767,137,-1, merged,0,0,0
66418,1000121,4,3114,2590,524,0.831728,0.168272,3.17891,486,38,3115,2590,525,0.831461,0.168539,3.173352,487,38,1, merged,1,1,0
66418,1000328,3,1257,943,314,0.750199,0.249801,2.347182,278,36,1259,944,315,0.749801,0.250199,2.341891,279,36,1, merged,1,1,0
66418,1000329,2,4150,3246,904,0.782169,0.217831,1.596983,767,137,4152,3248,904,0.782274,0.217726,1.59209,767,137,-1, merged,0,0,0
66437,1000015,2,2792,2501,291,0.895774,0.104226,1.695774,266,25,2793,2502,291,0.895811,0.104189,1.658969,266,25,1, merged,0,0,0
66463,1000105,3,983,779,204,0.792472,0.207528,2.076222,171,33,984,780,204,0.792683,0.207317,2.081947,171,33,1, merged,0,0,0
66471,1000023,1,2307,2012,295,0.872128,0.127872,0.872128,262,33,2308,2013,295,0.872184,0.127816,0.872184,262,33,1, merged,0,0,0
66492,1000023,1,2309,2014,295,0.872239,0.127761,0.872239,262,33,2310,2014,296,0.871861,0.128139,0.871861,263,33,1, abandoned,1,1,0
66492,1000130,2,999,829,170,0.82983,0.17017,1.702069,133,37,1000,830,170,0.83,0.17,1.701861,133,37,-1, abandoned,0,0,0
66493,1000121,2,3124,2598,526,0.831626,0.168374,1.727497,488,38,3126,2600,526,0.831734,0.168266,1.727791,488,38,-1, merged,0,0,0
66494,1000327,2,769,612,157,0.795839,0.204161,1.578447,121,36,770,613,157,0.796104,0.203896,1.583338,121,36,1, merged,0,0,0
66499,1000014,1,3788,3044,744,0.80359,0.19641,0.80359,700,44,3790,3046,744,0.803694,0.196306,0.803694,700,44,1, merged,0,0,0
66502,1000007,2,2137,1721,416,0.805335,0.194665,1.529473,361,55,2138,1722,416,0.805426,0.194574,1.51729,361,55,1, merged,0,0,0
66511,1000166,4,693,527,166,0.760462,0.239538,3.082694,159,7,694,528,166,0.760807,0.239193,3.088085,159,7,1, merged,0,0,0
66513,1000014,2,3791,3047,744,0.803746,0.196254,1.640551,700,44,3792,3047,745,0.803534,0.196466,1.635149,701,44,1, abandoned,1,1,0
66515,1000054,3,1454,1226,228,0.843191,0.156809,2.450486,208,20,1458,1228,230,0.84225,0.15775,2.446255,210,20,1, merged,1,1,0
66515,1000166,5,694,528,166,0.760807,0.239193,3.896142,159,7,696,529,167,0.760057,0.239943,3.887035,160,7,1, merged,1,1,0
66518,1000130,2,1000,830,170,0.83,0.17,1.612378,133,37,1001,831,170,0.83017,0.16983,1.612653,133,37,1, merged,0,0,0
66518,1000329,1,4154,3250,904,0.782378,0.217622,0.782378,767,137,4156,3252,904,0.782483,0.217517,0.782483,767,137,-1, merged,0,0,0
66535,1000329,2,4157,3253,904,0.782535,0.217465,1.614151,767,137,4158,3253,905,0.782347,0.217653,1.611699,768,137,1, merged,1,1,0
66536,1000329,2,4158,3253,905,0.782347,0.217653,1.611699,768,137,4159,3253,906,0.782159,0.217841,1.609278,769,137,1, merged,1,1,0
66540,1000014,1,3792,3047,745,0.803534,0.196466,0.803534,701,44,3795,3050,745,0.803689,0.196311,0.803689,701,44,-1, merged,0,0,0
66540,1000105,2,984,780,204,0.792683,0.207317,1.596217,171,33,985,781,204,0.792893,0.207107,1.596582,171,33,1, merged,0,0,0
66546,1000009,1,2414,2018,396,0.835957,0.164043,0.835957,351,45,2415,2019,396,0.836025,0.163975,0.836025,351,45,1, merged,0,0,0
66546,1000026,2,791,665,126,0.840708,0.159292,1.676665,123,3,792,666,126,0.840909,0.159091,1.676934,123,3,1, merged,0,0,0
66560,1000534,2,836,642,194,0.767943,0.232057,1.362145,168,26,838,644,194,0.768496,0.231504,1.368496,168,26,-1, merged,0,0,0
66565,1000091,2,731,576,155,0.787962,0.212038,1.61847,129,26,732,577,155,0.788251,0.211749,1.617107,129,26,1, merged,0,0,0
66565,1000130,1,1003,833,170,0.830508,0.169492,0.830508,133,37,1005,833,172,0.828856,0.171144,0.828856,133,39,-1, merged,1,1,0
66567,1000091,4,732,577,155,0.788251,0.211749,3.152357,129,26,733,578,155,0.78854,0.21146,3.15295,129,26,-1, abandoned,0,0,0
66567,1000121,3,3128,2602,526,0.831841,0.168159,2.364105,488,38,3129,2603,526,0.831895,0.168105,2.36441,488,38,-1, abandoned,0,0,0
66567,1000328,2,1260,945,315,0.75,0.25,1.532264,279,36,1261,946,315,0.750198,0.249802,1.532514,279,36,-1, abandoned,0,0,0
66567,1000329,1,4161,3255,906,0.782264,0.217736,0.782264,769,137,4162,3256,906,0.782316,0.217684,0.782316,769,137,-1, abandoned,0,0,0
66579,1000091,1,733,578,155,0.78854,0.21146,0.78854,129,26,734,579,155,0.788828,0.211172,0.788828,129,26,1, merged,0,0,0
66580,1000015,3,2794,2503,291,0.895848,0.104152,2.151946,266,25,2796,2504,292,0.895565,0.104435,2.101914,267,25,1, merged,1,1,0
66582,1000023,2,2316,2017,299,0.870898,0.129102,1.690253,266,33,2317,2018,299,0.870954,0.129046,1.691467,266,33,1, merged,0,0,0
66585,1000005,2,1294,1114,180,0.860896,0.139104,1.860896,170,10,1296,1116,180,0.861111,0.138889,1.361111,170,10,-1, merged,0,0,0
66586,1000014,2,3795,3050,745,0.803689,0.196311,1.491189,701,44,3796,3051,745,0.803741,0.196259,1.497618,701,44,1, merged,0,0,0
66590,1000054,1,1458,1228,230,0.84225,0.15775,0.84225,210,20,1459,1229,230,0.842358,0.157642,0.842358,210,20,1, merged,0,0,0
66590,1000592,2,986,843,143,0.85497,0.14503,1.697219,93,50,987,844,143,0.855117,0.144883,1.697474,93,50,1, merged,0,0,0
66591,1000014,3,3796,3051,745,0.803741,0.196259,2.348025,701,44,3797,3052,745,0.803792,0.196208,2.349451,701,44,1, merged,0,0,0
66591,1000121,2,3129,2603,526,0.831895,0.168105,1.544285,488,38,3131,2605,526,0.832003,0.167997,1.545659,488,38,1, merged,0,0,0
66591,1000132,4,1013,840,173,0.82922,0.17078,3.177245,147,26,1014,841,173,0.829389,0.170611,3.17884,147,26,1, merged,0,0,0
66592,1000004,1,5179,4552,627,0.878934,0.121066,0.878934,499,128,5184,4557,627,0.879051,0.120949,0.879051,499,128,-1, merged,0,0,0
66594,1000005,2,1296,1116,180,0.861111,0.138889,1.705556,170,10,1297,1117,180,0.861218,0.138782,1.706046,170,10,1, merged,0,0,0
66597,1000023,2,2318,2019,299,0.871009,0.128991,1.716218,266,33,2319,2020,299,0.871065,0.128935,1.716653,266,33,1, merged,0,0,0
66614,1000043,1,743,613,130,0.825034,0.174966,0.825034,112,18,744,614,130,0.825269,0.174731,0.825269,112,18,1, merged,0,0,0
66614,1000108,2,666,564,102,0.846847,0.153153,1.67188,96,6,667,565,102,0.847076,0.152924,1.672345,96,6,1, merged,0,0,0
66615,1000023,2,2319,2020,299,0.871065,0.128935,1.716653,266,33,2320,2021,299,0.871121,0.128879,1.712584,266,33,1, merged,0,0,0
66617,1000014,2,3797,3052,745,0.803792,0.196208,1.49767,701,44,3798,3053,745,0.803844,0.196156,1.503844,701,44,1, merged,0,0,0
66618,1000014,2,3798,3053,745,0.803844,0.196156,1.503844,701,44,3799,3054,745,0.803896,0.196104,1.509778,701,44,1, merged,0,0,0
66619,1000014,2,3799,3054,745,0.803896,0.196104,1.509778,701,44,3800,3055,745,0.803947,0.196053,1.502061,701,44,1, merged,0,0,0
66620,1000014,2,3800,3055,745,0.803947,0.196053,1.502061,701,44,3801,3056,745,0.803999,0.196001,1.489184,701,44,1, merged,0,0,0
66631,1000054,2,1459,1229,230,0.842358,0.157642,1.671746,210,20,1460,1230,230,0.842466,0.157534,1.671037,210,20,1, merged,0,0,0
66631,1000132,1,1014,841,173,0.829389,0.170611,0.829389,147,26,1015,841,174,0.828571,0.171429,0.828571,148,26,1, merged,1,1,0
66638,1000329,1,4162,3256,906,0.782316,0.217684,0.782316,769,137,4164,3258,906,0.782421,0.217579,0.782421,769,137,-1, merged,0,0,0
66640,1000328,2,1263,948,315,0.750594,0.249406,1.541108,279,36,1264,949,315,0.750791,0.249209,1.540161,279,36,1, merged,0,0,0
66641,1000054,1,1460,1230,230,0.842466,0.157534,0.842466,210,20,1461,1231,230,0.842574,0.157426,0.842574,210,20,1, merged,0,0,0
66641,1000166,3,698,531,167,0.760745,0.239255,2.391324,160,7,699,532,167,0.761087,0.238913,2.392321,160,7,1, merged,0,0,0
66644,1000108,2,667,565,102,0.847076,0.152924,1.741396,96,6,668,565,103,0.845808,0.154192,1.739538,97,6,1, abandoned,1,1,0
66644,1000153,1,1514,1354,160,0.89432,0.10568,0.89432,122,38,1515,1354,161,0.893729,0.106271,0.893729,123,38,1, abandoned,1,1,0
66645,1000329,1,4164,3258,906,0.782421,0.217579,0.782421,769,137,4167,3260,907,0.782337,0.217663,0.782337,770,137,-1, merged,1,0,0
66649,1000015,2,2796,2504,292,0.895565,0.104435,1.645565,267,25,2797,2505,292,0.895602,0.104398,1.626372,267,25,1, merged,0,0,0
66664,1000023,1,2321,2022,299,0.871176,0.128824,0.871176,266,33,2323,2024,299,0.871287,0.128713,0.871287,266,33,-1, merged,0,0,0
66665,1000007,2,2140,1724,416,0.805607,0.194393,1.634179,361,55,2141,1724,417,0.805231,0.194769,1.632343,362,55,1, merged,1,1,0
66665,1000132,1,1015,841,174,0.828571,0.171429,0.828571,148,26,1018,842,176,0.827112,0.172888,0.827112,150,26,1, merged,1,1,0
66671,1000004,3,5184,4557,627,0.879051,0.120949,2.400434,499,128,5187,4560,627,0.879121,0.120879,2.402,499,128,-1, merged,0,0,0
66671,1000329,2,4168,3261,907,0.78239,0.21761,1.521383,770,137,4170,3262,908,0.782254,0.217746,1.522879,771,137,1, merged,1,1,0
66674,1000009,2,2417,2021,396,0.836161,0.163839,1.64,351,45,2418,2022,396,0.836228,0.163772,1.639856,351,45,1, merged,0,0,0
66674,1000014,1,3803,3057,746,0.803839,0.196161,0.803839,702,44,3804,3057,747,0.803628,0.196372,0.803628,703,44,1, merged,1,1,0
66684,1000012,2,1009,863,146,0.855302,0.144698,1.749032,139,7,1010,864,146,0.855446,0.144554,1.749245,139,7,1, merged,0,0,0
66684,1000153,1,1515,1354,161,0.893729,0.106271,0.893729,123,38,1516,1355,161,0.893799,0.106201,0.893799,123,38,1, merged,0,0,0
66689,1000120,1,2562,2258,304,0.881343,0.118657,0.881343,265,39,2563,2259,304,0.881389,0.118611,0.881389,265,39,1, merged,0,0,0
66691,1000014,1,3805,3058,747,0.803679,0.196321,0.803679,703,44,3807,3059,748,0.80352,0.19648,0.80352,704,44,1, merged,1,1,0
66694,1000005,1,1306,1125,181,0.861409,0.138591,0.861409,171,10,1308,1126,182,0.860856,0.139144,0.860856,172,10,1, merged,1,1,0
66694,1000121,2,3131,2605,526,0.832003,0.167997,1.693411,488,38,3132,2606,526,0.832056,0.167944,1.692912,488,38,-1, merged,0,0,0
66695,1000121,2,3132,2606,526,0.832056,0.167944,1.659168,488,38,3133,2607,526,0.83211,0.16789,1.659391,488,38,-1, abandoned,0,0,0
66695,1000132,1,1018,842,176,0.827112,0.172888,0.827112,150,26,1019,843,176,0.827282,0.172718,0.827282,150,26,-1, abandoned,0,0,0
66700,1000014,3,3807,3059,748,0.80352,0.19648,2.322529,704,44,3808,3060,748,0.803571,0.196429,2.310366,704,44,1, merged,0,0,0
66700,1000140,1,680,567,113,0.833824,0.166176,0.833824,101,12,681,568,113,0.834068,0.165932,0.834068,101,12,-1, merged,0,0,0
66703,1000199,2,726,627,99,0.863636,0.136364,1.722532,85,14,727,628,99,0.863824,0.136176,1.723008,85,14,1, merged,0,0,0
66704,1000023,2,2328,2027,301,0.870704,0.129296,1.691217,268,33,2330,2028,302,0.870386,0.129614,1.685673,269,33,1, merged,1,1,0
66706,1000105,2,987,783,204,0.793313,0.206687,1.620595,171,33,988,784,204,0.793522,0.206478,1.620973,171,33,-1, abandoned,0,0,0
66706,1000132,1,1019,843,176,0.827282,0.172718,0.827282,150,26,1020,844,176,0.827451,0.172549,0.827451,150,26,-1, abandoned,0,0,0
66707,1000026,1,792,666,126,0.840909,0.159091,0.840909,123,3,793,667,126,0.84111,0.15889,0.84111,123,3,-1, merged,0,0,0
66707,1000120,2,2563,2259,304,0.881389,0.118611,1.722298,265,39,2564,2260,304,0.881435,0.118565,1.722545,265,39,1, merged,0,0,0
66708,1000153,1,1517,1356,161,0.893869,0.106131,0.893869,123,38,1518,1357,161,0.893939,0.106061,0.893939,123,38,1, merged,0,0,0
66717,1000108,2,669,566,103,0.846039,0.153961,1.739978,97,6,670,567,103,0.846269,0.153731,1.740278,97,6,1, merged,0,0,0
66717,1000153,1,1518,1357,161,0.893939,0.106061,0.893939,123,38,1519,1358,161,0.894009,0.105991,0.894009,123,38,1, merged,0,0,0
66720,1000110,2,837,750,87,0.896057,0.103943,1.730125,80,7,838,751,87,0.896181,0.103819,1.730735,80,7,1, merged,0,0,0
66720,1000140,1,681,568,113,0.834068,0.165932,0.834068,101,12,683,570,113,0.834553,0.165447,0.834553,101,12,1, merged,0,0,0
66725,1000015,1,2799,2507,292,0.895677,0.104323,0.895677,267,25,2800,2508,292,0.895714,0.104286,0.895714,267,25,-1, abandoned,0,0,0
66725,1000328,2,1264,949,315,0.750791,0.249209,1.646468,279,36,1265,949,316,0.750198,0.249802,1.645912,280,36,1, abandoned,1,1,0
66726,1000023,1,2332,2030,302,0.870497,0.129503,0.870497,269,33,2335,2031,304,0.869807,0.130193,0.869807,271,33,1, merged,1,1,0
66727,1000014,2,3808,3060,748,0.803571,0.196429,1.470238,704,44,3809,3061,748,0.803623,0.196377,1.303623,704,44,1, merged,0,0,0
66729,1000009,1,2419,2023,396,0.836296,0.163704,0.836296,351,45,2420,2023,397,0.83595,0.16405,0.83595,352,45,1, abandoned,1,1,0
66729,1000153,2,1519,1358,161,0.894009,0.105991,1.730305,123,38,1520,1359,161,0.894079,0.105921,1.730029,123,38,-1, abandoned,0,0,0
66733,1000043,1,744,614,130,0.825269,0.174731,0.825269,112,18,745,615,130,0.825503,0.174497,0.825503,112,18,1, merged,0,0,0
66733,1000054,2,1461,1231,230,0.842574,0.157426,1.667842,210,20,1462,1232,230,0.842681,0.157319,1.668185,210,20,1, merged,0,0,0
66741,1000009,2,2420,2023,397,0.83595,0.16405,1.639573,352,45,2422,2024,398,0.835673,0.164327,1.638874,353,45,-1, merged,1,0,0
66741,1000014,1,3809,3061,748,0.803623,0.196377,0.803623,704,44,3811,3061,750,0.803201,0.196799,0.803201,706,44,1, merged,1,1,0
66744,1000015,2,2800,2508,292,0.895714,0.104286,1.677667,267,25,2801,2509,292,0.895752,0.104248,1.677757,267,25,1, merged,0,0,0
66744,1000329,1,4178,3267,911,0.781953,0.218047,0.781953,773,138,4179,3268,911,0.782005,0.217995,0.782005,773,138,1, merged,0,0,0
66747,1000012,2,1011,865,146,0.855589,0.144411,1.749606,139,7,1012,866,146,0.855731,0.144269,1.749929,139,7,1, merged,0,0,0
66749,1000153,2,1520,1359,161,0.894079,0.105921,1.662575,123,38,1521,1360,161,0.894149,0.105851,1.662921,123,38,1, merged,0,0,0
66749,1000534,1,838,644,194,0.768496,0.231504,0.768496,168,26,839,645,194,0.768772,0.231228,0.768772,168,26,1, merged,0,0,0
66753,1000023,2,2336,2032,304,0.869863,0.130137,1.748552,271,33,2337,2033,304,0.869919,0.130081,1.749004,271,33,1, merged,0,0,0
66754,1000023,2,2337,2033,304,0.869919,0.130081,1.749004,271,33,2338,2034,304,0.869974,0.130026,1.749453,271,33,1, merged,0,0,0
66757,1000023,2,2338,2034,304,0.869974,0.130026,1.737098,271,33,2339,2035,304,0.87003,0.12997,1.737335,271,33,1, merged,0,0,0
66783,1000054,2,1462,1232,230,0.842681,0.157319,1.528165,210,20,1463,1233,230,0.842789,0.157211,1.530789,210,20,1, merged,0,0,0
66784,1000026,1,793,667,126,0.84111,0.15889,0.84111,123,3,795,669,126,0.841509,0.158491,0.841509,123,3,-1, merged,0,0,0
66784,1000054,2,1463,1233,230,0.842789,0.157211,1.683899,210,20,1464,1233,231,0.842213,0.157787,1.683723,211,20,1, merged,1,1,0
66784,1000132,4,1021,845,176,0.82762,0.17238,3.192241,150,26,1023,847,176,0.827957,0.172043,3.190251,150,26,-1, merged,0,0,0
66790,1000329,1,4179,3268,911,0.782005,0.217995,0.782005,773,138,4180,3269,911,0.782057,0.217943,0.782057,773,138,1, merged,0,0,0
66813,1000014,2,3816,3066,750,0.803459,0.196541,1.451346,706,44,3817,3067,750,0.803511,0.196489,1.456288,706,44,1, merged,0,0,0
66822,1000023,2,2342,2035,307,0.868915,0.131085,1.63454,274,33,2343,2036,307,0.868971,0.131029,1.635205,274,33,1, merged,0,0,0
66828,1000005,1,1314,1130,184,0.85997,0.14003,0.85997,174,10,1315,1131,184,0.860076,0.139924,0.860076,174,10,1, merged,0,0,0
66828,1000121,2,3137,2611,526,0.832324,0.167676,1.692293,488,38,3138,2612,526,0.832377,0.167623,1.692453,488,38,1, merged,0,0,0
66862,1000009,2,2424,2026,398,0.835809,0.164191,1.77427,353,45,2425,2027,398,0.835876,0.164124,1.774808,353,45,1, merged,0,0,0
66881,1000023,1,2347,2038,309,0.868343,0.131657,0.868343,276,33,2348,2039,309,0.868399,0.131601,0.868399,276,33,1, merged,0,0,0
66882,1000091,1,736,581,155,0.789402,0.210598,0.789402,129,26,737,582,155,0.789688,0.210312,0.789688,129,26,1, merged,0,0,0
66883,1000014,1,3817,3067,750,0.803511,0.196489,0.803511,706,44,3819,3068,751,0.803352,0.196648,0.803352,707,44,-1, abandoned,1,0,0
66896,1000026,2,795,669,126,0.841509,0.158491,1.735658,123,3,796,669,127,0.840452,0.159548,1.73467,124,3,1, abandoned,1,1,0
66896,1000153,1,1521,1360,161,0.894149,0.105851,0.894149,123,38,1522,1361,161,0.894218,0.105782,0.894218,123,38,-1, abandoned,0,0,0
66900,1000007,1,2143,1726,417,0.805413,0.194587,0.805413,362,55,2144,1727,417,0.805504,0.194496,0.805504,362,55,-1, abandoned,0,0,0
66905,1000007,4,2144,1727,417,0.805504,0.194496,3.219573,362,55,2146,1728,418,0.805219,0.194781,3.201469,363,55,1, merged,1,1,0
66905,1000009,1,2426,2028,398,0.835944,0.164056,0.835944,353,45,2427,2028,399,0.8356,0.1644,0.8356,354,45,1, merged,1,1,0
66905,1000132,3,1024,848,176,0.828125,0.171875,2.414069,150,26,1025,848,177,0.827317,0.172683,2.39625,151,26,1, merged,1,1,0
66907,1000054,1,1466,1234,232,0.841746,0.158254,0.841746,212,20,1467,1235,232,0.841854,0.158146,0.841854,212,20,1, merged,0,0,0
66907,1000166,2,701,534,167,0.761769,0.238231,1.603515,160,7,702,535,167,0.762108,0.237892,1.603962,160,7,1, merged,0,0,0
66919,1000007,1,2146,1728,418,0.805219,0.194781,0.805219,363,55,2150,1730,420,0.804651,0.195349,0.804651,365,55,-1, merged,1,0,0
66919,1000132,2,1025,848,177,0.827317,0.172683,1.632536,151,26,1027,849,178,0.82668,0.17332,1.631331,151,27,-1, merged,1,0,0
66938,1000004,2,5188,4561,627,0.879144,0.120856,1.719596,499,128,5189,4562,627,0.879167,0.120833,1.71982,499,128,1, merged,0,0,0
66938,1000026,1,796,669,127,0.840452,0.159548,0.840452,124,3,797,670,127,0.840652,0.159348,0.840652,124,3,1, merged,0,0,0
66939,1000011,2,1096,1005,91,0.916971,0.083029,1.776126,84,7,1097,1006,91,0.917046,0.082954,1.77686,84,7,1, merged,0,0,0
66940,1000043,2,745,615,130,0.825503,0.174497,1.614706,112,18,746,616,130,0.825737,0.174263,1.615481,112,18,1, merged,0,0,0
66941,1000026,1,797,670,127,0.840652,0.159348,0.840652,124,3,798,671,127,0.840852,0.159148,0.840852,124,3,1, merged,0,0,0
66941,1000166,3,703,536,167,0.762447,0.237553,2.180022,160,7,704,537,167,0.762784,0.237216,2.188542,160,7,1, merged,0,0,0
66942,1000120,2,2565,2261,304,0.881481,0.118519,1.671225,265,39,2566,2262,304,0.881528,0.118472,1.671809,265,39,1, merged,0,0,0
66944,1000004,2,5189,4562,627,0.879167,0.120833,1.774993,499,128,5190,4563,627,0.879191,0.120809,1.775054,499,128,1, merged,0,0,0
66944,1000015,1,2803,2511,292,0.895826,0.104174,0.895826,267,25,2804,2512,292,0.895863,0.104137,0.895863,267,25,1, merged,0,0,0
66945,1000130,1,1011,839,172,0.829871,0.170129,0.829871,133,39,1012,840,172,0.83004,0.16996,0.83004,133,39,1, merged,0,0,0
66945,1000329,2,4182,3270,912,0.781923,0.218077,1.611794,773,139,4183,3271,912,0.781975,0.218025,1.612014,773,139,1, merged,0,0,0
66956,1000014,2,3819,3068,751,0.803352,0.196648,1.476079,707,44,3821,3069,752,0.803193,0.196807,1.46986,708,44,1, merged,1,1,0
66956,1000026,3,798,671,127,0.840852,0.159148,2.316931,124,3,800,672,128,0.84,0.16,2.30986,125,3,-1, merged,1,0,0
66956,1000140,4,688,575,113,0.835756,0.164244,3.152687,101,12,689,576,113,0.835994,0.164006,3.145854,101,12,1, merged,0,0,0
66960,1000130,2,1014,842,172,0.830375,0.169625,1.60296,133,39,1017,845,172,0.830875,0.169125,1.603183,133,39,-1, merged,0,0,0
66983,1000004,2,5191,4564,627,0.879214,0.120786,1.719214,499,128,5192,4565,627,0.879237,0.120763,1.718189,499,128,-1, abandoned,0,0,0
66983,1000026,1,800,672,128,0.84,0.16,0.84,125,3,801,672,129,0.838951,0.161049,0.838951,126,3,1, abandoned,1,1,0
66992,1000004,2,5193,4566,627,0.879261,0.120739,1.682346,499,128,5194,4567,627,0.879284,0.120716,1.682421,499,128,1, merged,0,0,0
66992,1000014,1,3824,3071,753,0.803086,0.196914,0.803086,709,44,3825,3072,753,0.803137,0.196863,0.803137,709,44,1, merged,0,0,0
66994,1000023,1,2348,2039,309,0.868399,0.131601,0.868399,276,33,2349,2040,309,0.868455,0.131545,0.868455,276,33,1, merged,0,0,0
66996,1000534,2,840,646,194,0.769048,0.230952,1.350129,168,26,842,647,195,0.768409,0.231591,1.341742,169,26,1, merged,1,1,0
66998,1000011,2,1097,1006,91,0.917046,0.082954,1.62779,84,7,1098,1007,91,0.917122,0.082878,1.630237,84,7,1, merged,0,0,0
67001,1000004,7,5195,4568,627,0.879307,0.120693,5.830957,499,128,5198,4570,628,0.879184,0.120816,5.821998,500,128,-1, merged,1,0,0
67001,1000005,5,1323,1138,185,0.860166,0.139834,4.108655,175,10,1324,1138,186,0.859517,0.140483,4.10185,176,10,1, merged,1,1,0
67001,1000105,1,992,787,205,0.793347,0.206653,0.793347,172,33,993,787,206,0.792548,0.207452,0.792548,173,33,1, merged,1,1,0
67001,1000132,4,1030,852,178,0.827184,0.172816,3.248488,151,27,1031,852,179,0.826382,0.173618,3.242333,152,27,1, merged,1,1,0
67001,1000329,3,4185,3273,912,0.782079,0.217921,2.421304,773,139,4189,3276,913,0.782048,0.217952,2.415951,774,139,-1, merged,1,0,0
67012,1000005,1,1324,1138,186,0.859517,0.140483,0.859517,176,10,1326,1140,186,0.859729,0.140271,0.859729,176,10,-1, merged,0,0,0
67012,1000121,2,3160,2631,529,0.832595,0.167405,1.692112,490,39,3163,2633,530,0.832438,0.167562,1.692166,491,39,-1, merged,1,0,0
67018,1000004,1,5198,4570,628,0.879184,0.120816,0.879184,500,128,5200,4571,629,0.879038,0.120962,0.879038,501,128,1, merged,1,1,0
67018,1000023,2,2349,2040,309,0.868455,0.131545,1.747639,276,33,2350,2041,309,0.868511,0.131489,1.747549,276,33,1, merged,0,0,0
67020,1000120,1,2569,2265,304,0.881666,0.118334,0.881666,265,39,2571,2266,305,0.881369,0.118631,0.881369,265,40,-1, merged,1,0,0
67027,1000011,1,1098,1007,91,0.917122,0.082878,0.917122,84,7,1100,1007,93,0.915455,0.084545,0.915455,86,7,1, abandoned,1,1,0
67027,1000015,2,2804,2512,292,0.895863,0.104137,1.812985,267,25,2805,2512,293,0.895544,0.104456,1.810998,268,25,1, abandoned,1,1,0
67035,1000054,2,1471,1239,232,0.842284,0.157716,1.606075,212,20,1472,1240,232,0.842391,0.157609,1.606516,212,20,1, merged,0,0,0
67035,1000166,1,707,540,167,0.763791,0.236209,0.763791,160,7,708,541,167,0.764124,0.235876,0.764124,160,7,1, merged,0,0,0
67038,1000007,1,2152,1732,420,0.804833,0.195167,0.804833,365,55,2153,1733,420,0.804923,0.195077,0.804923,365,55,1, merged,0,0,0
67039,1000015,2,2805,2512,293,0.895544,0.104456,1.677592,268,25,2806,2513,293,0.895581,0.104419,1.677681,268,25,-1, abandoned,0,0,0
67039,1000329,1,4189,3276,913,0.782048,0.217952,0.782048,774,139,4190,3277,913,0.7821,0.2179,0.7821,774,139,-1, abandoned,0,0,0
67047,1000005,1,1326,1140,186,0.859729,0.140271,0.859729,176,10,1330,1142,188,0.858647,0.141353,0.858647,178,10,-1, merged,1,0,0
67047,1000121,2,3174,2638,536,0.831128,0.168872,1.690856,497,39,3175,2639,536,0.831181,0.168819,1.689828,497,39,-1, merged,0,0,0
67056,1000011,2,1102,1008,94,0.914701,0.085299,1.488034,87,7,1103,1009,94,0.914778,0.085222,1.493725,87,7,1, merged,0,0,0
67057,1000108,3,671,568,103,0.846498,0.153502,2.378203,97,6,672,569,103,0.846726,0.153274,2.378681,97,6,1, merged,0,0,0
67057,1000328,2,1266,949,317,0.749605,0.250395,1.531705,280,37,1267,950,317,0.749803,0.250197,1.531955,280,37,1, merged,0,0,0
67057,1000329,1,4190,3277,913,0.7821,0.2179,0.7821,774,139,4191,3278,913,0.782152,0.217848,0.782152,774,139,1, merged,0,0,0
67058,1000011,2,1103,1009,94,0.914778,0.085222,1.771077,87,7,1104,1010,94,0.914855,0.085145,1.771296,87,7,1, merged,0,0,0
67058,1000012,1,1016,870,146,0.856299,0.143701,0.856299,139,7,1017,871,146,0.856441,0.143559,0.856441,139,7,1, merged,0,0,0
67061,1000005,2,1331,1143,188,0.858753,0.141247,1.699717,178,10,1332,1144,188,0.858859,0.141141,1.700205,178,10,1, merged,0,0,0
67067,1000012,2,1017,871,146,0.856441,0.143559,1.750659,139,7,1018,872,146,0.856582,0.143418,1.750282,139,7,1, merged,0,0,0
67067,1000153,1,1522,1361,161,0.894218,0.105782,0.894218,123,38,1524,1362,162,0.893701,0.106299,0.893701,123,39,-1, merged,1,0,0
67071,1000004,1,5207,4577,630,0.879009,0.120991,0.879009,501,129,5209,4579,630,0.879055,0.120945,0.879055,501,129,-1, merged,0,0,0
67071,1000014,2,3826,3073,753,0.803189,0.196811,1.682198,709,44,3827,3074,753,0.80324,0.19676,1.682296,709,44,1, merged,0,0,0
67071,1000120,3,2571,2266,305,0.881369,0.118631,2.563567,265,40,2572,2267,305,0.881415,0.118585,2.563711,265,40,1, merged,0,0,0
67072,1000105,2,994,788,206,0.792757,0.207243,1.475449,173,33,995,788,207,0.79196,0.20804,1.46815,173,34,-1, merged,1,1,0
67085,1000014,1,3830,3077,753,0.803394,0.196606,0.803394,709,44,3831,3078,753,0.803446,0.196554,0.803446,709,44,1, merged,0,0,0
67085,1000026,2,801,672,129,0.838951,0.161049,1.642346,126,3,802,673,129,0.839152,0.160848,1.642598,126,3,1, merged,0,0,0
67090,1000023,2,2350,2041,309,0.868511,0.131489,1.668511,276,33,2351,2042,309,0.868567,0.131433,1.681067,276,33,1, merged,0,0,0
67113,1000004,2,5211,4581,630,0.879102,0.120898,1.736669,501,129,5212,4582,630,0.879125,0.120875,1.737113,501,129,1, merged,0,0,0
67113,1000007,3,2154,1734,420,0.805014,0.194986,2.541683,365,55,2155,1735,420,0.805104,0.194896,2.542218,365,55,1, merged,0,0,0
67121,1000004,1,5213,4583,630,0.879148,0.120852,0.879148,501,129,5214,4584,630,0.879171,0.120829,0.879171,501,129,1, merged,0,0,0
67121,1000132,2,1035,856,179,0.827053,0.172947,1.706201,152,27,1036,857,179,0.82722,0.17278,1.706392,152,27,1, merged,0,0,0
67123,1000054,2,1474,1242,232,0.842605,0.157395,1.607062,212,20,1475,1243,232,0.842712,0.157288,1.607501,212,20,1, merged,0,0,0
67123,1000166,1,709,542,167,0.764457,0.235543,0.764457,160,7,710,543,167,0.764789,0.235211,0.764789,160,7,1, merged,0,0,0
67129,1000153,2,1524,1362,162,0.893701,0.106299,1.638853,123,39,1525,1363,162,0.89377,0.10623,1.639627,123,39,1, merged,0,0,0
67139,1000014,3,3832,3079,753,0.803497,0.196503,2.476077,709,44,3833,3080,753,0.803548,0.196452,2.474616,709,44,1, merged,0,0,0
67139,1000121,1,3176,2640,536,0.831234,0.168766,0.831234,497,39,3177,2640,537,0.830973,0.169027,0.830973,498,39,1, merged,1,1,0
67148,1000004,2,5214,4584,630,0.879171,0.120829,1.698844,501,129,5215,4585,630,0.879195,0.120805,1.699847,501,129,1, merged,0,0,0
67155,1000043,2,747,617,130,0.825971,0.174029,1.672697,112,18,748,618,130,0.826203,0.173797,1.673157,112,18,1, merged,0,0,0
67155,1000108,1,672,569,103,0.846726,0.153274,0.846726,97,6,673,570,103,0.846954,0.153046,0.846954,97,6,-1, merged,0,0,0
67158,1000004,2,5216,4586,630,0.879218,0.120782,1.781179,501,129,5217,4587,630,0.879241,0.120759,1.776015,501,129,-1, merged,0,0,0
67174,1000007,2,2157,1737,420,0.805285,0.194715,1.641223,365,55,2159,1739,420,0.805465,0.194535,1.640716,365,55,1, merged,0,0,0
67174,1000009,1,2432,2033,399,0.835938,0.164062,0.835938,354,45,2434,2033,401,0.835251,0.164749,0.835251,356,45,1, merged,1,1,0
67178,1000054,2,1476,1244,232,0.842818,0.157182,1.593015,212,20,1478,1246,232,0.843031,0.156969,1.593425,212,20,1, merged,0,0,0
67178,1000328,1,1269,952,317,0.750197,0.249803,0.750197,280,37,1270,953,317,0.750394,0.249606,0.750394,280,37,1, merged,0,0,0
67179,1000054,2,1478,1246,232,0.843031,0.156969,1.593425,212,20,1479,1247,232,0.843137,0.156863,1.593727,212,20,1, merged,0,0,0
67179,1000328,1,1270,953,317,0.750394,0.249606,0.750394,280,37,1271,954,317,0.75059,0.24941,0.75059,280,37,1, merged,0,0,0
67180,1000054,2,1479,1247,232,0.843137,0.156863,1.593727,212,20,1480,1248,232,0.843243,0.156757,1.594029,212,20,1, merged,0,0,0
67180,1000328,1,1271,954,317,0.75059,0.24941,0.75059,280,37,1272,955,317,0.750786,0.249214,0.750786,280,37,1, merged,0,0,0
67181,1000054,2,1480,1248,232,0.843243,0.156757,1.594029,212,20,1481,1249,232,0.843349,0.156651,1.594526,212,20,1, merged,0,0,0
67181,1000328,1,1272,955,317,0.750786,0.249214,0.750786,280,37,1274,957,317,0.751177,0.248823,0.751177,280,37,1, merged,0,0,0
67182,1000054,2,1481,1249,232,0.843349,0.156651,1.594526,212,20,1482,1250,232,0.843455,0.156545,1.594827,212,20,1, merged,0,0,0
67182,1000328,1,1274,957,317,0.751177,0.248823,0.751177,280,37,1275,958,317,0.751373,0.248627,0.751373,280,37,1, merged,0,0,0
67183,1000054,2,1482,1250,232,0.843455,0.156545,1.594827,212,20,1483,1251,232,0.84356,0.15644,1.595128,212,20,1, merged,0,0,0
67183,1000328,1,1275,958,317,0.751373,0.248627,0.751373,280,37,1276,959,317,0.751567,0.248433,0.751567,280,37,1, merged,0,0,0
67188,1000012,2,1018,872,146,0.856582,0.143418,1.75238,139,7,1019,873,146,0.856722,0.143278,1.752695,139,7,1, merged,0,0,0
67189,1000329,2,4192,3279,913,0.782204,0.217796,1.032204,774,139,4193,3279,914,0.782018,0.217982,0.982018,775,139,1, abandoned,1,1,0
67190,1000009,4,2434,2033,401,0.835251,0.164749,2.551402,356,45,2435,2034,401,0.835318,0.164682,2.599388,356,45,1, merged,0,0,0
67203,1000014,1,3835,3082,753,0.803651,0.196349,0.803651,709,44,3836,3083,753,0.803702,0.196298,0.803702,709,44,1, merged,0,0,0
67203,1000026,2,802,673,129,0.839152,0.160848,1.642803,126,3,803,674,129,0.839352,0.160648,1.643054,126,3,1, merged,0,0,0
67207,1000014,1,3836,3083,753,0.803702,0.196298,0.803702,709,44,3838,3084,754,0.803544,0.196456,0.803544,710,44,-1, merged,1,0,0
67207,1000026,2,803,674,129,0.839352,0.160648,1.643054,126,3,806,677,129,0.83995,0.16005,1.643494,126,3,-1, merged,0,0,0
67211,1000121,2,3179,2642,537,0.831079,0.168921,1.72847,498,39,3180,2642,538,0.830818,0.169182,1.726651,499,39,1, abandoned,1,1,0
67214,1000592,2,990,847,143,0.855556,0.144444,1.628283,93,50,991,848,143,0.855701,0.144299,1.63831,93,50,-1, abandoned,0,0,0
67215,1000054,2,1483,1251,232,0.84356,0.15644,1.522132,212,20,1484,1252,232,0.843666,0.156334,1.524139,212,20,1, merged,0,0,0
67220,1000005,4,1343,1151,192,0.857036,0.142964,3.583687,181,11,1344,1152,192,0.857143,0.142857,3.084207,181,11,1, merged,0,0,0
67220,1000121,3,3180,2642,538,0.830818,0.169182,2.726651,499,39,3181,2643,538,0.830871,0.169129,2.227065,499,39,1, merged,0,0,0
67226,1000004,3,5219,4589,630,0.879287,0.120713,1.648791,501,129,5220,4590,630,0.87931,0.12069,1.982597,501,129,-1, merged,0,0,0
67226,1000534,1,846,651,195,0.769504,0.230496,0.769504,169,26,852,656,196,0.769953,0.230047,0.769953,170,26,-1, merged,1,0,0
67236,1000023,1,2354,2045,309,0.868734,0.131266,0.868734,276,33,2355,2046,309,0.86879,0.13121,0.86879,276,33,1, merged,0,0,0
67237,1000108,1,673,570,103,0.846954,0.153046,0.846954,97,6,674,571,103,0.847181,0.152819,0.847181,97,6,1, merged,0,0,0
67237,1000110,3,841,753,88,0.895363,0.104637,2.572726,81,7,842,754,88,0.895487,0.104513,2.573242,81,7,1, merged,0,0,0
67237,1000130,2,1026,852,174,0.830409,0.169591,1.677363,135,39,1027,853,174,0.830574,0.169426,1.677755,135,39,1, merged,0,0,0
67246,1000091,2,738,583,155,0.789973,0.210027,1.54154,129,26,739,584,155,0.790257,0.209743,1.541431,129,26,-1, abandoned,0,0,0
67246,1000328,1,1276,959,317,0.751567,0.248433,0.751567,280,37,1278,960,318,0.751174,0.248826,0.751174,281,37,1, abandoned,1,1,0
67257,1000004,1,5220,4590,630,0.87931,0.12069,0.87931,501,129,5221,4591,630,0.879333,0.120667,0.879333,501,129,1, merged,0,0,0
67257,1000121,3,3181,2643,538,0.830871,0.169129,2.538464,499,39,3182,2644,538,0.830924,0.169076,2.539116,499,39,1, merged,0,0,0
67257,1000329,4,4194,3280,914,0.78207,0.21793,3.320534,775,139,4195,3281,914,0.782122,0.217878,3.321238,775,139,1, merged,0,0,0
67267,1000153,2,1533,1371,162,0.894325,0.105675,1.743487,123,39,1534,1372,162,0.894394,0.105606,1.743976,123,39,1, merged,0,0,0
67269,1000005,1,1345,1153,192,0.857249,0.142751,0.857249,181,11,1346,1154,192,0.857355,0.142645,0.857355,181,11,1, merged,0,0,0
67269,1000121,2,3182,2644,538,0.830924,0.169076,1.688173,499,39,3183,2645,538,0.830977,0.169023,1.688332,499,39,1, merged,0,0,0
67271,1000023,2,2356,2047,309,0.868846,0.131154,1.718846,276,33,2357,2048,309,0.868901,0.131099,1.726044,276,33,1, merged,0,0,0
67274,1000014,1,3841,3087,754,0.803697,0.196303,0.803697,710,44,3842,3088,754,0.803748,0.196252,0.803748,710,44,1, merged,0,0,0
67278,1000009,1,2435,2034,401,0.835318,0.164682,0.835318,356,45,2436,2034,402,0.834975,0.165025,0.834975,356,46,-1, merged,1,1,0
67278,1000534,2,852,656,196,0.769953,0.230047,1.605271,170,26,853,656,197,0.76905,0.23095,1.604026,170,27,-1, merged,1,1,0
67280,1000153,1,1535,1373,162,0.894463,0.105537,0.894463,123,39,1537,1374,163,0.893949,0.106051,0.893949,124,39,1, merged,1,1,0
67281,1000153,1,1537,1374,163,0.893949,0.106051,0.893949,124,39,1539,1375,164,0.893437,0.106563,0.893437,124,40,-1, merged,1,0,0
67301,1000199,2,727,628,99,0.863824,0.136176,1.725547,85,14,728,629,99,0.864011,0.135989,1.726011,85,14,1, merged,0,0,0
67306,1000026,2,806,677,129,0.83995,0.16005,1.733388,126,3,808,679,129,0.840347,0.159653,1.733273,126,3,-1, merged,0,0,0
67306,1000153,1,1539,1375,164,0.893437,0.106563,0.893437,124,40,1541,1376,165,0.892927,0.107073,0.892927,125,40,1, merged,1,1,0
67310,1000043,1,751,621,130,0.826897,0.173103,0.826897,112,18,752,622,130,0.827128,0.172872,0.827128,112,18,1, merged,0,0,0
67310,1000130,2,1039,860,179,0.827719,0.172281,1.654616,140,39,1040,861,179,0.827885,0.172115,1.655012,140,39,1, merged,0,0,0
67311,1000005,2,1347,1155,192,0.857461,0.142539,1.661209,181,11,1348,1156,192,0.857567,0.142433,1.661208,181,11,1, merged,0,0,0
67311,1000014,1,3842,3088,754,0.803748,0.196252,0.803748,710,44,3845,3090,755,0.803641,0.196359,0.803641,711,44,1, merged,1,1,0
67312,1000011,2,1107,1013,94,0.915086,0.084914,1.810422,87,7,1108,1014,94,0.915162,0.084838,1.810255,87,7,1, merged,0,0,0
67312,1000015,1,2809,2515,294,0.895336,0.104664,0.895336,269,25,2812,2517,295,0.895092,0.104908,0.895092,270,25,1, merged,1,1,0
67318,1000026,1,808,679,129,0.840347,0.159653,0.840347,126,3,809,680,129,0.840544,0.159456,0.840544,126,3,1, merged,0,0,0
67319,1000007,2,2160,1740,420,0.805556,0.194444,1.640531,365,55,2161,1741,420,0.805646,0.194354,1.640891,365,55,-1, merged,0,0,0
67319,1000009,1,2436,2034,402,0.834975,0.165025,0.834975,356,46,2440,2038,402,0.835246,0.164754,0.835246,356,46,-1, merged,0,0,0
67319,1000026,5,809,680,129,0.840544,0.159456,4.014606,126,3,811,681,130,0.839704,0.160296,4.014698,127,3,1, merged,1,1,0
67327,1000130,2,1040,861,179,0.827885,0.172115,1.618693,140,39,1042,862,180,0.827255,0.172745,1.615565,141,39,1, merged,1,1,0
67328,1000199,1,728,629,99,0.864011,0.135989,0.864011,85,14,729,630,99,0.864198,0.135802,0.864198,85,14,1, merged,0,0,0
67335,1000328,1,1280,962,318,0.751563,0.248438,0.751563,281,37,1281,963,318,0.751756,0.248244,0.751756,281,37,-1, merged,0,0,0
67336,1000004,1,5221,4591,630,0.879333,0.120667,0.879333,501,129,5223,4591,632,0.878997,0.121003,0.878997,503,129,1, merged,1,1,0
67336,1000121,3,3186,2648,538,0.831136,0.168864,2.48804,499,39,3187,2649,538,0.831189,0.168811,2.486722,499,39,1, merged,0,0,0
67339,1000003,1,1681,1385,296,0.823914,0.176086,0.823914,254,42,1683,1387,296,0.824124,0.175876,0.824124,254,42,-1, merged,0,0,0
67339,1000199,2,729,630,99,0.864198,0.135802,1.688112,85,14,731,632,99,0.864569,0.135431,1.688693,85,14,-1, merged,0,0,0
67341,1000054,2,1486,1253,233,0.843203,0.156797,1.523677,213,20,1487,1254,233,0.843309,0.156691,1.525662,213,20,1, merged,0,0,0
67348,1000004,2,5223,4591,632,0.878997,0.121003,1.644775,503,129,5224,4592,632,0.87902,0.12098,1.642986,503,129,-1, merged,0,0,0
67348,1000166,1,713,546,167,0.765778,0.234222,0.765778,160,7,716,547,169,0.763966,0.236034,0.763966,161,8,1, merged,1,1,0
67352,1000199,2,731,632,99,0.864569,0.135431,1.649994,85,14,732,633,99,0.864754,0.135246,1.650468,85,14,-1, abandoned,0,0,0
67353,1000004,2,5224,4592,632,0.87902,0.12098,1.747977,503,129,5225,4593,632,0.879043,0.120957,1.747631,503,129,-1, abandoned,0,0,0
67353,1000023,1,2358,2049,309,0.868957,0.131043,0.868957,276,33,2359,2049,310,0.868588,0.131412,0.868588,277,33,1, abandoned,1,1,0
67361,1000329,1,4195,3281,914,0.782122,0.217878,0.782122,775,139,4199,3285,914,0.782329,0.217671,0.782329,775,139,-1, merged,0,0,0
67362,1000091,3,739,584,155,0.790257,0.209743,2.348512,129,26,740,585,155,0.790541,0.209459,2.349488,129,26,1, merged,0,0,0
67362,1000329,1,4199,3285,914,0.782329,0.217671,0.782329,775,139,4201,3286,915,0.782195,0.217805,0.782195,776,139,1, merged,1,1,0
67364,1000534,1,853,656,197,0.76905,0.23095,0.76905,170,27,854,657,197,0.769321,0.230679,0.769321,170,27,1, merged,0,0,0
67378,1000534,1,854,657,197,0.769321,0.230679,0.769321,170,27,855,658,197,0.769591,0.230409,0.769591,170,27,1, merged,0,0,0
67383,1000121,3,3187,2649,538,0.831189,0.168811,2.404807,499,39,3188,2650,538,0.831242,0.168758,2.405369,499,39,1, merged,0,0,0
67383,1000329,2,4201,3286,915,0.782195,0.217805,1.573618,776,139,4203,3288,915,0.782298,0.217702,1.574127,776,139,-1, merged,0,0,0
67388,1000014,2,3845,3090,755,0.803641,0.196359,1.574283,711,44,3846,3091,755,0.803692,0.196308,1.575034,711,44,1, merged,0,0,0
67389,1000014,3,3846,3091,755,0.803692,0.196308,2.265174,711,44,3847,3092,755,0.803743,0.196257,2.270224,711,44,1, merged,0,0,0
67390,1000014,3,3847,3092,755,0.803743,0.196257,2.270224,711,44,3848,3093,755,0.803794,0.196206,2.275152,711,44,1, merged,0,0,0
67391,1000005,1,1348,1156,192,0.857567,0.142433,0.857567,181,11,1350,1157,193,0.857037,0.142963,0.857037,182,11,1, merged,1,1,0
67399,1000015,1,2814,2519,295,0.895167,0.104833,0.895167,270,25,2815,2520,295,0.895204,0.104796,0.895204,270,25,-1, merged,0,0,0
67401,1000011,1,1108,1014,94,0.915162,0.084838,0.915162,87,7,1109,1015,94,0.915239,0.084761,0.915239,87,7,-1, abandoned,0,0,0
67401,1000120,2,2576,2271,305,0.881599,0.118401,1.796762,265,40,2577,2272,305,0.881645,0.118355,1.796884,265,40,-1, abandoned,0,0,0
67402,1000120,2,2577,2272,305,0.881645,0.118355,1.651236,265,40,2578,2273,305,0.881691,0.118309,1.651551,265,40,-1, abandoned,0,0,0
67402,1000534,1,855,658,197,0.769591,0.230409,0.769591,170,27,856,659,197,0.76986,0.23014,0.76986,170,27,-1, abandoned,0,0,0
67404,1000592,2,991,848,143,0.855701,0.144299,1.547059,93,50,992,849,143,0.855847,0.144153,1.538774,93,50,1, merged,0,0,0
67405,1000004,2,5226,4594,632,0.879066,0.120934,1.661365,503,129,5229,4597,632,0.879136,0.120864,1.661114,503,129,-1, merged,0,0,0
67405,1000328,3,1281,963,318,0.751756,0.248244,2.413121,281,37,1284,965,319,0.751558,0.248442,2.412671,282,37,-1, merged,1,0,0
67405,1000329,1,4203,3288,915,0.782298,0.217702,0.782298,776,139,4206,3289,917,0.781978,0.218022,0.781978,778,139,1, merged,1,1,0
67408,1000105,2,998,791,207,0.792585,0.207415,1.605085,173,34,999,792,207,0.792793,0.207207,1.616322,173,34,1, merged,0,0,0
67411,1000153,1,1541,1376,165,0.892927,0.107073,0.892927,125,40,1542,1377,165,0.892996,0.107004,0.892996,125,40,1, merged,0,0,0
67414,1000132,2,1041,862,179,0.82805,0.17195,1.462459,152,27,1042,863,179,0.828215,0.171785,1.464579,152,27,1, merged,0,0,0
67417,1000014,3,3850,3095,755,0.803896,0.196104,1.67254,711,44,3851,3096,755,0.803947,0.196053,2.672702,711,44,1, merged,0,0,0
67417,1000023,1,2360,2050,310,0.868644,0.131356,0.868644,277,33,2362,2052,310,0.868755,0.131245,0.868755,277,33,1, merged,0,0,0
67418,1000130,2,1042,862,180,0.827255,0.172745,1.729958,141,39,1043,863,180,0.827421,0.172579,1.730647,141,39,1, merged,0,0,0
67424,1000153,1,1542,1377,165,0.892996,0.107004,0.892996,125,40,1543,1378,165,0.893065,0.106935,0.893065,125,40,1, merged,0,0,0
67425,1000003,2,1683,1387,296,0.824124,0.175876,1.717189,254,42,1684,1387,297,0.823634,0.176366,1.716838,255,42,1, merged,1,1,0
67425,1000109,3,828,717,111,0.865942,0.134058,2.583131,103,8,829,717,112,0.864897,0.135103,2.581736,104,8,1, merged,1,1,0
67425,1000153,1,1543,1378,165,0.893065,0.106935,0.893065,125,40,1545,1380,165,0.893204,0.106796,0.893204,125,40,-1, merged,0,0,0
67439,1000004,2,5229,4597,632,0.879136,0.120864,1.722444,503,129,5230,4598,632,0.879159,0.120841,1.722678,503,129,1, merged,0,0,0
67439,1000054,1,1487,1254,233,0.843309,0.156691,0.843309,213,20,1489,1256,233,0.843519,0.156481,0.843519,213,20,1, merged,0,0,0
67447,1000015,4,2815,2520,295,0.895204,0.104796,3.524885,270,25,2817,2522,295,0.895279,0.104721,3.522012,270,25,1, merged,0,0,0
67447,1000026,1,812,682,130,0.839901,0.160099,0.839901,127,3,814,683,131,0.839066,0.160934,0.839066,128,3,-1, merged,1,0,0
67447,1000153,3,1547,1381,166,0.892696,0.107304,2.629681,126,40,1548,1381,167,0.892119,0.107881,2.626733,127,40,1, merged,1,1,0
67460,1000014,3,3855,3100,755,0.80415,0.19585,2.14752,711,44,3856,3101,755,0.804201,0.195799,2.155078,711,44,1, merged,0,0,0
67462,1000026,2,814,683,131,0.839066,0.160934,1.662596,128,3,815,684,131,0.839264,0.160736,1.617042,128,3,-1, merged,0,0,0
67462,1000054,6,1492,1258,234,0.843164,0.156836,4.953235,214,20,1493,1259,234,0.843269,0.156731,4.90526,214,20,1, merged,0,0,0
67463,1000132,1,1045,865,180,0.827751,0.172249,0.827751,153,27,1046,866,180,0.827916,0.172084,0.827916,153,27,1, merged,0,0,0
67470,1000015,1,2817,2522,295,0.895279,0.104721,0.895279,270,25,2818,2522,296,0.894961,0.105039,0.894961,271,25,1, merged,1,1,0
67476,1000054,2,1493,1259,234,0.843269,0.156731,1.607235,214,20,1494,1260,234,0.843373,0.156627,1.607669,214,20,1, merged,0,0,0
67476,1000166,1,716,547,169,0.763966,0.236034,0.763966,161,8,717,548,169,0.764296,0.235704,0.764296,161,8,1, merged,0,0,0
67478,1000120,2,2581,2275,306,0.881441,0.118559,1.634498,266,40,2582,2276,306,0.881487,0.118513,1.635146,266,40,1, merged,0,0,0
67487,1000004,2,5232,4600,632,0.879205,0.120795,1.79452,503,129,5234,4602,632,0.879251,0.120749,1.793896,503,129,-1, merged,0,0,0
67487,1000011,1,1110,1016,94,0.915315,0.084685,0.915315,87,7,1113,1018,95,0.914645,0.085355,0.914645,88,7,1, merged,1,1,0
67493,1000004,1,5236,4604,632,0.879297,0.120703,0.879297,503,129,5240,4607,633,0.879198,0.120802,0.879198,504,129,-1, merged,1,0,0
67502,1000153,3,1549,1382,167,0.892189,0.107811,2.740328,127,40,1550,1383,167,0.892258,0.107742,2.732291,127,40,1, merged,0,0,0
67503,1000004,2,5240,4607,633,0.879198,0.120802,1.632857,504,129,5241,4608,633,0.879222,0.120778,1.633479,504,129,1, merged,0,0,0
67503,1000120,3,2582,2276,306,0.881487,0.118513,2.514344,266,40,2583,2277,306,0.881533,0.118467,2.515013,266,40,1, merged,0,0,0
67504,1000108,1,675,572,103,0.847407,0.152593,0.847407,97,6,676,573,103,0.847633,0.152367,0.847633,97,6,-1, abandoned,0,0,0
67504,1000110,2,842,754,88,0.895487,0.104513,1.742894,81,7,843,755,88,0.895611,0.104389,1.743244,81,7,-1, abandoned,0,0,0
67507,1000014,2,3856,3101,755,0.804201,0.195799,1.685734,711,44,3857,3102,755,0.804252,0.195748,1.685444,711,44,-1, abandoned,0,0,0
67507,1000120,1,2583,2277,306,0.881533,0.118467,0.881533,266,40,2584,2277,307,0.881192,0.118808,0.881192,267,40,1, abandoned,1,1,0
67508,1000534,1,861,662,199,0.768873,0.231127,0.768873,172,27,864,664,200,0.768519,0.231481,0.768519,172,28,1, merged,1,0,0
67510,1000014,3,3857,3102,755,0.804252,0.195748,2.381366,711,44,3859,3104,755,0.804353,0.195647,2.382159,711,44,1, merged,0,0,0
67515,1000166,1,717,548,169,0.764296,0.235704,0.764296,161,8,718,549,169,0.764624,0.235376,0.764624,161,8,1, merged,0,0,0
67517,1000166,2,718,549,169,0.764624,0.235376,1.4551,161,8,719,550,169,0.764951,0.235049,1.457865,161,8,1, merged,0,0,0
67527,1000153,1,1550,1383,167,0.892258,0.107742,0.892258,127,40,1552,1385,167,0.892397,0.107603,0.892397,127,40,1, merged,0,0,0
67532,1000023,4,2365,2055,310,0.868922,0.131078,3.362752,277,33,2366,2055,311,0.868555,0.131445,3.368381,277,34,-1, merged,1,1,0
67537,1000023,1,2366,2055,311,0.868555,0.131445,0.868555,277,34,2367,2055,312,0.868188,0.131812,0.868188,277,35,-1, merged,1,1,0
67538,1000023,1,2367,2055,312,0.868188,0.131812,0.868188,277,35,2368,2055,313,0.867821,0.132179,0.867821,277,36,-1, merged,1,1,0
67554,1000003,1,1687,1389,298,0.823355,0.176645,0.823355,256,42,1688,1389,299,0.822867,0.177133,0.822867,257,42,1, merged,1,1,0
67554,1000153,2,1553,1386,167,0.892466,0.107534,1.715821,127,40,1555,1387,168,0.891961,0.108039,1.714829,128,40,1, merged,1,1,0
67555,1000005,2,1350,1157,193,0.857037,0.142963,1.597662,182,11,1351,1158,193,0.857143,0.142857,1.598576,182,11,1, merged,0,0,0
67557,1000026,2,818,687,131,0.839853,0.160147,1.683436,128,3,820,689,131,0.840244,0.159756,1.683368,128,3,-1, merged,0,0,0
67557,1000054,1,1496,1262,234,0.843583,0.156417,0.843583,214,20,1498,1263,235,0.843124,0.156876,0.843124,215,20,1, merged,1,1,0
67566,1000023,1,2368,2055,313,0.867821,0.132179,0.867821,277,36,2369,2056,313,0.867877,0.132123,0.867877,277,36,1, merged,0,0,0
67567,1000329,2,4210,3293,917,0.782185,0.217815,1.638177,778,139,4211,3294,917,0.782237,0.217763,1.637368,778,139,1, merged,0,0,0
67567,1000592,1,993,850,143,0.855992,0.144008,0.855992,93,50,994,850,144,0.855131,0.144869,0.855131,93,51,-1, merged,1,1,0
67569,1000023,1,2370,2057,313,0.867932,0.132068,0.867932,277,36,2372,2059,313,0.868044,0.131956,0.868044,277,36,-1, merged,0,0,0
67575,1000121,2,3189,2651,538,0.831295,0.168705,1.727022,499,39,3190,2652,538,0.831348,0.168652,1.727252,499,39,1, merged,0,0,0
67580,1000054,2,1498,1263,235,0.843124,0.156876,1.633528,215,20,1499,1264,235,0.843229,0.156771,1.634161,215,20,1, merged,0,0,0
67588,1000007,1,2162,1742,420,0.805735,0.194265,0.805735,365,55,2163,1743,420,0.805825,0.194175,0.805825,365,55,1, merged,0,0,0
67588,1000153,2,1556,1388,168,0.892031,0.107969,1.697766,128,40,1557,1389,168,0.8921,0.1079,1.697925,128,40,1, merged,0,0,0
67589,1000004,1,5241,4608,633,0.879222,0.120778,0.879222,504,129,5243,4610,633,0.879268,0.120732,0.879268,504,129,-1, merged,0,0,0
67589,1000043,2,754,624,130,0.827586,0.172414,1.706808,112,18,755,625,130,0.827815,0.172185,1.707082,112,18,1, merged,0,0,0
67593,1000004,2,5243,4610,633,0.879268,0.120732,1.773948,504,129,5244,4611,633,0.879291,0.120709,1.774009,504,129,1, merged,0,0,0
67593,1000015,1,2820,2523,297,0.894681,0.105319,0.894681,272,25,2821,2524,297,0.894718,0.105282,0.894718,272,25,1, merged,0,0,0
67594,1000004,2,5244,4611,633,0.879291,0.120709,1.774009,504,129,5245,4612,633,0.879314,0.120686,1.774069,504,129,1, merged,0,0,0
67594,1000015,1,2821,2524,297,0.894718,0.105282,0.894718,272,25,2822,2525,297,0.894755,0.105245,0.894755,272,25,1, merged,0,0,0
67595,1000004,2,5245,4612,633,0.879314,0.120686,1.774069,504,129,5246,4613,633,0.879337,0.120663,1.774129,504,129,1, merged,0,0,0
67595,1000015,1,2822,2525,297,0.894755,0.105245,0.894755,272,25,2823,2526,297,0.894793,0.105207,0.894793,272,25,1, merged,0,0,0
67597,1000014,1,3861,3106,755,0.804455,0.195545,0.804455,711,44,3862,3107,755,0.804505,0.195495,0.804505,711,44,-1, merged,0,0,0
67603,1000014,1,3862,3107,755,0.804505,0.195495,0.804505,711,44,3863,3108,755,0.804556,0.195444,0.804556,711,44,-1, merged,0,0,0
67606,1000327,1,772,615,157,0.796632,0.203368,0.796632,121,36,774,615,159,0.794574,0.205426,0.794574,121,38,-1, merged,1,1,0
67607,1000004,1,5250,4617,633,0.879429,0.120571,0.879429,504,129,5251,4617,634,0.879261,0.120739,0.879261,505,129,1, merged,1,1,0
67607,1000023,4,2373,2060,313,0.868099,0.131901,3.45256,277,36,2375,2062,313,0.868211,0.131789,3.445745,277,36,-1, merged,0,0,0
67607,1000130,3,1065,875,190,0.821596,0.178404,2.58446,151,39,1068,876,192,0.820225,0.179775,2.577535,153,39,1, merged,1,1,0
67614,1000153,2,1558,1390,168,0.892169,0.107831,1.674406,128,40,1559,1391,168,0.892239,0.107761,1.674527,128,40,1, merged,0,0,0
67614,1000329,1,4211,3294,917,0.782237,0.217763,0.782237,778,139,4212,3295,917,0.782289,0.217711,0.782289,778,139,1, merged,0,0,0
67617,1000005,1,1351,1158,193,0.857143,0.142857,0.857143,182,11,1353,1160,193,0.857354,0.142646,0.857354,182,11,-1, merged,0,0,0
67617,1000121,2,3190,2652,538,0.831348,0.168652,1.688491,499,39,3191,2653,538,0.831401,0.168599,1.688755,499,39,1, merged,0,0,0
67626,1000328,2,1286,967,319,0.751944,0.248056,1.534099,282,37,1287,968,319,0.752137,0.247863,1.534158,282,37,-1, merged,0,0,0
67626,1000329,1,4214,3296,918,0.782155,0.217845,0.782155,778,140,4216,3297,919,0.782021,0.217979,0.782021,779,140,1, merged,1,1,0
67628,1000023,2,2376,2063,313,0.868266,0.131734,1.733909,277,36,2377,2064,313,0.868321,0.131679,1.734222,277,36,1, merged,0,0,0
67634,1000108,2,676,573,103,0.847633,0.152367,1.739872,97,6,677,574,103,0.847858,0.152142,1.740166,97,6,1, merged,0,0,0
67634,1000153,1,1559,1391,168,0.892239,0.107761,0.892239,128,40,1560,1392,168,0.892308,0.107692,0.892308,128,40,1, merged,0,0,0
67635,1000023,1,2378,2065,313,0.868377,0.131623,0.868377,277,36,2381,2068,313,0.868543,0.131457,0.868543,277,36,-1, merged,0,0,0
67644,1000004,1,5251,4617,634,0.879261,0.120739,0.879261,505,129,5252,4618,634,0.879284,0.120716,0.879284,505,129,-1, merged,0,0,0
67644,1000120,2,2587,2280,307,0.88133,0.11867,1.760591,267,40,2588,2281,307,0.881376,0.118624,1.76066,267,40,-1, merged,0,0,0
67646,1000007,1,2163,1743,420,0.805825,0.194175,0.805825,365,55,2165,1744,421,0.805543,0.194457,0.805543,366,55,1, merged,1,1,0
67661,1000015,2,2824,2527,297,0.89483,0.10517,1.735074,272,25,2825,2527,298,0.894513,0.105487,1.734319,273,25,1, merged,1,1,0
67661,1000026,1,820,689,131,0.840244,0.159756,0.840244,128,3,824,692,132,0.839806,0.160194,0.839806,129,3,-1, merged,1,0,0
67661,1000153,3,1566,1396,170,0.891443,0.108557,2.626517,130,40,1568,1397,171,0.890944,0.109056,2.625263,131,40,1, merged,1,1,0
67662,1000328,2,1287,968,319,0.752137,0.247863,1.534261,282,37,1288,969,319,0.752329,0.247671,1.53432,282,37,1, merged,0,0,0
67662,1000329,1,4218,3299,919,0.782124,0.217876,0.782124,779,140,4220,3300,920,0.781991,0.218009,0.781991,780,140,1, merged,1,1,0
67663,1000009,1,2446,2044,402,0.83565,0.16435,0.83565,356,46,2448,2045,403,0.835376,0.164624,0.835376,357,46,-1, merged,1,0,0
67663,1000015,2,2825,2527,298,0.894513,0.105487,1.730163,273,25,2826,2528,298,0.894551,0.105449,1.729926,273,25,1, merged,0,0,0
67671,1000329,1,4220,3300,920,0.781991,0.218009,0.781991,780,140,4221,3301,920,0.782042,0.217958,0.782042,780,140,1, merged,0,0,0
67674,1000003,1,1689,1390,299,0.822972,0.177028,0.822972,257,42,1691,1392,299,0.823182,0.176818,0.823182,257,42,-1, merged,0,0,0
67674,1000329,2,4221,3301,920,0.782042,0.217958,1.605014,780,140,4222,3302,920,0.782094,0.217906,1.605275,780,140,1, merged,0,0,0
67678,1000054,2,1501,1265,236,0.842771,0.157229,1.692771,216,20,1502,1266,236,0.842876,0.157124,1.693555,216,20,1, merged,0,0,0
67680,1000091,1,743,588,155,0.791386,0.208614,0.791386,129,26,746,591,155,0.792225,0.207775,0.792225,129,26,-1, merged,0,0,0
67680,1000329,2,4222,3302,920,0.782094,0.217906,1.57348,780,140,4224,3302,922,0.781723,0.218277,1.573949,782,140,1, merged,1,1,0
67681,1000091,1,746,591,155,0.792225,0.207775,0.792225,129,26,748,591,157,0.790107,0.209893,0.790107,131,26,1, merged,1,1,0
67681,1000329,2,4224,3302,922,0.781723,0.218277,1.573949,782,140,4226,3304,922,0.781827,0.218173,1.571934,782,140,-1, merged,0,0,0
67681,1000592,3,994,850,144,0.855131,0.144869,2.429079,93,51,996,851,145,0.854418,0.145582,2.426351,94,51,1, merged,1,1,0
67690,1000014,2,3863,3108,755,0.804556,0.195444,1.471223,711,44,3864,3109,755,0.804607,0.195393,1.476738,711,44,1, merged,0,0,0
67691,1000014,2,3864,3109,755,0.804607,0.195393,1.476738,711,44,3865,3110,755,0.804657,0.195343,1.465948,711,44,1, merged,0,0,0
67726,1000005,2,1357,1163,194,0.857038,0.142962,1.685609,183,11,1358,1164,194,0.857143,0.142857,1.685877,183,11,1, merged,0,0,0
67726,1000132,1,1050,870,180,0.828571,0.171429,0.828571,153,27,1051,871,180,0.828735,0.171265,0.828735,153,27,1, merged,0,0,0
67728,1000121,1,3196,2658,538,0.831665,0.168335,0.831665,499,39,3199,2660,539,0.83151,0.16849,0.83151,500,39,-1, abandoned,1,0,0
67728,1000329,2,4229,3307,922,0.781982,0.218018,1.613646,782,140,4230,3307,923,0.781797,0.218203,1.613307,783,140,1, abandoned,1,1,0
67733,1000120,1,2589,2282,307,0.881421,0.118579,0.881421,267,40,2592,2284,308,0.881173,0.118827,0.881173,268,40,1, merged,1,1,0
67734,1000015,1,2827,2529,298,0.894588,0.105412,0.894588,273,25,2828,2530,298,0.894625,0.105375,0.894625,273,25,1, merged,0,0,0
67734,1000328,2,1288,969,319,0.752329,0.247671,1.646917,282,37,1289,970,319,0.752521,0.247479,1.647147,282,37,1, merged,0,0,0
67735,1000023,2,2383,2070,313,0.868653,0.131347,1.735826,277,36,2384,2071,313,0.868708,0.131292,1.736132,277,36,1, merged,0,0,0
67737,1000014,1,3865,3110,755,0.804657,0.195343,0.804657,711,44,3867,3111,756,0.8045,0.1955,0.8045,712,44,1, merged,1,1,0
67745,1000105,2,1006,799,207,0.794235,0.205765,1.585167,173,34,1007,800,207,0.794439,0.205561,1.585896,173,34,1, merged,0,0,0
67746,1000026,2,825,693,132,0.84,0.16,1.731291,129,3,826,694,132,0.840194,0.159806,1.730987,129,3,1, merged,0,0,0
67746,1000153,1,1573,1402,171,0.891291,0.108709,0.891291,131,40,1575,1403,172,0.890794,0.109206,0.890794,132,40,1, merged,1,1,0
67756,1000004,1,5258,4623,635,0.879232,0.120768,0.879232,506,129,5259,4624,635,0.879255,0.120745,0.879255,506,129,1, merged,0,0,0
67756,1000329,2,4230,3307,923,0.781797,0.218203,1.661028,783,140,4231,3308,923,0.781848,0.218152,1.661103,783,140,1, merged,0,0,0
67762,1000054,1,1502,1266,236,0.842876,0.157124,0.842876,216,20,1505,1269,236,0.843189,0.156811,0.843189,216,20,-1, merged,0,0,0
67764,1000054,5,1505,1269,236,0.843189,0.156811,3.460321,216,20,1506,1270,236,0.843293,0.156707,3.422688,216,20,1, merged,0,0,0
67765,1000014,2,3867,3111,756,0.8045,0.1955,1.8045,712,44,3868,3112,756,0.80455,0.19545,1.80455,712,44,1, merged,0,0,0
67770,1000014,1,3868,3112,756,0.80455,0.19545,0.80455,712,44,3870,3114,756,0.804651,0.195349,0.804651,712,44,1, merged,0,0,0
67771,1000011,2,1115,1020,95,0.914798,0.085202,1.809461,88,7,1116,1021,95,0.914875,0.085125,1.809574,88,7,1, merged,0,0,0
67771,1000015,1,2829,2531,298,0.894662,0.105338,0.894662,273,25,2830,2532,298,0.8947,0.1053,0.8947,273,25,1, merged,0,0,0
67776,1000121,2,3200,2661,539,0.831562,0.168437,1.727997,500,39,3201,2662,539,0.831615,0.168385,1.728225,500,39,1, merged,0,0,0
67778,1000054,1,1506,1270,236,0.843293,0.156707,0.843293,216,20,1507,1271,236,0.843397,0.156603,0.843397,216,20,1, merged,0,0,0
67779,1000054,1,1507,1271,236,0.843397,0.156603,0.843397,216,20,1508,1272,236,0.843501,0.156499,0.843501,216,20,1, merged,0,0,0
67781,1000005,2,1358,1164,194,0.857143,0.142857,1.597143,183,11,1360,1166,194,0.857353,0.142647,1.592647,183,11,-1, merged,0,0,0
67785,1000043,2,755,625,130,0.827815,0.172185,1.668936,112,18,757,627,130,0.828269,0.171731,1.668547,112,18,-1, abandoned,0,0,0
67786,1000054,1,1508,1272,236,0.843501,0.156499,0.843501,216,20,1510,1274,236,0.843709,0.156291,0.843709,216,20,-1, merged,0,0,0
67795,1000014,1,3870,3114,756,0.804651,0.195349,0.804651,712,44,3871,3115,756,0.804702,0.195298,0.804702,712,44,1, merged,0,0,0
67811,1000015,2,2832,2534,298,0.894774,0.105226,1.473721,273,25,2833,2535,298,0.894811,0.105189,1.479227,273,25,1, merged,0,0,0
67812,1000043,2,757,627,130,0.828269,0.171731,1.494936,112,18,758,627,131,0.827177,0.172823,1.470034,113,18,1, abandoned,1,1,0
67814,1000132,1,1053,873,180,0.82906,0.17094,0.82906,153,27,1054,874,180,0.829222,0.170778,0.829222,153,27,1, merged,0,0,0
67815,1000132,2,1054,874,180,0.829222,0.170778,1.651803,153,27,1055,875,180,0.829384,0.170616,1.643214,153,27,1, merged,0,0,0
67816,1000004,1,5259,4624,635,0.879255,0.120745,0.879255,506,129,5260,4625,635,0.879278,0.120722,0.879278,506,129,1, merged,0,0,0
67816,1000329,2,4232,3309,923,0.7819,0.2181,1.661154,783,140,4233,3310,923,0.781951,0.218049,1.661229,783,140,1, merged,0,0,0
67817,1000004,2,5260,4625,635,0.879278,0.120722,1.631705,506,129,5261,4626,635,0.879301,0.120699,1.632327,506,129,1, merged,0,0,0
67818,1000109,2,830,718,112,0.86506,0.13494,1.647012,104,8,831,718,113,0.864019,0.135981,1.646074,104,9,-1, merged,1,1,0
67818,1000329,1,4233,3310,923,0.781951,0.218049,0.781951,783,140,4235,3312,923,0.782054,0.217946,0.782054,783,140,-1, merged,0,0,0
67823,1000003,1,1694,1394,300,0.822904,0.177096,0.822904,258,42,1695,1395,300,0.823009,0.176991,0.823009,258,42,1, merged,0,0,0
67823,1000054,2,1511,1275,236,0.843812,0.156188,1.666716,216,20,1512,1276,236,0.843915,0.156085,1.666924,216,20,1, merged,0,0,0
67830,1000054,1,1512,1276,236,0.843915,0.156085,0.843915,216,20,1513,1276,237,0.843358,0.156642,0.843358,217,20,1, merged,1,1,0
67832,1000007,2,2174,1753,421,0.806348,0.193652,1.526348,366,55,2176,1754,422,0.806066,0.193934,1.520352,367,55,1, merged,1,1,0
67832,1000015,3,2833,2535,298,0.894811,0.105189,2.421159,273,25,2834,2535,299,0.894495,0.105505,2.414847,274,25,1, merged,1,1,0
67837,1000004,2,5261,4626,635,0.879301,0.120699,1.661355,506,129,5262,4627,635,0.879323,0.120677,1.661481,506,129,1, merged,0,0,0
67837,1000329,1,4235,3312,923,0.782054,0.217946,0.782054,783,140,4237,3314,923,0.782157,0.217843,0.782157,783,140,-1, merged,0,0,0
67856,1000005,2,1367,1172,195,0.857352,0.142648,1.686897,184,11,1368,1173,195,0.857456,0.142544,1.687163,184,11,1, merged,0,0,0
67856,1000132,1,1056,876,180,0.829545,0.170455,0.829545,153,27,1057,877,180,0.829707,0.170293,0.829707,153,27,1, merged,0,0,0
67857,1000015,1,2835,2536,299,0.894533,0.105467,0.894533,274,25,2836,2537,299,0.89457,0.10543,0.89457,274,25,-1, abandoned,0,0,0
67857,1000121,2,3201,2662,539,0.831615,0.168385,1.726148,500,39,3202,2663,539,0.831668,0.168332,1.726238,500,39,-1, abandoned,0,0,0
67861,1000120,1,2596,2288,308,0.881356,0.118644,0.881356,268,40,2597,2289,308,0.881402,0.118598,0.881402,268,40,-1, merged,0,0,0
67867,1000121,2,3204,2664,540,0.831461,0.168539,1.573697,501,39,3205,2665,540,0.831513,0.168487,1.574547,501,39,1, merged,0,0,0
67894,1000014,1,3872,3116,756,0.804752,0.195248,0.804752,712,44,3877,3120,757,0.804746,0.195254,0.804746,713,44,-1, merged,1,0,0
67894,1000329,3,4239,3316,923,0.78226,0.21774,2.554225,783,140,4240,3317,923,0.782311,0.217689,2.554799,783,140,-1, merged,0,0,0
67895,1000120,1,2597,2289,308,0.881402,0.118598,0.881402,268,40,2598,2290,308,0.881447,0.118553,0.881447,268,40,1, merged,0,0,0
67898,1000005,1,1369,1174,195,0.85756,0.14244,0.85756,184,11,1370,1175,195,0.857664,0.142336,0.857664,184,11,1, merged,0,0,0
67904,1000004,1,5265,4630,635,0.879392,0.120608,0.879392,506,129,5266,4630,636,0.879225,0.120775,0.879225,507,129,1, merged,1,1,0
67905,1000007,1,2181,1759,422,0.806511,0.193489,0.806511,367,55,2182,1759,423,0.806141,0.193859,0.806141,368,55,1, merged,1,1,0
67905,1000011,2,1120,1025,95,0.915179,0.084821,1.721689,88,7,1121,1026,95,0.915254,0.084746,1.721395,88,7,1, merged,0,0,0
67918,1000015,2,2838,2539,299,0.894644,0.105356,1.785507,274,25,2839,2540,299,0.894681,0.105319,1.785613,274,25,1, merged,0,0,0
67918,1000153,1,1576,1404,172,0.890863,0.109137,0.890863,132,40,1577,1405,172,0.890932,0.109068,0.890932,132,40,1, merged,0,0,0
67924,1000009,2,2449,2046,403,0.835443,0.164557,1.768776,357,46,2451,2048,403,0.835577,0.164423,1.769401,357,46,-1, merged,0,0,0
67937,1000132,1,1057,877,180,0.829707,0.170293,0.829707,153,27,1059,879,180,0.830028,0.169972,0.830028,153,27,-1, merged,0,0,0
67937,1000329,2,4240,3317,923,0.782311,0.217689,1.612018,783,140,4241,3318,923,0.782363,0.217637,1.612391,783,140,-1, merged,0,0,0
67945,1000009,2,2452,2049,403,0.835644,0.164356,1.64039,357,46,2453,2049,404,0.835304,0.164696,1.639842,358,46,1, merged,1,1,0
67945,1000014,1,3877,3120,757,0.804746,0.195254,0.804746,713,44,3878,3120,758,0.804538,0.195462,0.804538,714,44,1, merged,1,1,0
67945,1000534,3,865,665,200,0.768786,0.231214,2.409176,172,28,866,666,200,0.769053,0.230947,2.408895,172,28,-1, merged,0,0,0
67950,1000014,2,3878,3120,758,0.804538,0.195462,1.645118,714,44,3880,3121,759,0.804381,0.195619,1.645153,715,44,1, merged,1,1,0
67950,1000026,1,828,696,132,0.84058,0.15942,0.84058,129,3,829,697,132,0.840772,0.159228,0.840772,129,3,-1, merged,0,0,0
67950,1000140,4,691,578,113,0.836469,0.163531,3.140928,101,12,692,579,113,0.836705,0.163295,3.137596,101,12,1, merged,0,0,0
67952,1000054,1,1514,1277,237,0.843461,0.156539,0.843461,217,20,1515,1278,237,0.843564,0.156436,0.843564,217,20,1, merged,0,0,0
67954,1000054,1,1515,1278,237,0.843564,0.156436,0.843564,217,20,1516,1279,237,0.843668,0.156332,0.843668,217,20,1, merged,0,0,0
67958,1000054,1,1516,1279,237,0.843668,0.156332,0.843668,217,20,1517,1280,237,0.843771,0.156229,0.843771,217,20,1, merged,0,0,0
67972,1000130,2,1078,886,192,0.821892,0.178108,1.690525,153,39,1079,887,192,0.822057,0.177943,1.690866,153,39,1, merged,0,0,0
67979,1000130,2,1084,892,192,0.822878,0.177122,1.51119,153,39,1087,894,193,0.822447,0.177553,1.514755,153,40,-1, merged,1,0,0
67980,1000007,2,2182,1759,423,0.806141,0.193859,1.721471,368,55,2185,1761,424,0.80595,0.19405,1.720464,369,55,-1, abandoned,1,0,0
67980,1000011,1,1122,1027,95,0.91533,0.08467,0.91533,88,7,1123,1027,96,0.914515,0.085485,0.914515,89,7,1, abandoned,1,1,0
67984,1000054,2,1517,1280,237,0.843771,0.156229,1.843771,217,20,1518,1281,237,0.843874,0.156126,1.843874,217,20,1, merged,0,0,0
67993,1000026,2,829,697,132,0.840772,0.159228,1.715772,129,3,830,698,132,0.840964,0.159036,1.720964,129,3,1, merged,0,0,0
67993,1000054,3,1518,1281,237,0.843874,0.156126,2.559646,217,20,1519,1282,237,0.843976,0.156024,2.56494,217,20,1, merged,0,0,0
67994,1000003,2,1696,1396,300,0.823113,0.176887,1.635613,258,42,1697,1397,300,0.823217,0.176783,1.587923,258,42,-1, merged,0,0,0
67997,1000026,1,831,699,132,0.841155,0.158845,0.841155,129,3,832,699,133,0.840144,0.159856,0.840144,130,3,1, merged,1,1,0
67997,1000054,3,1519,1282,237,0.843976,0.156024,2.355766,217,20,1520,1283,237,0.844079,0.155921,2.35616,217,20,1, merged,0,0,0
68010,1000121,2,3209,2669,540,0.831723,0.168277,1.614086,501,39,3211,2670,541,0.831517,0.168483,1.613931,502,39,1, merged,1,1,0
68010,1000329,1,4241,3318,923,0.782363,0.217637,0.782363,783,140,4242,3319,923,0.782414,0.217586,0.782414,783,140,-1, merged,0,0,0
68015,1000005,1,1379,1184,195,0.858593,0.141407,0.858593,184,11,1380,1184,196,0.857971,0.142029,0.857971,185,11,1, merged,1,1,0
68019,1000004,1,5273,4637,636,0.879386,0.120614,0.879386,507,129,5277,4638,639,0.878908,0.121092,0.878908,510,129,1, merged,1,1,0
68021,1000003,3,1697,1397,300,0.823217,0.176783,2.455931,258,42,1698,1398,300,0.823322,0.176678,2.460067,258,42,1, merged,0,0,0
68021,1000328,1,1290,971,319,0.752713,0.247287,0.752713,282,37,1291,971,320,0.75213,0.24787,0.75213,283,37,1, merged,1,1,0
68028,1000004,1,5277,4638,639,0.878908,0.121092,0.878908,510,129,5278,4639,639,0.878931,0.121069,0.878931,510,129,-1, merged,0,0,0
68028,1000329,2,4246,3322,924,0.782383,0.217617,1.661292,784,140,4247,3323,924,0.782435,0.217565,1.661366,784,140,1, merged,0,0,0
68029,1000009,1,2455,2051,404,0.835438,0.164562,0.835438,358,46,2459,2054,405,0.835299,0.164701,0.835299,359,46,-1, merged,1,0,0
68030,1000009,3,2459,2054,405,0.835299,0.164701,2.517019,359,46,2460,2055,405,0.835366,0.164634,2.523583,359,46,1, merged,0,0,0
68030,1000120,2,2604,2296,308,0.88172,0.11828,1.68172,268,40,2605,2297,308,0.881766,0.118234,1.688217,268,40,1, merged,0,0,0
68036,1000014,1,3881,3122,759,0.804432,0.195568,0.804432,715,44,3883,3124,759,0.804533,0.195467,0.804533,715,44,-1, abandoned,0,0,0
68036,1000329,2,4247,3323,924,0.782435,0.217565,1.586867,784,140,4248,3324,924,0.782486,0.217514,1.587018,784,140,-1, abandoned,0,0,0
68052,1000023,2,2393,2079,314,0.868784,0.131216,1.662902,278,36,2394,2080,314,0.868839,0.131161,1.668839,278,36,1, merged,0,0,0
68056,1000091,2,750,593,157,0.790667,0.209333,1.573153,131,26,751,593,158,0.789614,0.210386,1.572355,132,26,1, abandoned,1,1,0
68056,1000329,1,4248,3324,924,0.782486,0.217514,0.782486,784,140,4253,3329,924,0.782742,0.217258,0.782742,784,140,-1, abandoned,0,0,0
68061,1000329,2,4253,3329,924,0.782742,0.217258,1.59199,784,140,4255,3331,924,0.782844,0.217156,1.589662,784,140,-1, merged,0,0,0
68068,1000005,2,1380,1184,196,0.857971,0.142029,1.689593,185,11,1381,1185,196,0.858074,0.141926,1.689748,185,11,1, merged,0,0,0
68068,1000121,1,3213,2672,541,0.831622,0.168378,0.831622,502,39,3214,2673,541,0.831674,0.168326,0.831674,502,39,-1, merged,0,0,0
68074,1000023,1,2396,2082,314,0.868948,0.131052,0.868948,278,36,2397,2082,315,0.868586,0.131414,0.868586,279,36,1, merged,1,1,0
68077,1000091,1,751,593,158,0.789614,0.210386,0.789614,132,26,753,594,159,0.788845,0.211155,0.788845,133,26,1, merged,1,1,0
68077,1000130,2,1087,894,193,0.822447,0.177553,1.612061,153,40,1088,895,193,0.82261,0.17739,1.611455,153,40,1, merged,0,0,0
68087,1000023,1,2397,2082,315,0.868586,0.131414,0.868586,279,36,2398,2083,315,0.868641,0.131359,0.868641,279,36,1, merged,0,0,0
68089,1000014,2,3884,3125,759,0.804583,0.195417,1.673223,715,44,3885,3125,760,0.804376,0.195624,1.672654,716,44,1, abandoned,1,1,0
68089,1000023,1,2398,2083,315,0.868641,0.131359,0.868641,279,36,2399,2083,316,0.868278,0.131722,0.868278,280,36,1, abandoned,1,1,0
68090,1000023,1,2399,2083,316,0.868278,0.131722,0.868278,280,36,2400,2083,317,0.867917,0.132083,0.867917,281,36,1, merged,1,1,0
68098,1000108,1,681,577,104,0.847283,0.152717,0.847283,98,6,683,579,104,0.847731,0.152269,0.847731,98,6,-1, merged,0,0,0
68098,1000140,2,692,579,113,0.836705,0.163295,1.683989,101,12,693,580,113,0.836941,0.163059,1.684671,101,12,1, merged,0,0,0
68112,1000004,2,5278,4639,639,0.878931,0.121069,1.512265,510,129,5279,4639,640,0.878765,0.121235,1.491668,511,129,1, merged,1,1,0
68113,1000054,2,1522,1285,237,0.844284,0.155716,1.721117,217,20,1525,1286,239,0.843279,0.156721,1.717914,219,20,1, merged,1,1,0
68114,1000015,3,2839,2540,299,0.894681,0.105319,1.73796,274,25,2840,2541,299,0.894718,0.105282,1.737547,274,25,1, merged,0,0,0
68114,1000054,1,1525,1286,239,0.843279,0.156721,0.843279,219,20,1527,1287,240,0.842829,0.157171,0.842829,220,20,1, merged,1,1,0
68115,1000015,2,2840,2541,299,0.894718,0.105282,1.737547,274,25,2841,2542,299,0.894755,0.105245,1.737687,274,25,1, merged,0,0,0
68115,1000054,1,1527,1287,240,0.842829,0.157171,0.842829,220,20,1528,1288,240,0.842932,0.157068,0.842932,220,20,1, merged,0,0,0
68116,1000054,1,1528,1288,240,0.842932,0.157068,0.842932,220,20,1530,1290,240,0.843137,0.156863,0.843137,220,20,-1, merged,0,0,0
68127,1000007,1,2187,1763,424,0.806127,0.193873,0.806127,369,55,2188,1764,424,0.806216,0.193784,0.806216,369,55,1, merged,0,0,0
68128,1000007,2,2188,1764,424,0.806216,0.193784,1.636404,369,55,2189,1765,424,0.806304,0.193696,1.63571,369,55,-1, merged,0,0,0
68128,1000132,1,1060,880,180,0.830189,0.169811,0.830189,153,27,1061,880,181,0.829406,0.170594,0.829406,154,27,1, merged,1,1,0
68132,1000009,1,2461,2056,405,0.835433,0.164567,0.835433,359,46,2463,2058,405,0.835566,0.164434,0.835566,359,46,-1, merged,0,0,0
68132,1000011,3,1123,1027,96,0.914515,0.085485,2.613584,89,7,1126,1029,97,0.913854,0.086146,2.609781,90,7,1, merged,1,1,0
68133,1000014,2,3885,3125,760,0.804376,0.195624,1.573695,716,44,3886,3126,760,0.804426,0.195574,1.574277,716,44,1, merged,0,0,0
68133,1000534,1,867,667,200,0.769319,0.230681,0.769319,172,28,869,669,200,0.76985,0.23015,0.76985,172,28,-1, merged,0,0,0
68152,1000054,3,1530,1290,240,0.843137,0.156863,2.618612,220,20,1531,1291,240,0.84324,0.15676,2.619488,220,20,1, merged,0,0,0
68155,1000329,2,4255,3331,924,0.782844,0.217156,1.551172,784,140,4256,3332,924,0.782895,0.217105,1.551562,784,140,1, merged,0,0,0
68160,1000328,1,1291,971,320,0.75213,0.24787,0.75213,283,37,1292,971,321,0.751548,0.248452,0.751548,284,37,1, merged,1,1,0
68160,1000329,2,4256,3332,924,0.782895,0.217105,1.535025,784,140,4257,3333,924,0.782946,0.217054,1.534494,784,140,1, merged,0,0,0
68163,1000091,1,759,597,162,0.786561,0.213439,0.786561,136,26,760,598,162,0.786842,0.213158,0.786842,136,26,1, merged,0,0,0
68163,1000130,2,1088,895,193,0.82261,0.17739,1.609172,153,40,1089,896,193,0.822773,0.177227,1.609615,153,40,1, merged,0,0,0
68165,1000007,2,2190,1766,424,0.806393,0.193607,1.670415,369,55,2192,1767,425,0.806113,0.193887,1.667695,370,55,-1, abandoned,1,0,0
68168,1000109,2,832,719,113,0.864183,0.135817,1.628889,104,9,833,720,113,0.864346,0.135654,1.601188,104,9,1, merged,0,0,0
68171,1000328,2,1292,971,321,0.751548,0.248452,1.620881,284,37,1293,971,322,0.750967,0.249033,1.619493,285,37,1, abandoned,1,1,0
68175,1000004,1,5279,4639,640,0.878765,0.121235,0.878765,511,129,5280,4640,640,0.878788,0.121212,0.878788,511,129,-1, merged,0,0,0
68175,1000121,3,3214,2673,541,0.831674,0.168326,2.461406,502,39,3215,2674,541,0.831726,0.168274,2.461673,502,39,1, merged,0,0,0
68175,1000328,2,1293,971,322,0.750967,0.249033,1.629732,285,37,1294,972,322,0.751159,0.248841,1.629947,285,37,1, merged,0,0,0
68182,1000091,2,760,598,162,0.786842,0.213158,1.59366,136,26,761,599,162,0.787122,0.212878,1.595032,136,26,1, merged,0,0,0
68183,1000004,1,5280,4640,640,0.878788,0.121212,0.878788,511,129,5281,4641,640,0.878811,0.121189,0.878811,511,129,1, merged,0,0,0
68183,1000329,3,4257,3333,924,0.782946,0.217054,2.116279,784,140,4258,3334,924,0.782997,0.217003,2.123346,784,140,1, merged,0,0,0
68184,1000007,2,2192,1767,425,0.806113,0.193887,1.63568,370,55,2193,1768,425,0.806202,0.193798,1.634988,370,55,1, merged,0,0,0
68184,1000132,1,1062,881,181,0.829567,0.170433,0.829567,154,27,1063,881,182,0.828786,0.171214,0.828786,155,27,1, merged,1,1,0
68185,1000007,2,2193,1768,425,0.806202,0.193798,1.634988,370,55,2194,1769,425,0.80629,0.19371,1.635398,370,55,-1, abandoned,0,0,0
68185,1000132,1,1063,881,182,0.828786,0.171214,0.828786,155,27,1065,883,182,0.829108,0.170892,0.829108,155,27,-1, abandoned,0,0,0
68188,1000007,2,2194,1769,425,0.80629,0.19371,1.635558,370,55,2195,1769,426,0.805923,0.194077,1.634414,371,55,1, abandoned,1,1,0
68188,1000132,1,1066,884,182,0.829268,0.170732,0.829268,155,27,1067,884,183,0.828491,0.171509,0.828491,156,27,1, abandoned,1,1,0
68193,1000005,2,1391,1195,196,0.859094,0.140906,1.73794,185,11,1393,1197,196,0.859296,0.140704,1.736456,185,11,-1, merged,0,0,0
68197,1000007,2,2195,1769,426,0.805923,0.194077,1.634574,371,55,2196,1770,426,0.806011,0.193989,1.633887,371,55,-1, merged,0,0,0
68197,1000132,1,1068,885,183,0.828652,0.171348,0.828652,156,27,1069,885,184,0.827877,0.172123,0.827877,157,27,1, merged,1,1,0
68199,1000043,2,759,628,131,0.827404,0.172596,1.669148,113,18,760,629,131,0.827632,0.172368,1.669737,113,18,1, merged,0,0,0
68199,1000121,3,3215,2674,541,0.831726,0.168274,2.500874,502,39,3216,2675,541,0.831779,0.168221,2.501515,502,39,1, merged,0,0,0
68207,1000007,2,2196,1770,426,0.806011,0.193989,1.633887,371,55,2197,1771,426,0.806099,0.193901,1.633202,371,55,1, merged,0,0,0
68207,1000132,1,1069,885,184,0.827877,0.172123,0.827877,157,27,1070,885,185,0.827103,0.172897,0.827103,158,27,1, merged,1,1,0
68208,1000007,2,2197,1771,426,0.806099,0.193901,1.633202,371,55,2198,1772,426,0.806187,0.193813,1.633452,371,55,1, merged,0,0,0
68208,1000132,1,1070,885,185,0.827103,0.172897,0.827103,158,27,1071,886,185,0.827264,0.172736,0.827264,158,27,1, merged,0,0,0
68212,1000005,2,1394,1198,196,0.859397,0.140603,1.687029,185,11,1395,1199,196,0.859498,0.140502,1.686042,185,11,1, merged,0,0,0
68212,1000043,1,760,629,131,0.827632,0.172368,0.827632,113,18,761,629,132,0.826544,0.173456,0.826544,114,18,1, merged,1,1,0
68214,1000091,1,761,599,162,0.787122,0.212878,0.787122,136,26,762,600,162,0.787402,0.212598,0.787402,136,26,1, merged,0,0,0
68214,1000534,3,870,670,200,0.770115,0.229885,2.466493,172,28,871,671,200,0.770379,0.229621,2.467201,172,28,1, merged,0,0,0
68215,1000012,2,1046,900,146,0.860421,0.139579,1.751422,139,7,1047,901,146,0.860554,0.139446,1.751624,139,7,1, merged,0,0,0
68215,1000153,1,1578,1406,172,0.891001,0.108999,0.891001,132,40,1579,1407,172,0.89107,0.10893,0.89107,132,40,1, merged,0,0,0
68223,1000005,2,1396,1200,196,0.859599,0.140401,1.691377,185,11,1397,1201,196,0.859699,0.140301,1.69153,185,11,1, merged,0,0,0
68223,1000121,1,3216,2675,541,0.831779,0.168221,0.831779,502,39,3217,2676,541,0.831831,0.168169,0.831831,502,39,1, merged,0,0,0
68227,1000121,2,3217,2676,541,0.831831,0.168169,1.675013,502,39,3218,2677,541,0.831883,0.168117,1.675421,502,39,1, merged,0,0,0
68229,1000011,2,1128,1031,97,0.914007,0.085993,1.808319,90,7,1129,1032,97,0.914083,0.085917,1.808081,90,7,1, merged,0,0,0
68229,1000015,1,2848,2547,301,0.894312,0.105688,0.894312,276,25,2849,2547,302,0.893998,0.106002,0.893998,277,25,1, merged,1,1,0
68234,1000014,1,3888,3128,760,0.804527,0.195473,0.804527,716,44,3889,3129,760,0.804577,0.195423,0.804577,716,44,1, merged,0,0,0
68241,1000110,1,844,756,88,0.895735,0.104265,0.895735,81,7,845,757,88,0.895858,0.104142,0.895858,81,7,1, merged,0,0,0
68241,1000130,2,1090,897,193,0.822936,0.177064,1.71867,153,40,1091,898,193,0.823098,0.176902,1.718956,153,40,1, merged,0,0,0
68243,1000009,1,2463,2058,405,0.835566,0.164434,0.835566,359,46,2464,2058,406,0.835227,0.164773,0.835227,360,46,1, abandoned,1,1,0
68243,1000014,2,3889,3129,760,0.804577,0.195423,1.640143,716,44,3890,3130,760,0.804627,0.195373,1.639855,716,44,-1, abandoned,0,0,0
68244,1000011,1,1129,1032,97,0.914083,0.085917,0.914083,90,7,1130,1033,97,0.914159,0.085841,0.914159,90,7,1, merged,0,0,0
68246,1000011,2,1130,1033,97,0.914159,0.085841,1.775146,90,7,1131,1034,97,0.914235,0.085765,1.775842,90,7,1, merged,0,0,0
68252,1000004,2,5281,4641,640,0.878811,0.121189,1.70065,511,129,5283,4642,641,0.878667,0.121333,1.698667,512,129,1, merged,1,1,0
68256,1000110,2,845,757,88,0.895858,0.104142,1.733502,81,7,846,758,88,0.895981,0.104019,1.733858,81,7,1, merged,0,0,0
68256,1000140,1,696,583,113,0.837644,0.162356,0.837644,101,12,697,584,113,0.837877,0.162123,0.837877,101,12,1, merged,0,0,0
68260,1000004,1,5283,4642,641,0.878667,0.121333,0.878667,512,129,5287,4646,641,0.878759,0.121241,0.878759,512,129,-1, merged,0,0,0
68263,1000121,2,3218,2677,541,0.831883,0.168117,1.728843,502,39,3219,2678,541,0.831935,0.168065,1.729069,502,39,1, merged,0,0,0
68265,1000091,1,763,601,162,0.78768,0.21232,0.78768,136,26,764,602,162,0.787958,0.212042,0.787958,136,26,-1, merged,0,0,0
68273,1000004,2,5288,4647,641,0.878782,0.121218,1.584665,512,129,5289,4648,641,0.878805,0.121195,1.571113,512,129,1, merged,0,0,0
68273,1000153,3,1579,1407,172,0.89107,0.10893,2.475735,132,40,1580,1408,172,0.891139,0.108861,2.462252,132,40,1, merged,0,0,0
68277,1000054,2,1531,1291,240,0.84324,0.15676,1.669894,220,20,1532,1292,240,0.843342,0.156658,1.670319,220,20,1, merged,0,0,0
68277,1000132,1,1073,887,186,0.826654,0.173346,0.826654,158,28,1075,889,186,0.826977,0.173023,0.826977,158,28,-1, merged,0,0,0
68279,1000329,2,4262,3338,924,0.7832,0.2168,1.456429,784,140,4263,3339,924,0.783251,0.216749,1.457761,784,140,1, merged,0,0,0
68280,1000329,2,4263,3339,924,0.783251,0.216749,1.457761,784,140,4264,3340,924,0.783302,0.216698,1.459083,784,140,1, merged,0,0,0
68281,1000153,1,1580,1408,172,0.891139,0.108861,0.891139,132,40,1583,1410,173,0.890714,0.109286,0.890714,133,40,1, merged,1,1,0
68282,1000153,1,1583,1410,173,0.890714,0.109286,0.890714,133,40,1584,1411,173,0.890783,0.109217,0.890783,133,40,1, merged,0,0,0
68283,1000009,2,2464,2058,406,0.835227,0.164773,1.605606,360,46,2465,2059,406,0.835294,0.164706,1.605936,360,46,1, merged,0,0,0
68283,1000534,1,871,671,200,0.770379,0.229621,0.770379,172,28,872,672,200,0.770642,0.229358,0.770642,172,28,1, merged,0,0,0
68291,1000015,1,2855,2553,302,0.894221,0.105779,0.894221,277,25,2856,2554,302,0.894258,0.105742,0.894258,277,25,1, merged,0,0,0
68292,1000108,1,685,581,104,0.848175,0.151825,0.848175,98,6,689,585,104,0.849057,0.150943,0.849057,98,6,-1, merged,0,0,0
68295,1000009,1,2465,2059,406,0.835294,0.164706,0.835294,360,46,2466,2059,407,0.834955,0.165045,0.834955,361,46,1, merged,1,1,0
68295,1000534,2,873,673,200,0.770905,0.229095,1.606199,172,28,875,675,200,0.771429,0.228571,1.606384,172,28,-1, merged,0,0,0
68297,1000043,2,761,629,132,0.826544,0.173456,1.675601,114,18,762,630,132,0.826772,0.173228,1.676047,114,18,1, merged,0,0,0
68297,1000108,1,689,585,104,0.849057,0.150943,0.849057,98,6,690,586,104,0.849275,0.150725,0.849275,98,6,1, merged,0,0,0
68298,1000004,1,5289,4648,641,0.878805,0.121195,0.878805,512,129,5291,4649,642,0.878662,0.121338,0.878662,513,129,-1, abandoned,1,0,0
68300,1000121,1,3219,2678,541,0.831935,0.168065,0.831935,502,39,3220,2678,542,0.831677,0.168323,0.831677,503,39,1, abandoned,1,1,0
68300,1000329,2,4265,3341,924,0.783353,0.216647,1.615288,784,140,4266,3341,925,0.783169,0.216831,1.614846,785,140,1, abandoned,1,1,0
68301,1000130,3,1091,898,193,0.823098,0.176902,2.563896,153,40,1092,899,193,0.82326,0.17674,2.564895,153,40,1, merged,0,0,0
68302,1000004,1,5291,4649,642,0.878662,0.121338,0.878662,513,129,5293,4651,642,0.878708,0.121292,0.878708,513,129,-1, merged,0,0,0
68302,1000592,2,999,854,145,0.854855,0.145145,1.733517,94,51,1000,855,145,0.855,0.145,1.733708,94,51,1, merged,0,0,0
68303,1000005,2,1402,1206,196,0.8602,0.1398,1.691877,185,11,1404,1207,197,0.859687,0.140313,1.691416,186,11,1, merged,1,1,0
68303,1000121,1,3220,2678,542,0.831677,0.168323,0.831677,503,39,3221,2679,542,0.831729,0.168271,0.831729,503,39,-1, merged,0,0,0
68304,1000005,2,1404,1207,197,0.859687,0.140313,1.75682,186,11,1405,1208,197,0.859786,0.140214,1.757093,186,11,1, merged,0,0,0
68310,1000005,2,1405,1208,197,0.859786,0.140214,1.700236,186,11,1406,1209,197,0.859886,0.140114,1.700693,186,11,-1, abandoned,0,0,0
68310,1000329,3,4266,3341,925,0.783169,0.216831,2.483405,785,140,4267,3341,926,0.782986,0.217014,2.483679,786,140,1, abandoned,1,1,0
68324,1000009,2,2468,2061,407,0.835089,0.164911,1.725941,361,46,2469,2061,408,0.834751,0.165249,1.724549,362,46,1, merged,1,1,0
68324,1000109,3,833,720,113,0.864346,0.135654,2.590287,104,9,835,722,113,0.864671,0.135329,2.58922,104,9,-1, merged,0,0,0
68324,1000153,1,1585,1412,173,0.890852,0.109148,0.890852,133,40,1588,1413,175,0.889798,0.110202,0.889798,135,40,1, merged,1,1,0
68331,1000140,1,698,585,113,0.838109,0.161891,0.838109,101,12,699,586,113,0.83834,0.16166,0.83834,101,12,-1, merged,0,0,0
68334,1000153,1,1589,1414,175,0.889868,0.110132,0.889868,135,40,1590,1415,175,0.889937,0.110063,0.889937,135,40,1, merged,0,0,0
68336,1000109,2,835,722,113,0.864671,0.135329,1.731459,104,9,836,723,113,0.864833,0.135167,1.731864,104,9,1, merged,0,0,0
68338,1000023,1,2405,2087,318,0.867775,0.132225,0.867775,282,36,2407,2088,319,0.86747,0.13253,0.86747,283,36,1, abandoned,1,1,0
68339,1000004,1,5293,4651,642,0.878708,0.121292,0.878708,513,129,5294,4652,642,0.878731,0.121269,0.878731,513,129,1, merged,0,0,0
68339,1000592,2,1000,855,145,0.855,0.145,1.733708,94,51,1001,856,145,0.855145,0.144855,1.733875,94,51,1, merged,0,0,0
68341,1000009,2,2469,2061,408,0.834751,0.165249,1.419166,362,46,2470,2062,408,0.834818,0.165182,1.424561,362,46,1, merged,0,0,0
68343,1000003,2,1698,1398,300,0.823322,0.176678,1.702052,258,42,1699,1398,301,0.822837,0.177163,1.701402,258,43,-1, merged,1,1,0
68343,1000004,1,5294,4652,642,0.878731,0.121269,0.878731,513,129,5295,4652,643,0.878565,0.121435,0.878565,513,130,-1, merged,1,1,0
68345,1000153,5,1590,1415,175,0.889937,0.110063,3.998806,135,40,1591,1416,175,0.890006,0.109994,4.014318,135,40,1, merged,0,0,0
68346,1000140,1,699,586,113,0.83834,0.16166,0.83834,101,12,701,587,114,0.837375,0.162625,0.837375,102,12,1, merged,1,1,0
68349,1000110,2,846,758,88,0.895981,0.104019,1.733356,81,7,848,759,89,0.895047,0.104953,1.732885,82,7,1, merged,1,1,0
68349,1000140,1,701,587,114,0.837375,0.162625,0.837375,102,12,703,589,114,0.837838,0.162162,0.837838,102,12,-1, merged,0,0,0
68356,1000004,2,5295,4652,643,0.878565,0.121435,1.719372,513,130,5297,4653,644,0.878422,0.121578,1.717348,514,130,1, merged,1,1,0
68363,1000012,1,1050,904,146,0.860952,0.139048,0.860952,139,7,1051,904,147,0.860133,0.139867,0.860133,140,7,1, merged,1,1,0
68364,1000153,2,1591,1416,175,0.890006,0.109994,1.753516,135,40,1592,1417,175,0.890075,0.109925,1.753964,135,40,1, merged,0,0,0
68368,1000007,2,2203,1777,426,0.806627,0.193373,1.700885,371,55,2204,1778,426,0.806715,0.193285,1.70101,371,55,1, merged,0,0,0
68368,1000015,1,2856,2554,302,0.894258,0.105742,0.894258,277,25,2857,2555,302,0.894295,0.105705,0.894295,277,25,1, merged,0,0,0
68371,1000007,1,2206,1779,427,0.806437,0.193563,0.806437,372,55,2207,1780,427,0.806525,0.193475,0.806525,372,55,1, merged,0,0,0
68371,1000015,2,2857,2555,302,0.894295,0.105705,1.700732,277,25,2858,2556,302,0.894332,0.105668,1.700856,277,25,1, merged,0,0,0
68375,1000140,2,703,589,114,0.837838,0.162162,1.630338,102,12,704,590,114,0.838068,0.161932,1.629631,102,12,1, merged,0,0,0
68377,1000120,2,2611,2303,308,0.882038,0.117962,1.655451,268,40,2612,2304,308,0.882083,0.117917,1.656179,268,40,1, merged,0,0,0
68383,1000329,2,4269,3343,926,0.783087,0.216913,1.592076,786,140,4270,3343,927,0.782904,0.217096,1.587373,787,140,1, abandoned,1,1,0
68390,1000015,2,2861,2559,302,0.894443,0.105557,1.737785,277,25,2862,2560,302,0.894479,0.105521,1.737924,277,25,1, merged,0,0,0
68390,1000054,1,1532,1292,240,0.843342,0.156658,0.843342,220,20,1533,1293,240,0.843444,0.156556,0.843444,220,20,1, merged,0,0,0
68391,1000054,5,1533,1293,240,0.843444,0.156556,3.391414,220,20,1534,1294,240,0.843546,0.156454,3.367309,220,20,1, merged,0,0,0
68393,1000329,1,4270,3343,927,0.782904,0.217096,0.782904,787,140,4271,3344,927,0.782955,0.217045,0.782955,787,140,-1, merged,0,0,0
68403,1000592,1,1001,856,145,0.855145,0.144855,0.855145,94,51,1003,857,146,0.854437,0.145563,0.854437,95,51,1, merged,1,1,0
68404,1000003,1,1700,1399,301,0.822941,0.177059,0.822941,258,43,1702,1401,301,0.823149,0.176851,0.823149,258,43,-1, merged,0,0,0
68407,1000328,1,1295,973,322,0.751351,0.248649,0.751351,285,37,1297,975,322,0.751735,0.248265,0.751735,285,37,1, merged,0,0,0
68409,1000004,3,5297,4653,644,0.878422,0.121578,2.306024,514,130,5298,4654,644,0.878445,0.121555,2.291916,514,130,1, merged,0,0,0
68410,1000014,1,3895,3135,760,0.804878,0.195122,0.804878,716,44,3898,3137,761,0.804772,0.195228,0.804772,717,44,1, merged,1,1,0
68415,1000004,1,5298,4654,644,0.878445,0.121555,0.878445,514,130,5300,4655,645,0.878302,0.121698,0.878302,514,131,-1, merged,1,0,0
68415,1000120,2,2612,2304,308,0.882083,0.117917,1.760527,268,40,2613,2305,308,0.882128,0.117872,1.76043,268,40,-1, merged,0,0,0
68418,1000005,2,1407,1210,197,0.859986,0.140014,1.679195,186,11,1409,1211,198,0.859475,0.140525,1.676376,187,11,1, merged,1,1,0
68421,1000054,1,1534,1294,240,0.843546,0.156454,0.843546,220,20,1536,1295,241,0.843099,0.156901,0.843099,221,20,1, merged,1,1,0
68422,1000153,2,1592,1417,175,0.890075,0.109925,1.539198,135,40,1593,1418,175,0.890144,0.109856,1.535493,135,40,1, merged,0,0,0
68424,1000009,3,2473,2065,408,0.835018,0.164982,2.070111,362,46,2474,2066,408,0.835085,0.164915,2.07742,362,46,1, merged,0,0,0
68426,1000004,1,5300,4655,645,0.878302,0.121698,0.878302,514,131,5302,4657,645,0.878348,0.121652,0.878348,514,131,-1, merged,0,0,0
68426,1000120,2,2613,2305,308,0.882128,0.117872,1.76043,268,40,2614,2306,308,0.882173,0.117827,1.760521,268,40,1, merged,0,0,0
68449,1000023,1,2410,2091,319,0.867635,0.132365,0.867635,283,36,2412,2092,320,0.86733,0.13267,0.86733,284,36,1, merged,1,1,0
68455,1000003,1,1702,1401,301,0.823149,0.176851,0.823149,258,43,1703,1402,301,0.823253,0.176747,0.823253,258,43,-1, merged,0,0,0
68455,1000109,3,838,725,113,0.865155,0.134845,1.688304,104,9,839,726,113,0.865316,0.134684,2.188569,104,9,1, merged,0,0,0
68457,1000004,2,5302,4657,645,0.878348,0.121652,1.54889,514,131,5304,4659,645,0.878394,0.121606,1.543778,514,131,-1, merged,0,0,0
68464,1000004,2,5304,4659,645,0.878394,0.121606,1.768538,514,131,5305,4660,645,0.878417,0.121583,1.76863,514,131,-1, abandoned,0,0,0
68464,1000009,3,2474,2066,408,0.835085,0.164915,2.603623,362,46,2475,2067,408,0.835152,0.164848,2.603781,362,46,-1, abandoned,0,0,0
68464,1000153,1,1593,1418,175,0.890144,0.109856,0.890144,135,40,1594,1419,175,0.890213,0.109787,0.890213,135,40,-1, abandoned,0,0,0
68466,1000009,2,2475,2067,408,0.835152,0.164848,1.639973,362,46,2476,2068,408,0.835218,0.164782,1.64014,362,46,1, merged,0,0,0
68466,1000014,1,3899,3138,761,0.804822,0.195178,0.804822,717,44,3901,3140,761,0.804922,0.195078,0.804922,717,44,-1, merged,0,0,0
68474,1000004,1,5305,4660,645,0.878417,0.121583,0.878417,514,131,5306,4661,645,0.87844,0.12156,0.87844,514,131,-1, merged,0,0,0
68474,1000015,2,2870,2567,303,0.894425,0.105575,1.772842,278,25,2871,2568,303,0.894462,0.105538,1.772901,278,25,1, merged,0,0,0
68474,1000153,4,1594,1419,175,0.890213,0.109787,3.559376,135,40,1595,1420,175,0.890282,0.109718,3.559678,135,40,1, merged,0,0,0
68476,1000005,2,1410,1212,198,0.859574,0.140426,1.526241,187,11,1411,1213,198,0.859674,0.140326,1.57396,187,11,1, merged,0,0,0
68484,1000004,1,5306,4661,645,0.87844,0.12156,0.87844,514,131,5307,4662,645,0.878462,0.121538,0.878462,514,131,-1, merged,0,0,0
68484,1000015,4,2871,2568,303,0.894462,0.105538,3.559678,278,25,2872,2569,303,0.894499,0.105501,3.55786,278,25,1, merged,0,0,0
68484,1000153,2,1595,1420,175,0.890282,0.109718,1.768722,135,40,1596,1420,176,0.889724,0.110276,1.768187,136,40,1, merged,1,1,0
68489,1000153,3,1596,1420,176,0.889724,0.110276,2.664327,136,40,1597,1421,176,0.889793,0.110207,2.665624,136,40,-1, abandoned,0,0,0
68496,1000140,1,706,592,114,0.838527,0.161473,0.838527,102,12,707,593,114,0.838755,0.161245,0.838755,102,12,1, merged,0,0,0
68498,1000009,1,2476,2068,408,0.835218,0.164782,0.835218,362,46,2477,2069,408,0.835285,0.164715,0.835285,362,46,1, merged,0,0,0
68498,1000015,2,2872,2569,303,0.894499,0.105501,1.729717,278,25,2873,2570,303,0.894535,0.105465,1.72982,278,25,1, merged,0,0,0
68506,1000026,1,832,699,133,0.840144,0.159856,0.840144,130,3,834,700,134,0.839329,0.160671,0.839329,131,3,1, merged,1,1,0
68515,1000004,1,5309,4664,645,0.878508,0.121492,0.878508,514,131,5310,4664,646,0.878343,0.121657,0.878343,515,131,1, merged,1,1,0
68517,1000110,2,848,759,89,0.895047,0.104953,1.732847,82,7,849,760,89,0.895171,0.104829,1.733199,82,7,1, merged,0,0,0
68517,1000140,1,709,594,115,0.8378,0.1622,0.8378,103,12,710,595,115,0.838028,0.161972,0.838028,103,12,1, merged,0,0,0
68526,1000012,1,1053,906,147,0.860399,0.139601,0.860399,140,7,1054,906,148,0.859583,0.140417,0.859583,141,7,1, merged,1,1,0
68533,1000014,1,3901,3140,761,0.804922,0.195078,0.804922,717,44,3903,3142,761,0.805022,0.194978,0.805022,717,44,-1, merged,0,0,0
68533,1000329,2,4273,3346,927,0.783056,0.216944,1.587978,787,140,4274,3347,927,0.783107,0.216893,1.588129,787,140,-1, merged,0,0,0
68534,1000014,2,3903,3142,761,0.805022,0.194978,1.68733,717,44,3904,3143,761,0.805072,0.194928,1.687425,717,44,1, merged,0,0,0
68534,1000120,1,2617,2309,308,0.882308,0.117692,0.882308,268,40,2618,2310,308,0.882353,0.117647,0.882353,268,40,1, merged,0,0,0
68545,1000004,1,5310,4664,646,0.878343,0.121657,0.878343,515,131,5311,4665,646,0.878366,0.121634,0.878366,515,131,-1, abandoned,0,0,0
68545,1000120,2,2618,2310,308,0.882353,0.117647,1.760696,268,40,2619,2311,308,0.882398,0.117602,1.760764,268,40,-1, abandoned,0,0,0
68551,1000004,1,5311,4665,646,0.878366,0.121634,0.878366,515,131,5312,4666,646,0.878389,0.121611,0.878389,515,131,1, merged,0,0,0
68555,1000328,2,1299,977,322,0.752117,0.247883,1.535142,285,37,1300,978,322,0.752308,0.247692,1.535384,285,37,1, merged,0,0,0
68555,1000329,1,4277,3349,928,0.783025,0.216975,0.783025,788,140,4278,3350,928,0.783076,0.216924,0.783076,788,140,-1, merged,0,0,0
68560,1000003,1,1703,1402,301,0.823253,0.176747,0.823253,258,43,1704,1403,301,0.823357,0.176643,0.823357,258,43,1, merged,0,0,0
68560,1000199,2,734,635,99,0.865123,0.134877,1.688376,85,14,735,636,99,0.865306,0.134694,1.688663,85,14,1, merged,0,0,0
68566,1000015,2,2880,2577,303,0.894792,0.105208,1.784585,278,25,2881,2578,303,0.894828,0.105172,1.783509,278,25,1, merged,0,0,0
68566,1000153,1,1597,1421,176,0.889793,0.110207,0.889793,136,40,1599,1421,178,0.88868,0.11132,0.88868,136,42,-1, merged,1,1,0
68570,1000534,2,875,675,200,0.771429,0.228571,1.495567,172,28,876,676,200,0.771689,0.228311,1.505023,172,28,1, merged,0,0,0
68588,1000007,1,2211,1784,427,0.806875,0.193125,0.806875,372,55,2214,1786,428,0.806685,0.193315,0.806685,373,55,-1, merged,1,0,0
68588,1000009,2,2482,2074,408,0.835616,0.164384,1.642491,362,46,2483,2075,408,0.835683,0.164317,1.642367,362,46,1, merged,0,0,0
68595,1000004,3,5312,4666,646,0.878389,0.121611,2.588101,515,131,5313,4667,646,0.878411,0.121589,2.588373,515,131,-1, merged,0,0,0
68595,1000043,2,764,632,132,0.827225,0.172775,1.709713,114,18,766,634,132,0.827676,0.172324,1.709962,114,18,-1, merged,0,0,0
68595,1000120,1,2621,2313,308,0.882488,0.117512,0.882488,268,40,2625,2316,309,0.882286,0.117714,0.882286,269,40,1, merged,1,1,0
68607,1000015,1,2881,2578,303,0.894828,0.105172,0.894828,278,25,2882,2579,303,0.894865,0.105135,0.894865,278,25,1, merged,0,0,0
68607,1000329,2,4278,3350,928,0.783076,0.216924,1.677904,788,140,4279,3351,928,0.783127,0.216873,1.677992,788,140,1, merged,0,0,0
68610,1000120,1,2628,2319,309,0.88242,0.11758,0.88242,269,40,2629,2320,309,0.882465,0.117535,0.882465,269,40,1, merged,0,0,0
68613,1000140,1,710,595,115,0.838028,0.161972,0.838028,103,12,711,595,116,0.83685,0.16315,0.83685,104,12,1, merged,1,1,0
68623,1000109,1,839,726,113,0.865316,0.134684,0.865316,104,9,840,727,113,0.865476,0.134524,0.865476,104,9,1, merged,0,0,0
68630,1000005,2,1416,1216,200,0.858757,0.141243,1.691215,189,11,1418,1218,200,0.858956,0.141044,1.691208,189,11,1, merged,0,0,0
68630,1000121,1,3235,2693,542,0.832457,0.167543,0.832457,503,39,3237,2694,543,0.832252,0.167748,0.832252,503,40,-1, merged,1,0,0
68635,1000009,1,2483,2075,408,0.835683,0.164317,0.835683,362,46,2486,2077,409,0.835479,0.164521,0.835479,363,46,-1, merged,1,0,0
68635,1000015,2,2882,2579,303,0.894865,0.105135,1.730547,278,25,2883,2579,304,0.894554,0.105446,1.730033,279,25,1, merged,1,1,0
68638,1000007,1,2218,1790,428,0.807033,0.192967,0.807033,373,55,2219,1790,429,0.80667,0.19333,0.80667,373,56,-1, merged,1,1,0
68638,1000534,2,876,676,200,0.771689,0.228311,1.578723,172,28,877,676,201,0.77081,0.22919,1.577479,172,29,-1, merged,1,1,0
68641,1000153,2,1599,1421,178,0.88868,0.11132,1.751512,136,42,1600,1422,178,0.88875,0.11125,1.752186,136,42,1, merged,0,0,0
68642,1000153,2,1600,1422,178,0.88875,0.11125,1.752186,136,42,1601,1423,178,0.888819,0.111181,1.752855,136,42,1, merged,0,0,0
68643,1000007,3,2219,1790,429,0.80667,0.19333,2.424301,373,56,2220,1791,429,0.806757,0.193243,2.426538,373,56,1, merged,0,0,0
68643,1000015,2,2883,2579,304,0.894554,0.105446,1.617631,279,25,2884,2580,304,0.894591,0.105409,1.619782,279,25,1, merged,0,0,0
68645,1000153,2,1601,1423,178,0.888819,0.111181,1.752855,136,42,1602,1424,178,0.888889,0.111111,1.753518,136,42,1, merged,0,0,0
68648,1000014,2,3906,3144,762,0.804916,0.195084,1.645623,717,45,3909,3144,765,0.804298,0.195702,1.645357,720,45,1, abandoned,1,1,0
68648,1000043,3,767,635,132,0.827901,0.172099,2.473524,114,18,768,635,133,0.826823,0.173177,2.47218,115,18,1, abandoned,1,1,0
68653,1000120,3,2629,2320,309,0.882465,0.117535,2.406027,269,40,2630,2321,309,0.88251,0.11749,2.404352,269,40,-1, abandoned,0,0,0
68660,1000105,1,1017,808,209,0.794494,0.205506,0.794494,175,34,1018,808,210,0.793713,0.206287,0.793713,176,34,1, abandoned,1,1,0
68660,1000132,3,1082,894,188,0.826248,0.173752,2.492536,160,28,1083,895,188,0.826408,0.173592,2.470121,160,28,-1, abandoned,0,0,0
68662,1000011,1,1139,1042,97,0.914838,0.085162,0.914838,90,7,1141,1043,98,0.91411,0.08589,0.91411,91,7,1, merged,1,1,0
68662,1000026,2,834,700,134,0.839329,0.160671,1.754166,131,3,835,701,134,0.839521,0.160479,1.753631,131,3,1, merged,0,0,0
68666,1000105,2,1018,808,210,0.793713,0.206287,1.276066,176,34,1019,809,210,0.793916,0.206084,1.282288,176,34,1, merged,0,0,0
68667,1000105,1,1019,809,210,0.793916,0.206084,0.793916,176,34,1020,810,210,0.794118,0.205882,0.794118,176,34,-1, merged,0,0,0
68670,1000329,1,4280,3352,928,0.783178,0.216822,0.783178,788,140,4281,3353,928,0.783228,0.216772,0.783228,788,140,-1, abandoned,0,0,0
68672,1000005,3,1420,1219,201,0.858451,0.141549,2.588866,190,11,1421,1220,201,0.85855,0.14145,2.589188,190,11,1, merged,0,0,0
68672,1000121,1,3237,2694,543,0.832252,0.167748,0.832252,503,40,3238,2695,543,0.832304,0.167696,0.832304,503,40,-1, merged,0,0,0
68674,1000005,2,1421,1220,201,0.85855,0.14145,1.614648,190,11,1422,1221,201,0.85865,0.14135,1.620555,190,11,1, merged,0,0,0
68682,1000110,2,849,760,89,0.895171,0.104829,1.709986,82,7,850,761,89,0.895294,0.104706,1.710537,82,7,1, merged,0,0,0
68685,1000005,1,1422,1221,201,0.85865,0.14135,0.85865,190,11,1423,1221,202,0.858046,0.141954,0.858046,191,11,1, merged,1,1,0
68685,1000023,2,2414,2094,320,0.86744,0.13256,1.72609,284,36,2415,2095,320,0.867495,0.132505,1.725541,284,36,1, merged,0,0,0
68698,1000009,2,2489,2079,410,0.835275,0.164725,1.648528,364,46,2491,2081,410,0.835407,0.164593,1.644931,364,46,-1, merged,0,0,0
68711,1000003,1,1704,1403,301,0.823357,0.176643,0.823357,258,43,1705,1404,301,0.82346,0.17654,0.82346,258,43,-1, merged,0,0,0
68711,1000004,2,5320,4673,647,0.878383,0.121617,1.70174,515,132,5322,4675,647,0.878429,0.121571,1.70189,515,132,-1, merged,0,0,0
68721,1000005,2,1426,1224,202,0.858345,0.141655,1.643242,191,11,1428,1225,203,0.857843,0.142157,1.639164,192,11,1, merged,1,1,0
68721,1000121,3,3240,2697,543,0.832407,0.167593,2.475649,503,40,3241,2697,544,0.832151,0.167849,2.471315,504,40,1, merged,1,1,0
68721,1000140,4,711,595,116,0.83685,0.16315,3.312499,104,12,712,596,116,0.837079,0.162921,3.308394,104,12,1, merged,0,0,0
68723,1000534,2,877,676,201,0.77081,0.22919,1.681179,172,29,879,677,202,0.770193,0.229807,1.680876,173,29,1, merged,1,1,0
68741,1000026,1,837,703,134,0.839904,0.160096,0.839904,131,3,840,704,136,0.838095,0.161905,0.838095,133,3,1, merged,1,1,0
68749,1000534,1,879,677,202,0.770193,0.229807,0.770193,173,29,882,678,204,0.768707,0.231293,0.768707,175,29,1, merged,1,1,0
68761,1000012,2,1057,909,148,0.859981,0.140019,1.753845,141,7,1058,910,148,0.860113,0.139887,1.754153,141,7,1, merged,0,0,0
68763,1000005,1,1437,1229,208,0.855254,0.144746,0.855254,197,11,1438,1230,208,0.855355,0.144645,0.855355,197,11,1, merged,0,0,0
68763,1000110,3,850,761,89,0.895294,0.104706,2.582699,82,7,851,762,89,0.895417,0.104583,2.582974,82,7,1, merged,0,0,0
68763,1000121,2,3241,2697,544,0.832151,0.167849,1.687405,504,40,3242,2698,544,0.832202,0.167798,1.687557,504,40,1, merged,0,0,0
68766,1000009,4,2494,2084,410,0.835605,0.164395,3.042408,364,46,2495,2085,410,0.835671,0.164329,3.047867,364,46,1, merged,0,0,0
68766,1000026,3,840,704,136,0.838095,0.161905,2.206803,133,3,841,705,136,0.838288,0.161712,2.212195,133,3,1, merged,0,0,0
68766,1000534,1,882,678,204,0.768707,0.231293,0.768707,175,29,883,679,204,0.768969,0.231031,0.768969,175,29,1, merged,0,0,0
68773,1000026,2,841,705,136,0.838288,0.161712,1.74545,133,3,844,707,137,0.837678,0.162322,1.742691,134,3,1, merged,1,1,0
68773,1000120,3,2632,2323,309,0.882599,0.117401,2.628048,269,40,2633,2324,309,0.882643,0.117357,2.625334,269,40,1, merged,0,0,0
68777,1000014,1,3910,3145,765,0.804348,0.195652,0.804348,720,45,3911,3146,765,0.804398,0.195602,0.804398,720,45,-1, merged,0,0,0
68777,1000105,2,1020,810,210,0.794118,0.205882,1.598465,176,34,1023,813,210,0.794721,0.205279,1.599119,176,34,-1, merged,0,0,0
68793,1000003,2,1705,1404,301,0.82346,0.17654,1.659132,258,43,1706,1405,301,0.823564,0.176436,1.6589,258,43,-1, merged,0,0,0
68793,1000007,3,2220,1791,429,0.806757,0.193243,2.465889,373,56,2222,1793,429,0.806931,0.193069,2.465831,373,56,1, merged,0,0,0
68793,1000009,1,2495,2085,410,0.835671,0.164329,0.835671,364,46,2496,2085,411,0.835337,0.164663,0.835337,365,46,1, merged,1,1,0
68798,1000015,2,2891,2587,304,0.894846,0.105154,1.78332,279,25,2892,2588,304,0.894882,0.105118,1.783425,279,25,1, merged,0,0,0
68798,1000153,1,1605,1426,179,0.888474,0.111526,0.888474,137,42,1606,1427,179,0.888543,0.111457,0.888543,137,42,-1, merged,0,0,0
68801,1000014,1,3911,3146,765,0.804398,0.195602,0.804398,720,45,3913,3147,766,0.804242,0.195758,0.804242,721,45,1, merged,1,1,0
68801,1000153,2,1606,1427,179,0.888543,0.111457,1.692941,137,42,1607,1428,179,0.888612,0.111388,1.692855,137,42,1, merged,0,0,0
68806,1000023,1,2427,2105,322,0.867326,0.132674,0.867326,286,36,2428,2106,322,0.867381,0.132619,0.867381,286,36,1, merged,0,0,0
68809,1000054,4,1537,1296,241,0.843201,0.156799,2.698261,221,20,1538,1297,241,0.843303,0.156697,2.68725,221,20,1, merged,0,0,0
68811,1000009,2,2496,2085,411,0.835337,0.164663,1.639579,365,46,2497,2086,411,0.835402,0.164598,1.639695,365,46,1, merged,0,0,0
68811,1000014,1,3913,3147,766,0.804242,0.195758,0.804242,721,45,3914,3148,766,0.804292,0.195708,0.804292,721,45,1, merged,0,0,0
68813,1000004,1,5325,4678,647,0.878498,0.121502,0.878498,515,132,5328,4681,647,0.878566,0.121434,0.878566,515,132,-1, merged,0,0,0
68813,1000043,2,769,636,133,0.827048,0.172952,1.705546,115,18,770,637,133,0.827273,0.172727,1.705839,115,18,1, merged,0,0,0
68839,1000110,2,851,762,89,0.895417,0.104583,1.71066,82,7,852,763,89,0.89554,0.10446,1.711208,82,7,1, merged,0,0,0
68850,1000120,1,2636,2327,309,0.882777,0.117223,0.882777,269,40,2637,2328,309,0.882821,0.117179,0.882821,269,40,1, merged,0,0,0
68864,1000009,3,2502,2090,412,0.835332,0.164668,2.237393,365,47,2503,2091,412,0.835398,0.164602,2.23929,365,47,1, merged,0,0,0
68864,1000015,4,2893,2589,304,0.894919,0.105081,3.132312,279,25,2894,2590,304,0.894955,0.105045,3.134245,279,25,1, merged,0,0,0
68865,1000014,1,3914,3148,766,0.804292,0.195708,0.804292,721,45,3915,3149,766,0.804342,0.195658,0.804342,721,45,-1, merged,0,0,0
68868,1000054,1,1538,1297,241,0.843303,0.156697,0.843303,221,20,1540,1299,241,0.843506,0.156494,0.843506,221,20,-1, merged,0,0,0
68875,1000091,3,765,603,162,0.788235,0.211765,1.65352,136,26,766,604,162,0.788512,0.211488,2.654491,136,26,1, merged,0,0,0
68877,1000054,1,1540,1299,241,0.843506,0.156494,0.843506,221,20,1541,1300,241,0.843608,0.156392,0.843608,221,20,1, merged,0,0,0
68879,1000014,2,3915,3149,766,0.804342,0.195658,1.699334,721,45,3916,3150,766,0.804392,0.195608,1.69942,721,45,1, merged,0,0,0
68879,1000015,1,2895,2591,304,0.894991,0.105009,0.894991,279,25,2896,2592,304,0.895028,0.104972,0.895028,279,25,1, merged,0,0,0
68915,1000004,2,5328,4681,647,0.878566,0.121434,1.761786,515,132,5329,4682,647,0.878589,0.121411,1.761186,515,132,1, merged,0,0,0
68915,1000120,1,2646,2337,309,0.88322,0.11678,0.88322,269,40,2649,2338,311,0.882597,0.117403,0.882597,271,40,1, merged,1,1,0
68925,1000014,1,3919,3153,766,0.804542,0.195458,0.804542,721,45,3920,3154,766,0.804592,0.195408,0.804592,721,45,1, merged,0,0,0
68927,1000004,1,5329,4682,647,0.878589,0.121411,0.878589,515,132,5330,4682,648,0.878424,0.121576,0.878424,516,132,1, merged,1,1,0
68937,1000015,2,2905,2601,304,0.895353,0.104647,1.784034,279,25,2906,2602,304,0.895389,0.104611,1.784209,279,25,1, merged,0,0,0
68937,1000153,1,1608,1429,179,0.888682,0.111318,0.888682,137,42,1610,1431,179,0.88882,0.11118,0.88882,137,42,-1, merged,0,0,0
68938,1000014,2,3920,3154,766,0.804592,0.195408,1.574053,721,45,3921,3155,766,0.804642,0.195358,1.572499,721,45,1, merged,0,0,0
68939,1000003,3,1707,1405,302,0.823081,0.176919,2.421856,258,44,1708,1405,303,0.8226,0.1774,2.422258,258,45,-1, merged,1,1,0
68939,1000005,2,1441,1233,208,0.855656,0.144344,1.598775,197,11,1442,1234,208,0.855756,0.144244,1.599658,197,11,1, merged,0,0,0
68955,1000005,1,1442,1234,208,0.855756,0.144244,0.855756,197,11,1443,1235,208,0.855856,0.144144,0.855856,197,11,1, merged,0,0,0
68964,1000003,2,1708,1405,303,0.8226,0.1774,1.734687,258,45,1709,1406,303,0.822703,0.177297,1.731794,258,45,-1, merged,0,0,0
68969,1000014,2,3921,3155,766,0.804642,0.195358,1.471308,721,45,3922,3156,766,0.804691,0.195309,1.460941,721,45,1, merged,0,0,0
68970,1000014,1,3922,3156,766,0.804691,0.195309,0.804691,721,45,3926,3157,769,0.804126,0.195874,0.804126,724,45,-1, merged,1,0,0
68970,1000120,3,2650,2339,311,0.882642,0.117358,2.470246,271,40,2653,2341,312,0.882397,0.117603,2.469487,271,41,-1, merged,1,0,0
68970,1000328,4,1302,980,322,0.752688,0.247312,3.222934,285,37,1303,981,322,0.752878,0.247122,3.222365,285,37,1, merged,0,0,0
68970,1000329,2,4284,3354,930,0.782913,0.217087,1.587605,788,142,4285,3355,930,0.782964,0.217036,1.58709,788,142,-1, merged,0,0,0
68975,1000014,2,3926,3157,769,0.804126,0.195874,1.53942,724,45,3927,3158,769,0.804176,0.195824,1.54204,724,45,1, merged,0,0,0
68977,1000014,2,3927,3158,769,0.804176,0.195824,1.44292,724,45,3928,3159,769,0.804226,0.195774,1.444851,724,45,1, merged,0,0,0
68978,1000120,1,2653,2341,312,0.882397,0.117603,0.882397,271,41,2654,2342,312,0.882442,0.117558,0.882442,271,41,1, merged,0,0,0
68979,1000120,1,2654,2342,312,0.882442,0.117558,0.882442,271,41,2657,2344,313,0.882198,0.117802,0.882198,272,41,1, merged,1,1,0
68983,1000120,1,2660,2346,314,0.881955,0.118045,0.881955,273,41,2662,2347,315,0.881668,0.118332,0.881668,274,41,1, merged,1,1,0
68986,1000007,2,2226,1796,430,0.806828,0.193172,1.453887,374,56,2230,1797,433,0.80583,0.19417,1.448165,377,56,1, merged,1,1,0
68986,1000026,4,845,708,137,0.83787,0.16213,3.118165,134,3,846,709,137,0.838061,0.161939,3.112194,134,3,1, merged,0,0,0
68986,1000132,3,1083,895,188,0.826408,0.173592,2.280295,160,28,1086,897,189,0.825967,0.174033,2.274132,161,28,1, merged,1,1,0
68989,1000054,4,1544,1302,242,0.843264,0.156736,2.814686,222,20,1545,1303,242,0.843366,0.156634,2.8235,222,20,1, merged,0,0,0
68989,1000166,3,722,553,169,0.765928,0.234072,1.971421,161,8,723,554,169,0.766252,0.233748,1.980134,161,8,1, merged,0,0,0
68990,1000009,2,2504,2092,412,0.835463,0.164537,1.561389,365,47,2505,2093,412,0.835529,0.164471,1.56347,365,47,1, merged,0,0,0
69003,1000592,2,1003,857,146,0.854437,0.145563,1.628409,95,51,1004,858,146,0.854582,0.145418,1.623289,95,51,-1, abandoned,0,0,0
69006,1000199,2,737,638,99,0.865672,0.134328,1.736696,85,14,738,639,99,0.865854,0.134146,1.737106,85,14,1, merged,0,0,0
69032,1000014,1,3929,3160,769,0.804276,0.195724,0.804276,724,45,3930,3161,769,0.804326,0.195674,0.804326,724,45,1, merged,0,0,0
69032,1000015,2,2916,2612,304,0.895748,0.104252,1.700023,279,25,2917,2613,304,0.895783,0.104217,1.700109,279,25,1, merged,0,0,0
69032,1000153,3,1610,1431,179,0.88882,0.11118,2.588843,137,42,1611,1432,179,0.888889,0.111111,2.588998,137,42,1, merged,0,0,0
69035,1000003,2,1709,1406,303,0.822703,0.177297,1.627029,258,45,1711,1407,304,0.822326,0.177674,1.626497,258,46,-1, merged,1,0,0
69035,1000014,1,3930,3161,769,0.804326,0.195674,0.804326,724,45,3932,3162,770,0.804171,0.195829,0.804171,725,45,1, merged,1,1,0
69040,1000003,3,1711,1407,304,0.822326,0.177674,2.556171,258,46,1712,1408,304,0.82243,0.17757,2.555014,258,46,-1, merged,0,0,0
69040,1000015,2,2917,2613,304,0.895783,0.104217,1.733845,279,25,2919,2614,305,0.895512,0.104488,1.732584,280,25,1, merged,1,1,0
69040,1000026,1,846,709,137,0.838061,0.161939,0.838061,134,3,847,709,138,0.837072,0.162928,0.837072,135,3,1, merged,1,1,0
69046,1000004,2,5332,4684,648,0.87847,0.12153,1.647016,516,132,5333,4685,648,0.878492,0.121508,1.647723,516,132,1, merged,0,0,0
69056,1000014,1,3932,3162,770,0.804171,0.195829,0.804171,725,45,3933,3163,770,0.804221,0.195779,0.804221,725,45,-1, merged,0,0,0
69056,1000120,3,2663,2348,315,0.881712,0.118288,2.455114,274,41,2664,2349,315,0.881757,0.118243,2.455889,274,41,1, merged,0,0,0
69057,1000054,2,1545,1303,242,0.843366,0.156634,1.506524,222,20,1546,1304,242,0.843467,0.156533,1.508388,222,20,1, merged,0,0,0
69061,1000120,1,2664,2349,315,0.881757,0.118243,0.881757,274,41,2665,2350,315,0.881801,0.118199,0.881801,274,41,1, merged,0,0,0
69084,1000005,1,1449,1241,208,0.856453,0.143547,0.856453,197,11,1450,1242,208,0.856552,0.143448,0.856552,197,11,1, merged,0,0,0
69084,1000014,2,3935,3165,770,0.80432,0.19568,1.660773,725,45,3936,3166,770,0.80437,0.19563,1.660922,725,45,1, merged,0,0,0
69095,1000014,1,3936,3166,770,0.80437,0.19563,0.80437,725,45,3937,3167,770,0.80442,0.19558,0.80442,725,45,1, merged,0,0,0
69095,1000023,2,2432,2109,323,0.867188,0.132812,1.671557,287,36,2433,2110,323,0.867242,0.132758,1.671662,287,36,1, merged,0,0,0
69097,1000004,3,5337,4689,648,0.878583,0.121417,2.534337,516,132,5338,4689,649,0.878419,0.121581,2.534503,516,133,-1, merged,1,1,0
69097,1000023,1,2433,2110,323,0.867242,0.132758,0.867242,287,36,2434,2111,323,0.867297,0.132703,0.867297,287,36,1, merged,0,0,0
69097,1000091,2,766,604,162,0.788512,0.211488,1.655754,136,26,767,605,162,0.788787,0.211213,1.656084,136,26,1, merged,0,0,0
69098,1000004,3,5338,4689,649,0.878419,0.121581,2.420703,516,133,5339,4690,649,0.878442,0.121558,2.423296,516,133,1, merged,0,0,0
69098,1000014,2,3937,3167,770,0.80442,0.19558,1.542284,725,45,3938,3168,770,0.804469,0.195531,1.544854,725,45,1, merged,0,0,0
69105,1000054,2,1546,1304,242,0.843467,0.156533,1.698049,222,20,1547,1305,242,0.843568,0.156432,1.698439,222,20,1, merged,0,0,0
69105,1000592,1,1004,858,146,0.854582,0.145418,0.854582,95,51,1006,860,146,0.854871,0.145129,0.854871,95,51,1, merged,0,0,0
69108,1000014,4,3938,3168,770,0.804469,0.195531,3.324111,725,45,3939,3169,770,0.804519,0.195481,3.324754,725,45,1, merged,0,0,0
69108,1000043,3,771,638,133,0.827497,0.172503,2.519642,115,18,772,639,133,0.82772,0.17228,2.520235,115,18,1, merged,0,0,0
69108,1000140,1,719,602,117,0.837274,0.162726,0.837274,105,12,720,603,117,0.8375,0.1625,0.8375,105,12,1, merged,0,0,0
69108,1000592,2,1006,860,146,0.854871,0.145129,1.692145,95,51,1007,861,146,0.855015,0.144985,1.692515,95,51,1, merged,0,0,0
69109,1000043,3,772,639,133,0.82772,0.17228,2.520235,115,18,773,640,133,0.827943,0.172057,2.520827,115,18,1, merged,0,0,0
69109,1000140,1,720,603,117,0.8375,0.1625,0.8375,105,12,721,604,117,0.837725,0.162275,0.837725,105,12,1, merged,0,0,0
69109,1000592,2,1007,861,146,0.855015,0.144985,1.692515,95,51,1008,862,146,0.855159,0.144841,1.692884,95,51,1, merged,0,0,0
69110,1000005,2,1450,1242,208,0.856552,0.143448,1.596936,197,11,1451,1243,208,0.856651,0.143349,1.599508,197,11,1, merged,0,0,0
69120,1000004,1,5339,4690,649,0.878442,0.121558,0.878442,516,133,5341,4692,649,0.878487,0.121513,0.878487,516,133,-1, merged,0,0,0
69122,1000004,2,5341,4692,649,0.878487,0.121513,1.632042,516,133,5342,4693,649,0.87851,0.12149,1.632647,516,133,1, merged,0,0,0
69128,1000009,2,2506,2094,412,0.835595,0.164405,1.71744,365,47,2507,2095,412,0.83566,0.16434,1.71755,365,47,1, merged,0,0,0
69128,1000120,1,2666,2351,315,0.881845,0.118155,0.881845,274,41,2667,2352,315,0.88189,0.11811,0.88189,274,41,1, merged,0,0,0
69129,1000120,1,2667,2352,315,0.88189,0.11811,0.88189,274,41,2668,2353,315,0.881934,0.118066,0.881934,274,41,1, merged,0,0,0
69132,1000130,1,1130,936,194,0.828319,0.171681,0.828319,154,40,1131,937,194,0.82847,0.17153,0.82847,154,40,1, merged,0,0,0
69132,1000199,2,738,639,99,0.865854,0.134146,1.694172,85,14,739,640,99,0.866035,0.133965,1.694506,85,14,1, merged,0,0,0
69143,1000054,2,1547,1305,242,0.843568,0.156432,1.596446,222,20,1548,1306,242,0.843669,0.156331,1.596737,222,20,1, merged,0,0,0
69143,1000328,1,1303,981,322,0.752878,0.247122,0.752878,285,37,1304,982,322,0.753067,0.246933,0.753067,285,37,1, merged,0,0,0
69150,1000005,1,1452,1244,208,0.856749,0.143251,0.856749,197,11,1453,1245,208,0.856848,0.143152,0.856848,197,11,-1, merged,0,0,0
69150,1000121,2,3248,2701,547,0.831589,0.168411,1.688338,507,40,3249,2702,547,0.831641,0.168359,1.688488,507,40,1, merged,0,0,0
69158,1000108,1,695,591,104,0.85036,0.14964,0.85036,98,6,698,594,104,0.851003,0.148997,0.851003,98,6,-1, merged,0,0,0
69158,1000110,3,853,764,89,0.895662,0.104338,2.583747,82,7,854,765,89,0.895785,0.104215,2.584738,82,7,1, merged,0,0,0
69158,1000140,2,721,604,117,0.837725,0.162275,1.688085,105,12,722,605,117,0.83795,0.16205,1.688953,105,12,1, merged,0,0,0
69162,1000007,1,2230,1797,433,0.80583,0.19417,0.80583,377,56,2231,1797,434,0.805468,0.194532,0.805468,378,56,1, merged,1,1,0
69162,1000153,2,1613,1434,179,0.889027,0.110973,1.694856,137,42,1616,1436,180,0.888614,0.111386,1.694082,138,42,-1, merged,1,0,0
69163,1000091,3,767,605,162,0.788787,0.211213,2.456615,136,26,768,606,162,0.789062,0.210938,2.457364,136,26,1, merged,0,0,0
69163,1000130,1,1131,937,194,0.82847,0.17153,0.82847,154,40,1132,938,194,0.828622,0.171378,0.828622,154,40,1, merged,0,0,0
69164,1000105,1,1032,820,212,0.794574,0.205426,0.794574,177,35,1034,821,213,0.794004,0.205996,0.794004,178,35,1, merged,1,1,0
69169,1000120,2,2668,2353,315,0.881934,0.118066,1.775974,274,41,2669,2353,316,0.881604,0.118396,1.774166,275,41,1, merged,1,1,0
69169,1000329,3,4285,3355,930,0.782964,0.217036,2.558938,788,142,4287,3357,930,0.783065,0.216935,2.557231,788,142,-1, merged,0,0,0
69172,1000003,3,1714,1410,304,0.822637,0.177363,2.370013,258,46,1715,1411,304,0.822741,0.177259,2.367796,258,46,-1, abandoned,0,0,0
69172,1000014,2,3939,3169,770,0.804519,0.195481,1.547376,725,45,3940,3169,771,0.804315,0.195685,1.545055,726,45,1, abandoned,1,1,0
69178,1000003,4,1715,1411,304,0.822741,0.177259,3.230192,258,46,1717,1413,304,0.822947,0.177053,3.227655,258,46,-1, merged,0,0,0
69178,1000329,1,4287,3357,930,0.783065,0.216935,0.783065,788,142,4288,3358,930,0.783116,0.216884,0.783116,788,142,-1, merged,0,0,0
69179,1000329,2,4288,3358,930,0.783116,0.216884,1.425603,788,142,4289,3359,930,0.783166,0.216834,1.422341,788,142,-1, merged,0,0,0
69184,1000054,1,1548,1306,242,0.843669,0.156331,0.843669,222,20,1549,1307,242,0.84377,0.15623,0.84377,222,20,1, merged,0,0,0
69184,1000140,2,722,605,117,0.83795,0.16205,1.681619,105,12,723,606,117,0.838174,0.161826,1.681944,105,12,1, merged,0,0,0
69193,1000007,1,2231,1797,434,0.805468,0.194532,0.805468,378,56,2233,1798,435,0.805195,0.194805,0.805195,379,56,1, merged,1,1,0
69193,1000132,2,1089,900,189,0.826446,0.173554,1.631915,161,28,1091,902,189,0.826764,0.173236,1.631959,161,28,-1, merged,0,0,0
69194,1000011,1,1142,1044,98,0.914186,0.085814,0.914186,91,7,1143,1044,99,0.913386,0.086614,0.913386,92,7,1, merged,1,1,0
69194,1000153,2,1616,1436,180,0.888614,0.111386,1.8028,138,42,1617,1437,180,0.888683,0.111317,1.802069,138,42,1, merged,0,0,0
69197,1000009,2,2511,2098,413,0.835524,0.164476,1.731428,366,47,2512,2099,413,0.835589,0.164411,1.731529,366,47,1, merged,0,0,0
69197,1000015,1,2930,2625,305,0.895904,0.104096,0.895904,280,25,2931,2626,305,0.89594,0.10406,0.89594,280,25,1, merged,0,0,0
69198,1000105,2,1034,821,213,0.794004,0.205996,1.614517,178,35,1037,822,215,0.792671,0.207329,1.597549,180,35,1, merged,1,1,0
69199,1000003,1,1717,1413,304,0.822947,0.177053,0.822947,258,46,1718,1413,305,0.822468,0.177532,0.822468,259,46,1, merged,1,1,0
69199,1000026,2,847,709,138,0.837072,0.162928,1.660019,135,3,848,710,138,0.837264,0.162736,1.659732,135,3,1, merged,0,0,0
69200,1000014,2,3940,3169,771,0.804315,0.195685,1.700255,726,45,3941,3169,772,0.804111,0.195889,1.699475,727,45,1, merged,1,1,0
69200,1000015,1,2931,2626,305,0.89594,0.10406,0.89594,280,25,2934,2627,307,0.895365,0.104635,0.895365,282,25,1, merged,1,1,0
69202,1000005,1,1453,1245,208,0.856848,0.143152,0.856848,197,11,1454,1246,208,0.856946,0.143054,0.856946,197,11,1, merged,0,0,0
69202,1000329,3,4289,3359,930,0.783166,0.216834,2.430655,788,142,4291,3360,931,0.783034,0.216966,2.431135,788,143,1, merged,1,0,0
69205,1000014,1,3941,3169,772,0.804111,0.195889,0.804111,727,45,3942,3170,772,0.80416,0.19584,0.80416,727,45,1, merged,0,0,0
69205,1000091,2,769,607,162,0.789337,0.210663,1.593447,136,26,770,608,162,0.78961,0.21039,1.593771,136,26,1, merged,0,0,0
69211,1000026,2,848,710,138,0.837264,0.162736,1.681034,135,3,849,711,138,0.837456,0.162544,1.681327,135,3,1, merged,0,0,0
69211,1000054,1,1549,1307,242,0.84377,0.15623,0.84377,222,20,1550,1308,242,0.843871,0.156129,0.843871,222,20,1, merged,0,0,0
69212,1000592,2,1010,864,146,0.855446,0.144554,1.344082,95,51,1011,865,146,0.855589,0.144411,1.349971,95,51,1, merged,0,0,0
69216,1000105,2,1037,822,215,0.792671,0.207329,1.638825,180,35,1038,822,216,0.791908,0.208092,1.636882,181,35,1, merged,1,1,0
69218,1000120,2,2669,2353,316,0.881604,0.118396,1.654198,275,41,2670,2354,316,0.881648,0.118352,1.654904,275,41,1, merged,0,0,0
69222,1000014,1,3945,3173,772,0.804309,0.195691,0.804309,727,45,3946,3174,772,0.804359,0.195641,0.804359,727,45,1, merged,0,0,0
69222,1000015,2,2936,2629,307,0.895436,0.104564,1.699745,282,25,2937,2630,307,0.895472,0.104528,1.69983,282,25,1, merged,0,0,0
69226,1000328,1,1304,982,322,0.753067,0.246933,0.753067,285,37,1309,986,323,0.753247,0.246753,0.753247,286,37,-1, merged,1,0,0
69226,1000329,2,4291,3360,931,0.783034,0.216966,1.536102,788,143,4293,3361,932,0.782902,0.217098,1.536149,789,143,-1, merged,1,0,0
69227,1000328,1,1309,986,323,0.753247,0.246753,0.753247,286,37,1310,987,323,0.753435,0.246565,0.753435,286,37,-1, abandoned,0,0,0
69227,1000329,2,4293,3361,932,0.782902,0.217098,1.536149,789,143,4294,3362,932,0.782953,0.217047,1.536388,789,143,-1, abandoned,0,0,0
69228,1000328,1,1310,987,323,0.753435,0.246565,0.753435,286,37,1311,987,324,0.75286,0.24714,0.75286,287,37,1, abandoned,1,1,0
69228,1000329,2,4294,3362,932,0.782953,0.217047,1.536388,789,143,4295,3362,933,0.782771,0.217229,1.535631,790,143,1, abandoned,1,1,0
69229,1000023,1,2436,2113,323,0.867406,0.132594,0.867406,287,36,2437,2114,323,0.86746,0.13254,0.86746,287,36,1, merged,0,0,0
69229,1000054,2,1550,1308,242,0.843871,0.156129,1.711277,222,20,1551,1309,242,0.843972,0.156028,1.711432,222,20,1, merged,0,0,0
69234,1000004,1,5343,4694,649,0.878533,0.121467,0.878533,516,133,5344,4695,649,0.878555,0.121445,0.878555,516,133,1, merged,0,0,0
69239,1000153,1,1617,1437,180,0.888683,0.111317,0.888683,138,42,1618,1438,180,0.888752,0.111248,0.888752,138,42,1, merged,0,0,0
69249,1000132,2,1091,902,189,0.826764,0.173236,1.4691,161,28,1092,903,189,0.826923,0.173077,1.471851,161,28,1, merged,0,0,0
69256,1000004,1,5344,4695,649,0.878555,0.121445,0.878555,516,133,5345,4696,649,0.878578,0.121422,0.878578,516,133,1, merged,0,0,0
69258,1000004,1,5347,4698,649,0.878624,0.121376,0.878624,516,133,5348,4698,650,0.878459,0.121541,0.878459,517,133,1, merged,1,1,0
69262,1000534,1,886,682,204,0.769752,0.230248,0.769752,175,29,889,685,204,0.770529,0.229471,0.770529,175,29,-1, merged,0,0,0
69274,1000120,2,2672,2356,316,0.881737,0.118263,1.738879,275,41,2673,2357,316,0.881781,0.118219,1.742246,275,41,1, merged,0,0,0
69277,1000120,2,2674,2358,316,0.881825,0.118175,1.74229,275,41,2675,2359,316,0.881869,0.118131,1.726314,275,41,1, merged,0,0,0
69278,1000120,2,2675,2359,316,0.881869,0.118131,1.726314,275,41,2676,2360,316,0.881913,0.118087,1.711701,275,41,1, merged,0,0,0
69279,1000120,2,2676,2360,316,0.881913,0.118087,1.711701,275,41,2677,2361,316,0.881957,0.118043,1.698284,275,41,1, merged,0,0,0
69280,1000120,2,2677,2361,316,0.881957,0.118043,1.698284,275,41,2678,2362,316,0.882001,0.117999,1.705531,275,41,1, merged,0,0,0
69282,1000120,2,2678,2362,316,0.882001,0.117999,1.708925,275,41,2679,2363,316,0.882046,0.117954,1.712234,275,41,1, merged,0,0,0
69282,1000329,3,4297,3364,933,0.782872,0.217128,2.491796,790,143,4298,3365,933,0.782922,0.217078,2.495157,790,143,1, merged,0,0,0
69283,1000120,1,2679,2363,316,0.882046,0.117954,0.882046,275,41,2680,2364,316,0.88209,0.11791,0.88209,275,41,1, merged,0,0,0
69283,1000329,2,4298,3365,933,0.782922,0.217078,1.664968,790,143,4299,3366,933,0.782973,0.217027,1.665062,790,143,1, merged,0,0,0
69284,1000120,1,2680,2364,316,0.88209,0.11791,0.88209,275,41,2681,2365,316,0.882134,0.117866,0.882134,275,41,1, merged,0,0,0
69284,1000329,2,4299,3366,933,0.782973,0.217027,1.665062,790,143,4300,3367,933,0.783023,0.216977,1.665157,790,143,1, merged,0,0,0
69290,1000014,2,3947,3175,772,0.804408,0.195592,1.596316,727,45,3948,3176,772,0.804458,0.195542,1.594843,727,45,1, merged,0,0,0
69296,1000108,1,700,596,104,0.851429,0.148571,0.851429,98,6,702,598,104,0.851852,0.148148,0.851852,98,6,-1, merged,0,0,0
69297,1000043,1,775,642,133,0.828387,0.171613,0.828387,115,18,776,642,134,0.82732,0.17268,0.82732,116,18,1, merged,1,1,0
69297,1000108,2,702,598,104,0.851852,0.148148,1.680239,98,6,703,599,104,0.852063,0.147937,1.679382,98,6,-1, merged,0,0,0
69298,1000108,1,703,599,104,0.852063,0.147937,0.852063,98,6,704,599,105,0.850852,0.149148,0.850852,99,6,1, merged,1,1,0
69298,1000121,4,3253,2704,549,0.831233,0.168767,3.313776,509,40,3254,2704,550,0.830977,0.169023,3.309491,510,40,1, merged,1,1,0
69298,1000329,2,4300,3367,933,0.783023,0.216977,1.635086,790,143,4302,3369,933,0.783124,0.216876,1.633976,790,143,-1, merged,0,0,0
69304,1000329,3,4302,3369,933,0.783124,0.216876,2.444266,790,143,4303,3369,934,0.782942,0.217058,2.441432,790,144,-1, merged,1,1,0
69305,1000132,3,1092,903,189,0.826923,0.173077,2.360471,161,28,1093,904,189,0.827081,0.172919,2.361808,161,28,1, merged,0,0,0
69307,1000015,2,2943,2636,307,0.895685,0.104315,1.666213,282,25,2944,2637,307,0.89572,0.10428,1.666507,282,25,1, merged,0,0,0
69307,1000534,1,889,685,204,0.770529,0.229471,0.770529,175,29,890,686,204,0.770787,0.229213,0.770787,175,29,-1, merged,0,0,0
69317,1000004,2,5350,4700,650,0.878505,0.121495,1.685135,517,133,5352,4700,652,0.878176,0.121824,1.687959,517,135,-1, merged,1,1,0
69317,1000014,3,3948,3176,772,0.804458,0.195542,2.489592,727,45,3949,3177,772,0.804507,0.195493,2.492466,727,45,1, merged,0,0,0
69319,1000004,1,5352,4700,652,0.878176,0.121824,0.878176,517,135,5353,4700,653,0.878012,0.121988,0.878012,517,136,-1, merged,1,1,0
69319,1000329,2,4306,3372,934,0.783093,0.216907,1.66127,790,144,4307,3372,935,0.782912,0.217088,1.660924,790,145,-1, merged,1,1,0
69325,1000043,1,776,642,134,0.82732,0.17268,0.82732,116,18,777,643,134,0.827542,0.172458,0.827542,116,18,1, merged,0,0,0
69325,1000108,2,704,599,105,0.850852,0.149148,1.678172,99,6,705,600,105,0.851064,0.148936,1.678606,99,6,1, merged,0,0,0
69329,1000592,2,1011,865,146,0.855589,0.144411,1.522255,95,51,1012,866,146,0.855731,0.144269,1.471116,95,51,-1, abandoned,0,0,0
69349,1000014,1,3949,3177,772,0.804507,0.195493,0.804507,727,45,3950,3178,772,0.804557,0.195443,0.804557,727,45,1, merged,0,0,0
69349,1000328,2,1326,1001,325,0.754902,0.245098,1.559409,288,37,1327,1002,325,0.755087,0.244913,1.559644,288,37,1, merged,0,0,0
69353,1000026,1,850,712,138,0.837647,0.162353,0.837647,135,3,851,713,138,0.837838,0.162162,0.837838,135,3,1, merged,0,0,0
69362,1000009,1,2514,2101,413,0.83572,0.16428,0.83572,366,47,2515,2101,414,0.835388,0.164612,0.835388,367,47,1, merged,1,1,0
69368,1000105,1,1039,823,216,0.792108,0.207892,0.792108,181,35,1040,824,216,0.792308,0.207692,0.792308,181,35,-1, merged,0,0,0
69372,1000091,1,770,608,162,0.78961,0.21039,0.78961,136,26,771,608,163,0.788586,0.211414,0.788586,136,27,-1, merged,1,1,0
69372,1000130,2,1132,938,194,0.828622,0.171378,1.618232,154,40,1133,938,195,0.827891,0.172109,1.616477,154,41,-1, merged,1,1,0
69377,1000003,2,1718,1413,305,0.822468,0.177532,1.68979,259,46,1719,1414,305,0.822571,0.177429,1.689947,259,46,1, merged,0,0,0
69377,1000023,1,2442,2118,324,0.867322,0.132678,0.867322,288,36,2443,2119,324,0.867376,0.132624,0.867376,288,36,1, merged,0,0,0
69380,1000023,2,2443,2119,324,0.867376,0.132624,1.711348,288,36,2444,2120,324,0.86743,0.13257,1.711503,288,36,1, merged,0,0,0
69380,1000054,1,1551,1309,242,0.843972,0.156028,0.843972,222,20,1552,1310,242,0.844072,0.155928,0.844072,222,20,1, merged,0,0,0
69386,1000004,2,5353,4700,653,0.878012,0.121988,1.660924,517,136,5354,4700,654,0.877848,0.122152,1.660265,517,137,-1, merged,1,1,0
69386,1000329,1,4307,3372,935,0.782912,0.217088,0.782912,790,145,4311,3373,938,0.782417,0.217583,0.782417,792,146,1, merged,1,1,0
69387,1000534,1,890,686,204,0.770787,0.229213,0.770787,175,29,891,687,204,0.771044,0.228956,0.771044,175,29,1, merged,0,0,0
69390,1000054,1,1552,1310,242,0.844072,0.155928,0.844072,222,20,1554,1311,243,0.843629,0.156371,0.843629,223,20,1, merged,1,1,0
69396,1000054,2,1555,1312,243,0.84373,0.15627,1.491212,223,20,1556,1313,243,0.84383,0.15617,1.49383,223,20,1, merged,0,0,0
69408,1000054,1,1556,1313,243,0.84383,0.15617,0.84383,223,20,1557,1314,243,0.843931,0.156069,0.843931,223,20,1, merged,0,0,0
69411,1000108,1,705,600,105,0.851064,0.148936,0.851064,99,6,706,601,105,0.851275,0.148725,0.851275,99,6,1, merged,0,0,0
69411,1000110,2,858,769,89,0.89627,0.10373,1.747334,82,7,859,770,89,0.896391,0.103609,1.747666,82,7,1, merged,0,0,0
69414,1000014,2,3952,3180,772,0.804656,0.195344,1.644656,727,45,3953,3181,772,0.804705,0.195295,1.641359,727,45,-1, merged,0,0,0
69415,1000329,4,4311,3373,938,0.782417,0.217583,2.170153,792,146,4312,3374,938,0.782468,0.217532,2.166853,792,146,-1, abandoned,0,0,0
69430,1000007,3,2233,1798,435,0.805195,0.194805,2.471867,379,56,2234,1799,435,0.805282,0.194718,2.471908,379,56,1, merged,0,0,0
69430,1000015,1,2951,2643,308,0.895629,0.104371,0.895629,282,26,2952,2643,309,0.895325,0.104675,0.895325,283,26,1, merged,1,1,0
69430,1000534,2,891,687,204,0.771044,0.228956,1.666672,175,29,892,688,204,0.7713,0.2287,1.666626,175,29,-1, merged,0,0,0
69431,1000007,2,2234,1799,435,0.805282,0.194718,1.687722,379,56,2235,1800,435,0.805369,0.194631,1.687853,379,56,1, merged,0,0,0
69431,1000120,1,2688,2372,316,0.88244,0.11756,0.88244,275,41,2689,2373,316,0.882484,0.117516,0.882484,275,41,1, merged,0,0,0
69432,1000007,2,2235,1800,435,0.805369,0.194631,1.687853,379,56,2236,1801,435,0.805456,0.194544,1.687984,379,56,1, merged,0,0,0
69432,1000120,1,2689,2373,316,0.882484,0.117516,0.882484,275,41,2690,2374,316,0.882528,0.117472,0.882528,275,41,1, merged,0,0,0
69440,1000091,1,771,608,163,0.788586,0.211414,0.788586,136,27,772,609,163,0.78886,0.21114,0.78886,136,27,-1, merged,0,0,0
69445,1000005,2,1457,1249,208,0.857241,0.142759,1.688326,197,11,1458,1250,208,0.857339,0.142661,1.688221,197,11,1, merged,0,0,0
69445,1000121,1,3262,2711,551,0.831085,0.168915,0.831085,511,40,3264,2712,552,0.830882,0.169118,0.830882,512,40,1, merged,1,1,0
69454,1000014,2,3953,3181,772,0.804705,0.195295,1.575911,727,45,3954,3182,772,0.804755,0.195245,1.575356,727,45,1, merged,0,0,0
69454,1000534,1,896,691,205,0.771205,0.228795,0.771205,175,30,898,692,206,0.770601,0.229399,0.770601,175,31,-1, merged,1,1,0
69457,1000003,2,1719,1414,305,0.822571,0.177429,1.690056,259,46,1720,1414,306,0.822093,0.177907,1.689632,259,47,-1, merged,1,1,0
69457,1000023,1,2445,2121,324,0.867485,0.132515,0.867485,288,36,2446,2122,324,0.867539,0.132461,0.867539,288,36,1, merged,0,0,0
69459,1000329,2,4312,3374,938,0.782468,0.217532,1.527922,792,146,4313,3375,938,0.782518,0.217482,1.52572,792,146,-1, abandoned,0,0,0
69460,1000026,1,851,713,138,0.837838,0.162162,0.837838,135,3,852,714,138,0.838028,0.161972,0.838028,135,3,1, merged,0,0,0
69464,1000329,2,4313,3375,938,0.782518,0.217482,1.65214,792,146,4314,3376,938,0.782568,0.217432,1.65236,792,146,1, merged,0,0,0
69471,1000329,2,4314,3376,938,0.782568,0.217432,1.652698,792,146,4315,3377,938,0.782619,0.217381,1.65179,792,146,-1, merged,0,0,0
69477,1000091,2,773,610,163,0.789133,0.210867,1.617024,136,27,774,610,164,0.788114,0.211886,1.615274,136,28,-1, merged,1,1,0
69477,1000130,1,1133,938,195,0.827891,0.172109,0.827891,154,41,1134,938,196,0.82716,0.17284,0.82716,154,42,-1, merged,1,1,0
69479,1000004,3,5354,4700,654,0.877848,0.122152,2.3867,517,137,5355,4700,655,0.877684,0.122316,2.380968,518,137,1, merged,1,1,0
69479,1000023,4,2447,2123,324,0.867593,0.132407,3.254293,288,36,2449,2125,324,0.867701,0.132299,3.248669,288,36,1, merged,0,0,0
69479,1000054,1,1557,1314,243,0.843931,0.156069,0.843931,223,20,1559,1315,244,0.843489,0.156511,0.843489,224,20,1, merged,1,1,0
69483,1000009,2,2518,2103,415,0.835187,0.164813,1.513153,368,47,2519,2104,415,0.835252,0.164748,1.496542,368,47,-1, abandoned,0,0,0
69486,1000003,2,1720,1414,306,0.822093,0.177907,1.687504,259,47,1724,1416,308,0.821346,0.178654,1.685957,261,47,-1, merged,1,0,0
69486,1000199,1,743,643,100,0.86541,0.13459,0.86541,85,15,746,645,101,0.864611,0.135389,0.864611,86,15,-1, merged,1,0,0
69489,1000005,1,1461,1253,208,0.857632,0.142368,0.857632,197,11,1462,1254,208,0.857729,0.142271,0.857729,197,11,1, merged,0,0,0
69489,1000121,2,3264,2712,552,0.830882,0.169118,1.688514,512,40,3265,2713,552,0.830934,0.169066,1.688663,512,40,1, merged,0,0,0
69504,1000091,2,775,611,164,0.788387,0.211613,1.615548,136,28,776,612,164,0.78866,0.21134,1.615973,136,28,1, merged,0,0,0
69504,1000130,1,1134,938,196,0.82716,0.17284,0.82716,154,42,1135,939,196,0.827313,0.172687,0.827313,154,42,1, merged,0,0,0
69507,1000015,1,2953,2644,309,0.895361,0.104639,0.895361,283,26,2955,2646,309,0.895431,0.104569,0.895431,283,26,1, merged,0,0,0
69516,1000153,3,1620,1440,180,0.888889,0.111111,2.527564,138,42,1621,1441,180,0.888957,0.111043,2.525956,138,42,1, merged,0,0,0
69516,1000534,2,898,692,206,0.770601,0.229399,1.638675,175,31,899,693,206,0.770857,0.229143,1.636998,175,31,-1, merged,0,0,0
69530,1000003,3,1724,1416,308,0.821346,0.178654,2.447889,261,47,1725,1417,308,0.821449,0.178551,2.44672,261,47,1, merged,0,0,0
69530,1000004,2,5355,4700,655,0.877684,0.122316,1.626543,518,137,5357,4701,656,0.877543,0.122457,1.625271,519,137,1, merged,1,1,0
69531,1000004,1,5357,4701,656,0.877543,0.122457,0.877543,519,137,5359,4702,657,0.877403,0.122597,0.877403,519,138,-1, merged,1,1,0
69531,1000043,2,779,644,135,0.826701,0.173299,1.704244,116,19,780,645,135,0.826923,0.173077,1.704326,116,19,1, merged,0,0,0
69537,1000054,1,1561,1317,244,0.84369,0.15631,0.84369,224,20,1562,1318,244,0.84379,0.15621,0.84379,224,20,1, merged,0,0,0
69545,1000009,1,2521,2106,415,0.835383,0.164617,0.835383,368,47,2522,2107,415,0.835448,0.164552,0.835448,368,47,-1, abandoned,0,0,0
69547,1000153,2,1621,1441,180,0.888957,0.111043,1.755099,138,42,1622,1442,180,0.889026,0.110974,1.7529,138,42,1, merged,0,0,0
69550,1000199,2,746,645,101,0.864611,0.135389,1.757527,86,15,747,646,101,0.864793,0.135207,1.757885,86,15,1, merged,0,0,0
69551,1000054,1,1563,1319,244,0.84389,0.15611,0.84389,224,20,1565,1320,245,0.84345,0.15655,0.84345,225,20,1, merged,1,1,0
69561,1000005,1,1468,1258,210,0.856948,0.143052,0.856948,199,11,1469,1259,210,0.857046,0.142954,0.857046,199,11,1, merged,0,0,0
69561,1000121,2,3267,2715,552,0.831038,0.168962,1.687986,512,40,3269,2715,554,0.830529,0.169471,1.687575,512,42,-1, merged,1,1,0
69562,1000005,1,1469,1259,210,0.857046,0.142954,0.857046,199,11,1471,1260,211,0.85656,0.14344,0.85656,200,11,1, merged,1,1,0
69562,1000121,2,3269,2715,554,0.830529,0.169471,1.687575,512,42,3270,2716,554,0.830581,0.169419,1.687141,512,42,-1, merged,0,0,0
69564,1000004,1,5359,4702,657,0.877403,0.122597,0.877403,519,138,5361,4704,657,0.877448,0.122552,0.877448,519,138,-1, merged,0,0,0
69564,1000120,2,2691,2375,316,0.882572,0.117428,1.759974,275,41,2692,2376,316,0.882615,0.117385,1.760063,275,41,1, merged,0,0,0
69574,1000004,3,5361,4704,657,0.877448,0.122552,2.555856,519,138,5364,4707,657,0.877517,0.122483,2.555366,519,138,-1, merged,0,0,0
69574,1000043,2,780,645,135,0.826923,0.173077,1.678408,116,19,781,646,135,0.827145,0.172855,1.677849,116,19,-1, merged,0,0,0
69574,1000108,1,707,602,105,0.851485,0.148515,0.851485,99,6,710,604,106,0.850704,0.149296,0.850704,100,6,1, merged,1,1,0
69577,1000140,2,724,607,117,0.838398,0.161602,1.614946,105,12,725,608,117,0.838621,0.161379,1.610551,105,12,1, merged,0,0,0
69579,1000007,2,2246,1811,435,0.806322,0.193678,1.649773,379,56,2248,1813,435,0.806495,0.193505,1.649407,379,56,-1, merged,0,0,0
69579,1000054,1,1565,1320,245,0.84345,0.15655,0.84345,225,20,1566,1320,246,0.842912,0.157088,0.842912,226,20,1, merged,1,1,0
69586,1000004,1,5364,4707,657,0.877517,0.122483,0.877517,519,138,5365,4708,657,0.87754,0.12246,0.87754,519,138,1, merged,0,0,0
69594,1000121,1,3272,2718,554,0.830685,0.169315,0.830685,512,42,3274,2720,554,0.830788,0.169212,0.830788,512,42,-1, merged,0,0,0
69594,1000328,2,1331,1006,325,0.755823,0.244177,1.586507,288,37,1332,1007,325,0.756006,0.243994,1.586794,288,37,1, merged,0,0,0
69597,1000121,1,3276,2722,554,0.830891,0.169109,0.830891,512,42,3279,2724,555,0.830741,0.169259,0.830741,513,42,-1, merged,1,0,0
69597,1000328,3,1332,1007,325,0.756006,0.243994,2.369516,288,37,1334,1008,326,0.755622,0.244378,2.369183,289,37,-1, merged,1,0,0
69597,1000329,2,4315,3377,938,0.782619,0.217381,1.61351,792,146,4319,3381,938,0.78282,0.21718,1.613561,792,146,-1, merged,0,0,0
69600,1000004,4,5365,4708,657,0.87754,0.12246,3.213193,519,138,5366,4709,657,0.877562,0.122438,3.218214,519,138,1, merged,0,0,0
69600,1000014,1,3955,3183,772,0.804804,0.195196,0.804804,727,45,3957,3185,772,0.804903,0.195097,0.804903,727,45,-1, merged,0,0,0
69600,1000015,2,2963,2654,309,0.895714,0.104286,1.700518,283,26,2964,2655,309,0.895749,0.104251,1.700652,283,26,1, merged,0,0,0
69605,1000592,2,1012,866,146,0.855731,0.144269,1.350113,95,51,1013,867,146,0.855874,0.144126,1.355874,95,51,1, merged,0,0,0
69607,1000015,2,2964,2655,309,0.895749,0.104251,1.759623,283,26,2965,2656,309,0.895784,0.104216,1.757403,283,26,1, merged,0,0,0
69612,1000121,2,3279,2724,555,0.830741,0.169259,1.60317,513,42,3280,2725,555,0.830793,0.169207,1.603718,513,42,1, merged,0,0,0
69622,1000023,1,2451,2127,324,0.867809,0.132191,0.867809,288,36,2452,2128,324,0.867863,0.132137,0.867863,288,36,1, merged,0,0,0
69622,1000109,2,841,728,113,0.865636,0.134364,1.733445,104,9,842,728,114,0.864608,0.135392,1.732471,104,10,-1, merged,1,1,0
69632,1000011,1,1143,1044,99,0.913386,0.086614,0.913386,92,7,1144,1045,99,0.913462,0.086538,0.913462,92,7,-1, merged,0,0,0
69632,1000120,2,2694,2378,316,0.882702,0.117298,1.796088,275,41,2695,2379,316,0.882746,0.117254,1.796207,275,41,-1, merged,0,0,0
69634,1000009,2,2530,2115,415,0.835968,0.164032,1.569302,368,47,2531,2115,416,0.835638,0.164362,1.577574,368,48,-1, merged,1,1,0
69637,1000005,3,1476,1265,211,0.857046,0.142954,2.541638,200,11,1478,1267,211,0.85724,0.14276,2.540431,200,11,-1, merged,0,0,0
69637,1000329,1,4319,3381,938,0.78282,0.21718,0.78282,792,146,4320,3382,938,0.78287,0.21713,0.78287,792,146,-1, merged,0,0,0
69642,1000015,2,2965,2656,309,0.895784,0.104216,1.735784,283,26,2966,2657,309,0.895819,0.104181,1.741973,283,26,1, merged,0,0,0
69643,1000054,2,1566,1320,246,0.842912,0.157088,1.50445,226,20,1567,1321,246,0.843012,0.156988,1.506277,226,20,1, merged,0,0,0
69644,1000054,2,1567,1321,246,0.843012,0.156988,1.506277,226,20,1568,1322,246,0.843112,0.156888,1.508087,226,20,1, merged,0,0,0
69651,1000120,2,2695,2379,316,0.882746,0.117254,1.74232,275,41,2696,2380,316,0.882789,0.117211,1.742959,275,41,1, merged,0,0,0
69653,1000054,2,1568,1322,246,0.843112,0.156888,1.609364,226,20,1570,1324,246,0.843312,0.156688,1.60745,226,20,-1, merged,0,0,0
69653,1000166,1,723,554,169,0.766252,0.233748,0.766252,161,8,725,554,171,0.764138,0.235862,0.764138,163,8,1, merged,1,1,0
69656,1000003,1,1725,1417,308,0.821449,0.178551,0.821449,261,47,1730,1422,308,0.821965,0.178035,0.821965,261,47,-1, merged,0,0,0
69656,1000005,2,1478,1267,211,0.85724,0.14276,1.678689,200,11,1480,1269,211,0.857432,0.142568,1.679398,200,11,1, merged,0,0,0
69657,1000329,2,4320,3382,938,0.78287,0.21713,1.628059,792,146,4321,3382,939,0.782689,0.217311,1.624356,792,147,-1, merged,1,1,0
69659,1000015,2,2966,2657,309,0.895819,0.104181,1.785186,283,26,2967,2658,309,0.895854,0.104146,1.785289,283,26,1, merged,0,0,0
69659,1000153,1,1627,1447,180,0.889367,0.110633,0.889367,138,42,1628,1448,180,0.889435,0.110565,0.889435,138,42,1, merged,0,0,0
69660,1000015,2,2967,2658,309,0.895854,0.104146,1.742008,283,26,2968,2659,309,0.895889,0.104111,1.747741,283,26,1, merged,0,0,0
69661,1000004,2,5366,4709,657,0.877562,0.122438,1.734995,519,138,5367,4710,657,0.877585,0.122415,1.735114,519,138,1, merged,0,0,0
69661,1000005,1,1480,1269,211,0.857432,0.142568,0.857432,200,11,1481,1270,211,0.857529,0.142471,0.857529,200,11,1, merged,0,0,0
69667,1000007,3,2250,1813,437,0.805778,0.194222,2.534703,379,58,2251,1814,437,0.805864,0.194136,2.534635,379,58,1, merged,0,0,0
69667,1000009,1,2534,2118,416,0.835833,0.164167,0.835833,368,48,2535,2118,417,0.835503,0.164497,0.835503,369,48,1, merged,1,1,0
69675,1000003,1,1730,1422,308,0.821965,0.178035,0.821965,261,47,1732,1423,309,0.821594,0.178406,0.821594,262,47,-1, merged,1,0,0
69675,1000109,2,842,728,114,0.864608,0.135392,1.686573,104,10,844,729,115,0.863744,0.136256,1.685338,105,10,1, merged,1,1,0
69677,1000026,2,854,716,138,0.838407,0.161593,1.698577,135,3,855,717,138,0.838596,0.161404,1.699356,135,3,1, merged,0,0,0
69677,1000120,3,2699,2383,316,0.88292,0.11708,2.581497,275,41,2700,2384,316,0.882963,0.117037,2.582319,275,41,1, merged,0,0,0
69682,1000014,1,3958,3186,772,0.804952,0.195048,0.804952,727,45,3959,3186,773,0.804749,0.195251,0.804749,728,45,1, abandoned,1,1,0
69684,1000014,2,3959,3186,773,0.804749,0.195251,1.596925,728,45,3960,3187,773,0.804798,0.195202,1.597985,728,45,1, merged,0,0,0
69685,1000043,2,781,646,135,0.827145,0.172855,1.672969,116,19,782,647,135,0.827366,0.172634,1.67352,116,19,1, merged,0,0,0
69689,1000004,4,5368,4711,657,0.877608,0.122392,3.367284,519,138,5369,4712,657,0.877631,0.122369,3.361993,519,138,1, merged,0,0,0
69689,1000043,3,782,647,135,0.827366,0.172634,2.489676,116,19,783,648,135,0.827586,0.172414,2.484363,116,19,1, merged,0,0,0
69705,1000011,2,1147,1048,99,0.913688,0.086312,1.796651,92,7,1148,1049,99,0.913763,0.086237,1.796769,92,7,1, merged,0,0,0
69705,1000120,1,2700,2384,316,0.882963,0.117037,0.882963,275,41,2701,2385,316,0.883006,0.116994,0.883006,275,41,1, merged,0,0,0
69709,1000014,2,3960,3187,773,0.804798,0.195202,1.647685,728,45,3961,3188,773,0.804847,0.195153,1.648068,728,45,1, merged,0,0,0
69709,1000105,4,1046,829,217,0.792543,0.207457,3.268254,181,36,1047,830,217,0.792741,0.207259,3.268991,181,36,1, merged,0,0,0
69709,1000132,3,1099,910,189,0.828025,0.171975,2.475711,161,28,1100,911,189,0.828182,0.171818,2.476249,161,28,1, merged,0,0,0
69723,1000007,1,2258,1821,437,0.806466,0.193534,0.806466,379,58,2259,1822,437,0.806552,0.193448,0.806552,379,58,1, merged,0,0,0
69723,1000015,2,2970,2661,309,0.89596,0.10404,1.702425,283,26,2971,2662,309,0.895995,0.104005,1.702546,283,26,1, merged,0,0,0
69724,1000004,3,5369,4712,657,0.877631,0.122369,2.580177,519,138,5370,4713,657,0.877654,0.122346,2.58032,519,138,1, merged,0,0,0
69724,1000007,1,2259,1822,437,0.806552,0.193448,0.806552,379,58,2260,1823,437,0.806637,0.193363,0.806637,379,58,1, merged,0,0,0
69724,1000015,2,2971,2662,309,0.895995,0.104005,1.702546,283,26,2972,2663,309,0.89603,0.10397,1.702667,283,26,1, merged,0,0,0
69725,1000004,1,5370,4713,657,0.877654,0.122346,0.877654,519,138,5372,4714,658,0.877513,0.122487,0.877513,520,138,-1, merged,1,0,0
69725,1000108,2,710,604,106,0.850704,0.149296,1.728358,100,6,711,605,106,0.850914,0.149086,1.728427,100,6,-1, merged,0,0,0
69744,1000329,1,4323,3384,939,0.78279,0.21721,0.78279,792,147,4324,3384,940,0.782609,0.217391,0.782609,792,148,-1, merged,1,1,0
69752,1000109,2,844,729,115,0.863744,0.136256,1.728537,105,10,845,730,115,0.863905,0.136095,1.728879,105,10,-1, abandoned,0,0,0
69752,1000199,1,747,646,101,0.864793,0.135207,0.864793,86,15,748,647,101,0.864973,0.135027,0.864973,86,15,-1, abandoned,0,0,0
69754,1000004,2,5372,4714,658,0.877513,0.122487,1.553189,520,138,5374,4716,658,0.877559,0.122441,1.550125,520,138,-1, abandoned,0,0,0
69764,1000004,2,5374,4716,658,0.877559,0.122441,1.722937,520,138,5375,4717,658,0.877581,0.122419,1.723219,520,138,1, merged,0,0,0
69774,1000003,2,1736,1424,312,0.820276,0.179724,0.820276,262,50,1737,1425,312,0.82038,0.17962,1.82038,262,50,1, merged,0,0,0
69775,1000003,2,1737,1425,312,0.82038,0.17962,1.82038,262,50,1738,1426,312,0.820483,0.179517,1.820483,262,50,1, merged,0,0,0
69799,1000023,2,2459,2134,325,0.867832,0.132168,1.764344,289,36,2461,2135,326,0.867534,0.132466,1.763125,290,36,1, merged,1,1,0
69799,1000108,3,712,606,106,0.851124,0.148876,2.615468,100,6,713,606,107,0.84993,0.15007,2.613055,101,6,1, merged,1,1,0
69799,1000110,1,860,771,89,0.896512,0.103488,0.896512,82,7,862,772,90,0.895592,0.104408,0.895592,83,7,1, merged,1,1,0
69821,1000003,1,1738,1426,312,0.820483,0.179517,0.820483,262,50,1740,1428,312,0.82069,0.17931,0.82069,262,50,-1, merged,0,0,0
69821,1000109,2,845,730,115,0.863905,0.136095,1.684389,105,10,846,731,115,0.864066,0.135934,1.684756,105,10,1, merged,0,0,0
69824,1000004,2,5375,4717,658,0.877581,0.122419,1.477581,520,138,5376,4718,658,0.877604,0.122396,1.48736,520,138,1, merged,0,0,0
69833,1000120,2,2704,2388,316,0.883136,0.116864,1.725241,275,41,2705,2389,316,0.883179,0.116821,1.725616,275,41,1, merged,0,0,0
69835,1000120,1,2705,2389,316,0.883179,0.116821,0.883179,275,41,2706,2390,316,0.883222,0.116778,0.883222,275,41,1, merged,0,0,0
69835,1000329,2,4326,3385,941,0.782478,0.217522,1.665657,792,149,4327,3386,941,0.782528,0.217472,1.665751,792,149,1, merged,0,0,0
69836,1000120,1,2706,2390,316,0.883222,0.116778,0.883222,275,41,2707,2391,316,0.883266,0.116734,0.883266,275,41,1, merged,0,0,0
69836,1000329,2,4327,3386,941,0.782528,0.217472,1.665751,792,149,4328,3387,941,0.782579,0.217421,1.665844,792,149,1, merged,0,0,0
69839,1000043,4,784,649,135,0.827806,0.172194,3.415227,116,19,785,650,135,0.828025,0.171975,3.416398,116,19,1, merged,0,0,0
69839,1000120,3,2708,2392,316,0.883309,0.116691,2.587421,275,41,2709,2393,316,0.883352,0.116648,2.588373,275,41,1, merged,0,0,0
69842,1000110,2,862,772,90,0.895592,0.104408,1.738688,83,7,863,773,90,0.895713,0.104287,1.739136,83,7,1, merged,0,0,0
69844,1000004,2,5381,4723,658,0.877718,0.122282,1.76107,520,138,5382,4724,658,0.877741,0.122259,1.761135,520,138,1, merged,0,0,0
69844,1000120,1,2709,2393,316,0.883352,0.116648,0.883352,275,41,2710,2394,316,0.883395,0.116605,0.883395,275,41,1, merged,0,0,0
69845,1000014,2,3964,3191,773,0.804995,0.195005,1.461245,728,45,3965,3192,773,0.805044,0.194956,1.466583,728,45,1, merged,0,0,0
69845,1000120,3,2710,2394,316,0.883395,0.116605,2.34464,275,41,2711,2395,316,0.883438,0.116562,2.35002,275,41,1, merged,0,0,0
69864,1000003,2,1740,1428,312,0.82069,0.17931,1.82069,262,50,1741,1429,312,0.820793,0.179207,1.820793,262,50,1, merged,0,0,0
69865,1000005,1,1486,1275,211,0.858008,0.141992,0.858008,200,11,1487,1276,211,0.858104,0.141896,0.858104,200,11,1, merged,0,0,0
69865,1000328,2,1335,1009,326,0.755805,0.244195,1.613813,289,37,1336,1010,326,0.755988,0.244012,1.614092,289,37,1, merged,0,0,0
69914,1000043,2,786,651,135,0.828244,0.171756,1.671668,116,19,787,652,135,0.828463,0.171537,1.670458,116,19,1, merged,0,0,0
69916,1000009,2,2536,2119,417,0.835568,0.164432,1.674164,369,48,2537,2120,417,0.835633,0.164367,1.673439,369,48,1, merged,0,0,0
69916,1000026,1,855,717,138,0.838596,0.161404,0.838596,135,3,857,718,139,0.837806,0.162194,0.837806,136,3,1, merged,1,1,0
69916,1000534,3,899,693,206,0.770857,0.229143,2.445021,175,31,900,694,206,0.771111,0.228889,2.44455,175,31,1, merged,0,0,0
69917,1000015,2,2983,2673,310,0.896078,0.103922,1.758057,284,26,2984,2674,310,0.896113,0.103887,1.75845,284,26,1, merged,0,0,0
69918,1000014,2,3965,3192,773,0.805044,0.194956,1.436357,728,45,3967,3193,774,0.80489,0.19511,1.433031,729,45,1, merged,1,1,0
69919,1000014,2,3967,3193,774,0.80489,0.19511,1.433031,729,45,3969,3194,775,0.804737,0.195263,1.429737,730,45,1, merged,1,1,0
69927,1000015,1,2985,2675,310,0.896147,0.103853,0.896147,284,26,2986,2676,310,0.896182,0.103818,0.896182,284,26,1, merged,0,0,0
69927,1000153,2,1634,1453,181,0.889229,0.110771,1.785376,139,42,1635,1454,181,0.889297,0.110703,1.785479,139,42,1, merged,0,0,0
69936,1000121,2,3292,2731,561,0.829587,0.170413,1.729908,519,42,3294,2732,562,0.829387,0.170613,1.729868,520,42,1, merged,1,1,0
69939,1000026,2,857,718,139,0.837806,0.162194,1.704203,136,3,858,719,139,0.837995,0.162005,1.704931,136,3,1, merged,0,0,0
69941,1000011,1,1151,1052,99,0.913988,0.086012,0.913988,92,7,1152,1053,99,0.914062,0.085938,0.914062,92,7,1, merged,0,0,0
69941,1000534,2,901,695,206,0.771365,0.228635,1.685353,175,31,902,696,206,0.771619,0.228381,1.685681,175,31,1, merged,0,0,0
69945,1000004,2,5382,4724,658,0.877741,0.122259,1.744676,520,138,5383,4725,658,0.877763,0.122237,1.738321,520,138,-1, abandoned,0,0,0
69951,1000015,2,2986,2676,310,0.896182,0.103818,1.785546,284,26,2987,2677,310,0.896217,0.103783,1.785649,284,26,1, merged,0,0,0
69951,1000153,1,1636,1455,181,0.889364,0.110636,0.889364,139,42,1637,1456,181,0.889432,0.110568,0.889432,139,42,1, merged,0,0,0
69952,1000329,1,4329,3387,942,0.782398,0.217602,0.782398,793,149,4331,3389,942,0.782498,0.217502,0.782498,793,149,1, merged,0,0,0
69954,1000004,1,5383,4725,658,0.877763,0.122237,0.877763,520,138,5387,4729,658,0.877854,0.122146,0.877854,520,138,-1, merged,0,0,0
69955,1000007,1,2264,1827,437,0.806979,0.193021,0.806979,379,58,2265,1827,438,0.806623,0.193377,0.806623,380,58,1, merged,1,1,0
69955,1000009,2,2539,2122,417,0.835762,0.164238,1.642741,369,48,2540,2122,418,0.835433,0.164567,1.642056,370,48,1, merged,1,1,0
69964,1000004,2,5387,4729,658,0.877854,0.122146,1.76172,520,138,5388,4730,658,0.877877,0.122123,1.761786,520,138,1, merged,0,0,0
69964,1000120,1,2721,2405,316,0.883866,0.116134,0.883866,275,41,2722,2406,316,0.883909,0.116091,0.883909,275,41,1, merged,0,0,0
69965,1000004,1,5388,4730,658,0.877877,0.122123,0.877877,520,138,5389,4731,658,0.877899,0.122101,0.877899,520,138,-1, merged,0,0,0
69969,1000120,2,2722,2406,316,0.883909,0.116091,1.744467,275,41,2723,2407,316,0.883952,0.116048,1.745063,275,41,1, merged,0,0,0
69979,1000004,3,5389,4731,658,0.877899,0.122101,2.489835,520,138,5390,4731,659,0.877737,0.122263,2.489239,521,138,1, abandoned,1,1,0
69979,1000121,2,3294,2732,562,0.829387,0.170613,1.611935,520,42,3295,2732,563,0.829135,0.170865,1.611503,521,42,1, abandoned,1,1,0
69979,1000329,1,4332,3390,942,0.782548,0.217452,0.782548,793,149,4333,3390,943,0.782368,0.217632,0.782368,794,149,1, abandoned,1,1,0
69987,1000014,1,3969,3194,775,0.804737,0.195263,0.804737,730,45,3970,3195,775,0.804786,0.195214,0.804786,730,45,1, merged,0,0,0
69988,1000014,1,3970,3195,775,0.804786,0.195214,0.804786,730,45,3971,3195,776,0.804583,0.195417,0.804583,731,45,1, abandoned,1,1,0
69988,1000328,2,1336,1010,326,0.755988,0.244012,1.560774,289,37,1337,1011,326,0.756171,0.243829,1.560754,289,37,-1, abandoned,0,0,0
69989,1000329,2,4333,3390,943,0.782368,0.217632,1.450307,794,149,4334,3391,943,0.782418,0.217582,1.45162,794,149,1, merged,0,0,0
69991,1000003,1,1741,1429,312,0.820793,0.179207,0.820793,262,50,1743,1431,312,0.820998,0.179002,0.820998,262,50,1, merged,0,0,0
69991,1000109,2,846,731,115,0.864066,0.135934,1.684859,105,10,847,732,115,0.864227,0.135773,1.685225,105,10,1, merged,0,0,0
69992,1000003,1,1743,1431,312,0.820998,0.179002,0.820998,262,50,1745,1433,312,0.821203,0.178797,0.821203,262,50,1, merged,0,0,0
69992,1000109,2,847,732,115,0.864227,0.135773,1.685225,105,10,848,733,115,0.864387,0.135613,1.68559,105,10,1, merged,0,0,0
69997,1000007,2,2265,1827,438,0.806623,0.193377,1.642056,380,58,2267,1829,438,0.806793,0.193207,1.641897,380,58,-1, abandoned,0,0,0
69997,1000009,1,2540,2122,418,0.835433,0.164567,0.835433,370,48,2541,2122,419,0.835104,0.164896,0.835104,371,48,1, abandoned,1,1,0
69998,1000004,1,5390,4731,659,0.877737,0.122263,0.877737,521,138,5392,4733,659,0.877782,0.122218,0.877782,521,138,-1, merged,0,0,0
69998,1000592,2,1013,867,146,0.855874,0.144126,1.73361,95,51,1014,868,146,0.856016,0.143984,1.733798,95,51,1, merged,0,0,0
70004,1000015,1,2988,2678,310,0.896252,0.103748,0.896252,284,26,2989,2679,310,0.896286,0.103714,0.896286,284,26,1, merged,0,0,0
70005,1000153,2,1638,1457,181,0.889499,0.110501,1.801264,139,42,1639,1458,181,0.889567,0.110433,1.801484,139,42,1, merged,0,0,0
70011,1000009,1,2541,2122,419,0.835104,0.164896,0.835104,371,48,2542,2123,419,0.835169,0.164831,0.835169,371,48,1, merged,0,0,0
70011,1000026,2,858,719,139,0.837995,0.162005,1.6731,136,3,859,720,139,0.838184,0.161816,1.673353,136,3,1, merged,0,0,0
70034,1000009,3,2544,2124,420,0.834906,0.165094,2.416024,372,48,2546,2125,421,0.834643,0.165357,2.415442,372,49,-1, merged,1,1,0
70037,1000003,2,1745,1433,312,0.821203,0.178797,1.628167,262,50,1746,1433,313,0.820733,0.179267,1.627341,263,50,1, merged,1,1,0
70037,1000007,1,2269,1831,438,0.806963,0.193037,0.806963,380,58,2270,1831,439,0.806608,0.193392,0.806608,381,58,1, merged,1,1,0
70037,1000009,3,2546,2125,421,0.834643,0.165357,2.462809,372,49,2547,2126,421,0.834707,0.165293,2.462049,372,49,1, merged,0,0,0
70042,1000120,2,2723,2407,316,0.883952,0.116048,1.736092,275,41,2724,2408,316,0.883994,0.116006,1.736707,275,41,1, merged,0,0,0
70044,1000091,2,776,612,164,0.78866,0.21134,1.658427,136,28,777,613,164,0.788932,0.211068,1.659302,136,28,1, merged,0,0,0
70045,1000091,2,777,613,164,0.788932,0.211068,1.659302,136,28,778,614,164,0.789203,0.210797,1.660171,136,28,1, merged,0,0,0
70046,1000026,1,860,721,139,0.838372,0.161628,0.838372,136,3,861,722,139,0.83856,0.16144,0.83856,136,3,1, merged,0,0,0
70046,1000054,2,1574,1328,246,0.84371,0.15629,1.682082,226,20,1575,1329,246,0.84381,0.15619,1.682369,226,20,1, merged,0,0,0
70047,1000054,2,1575,1329,246,0.84381,0.15619,1.607947,226,20,1576,1330,246,0.843909,0.156091,1.608371,226,20,1, merged,0,0,0
70047,1000166,1,725,554,171,0.764138,0.235862,0.764138,163,8,726,555,171,0.764463,0.235537,0.764463,163,8,1, merged,0,0,0
70051,1000004,1,5392,4733,659,0.877782,0.122218,0.877782,521,138,5396,4735,661,0.877502,0.122498,0.877502,523,138,-1, merged,1,0,0
70055,1000054,2,1576,1330,246,0.843909,0.156091,1.508883,226,20,1577,1331,246,0.844008,0.155992,1.504008,226,20,1, merged,0,0,0
70057,1000026,3,861,722,139,0.83856,0.16144,2.299908,136,3,862,723,139,0.838747,0.161253,2.305281,136,3,1, merged,0,0,0
70060,1000009,1,2547,2126,421,0.834707,0.165293,0.834707,372,49,2548,2127,421,0.834772,0.165228,0.834772,372,49,1, merged,0,0,0
70060,1000026,2,862,723,139,0.838747,0.161253,1.673455,136,3,863,724,139,0.838934,0.161066,1.673706,136,3,1, merged,0,0,0
70066,1000105,1,1048,831,217,0.792939,0.207061,0.792939,181,36,1049,832,217,0.793136,0.206864,0.793136,181,36,-1, merged,0,0,0
70067,1000009,2,2548,2127,421,0.834772,0.165228,1.588871,372,49,2549,2128,421,0.834837,0.165163,1.590082,372,49,1, merged,0,0,0
70071,1000014,1,3971,3195,776,0.804583,0.195417,0.804583,731,45,3972,3196,776,0.804632,0.195368,0.804632,731,45,1, merged,0,0,0
70080,1000007,1,2271,1831,440,0.806253,0.193747,0.806253,381,59,2272,1831,441,0.805898,0.194102,0.805898,382,59,1, merged,1,1,0
70080,1000015,3,2995,2685,310,0.896494,0.103506,2.541681,284,26,2996,2686,310,0.896529,0.103471,2.54039,284,26,1, merged,0,0,0
70080,1000026,2,863,724,139,0.838934,0.161066,1.645187,136,3,864,724,140,0.837963,0.162037,1.643861,137,3,1, merged,1,1,0
70080,1000153,4,1640,1459,181,0.889634,0.110366,3.431315,139,42,1641,1460,181,0.889701,0.110299,3.430091,139,42,1, merged,0,0,0
70089,1000120,2,2724,2408,316,0.883994,0.116006,1.737276,275,41,2725,2409,316,0.884037,0.115963,1.738443,275,41,1, merged,0,0,0
70090,1000120,2,2725,2409,316,0.884037,0.115963,1.740052,275,41,2726,2410,316,0.884079,0.115921,1.740237,275,41,1, merged,0,0,0
70090,1000592,1,1014,868,146,0.856016,0.143984,0.856016,95,51,1015,869,146,0.856158,0.143842,0.856158,95,51,1, merged,0,0,0
70097,1000043,2,787,652,135,0.828463,0.171537,1.668711,116,19,788,653,135,0.82868,0.17132,1.66926,116,19,1, merged,0,0,0
70100,1000004,2,5396,4735,661,0.877502,0.122498,1.682233,523,138,5397,4736,661,0.877525,0.122475,1.682304,523,138,1, merged,0,0,0
70100,1000014,1,3974,3198,776,0.804731,0.195269,0.804731,731,45,3975,3199,776,0.80478,0.19522,0.80478,731,45,1, merged,0,0,0
70112,1000011,1,1152,1053,99,0.914062,0.085938,0.914062,92,7,1153,1054,99,0.914137,0.085863,0.914137,92,7,-1, merged,0,0,0
70112,1000026,2,864,724,140,0.837963,0.162037,1.752025,137,3,865,724,141,0.836994,0.163006,1.751131,138,3,1, merged,1,1,0
70132,1000329,2,4335,3392,943,0.782468,0.217532,1.525325,794,149,4336,3393,943,0.782518,0.217482,1.523823,794,149,-1, merged,0,0,0
70137,1000014,1,3975,3199,776,0.80478,0.19522,0.80478,731,45,3976,3200,776,0.804829,0.195171,0.804829,731,45,1, merged,0,0,0
70143,1000007,3,2273,1832,441,0.805983,0.194017,2.250577,382,59,2275,1833,442,0.805714,0.194286,2.243026,383,59,-1, merged,1,0,0
70143,1000009,1,2549,2128,421,0.834837,0.165163,0.834837,372,49,2550,2129,421,0.834902,0.165098,0.834902,372,49,-1, merged,0,0,0
70149,1000054,1,1578,1332,246,0.844106,0.155894,0.844106,226,20,1579,1333,246,0.844205,0.155795,0.844205,226,20,1, merged,0,0,0
70153,1000091,1,780,615,165,0.788462,0.211538,0.788462,137,28,782,615,167,0.786445,0.213555,0.786445,139,28,1, abandoned,1,1,0
70153,1000329,2,4337,3394,943,0.782569,0.217431,1.57103,794,149,4338,3394,944,0.782388,0.217612,1.568833,795,149,1, abandoned,1,1,0
70154,1000091,2,782,615,167,0.786445,0.213555,1.642603,139,28,783,616,167,0.786718,0.213282,1.642033,139,28,-1, abandoned,0,0,0
70154,1000592,1,1015,869,146,0.856158,0.143842,0.856158,95,51,1016,869,147,0.855315,0.144685,0.855315,96,51,1, abandoned,1,1,0
70155,1000091,1,783,616,167,0.786718,0.213282,0.786718,139,28,784,617,167,0.78699,0.21301,0.78699,139,28,-1, abandoned,0,0,0
70155,1000329,3,4338,3394,944,0.782388,0.217612,2.424421,795,149,4340,3395,945,0.782258,0.217742,2.423865,796,149,-1, abandoned,1,0,0
70155,1000592,2,1016,869,147,0.855315,0.144685,1.642033,96,51,1018,870,148,0.854617,0.145383,1.641607,97,51,1, abandoned,1,1,0
70159,1000329,2,4340,3395,945,0.782258,0.217742,1.612323,796,149,4341,3395,946,0.782078,0.217922,1.613247,796,150,-1, merged,1,1,0
70164,1000005,2,1496,1283,213,0.85762,0.14238,1.686911,202,11,1498,1284,214,0.857143,0.142857,1.686234,203,11,1, merged,1,1,0
70164,1000121,1,3298,2735,563,0.82929,0.17071,0.82929,521,42,3300,2736,564,0.829091,0.170909,0.829091,522,42,1, merged,1,1,0
70167,1000005,2,1502,1286,216,0.856192,0.143808,1.685283,205,11,1504,1287,217,0.855718,0.144282,1.68461,206,11,1, merged,1,1,0
70167,1000121,1,3300,2736,564,0.829091,0.170909,0.829091,522,42,3302,2737,565,0.828892,0.171108,0.828892,523,42,1, merged,1,1,0
70171,1000005,2,1510,1290,220,0.854305,0.145695,1.683196,209,11,1512,1291,221,0.853836,0.146164,1.682528,210,11,1, merged,1,1,0
70171,1000121,1,3302,2737,565,0.828892,0.171108,0.828892,523,42,3304,2738,566,0.828692,0.171308,0.828692,524,42,1, merged,1,1,0
70179,1000004,2,5397,4736,661,0.877525,0.122475,1.718104,523,138,5398,4737,661,0.877547,0.122453,1.718456,523,138,-1, abandoned,0,0,0
70182,1000105,5,1049,832,217,0.793136,0.206864,4.035045,181,36,1050,833,217,0.793333,0.206667,4.037053,181,36,1, merged,0,0,0
70182,1000121,4,3304,2738,566,0.828692,0.171308,3.241908,524,42,3305,2739,566,0.828744,0.171256,3.243719,524,42,1, merged,0,0,0
70182,1000328,1,1337,1011,326,0.756171,0.243829,0.756171,289,37,1338,1012,326,0.756353,0.243647,0.756353,289,37,1, merged,0,0,0
70187,1000121,3,3305,2739,566,0.828744,0.171256,2.473933,524,42,3306,2740,566,0.828796,0.171204,2.473025,524,42,1, merged,0,0,0
70188,1000014,1,3976,3200,776,0.804829,0.195171,0.804829,731,45,3978,3201,777,0.804676,0.195324,0.804676,732,45,1, merged,1,1,0
70188,1000026,3,865,724,141,0.836994,0.163006,2.515241,138,3,866,725,141,0.837182,0.162818,2.507712,138,3,1, merged,0,0,0
70203,1000007,1,2275,1833,442,0.805714,0.194286,0.805714,383,59,2277,1834,443,0.805446,0.194554,0.805446,384,59,1, merged,1,1,0
70208,1000011,1,1154,1055,99,0.914211,0.085789,0.914211,92,7,1155,1056,99,0.914286,0.085714,0.914286,92,7,1, merged,0,0,0
70208,1000026,2,866,725,141,0.837182,0.162818,1.751394,138,3,867,726,141,0.83737,0.16263,1.751656,138,3,1, merged,0,0,0
70210,1000003,1,1748,1434,314,0.820366,0.179634,0.820366,263,51,1750,1436,314,0.820571,0.179429,0.820571,263,51,-1, merged,0,0,0
70210,1000014,2,3979,3202,777,0.804725,0.195275,1.625091,732,45,3980,3203,777,0.804774,0.195226,1.625345,732,45,1, merged,0,0,0
70211,1000005,1,1513,1292,221,0.853933,0.146067,0.853933,210,11,1515,1294,221,0.854125,0.145875,0.854125,210,11,-1, merged,0,0,0
70211,1000329,2,4341,3395,946,0.782078,0.217922,1.63601,796,150,4342,3395,947,0.781898,0.218102,1.636023,797,150,1, merged,1,1,0
70212,1000004,3,5399,4738,661,0.87757,0.12243,2.513593,523,138,5400,4739,661,0.877593,0.122407,2.513762,523,138,1, merged,0,0,0
70212,1000005,1,1515,1294,221,0.854125,0.145875,0.854125,210,11,1516,1295,221,0.854222,0.145778,0.854222,210,11,1, merged,0,0,0
70212,1000329,2,4342,3395,947,0.781898,0.218102,1.636023,797,150,4343,3396,947,0.781948,0.218052,1.63617,797,150,1, merged,0,0,0
70217,1000009,3,2551,2129,422,0.834575,0.165425,2.503009,372,50,2552,2129,423,0.834248,0.165752,2.50153,372,51,-1, merged,1,1,0
70217,1000015,2,2997,2687,310,0.896563,0.103437,1.668435,284,26,2998,2687,311,0.896264,0.103736,1.667282,284,27,-1, merged,1,1,0
70217,1000534,1,903,697,206,0.771872,0.228128,0.771872,175,31,904,697,207,0.771018,0.228982,0.771018,175,32,-1, merged,1,1,0
70222,1000007,2,2277,1834,443,0.805446,0.194554,1.639367,384,59,2278,1835,443,0.805531,0.194469,1.639126,384,59,1, merged,0,0,0
70222,1000009,1,2553,2129,424,0.833921,0.166079,0.833921,372,52,2554,2129,425,0.833594,0.166406,0.833594,373,52,1, merged,1,1,0
70224,1000007,1,2280,1837,443,0.805702,0.194298,0.805702,384,59,2281,1838,443,0.805787,0.194213,0.805787,384,59,1, merged,0,0,0
70228,1000054,2,1580,1334,246,0.844304,0.155696,1.673287,226,20,1581,1335,246,0.844402,0.155598,1.673539,226,20,1, merged,0,0,0
70228,1000132,1,1111,921,190,0.828983,0.171017,0.828983,162,28,1112,922,190,0.829137,0.170863,0.829137,162,28,1, merged,0,0,0
70234,1000005,2,1517,1296,221,0.854318,0.145682,1.636266,210,11,1518,1297,221,0.854414,0.145586,1.636462,210,11,1, merged,0,0,0
70234,1000329,1,4343,3396,947,0.781948,0.218052,0.781948,797,150,4345,3398,947,0.782048,0.217952,0.782048,797,150,1, merged,0,0,0
70246,1000014,3,3981,3204,777,0.804823,0.195177,2.123857,732,45,3982,3205,777,0.804872,0.195128,2.116066,732,45,1, merged,0,0,0
70247,1000005,2,1518,1297,221,0.854414,0.145586,1.64814,210,11,1519,1298,221,0.85451,0.14549,1.648432,210,11,1, merged,0,0,0
70247,1000105,1,1052,835,217,0.793726,0.206274,0.793726,181,36,1053,836,217,0.793922,0.206078,0.793922,181,36,1, merged,0,0,0
70252,1000023,1,2464,2138,326,0.867695,0.132305,0.867695,290,36,2465,2139,326,0.867748,0.132252,0.867748,290,36,1, merged,0,0,0
70254,1000003,1,1750,1436,314,0.820571,0.179429,0.820571,263,51,1754,1440,314,0.820981,0.179019,0.820981,263,51,-1, merged,0,0,0
70254,1000026,2,867,726,141,0.83737,0.16263,1.657942,138,3,868,726,142,0.836406,0.163594,1.657386,139,3,1, merged,1,1,0
70254,1000109,4,848,733,115,0.864387,0.135613,3.387482,105,10,850,735,115,0.864706,0.135294,3.386273,105,10,-1, merged,0,0,0
70254,1000199,3,749,648,101,0.865154,0.134846,2.523095,86,15,751,649,102,0.864181,0.135819,2.521567,87,15,1, merged,1,1,0
70257,1000054,2,1581,1335,246,0.844402,0.155598,1.502818,226,20,1582,1336,246,0.844501,0.155499,1.504599,226,20,1, merged,0,0,0
70258,1000108,1,715,608,107,0.85035,0.14965,0.85035,101,6,716,609,107,0.850559,0.149441,0.850559,101,6,1, merged,0,0,0
70262,1000007,1,2283,1840,443,0.805957,0.194043,0.805957,384,59,2284,1841,443,0.806042,0.193958,0.806042,384,59,1, merged,0,0,0
70279,1000003,4,1757,1442,315,0.820717,0.179283,3.358293,264,51,1759,1444,315,0.820921,0.179079,3.357083,264,51,-1, abandoned,0,0,0
70279,1000014,3,3982,3205,777,0.804872,0.195128,2.537576,732,45,3984,3206,778,0.804719,0.195281,2.536162,733,45,-1, abandoned,1,0,0
70279,1000015,1,2999,2688,311,0.896299,0.103701,0.896299,284,27,3000,2688,312,0.896,0.104,0.896,285,27,1, abandoned,1,1,0
70279,1000026,2,868,726,142,0.836406,0.163594,1.732704,139,3,869,726,143,0.835443,0.164557,1.731443,140,3,1, abandoned,1,1,0
70285,1000153,2,1643,1462,181,0.889836,0.110164,1.660853,139,42,1645,1464,181,0.88997,0.11003,1.66124,139,42,1, merged,0,0,0
70285,1000534,1,904,697,207,0.771018,0.228982,0.771018,175,32,905,698,207,0.771271,0.228729,0.771271,175,32,1, merged,0,0,0
70289,1000015,2,3000,2688,312,0.896,0.104,1.69163,285,27,3001,2689,312,0.896035,0.103965,1.691927,285,27,1, merged,0,0,0
70289,1000327,1,778,619,159,0.79563,0.20437,0.79563,121,38,779,620,159,0.795892,0.204108,0.795892,121,38,1, merged,0,0,0
70298,1000005,2,1522,1301,221,0.854796,0.145204,1.566796,210,11,1523,1302,221,0.854892,0.145108,1.568039,210,11,1, merged,0,0,0
70302,1000003,2,1759,1444,315,0.820921,0.179079,1.751477,264,51,1761,1446,315,0.821124,0.178876,1.745262,264,51,-1, merged,0,0,0
70309,1000026,1,869,726,143,0.835443,0.164557,0.835443,140,3,870,727,143,0.835632,0.164368,0.835632,140,3,1, merged,0,0,0
70309,1000054,3,1582,1336,246,0.844501,0.155499,2.340042,226,20,1583,1337,246,0.844599,0.155401,2.341996,226,20,1, merged,0,0,0
70315,1000043,1,791,656,135,0.82933,0.17067,0.82933,116,19,792,657,135,0.829545,0.170455,0.829545,116,19,1, merged,0,0,0
70319,1000105,3,1055,838,217,0.794313,0.205687,2.356371,181,36,1056,839,217,0.794508,0.205492,2.371332,181,36,1, merged,0,0,0
70320,1000011,2,1157,1058,99,0.914434,0.085566,1.770494,92,7,1158,1059,99,0.914508,0.085492,1.771112,92,7,1, merged,0,0,0
70322,1000026,1,870,727,143,0.835632,0.164368,0.835632,140,3,872,729,143,0.836009,0.163991,0.836009,140,3,-1, merged,0,0,0
70325,1000003,1,1761,1446,315,0.821124,0.178876,0.821124,264,51,1763,1448,315,0.821327,0.178673,0.821327,264,51,1, merged,0,0,0
70327,1000004,1,5404,4743,661,0.877683,0.122317,0.877683,523,138,5406,4744,662,0.877543,0.122457,0.877543,524,138,-1, merged,1,0,0
70327,1000121,2,3307,2741,566,0.828848,0.171152,1.706531,524,42,3308,2741,567,0.828597,0.171403,1.706141,525,42,1, merged,1,1,0
70329,1000005,2,1523,1302,221,0.854892,0.145108,1.522816,210,11,1524,1303,221,0.854987,0.145013,1.52416,210,11,1, merged,0,0,0
70332,1000004,3,5406,4744,662,0.877543,0.122457,2.528314,524,138,5407,4744,663,0.877381,0.122619,2.528556,524,139,-1, merged,1,1,0
70332,1000327,1,780,621,159,0.796154,0.203846,0.796154,121,38,781,622,159,0.796415,0.203585,0.796415,121,38,1, merged,0,0,0
70332,1000592,2,1018,870,148,0.854617,0.145383,1.650771,97,51,1019,871,148,0.85476,0.14524,1.651174,97,51,1, merged,0,0,0
70340,1000007,1,2291,1845,446,0.805325,0.194675,0.805325,387,59,2292,1846,446,0.80541,0.19459,0.80541,387,59,1, merged,0,0,0
70340,1000015,2,3004,2692,312,0.896138,0.103862,1.701464,285,27,3005,2693,312,0.896173,0.103827,1.701583,285,27,1, merged,0,0,0
70341,1000015,2,3005,2693,312,0.896173,0.103827,1.78979,285,27,3006,2694,312,0.896208,0.103792,1.788891,285,27,1, merged,0,0,0
70344,1000014,1,3986,3208,778,0.804817,0.195183,0.804817,733,45,3987,3209,778,0.804866,0.195134,0.804866,733,45,1, merged,0,0,0
70345,1000121,2,3308,2741,567,0.828597,0.171403,1.659766,525,42,3309,2742,567,0.828649,0.171351,1.660364,525,42,1, merged,0,0,0
70347,1000043,2,792,657,135,0.829545,0.170455,1.686149,116,19,793,658,135,0.82976,0.17024,1.686903,116,19,1, merged,0,0,0
70350,1000091,2,788,620,168,0.786802,0.213198,1.641562,140,28,789,621,168,0.787072,0.212928,1.641974,140,28,1, merged,0,0,0
70350,1000592,1,1019,871,148,0.85476,0.14524,0.85476,97,51,1020,872,148,0.854902,0.145098,0.854902,97,51,1, merged,0,0,0
70351,1000091,3,789,621,168,0.787072,0.212928,2.423893,140,28,790,622,168,0.787342,0.212658,2.423375,140,28,1, merged,0,0,0
70351,1000329,2,4347,3399,948,0.781919,0.218081,1.636821,797,151,4348,3400,948,0.781969,0.218031,1.636033,797,151,1, merged,0,0,0
70351,1000592,1,1020,872,148,0.854902,0.145098,0.854902,97,51,1021,872,149,0.854065,0.145935,0.854065,98,51,1, merged,1,1,0
70352,1000091,1,790,622,168,0.787342,0.212658,0.787342,140,28,792,623,169,0.786616,0.213384,0.786616,141,28,-1, abandoned,1,0,0
70352,1000329,2,4348,3400,948,0.781969,0.218031,1.56931,797,151,4349,3401,948,0.782019,0.217981,1.568635,797,151,-1, abandoned,0,0,0
70357,1000007,1,2292,1846,446,0.80541,0.19459,0.80541,387,59,2293,1847,446,0.805495,0.194505,0.805495,387,59,-1, merged,0,0,0
70357,1000015,2,3006,2694,312,0.896208,0.103792,1.701618,285,27,3007,2695,312,0.896242,0.103758,1.701737,285,27,1, merged,0,0,0
70359,1000054,2,1583,1337,246,0.844599,0.155401,1.609062,226,20,1584,1338,246,0.844697,0.155303,1.609484,226,20,1, merged,0,0,0
70359,1000166,1,726,555,171,0.764463,0.235537,0.764463,163,8,727,556,171,0.764787,0.235213,0.764787,163,8,1, merged,0,0,0
70361,1000014,2,3988,3210,778,0.804915,0.195085,1.662058,733,45,3989,3211,778,0.804964,0.195036,1.63255,733,45,-1, merged,0,0,0
70366,1000132,2,1113,923,190,0.82929,0.17071,1.618664,162,28,1114,923,191,0.828546,0.171454,1.616826,163,28,1, merged,1,1,0
70368,1000026,2,872,729,143,0.836009,0.163991,1.497774,140,3,873,730,143,0.836197,0.163803,1.499612,140,3,1, merged,0,0,0
70370,1000026,2,873,730,143,0.836197,0.163803,1.499612,140,3,874,731,143,0.836384,0.163616,1.501433,140,3,1, merged,0,0,0
70371,1000026,2,874,731,143,0.836384,0.163616,1.501433,140,3,875,732,143,0.836571,0.163429,1.503238,140,3,1, merged,0,0,0
70372,1000026,2,875,732,143,0.836571,0.163429,1.503238,140,3,876,733,143,0.836758,0.163242,1.505027,140,3,1, merged,0,0,0
70373,1000054,1,1584,1338,246,0.844697,0.155303,0.844697,226,20,1585,1339,246,0.844795,0.155205,0.844795,226,20,1, merged,0,0,0
70374,1000026,2,876,733,143,0.836758,0.163242,1.506614,140,3,877,734,143,0.836944,0.163056,1.508373,140,3,1, merged,0,0,0
70374,1000140,3,726,609,117,0.838843,0.161157,2.345457,105,12,727,610,117,0.839065,0.160935,2.347437,105,12,1, merged,0,0,0
70375,1000026,2,877,734,143,0.836944,0.163056,1.508373,140,3,878,735,143,0.83713,0.16287,1.510116,140,3,1, merged,0,0,0
70377,1000026,2,878,735,143,0.83713,0.16287,1.510116,140,3,879,736,143,0.837315,0.162685,1.511843,140,3,1, merged,0,0,0
70378,1000026,3,879,736,143,0.837315,0.162685,2.430211,140,3,880,737,143,0.8375,0.1625,2.432748,140,3,1, merged,0,0,0
70379,1000007,1,2293,1847,446,0.805495,0.194505,0.805495,387,59,2294,1848,446,0.80558,0.19442,0.80558,387,59,1, merged,0,0,0
70379,1000153,2,1649,1467,182,0.88963,0.11037,1.695125,139,43,1650,1468,182,0.889697,0.110303,1.695277,139,43,1, merged,0,0,0
70380,1000026,2,880,737,143,0.8375,0.1625,1.513556,140,3,881,738,143,0.837684,0.162316,1.515255,140,3,1, merged,0,0,0
70381,1000026,2,881,738,143,0.837684,0.162316,1.515255,140,3,882,739,143,0.837868,0.162132,1.516938,140,3,1, merged,0,0,0
70382,1000043,1,793,658,135,0.82976,0.17024,0.82976,116,19,798,660,138,0.827068,0.172932,0.827068,119,19,1, merged,1,1,0
70382,1000108,3,716,609,107,0.850559,0.149441,2.180319,101,6,717,610,107,0.850767,0.149233,2.511168,101,6,-1, merged,0,0,0
70383,1000026,2,882,739,143,0.837868,0.162132,1.516938,140,3,883,740,143,0.838052,0.161948,1.518608,140,3,1, merged,0,0,0
70384,1000054,2,1585,1339,246,0.844795,0.155205,1.68386,226,20,1586,1340,246,0.844893,0.155107,1.684179,226,20,1, merged,0,0,0
70384,1000140,1,727,610,117,0.839065,0.160935,0.839065,105,12,728,611,117,0.839286,0.160714,0.839286,105,12,1, merged,0,0,0
70386,1000026,2,883,740,143,0.838052,0.161948,1.518608,140,3,884,741,143,0.838235,0.161765,1.520263,140,3,1, merged,0,0,0
70390,1000026,1,885,742,143,0.838418,0.161582,0.838418,140,3,886,743,143,0.8386,0.1614,0.8386,140,3,1, merged,0,0,0
70392,1000026,2,887,744,143,0.838782,0.161218,1.52081,140,3,888,745,143,0.838964,0.161036,1.52245,140,3,1, merged,0,0,0
70393,1000026,1,888,745,143,0.838964,0.161036,0.838964,140,3,889,746,143,0.839145,0.160855,0.839145,140,3,1, merged,0,0,0
70393,1000140,2,728,611,117,0.839286,0.160714,1.67825,105,12,729,612,117,0.839506,0.160494,1.678651,105,12,1, merged,0,0,0
70394,1000026,1,889,746,143,0.839145,0.160855,0.839145,140,3,890,747,143,0.839326,0.160674,0.839326,140,3,1, merged,0,0,0
70398,1000026,2,890,747,143,0.839326,0.160674,1.522812,140,3,891,748,143,0.839506,0.160494,1.524438,140,3,1, merged,0,0,0
70401,1000003,1,1768,1451,317,0.820701,0.179299,0.820701,266,51,1769,1452,317,0.820803,0.179197,0.820803,266,51,1, merged,0,0,0
70401,1000109,2,850,735,115,0.864706,0.135294,1.685407,105,10,851,736,115,0.864865,0.135135,1.685668,105,10,1, merged,0,0,0
70402,1000004,2,5408,4745,663,0.877404,0.122596,1.377404,524,139,5409,4746,663,0.877427,0.122573,1.348015,524,139,-1, merged,0,0,0
70402,1000328,3,1338,1012,326,0.756353,0.243647,2.133757,289,37,1340,1013,327,0.75597,0.24403,2.103985,290,37,1, merged,1,1,0
70402,1000329,4,4349,3401,948,0.782019,0.217981,2.915775,797,151,4350,3402,948,0.782069,0.217931,2.886054,797,151,1, merged,0,0,0
70412,1000120,2,2732,2416,316,0.884334,0.115666,1.741477,275,41,2733,2417,316,0.884376,0.115624,1.742054,275,41,1, merged,0,0,0
70414,1000012,2,1132,983,149,0.868375,0.131625,1.535041,142,7,1133,984,149,0.868491,0.131509,1.504854,142,7,1, merged,0,0,0
70418,1000121,2,3309,2742,567,0.828649,0.171351,1.605473,525,42,3310,2743,567,0.828701,0.171299,1.603862,525,42,1, merged,0,0,0
70426,1000004,1,5409,4746,663,0.877427,0.122573,0.877427,524,139,5410,4746,664,0.877264,0.122736,0.877264,525,139,1, merged,1,1,0
70426,1000153,2,1650,1468,182,0.889697,0.110303,1.767123,139,43,1651,1469,182,0.889764,0.110236,1.767028,139,43,1, merged,0,0,0
70446,1000014,3,3991,3212,779,0.804811,0.195189,2.426564,734,45,3993,3213,780,0.804658,0.195342,2.425871,734,46,-1, merged,1,0,0
70446,1000043,2,798,660,138,0.827068,0.172932,1.621754,119,19,799,660,139,0.826033,0.173967,1.621213,120,19,1, merged,1,1,0
70447,1000026,2,891,748,143,0.839506,0.160494,1.524438,140,3,892,749,143,0.839686,0.160314,1.52605,140,3,1, merged,0,0,0
70448,1000026,3,892,749,143,0.839686,0.160314,2.290837,140,3,893,750,143,0.839866,0.160134,2.28686,140,3,-1, merged,0,0,0
70448,1000054,4,1590,1343,247,0.844654,0.155346,3.135491,227,20,1591,1343,248,0.844123,0.155877,3.130983,228,20,1, merged,1,1,0
70448,1000166,1,727,556,171,0.764787,0.235213,0.764787,163,8,728,556,172,0.763736,0.236264,0.763736,164,8,1, merged,1,1,0
70453,1000132,2,1114,923,191,0.828546,0.171454,1.664162,163,28,1116,925,191,0.828853,0.171147,1.661432,163,28,-1, merged,0,0,0
70455,1000121,1,3310,2743,567,0.828701,0.171299,0.828701,525,42,3311,2744,567,0.828753,0.171247,0.828753,525,42,-1, merged,0,0,0
70455,1000328,4,1340,1013,327,0.75597,0.24403,3.15502,290,37,1341,1014,327,0.756152,0.243848,3.153687,290,37,1, merged,0,0,0
70455,1000329,2,4350,3402,948,0.782069,0.217931,1.61077,797,151,4353,3404,949,0.781989,0.218011,1.610742,798,151,-1, merged,1,0,0
70456,1000015,2,3011,2698,313,0.896048,0.103952,1.775454,286,27,3012,2699,313,0.896082,0.103918,1.775712,286,27,1, merged,0,0,0
70468,1000004,2,5410,4746,664,0.877264,0.122736,1.681922,525,139,5411,4747,664,0.877287,0.122713,1.681744,525,139,-1, merged,0,0,0
70468,1000014,1,3993,3213,780,0.804658,0.195342,0.804658,734,46,3994,3213,781,0.804457,0.195543,0.804457,735,46,1, merged,1,1,0
70469,1000328,1,1341,1014,327,0.756152,0.243848,0.756152,290,37,1342,1015,327,0.756334,0.243666,0.756334,290,37,1, merged,0,0,0
70471,1000007,2,2297,1851,446,0.805834,0.194166,1.645699,387,59,2298,1852,446,0.805918,0.194082,1.645963,387,59,1, merged,0,0,0
70471,1000026,1,893,750,143,0.839866,0.160134,0.839866,140,3,894,751,143,0.840045,0.159955,0.840045,140,3,-1, merged,0,0,0
70473,1000091,2,793,624,169,0.786885,0.213115,1.682839,141,28,794,625,169,0.787154,0.212846,1.683228,141,28,1, merged,0,0,0
70473,1000110,1,865,775,90,0.895954,0.104046,0.895954,83,7,866,776,90,0.896074,0.103926,0.896074,83,7,1, merged,0,0,0
70474,1000091,2,794,625,169,0.787154,0.212846,1.683228,141,28,795,626,169,0.787421,0.212579,1.683615,141,28,1, merged,0,0,0
70474,1000110,1,866,776,90,0.896074,0.103926,0.896074,83,7,867,777,90,0.896194,0.103806,0.896194,83,7,1, merged,0,0,0
70478,1000004,1,5411,4747,664,0.877287,0.122713,0.877287,525,139,5412,4747,665,0.877125,0.122875,0.877125,526,139,1, merged,1,1,0
70478,1000121,2,3311,2744,567,0.828753,0.171247,1.70604,525,42,3312,2744,568,0.828502,0.171498,1.705627,526,42,1, merged,1,1,0
70490,1000012,2,1134,985,149,0.868607,0.131393,1.748236,142,7,1135,986,149,0.868722,0.131278,1.748575,142,7,1, merged,0,0,0
70509,1000003,2,1770,1453,317,0.820904,0.179096,1.735706,266,51,1771,1454,317,0.821005,0.178995,1.73588,266,51,1, merged,0,0,0
70509,1000011,1,1162,1063,99,0.914802,0.085198,0.914802,92,7,1163,1064,99,0.914875,0.085125,0.914875,92,7,1, merged,0,0,0
70510,1000003,1,1771,1454,317,0.821005,0.178995,0.821005,266,51,1772,1455,317,0.821106,0.178894,0.821106,266,51,1, merged,0,0,0
70514,1000054,2,1591,1343,248,0.844123,0.155877,1.639796,228,20,1593,1344,249,0.843691,0.156309,1.637456,229,20,1, merged,1,1,0
70519,1000011,2,1163,1064,99,0.914875,0.085125,1.772553,92,7,1164,1065,99,0.914948,0.085052,1.773157,92,7,1, merged,0,0,0
70533,1000003,1,1773,1456,317,0.821207,0.178793,0.821207,266,51,1774,1457,317,0.821308,0.178692,0.821308,266,51,1, merged,0,0,0
70533,1000012,2,1135,986,149,0.868722,0.131278,1.689929,142,7,1136,987,149,0.868838,0.131162,1.690146,142,7,1, merged,0,0,0
70540,1000012,1,1136,987,149,0.868838,0.131162,0.868838,142,7,1137,988,149,0.868953,0.131047,0.868953,142,7,1, merged,0,0,0
70544,1000120,2,2738,2421,317,0.884222,0.115778,1.742431,275,42,2739,2422,317,0.884264,0.115736,1.743,275,42,1, merged,0,0,0
70545,1000014,1,3994,3213,781,0.804457,0.195543,0.804457,735,46,3997,3215,782,0.804353,0.195647,0.804353,736,46,1, merged,1,1,0
70548,1000007,5,2304,1858,446,0.806424,0.193576,3.97392,387,59,2306,1859,447,0.806158,0.193842,3.956825,388,59,1, merged,1,1,0
70548,1000015,1,3018,2704,314,0.895958,0.104042,0.895958,287,27,3021,2707,314,0.896061,0.103939,0.896061,287,27,-1, merged,0,0,0
70551,1000023,2,2466,2140,326,0.867802,0.132198,1.737257,290,36,2467,2141,326,0.867856,0.132144,1.737476,290,36,-1, abandoned,0,0,0
70555,1000015,3,3021,2707,314,0.896061,0.103939,2.426029,287,27,3022,2708,314,0.896095,0.103905,2.431488,287,27,1, merged,0,0,0
70560,1000014,3,3997,3215,782,0.804353,0.195647,2.463546,736,46,3998,3216,782,0.804402,0.195598,2.464277,736,46,1, merged,0,0,0
70560,1000120,2,2739,2422,317,0.884264,0.115736,1.659193,275,42,2740,2423,317,0.884307,0.115693,1.659875,275,42,1, merged,0,0,0
70567,1000012,1,1137,988,149,0.868953,0.131047,0.868953,142,7,1138,989,149,0.869069,0.130931,0.869069,142,7,1, merged,0,0,0
70567,1000026,2,894,751,143,0.840045,0.159955,1.708998,140,3,895,752,143,0.840223,0.159777,1.709292,140,3,1, merged,0,0,0
70573,1000328,1,1342,1015,327,0.756334,0.243666,0.756334,290,37,1343,1016,327,0.756515,0.243485,0.756515,290,37,1, merged,0,0,0
70573,1000329,2,4353,3404,949,0.781989,0.218011,1.538323,798,151,4354,3405,949,0.78204,0.21796,1.538555,798,151,1, merged,0,0,0
70574,1000328,1,1343,1016,327,0.756515,0.243485,0.756515,290,37,1344,1017,327,0.756696,0.243304,0.756696,290,37,1, merged,0,0,0
70574,1000329,2,4354,3405,949,0.78204,0.21796,1.538555,798,151,4355,3406,949,0.78209,0.21791,1.538786,798,151,1, merged,0,0,0
70575,1000329,1,4355,3406,949,0.78209,0.21791,0.78209,798,151,4356,3407,949,0.78214,0.21786,0.78214,798,151,1, merged,0,0,0
70587,1000014,1,3998,3216,782,0.804402,0.195598,0.804402,736,46,3999,3217,782,0.804451,0.195549,0.804451,736,46,1, merged,0,0,0
70592,1000005,2,1528,1307,221,0.855366,0.144634,1.675242,210,11,1529,1308,221,0.855461,0.144539,1.675895,210,11,1, merged,0,0,0
70594,1000121,2,3312,2744,568,0.828502,0.171498,1.66076,526,42,3313,2745,568,0.828554,0.171446,1.661352,526,42,1, merged,0,0,0
70595,1000014,1,3999,3217,782,0.804451,0.195549,0.804451,736,46,4000,3218,782,0.8045,0.1955,0.8045,736,46,1, merged,0,0,0
70598,1000023,2,2467,2141,326,0.867856,0.132144,1.740489,290,36,2468,2142,326,0.867909,0.132091,1.739043,290,36,-1, abandoned,0,0,0
70609,1000014,2,4000,3218,782,0.8045,0.1955,1.466038,736,46,4001,3219,782,0.804549,0.195451,1.471216,736,46,1, merged,0,0,0
70610,1000023,2,2468,2142,326,0.867909,0.132091,1.708726,290,36,2470,2144,326,0.868016,0.131984,1.709157,290,36,-1, merged,0,0,0
70617,1000014,1,4001,3219,782,0.804549,0.195451,0.804549,736,46,4002,3220,782,0.804598,0.195402,0.804598,736,46,1, merged,0,0,0
70641,1000003,2,1774,1457,317,0.821308,0.178692,1.745446,266,51,1775,1458,317,0.821408,0.178592,1.746066,266,51,1, merged,0,0,0
70644,1000043,1,802,663,139,0.826683,0.173317,0.826683,120,19,803,664,139,0.826899,0.173101,0.826899,120,19,1, merged,0,0,0
70645,1000003,1,1775,1458,317,0.821408,0.178592,0.821408,266,51,1776,1459,317,0.821509,0.178491,0.821509,266,51,1, merged,0,0,0
70645,1000012,2,1139,990,149,0.869183,0.130817,1.690592,142,7,1140,991,149,0.869298,0.130702,1.690807,142,7,1, merged,0,0,0
70647,1000014,2,4005,3223,782,0.804744,0.195256,1.59086,736,46,4006,3223,783,0.804543,0.195457,1.589187,737,46,1, merged,1,1,0
70682,1000130,1,1149,953,196,0.829417,0.170583,0.829417,154,42,1151,953,198,0.827976,0.172024,0.827976,154,44,-1, merged,1,1,0
70701,1000140,1,732,614,118,0.838798,0.161202,0.838798,106,12,734,616,118,0.839237,0.160763,0.839237,106,12,1, merged,0,0,0
70702,1000054,1,1602,1353,249,0.844569,0.155431,0.844569,229,20,1603,1354,249,0.844666,0.155334,0.844666,229,20,1, merged,0,0,0
